these candles helped themselves .	these candles helped himself .
these dolls lost themselves .	these dolls lost herself .
that bottle bothered herself .	that bottle bothered themselves .
that cup had n't lost herself .	that cup had n't lost themselves .
the pictures are bothering themselves .	the pictures are bothering himself .
the door must bother herself .	the door must bother themselves .
the crayon can understand himself .	the crayon can understand themselves .
the plates were n't listening to themselves .	the plates were n't listening to himself .
the rug scared herself .	the rug scared themselves .
these forks can n't listen to themselves .	these forks can n't listen to himself .
those glasses are n't working with themselves .	those glasses are n't working with herself .
the glasses had n't bothered themselves .	the glasses had n't bothered herself .
the hats have n't lost themselves .	the hats have n't lost himself .
that book scared herself .	that book scared themselves .
these crayons talk to themselves .	these crayons talk to herself .
the plate talked to herself .	the plate talked to themselves .
that doll taught herself .	that doll taught themselves .
these books found themselves .	these books found himself .
that car found herself .	that car found themselves .
those trucks had scared themselves .	those trucks had scared himself .
these bowls had worried themselves .	these bowls had worried herself .
this candle taught herself .	this candle taught themselves .
the bottles must help themselves .	the bottles must help himself .
the buttons visit themselves .	the buttons visit himself .
this car taught herself .	this car taught themselves .
that car scares himself .	that car scares themselves .
these pictures taught themselves .	these pictures taught herself .
those dishes listen to themselves .	those dishes listen to herself .
these pictures listen to themselves .	these pictures listen to himself .
these cars visit themselves .	these cars visit herself .
this shoe might answer herself .	this shoe might answer themselves .
that shirt was n't helping himself .	that shirt was n't helping themselves .
that truck will work with himself .	that truck will work with themselves .
those books worked with themselves .	those books worked with himself .
the shirts visited themselves .	the shirts visited himself .
the couch did n't work with himself .	the couch did n't work with themselves .
the beds listen to themselves .	the beds listen to himself .
the bowls had found themselves .	the bowls had found herself .
those boats understand themselves .	those boats understand himself .
these cars understand themselves .	these cars understand herself .
the bowls worried themselves .	the bowls worried herself .
these shirts work with themselves .	these shirts work with himself .
the car had n't answered herself .	the car had n't answered themselves .
that bottle is n't talking to herself .	that bottle is n't talking to themselves .
this crayon scared himself .	this crayon scared themselves .
the bicycle will praise herself .	the bicycle will praise themselves .
that spoon helps himself .	that spoon helps themselves .
the crayons answered themselves .	the crayons answered himself .
the chair talks to herself .	the chair talks to themselves .
that box worked with himself .	that box worked with themselves .
those cups worked with themselves .	those cups worked with himself .
the shirt had n't helped himself .	the shirt had n't helped themselves .
the book could n't understand himself .	the book could n't understand themselves .
those chairs might understand themselves .	those chairs might understand himself .
the cups may listen to themselves .	the cups may listen to himself .
the candles did n't visit themselves .	the candles did n't visit himself .
the glasses taught themselves .	the glasses taught herself .
these toys have n't talked to themselves .	these toys have n't talked to herself .
the ring has confused herself .	the ring has confused themselves .
this rocket has n't confused herself .	this rocket has n't confused themselves .
that book lost herself .	that book lost themselves .
the plane has talked to herself .	the plane has talked to themselves .
those cups could n't scare themselves .	those cups could n't scare himself .
the toy bothered himself .	the toy bothered themselves .
those dolls are n't visiting themselves .	those dolls are n't visiting himself .
that ship lost herself .	that ship lost themselves .
these pictures wo n't understand themselves .	these pictures wo n't understand himself .
the shirts are helping themselves .	the shirts are helping himself .
these hats scare themselves .	these hats scare herself .
the books are n't working with themselves .	the books are n't working with himself .
those pictures were working with themselves .	those pictures were working with himself .
those dolls bothered themselves .	those dolls bothered herself .
that bag wo n't appreciate himself .	that bag wo n't appreciate themselves .
those bowls had bothered themselves .	those bowls had bothered himself .
those shoes could teach themselves .	those shoes could teach herself .
those books may teach themselves .	those books may teach himself .
the candle scares himself .	the candle scares themselves .
these crayons scared themselves .	these crayons scared himself .
those doors bother themselves .	those doors bother herself .
those books could bother themselves .	those books could bother himself .
the mirror would appreciate himself .	the mirror would appreciate themselves .
this candle helps herself .	this candle helps themselves .
the candles will listen to themselves .	the candles will listen to herself .
those pictures helped themselves .	those pictures helped himself .
these bottles bothered themselves .	these bottles bothered himself .
these crayons did n't appreciate themselves .	these crayons did n't appreciate himself .
this shirt lost himself .	this shirt lost themselves .
this plane talks to herself .	this plane talks to themselves .
that truck does n't praise herself .	that truck does n't praise themselves .
these bowls are visiting themselves .	these bowls are visiting himself .
this bed found himself .	this bed found themselves .
these rings answered themselves .	these rings answered himself .
the plates have taught themselves .	the plates have taught himself .
the buttons bothered themselves .	the buttons bothered herself .
these hats have n't scared themselves .	these hats have n't scared herself .
that chair is talking to himself .	that chair is talking to themselves .
the pictures had n't confused themselves .	the pictures had n't confused herself .
those crayons have visited themselves .	those crayons have visited himself .
this hat helped herself .	this hat helped themselves .
those books scare themselves .	those books scare herself .
the car is n't visiting himself .	the car is n't visiting themselves .
those chairs scare themselves .	those chairs scare herself .
those forks have helped themselves .	those forks have helped himself .
the chair should n't answer himself .	the chair should n't answer themselves .
those crayons are n't working with themselves .	those crayons are n't working with herself .
these buttons talked to themselves .	these buttons talked to himself .
that bag had n't scared herself .	that bag had n't scared themselves .
this doll did n't listen to himself .	this doll did n't listen to themselves .
those hats must bother themselves .	those hats must bother herself .
these dolls had n't worried themselves .	these dolls had n't worried herself .
the toy would n't praise herself .	the toy would n't praise themselves .
the rug does n't care for himself .	the rug does n't care for themselves .
that button helps herself .	that button helps themselves .
that bed wo n't answer himself .	that bed wo n't answer themselves .
that ship worried himself .	that ship worried themselves .
these books scare themselves .	these books scare herself .
the rocket scared herself .	the rocket scared themselves .
the shoe does n't work with himself .	the shoe does n't work with themselves .
the boats worry themselves .	the boats worry herself .
these buttons bother themselves .	these buttons bother himself .
those trucks teach themselves .	those trucks teach himself .
that hat had n't worked with himself .	that hat had n't worked with themselves .
this couch had confused herself .	this couch had confused themselves .
these shoes scared themselves .	these shoes scared himself .
the spoon is n't teaching herself .	the spoon is n't teaching themselves .
these bowls talked to themselves .	these bowls talked to himself .
these beds had n't lost themselves .	these beds had n't lost herself .
the box was bothering himself .	the box was bothering themselves .
this plane does n't visit himself .	this plane does n't visit themselves .
that book should teach himself .	that book should teach themselves .
these dolls listen to themselves .	these dolls listen to himself .
the rug had n't taught herself .	the rug had n't taught themselves .
those boxes would n't praise themselves .	those boxes would n't praise herself .
that chair is visiting himself .	that chair is visiting themselves .
those pictures praise themselves .	those pictures praise himself .
the cars bother themselves .	the cars bother herself .
the bowls answer themselves .	the bowls answer herself .
that door does n't understand herself .	that door does n't understand themselves .
this bicycle works with himself .	this bicycle works with themselves .
those spoons could praise themselves .	those spoons could praise himself .
these plates had n't helped themselves .	these plates had n't helped herself .
these cups are n't teaching themselves .	these cups are n't teaching himself .
the books talk to themselves .	the books talk to himself .
these dolls should n't worry themselves .	these dolls should n't worry herself .
the trucks visit themselves .	the trucks visit herself .
the mirror wo n't scare herself .	the mirror wo n't scare themselves .
the crayons have taught themselves .	the crayons have taught himself .
this bottle has n't scared herself .	this bottle has n't scared themselves .
those dolls would n't answer themselves .	those dolls would n't answer herself .
those boats do n't work with themselves .	those boats do n't work with herself .
the glasses were n't teaching themselves .	the glasses were n't teaching himself .
those beds have n't answered themselves .	those beds have n't answered herself .
the plates scared themselves .	the plates scared herself .
this bicycle has n't visited herself .	this bicycle has n't visited themselves .
these candles care for themselves .	these candles care for himself .
these chairs answered themselves .	these chairs answered herself .
the box has taught herself .	the box has taught themselves .
this glass has taught herself .	this glass has taught themselves .
those glasses did n't answer themselves .	those glasses did n't answer herself .
the boats would listen to themselves .	the boats would listen to himself .
that cup should help himself .	that cup should help themselves .
the boxes might worry themselves .	the boxes might worry herself .
those beds were n't talking to themselves .	those beds were n't talking to herself .
the shoes confused themselves .	the shoes confused himself .
the window might scare herself .	the window might scare themselves .
this rocket helps himself .	this rocket helps themselves .
that car helped herself .	that car helped themselves .
these spoons teach themselves .	these spoons teach herself .
the couch confused herself .	the couch confused themselves .
the bottles worried themselves .	the bottles worried herself .
these buttons can help themselves .	these buttons can help himself .
this chair had worried himself .	this chair had worried themselves .
this bicycle is n't visiting himself .	this bicycle is n't visiting themselves .
that ring will appreciate himself .	that ring will appreciate themselves .
these books answered themselves .	these books answered himself .
these dolls had n't talked to themselves .	these dolls had n't talked to himself .
the glasses care for themselves .	the glasses care for herself .
these bowls answer themselves .	these bowls answer herself .
those trucks taught themselves .	those trucks taught himself .
the car might care for herself .	the car might care for themselves .
this hat was n't bothering herself .	this hat was n't bothering themselves .
the shoes worked with themselves .	the shoes worked with herself .
those shoes had visited themselves .	those shoes had visited himself .
the trucks found themselves .	the trucks found himself .
the books are listening to themselves .	the books are listening to herself .
the cars answer themselves .	the cars answer himself .
the toy helps herself .	the toy helps themselves .
this window talked to herself .	this window talked to themselves .
those shirts had taught themselves .	those shirts had taught himself .
the trucks confused themselves .	the trucks confused herself .
those windows have confused themselves .	those windows have confused herself .
that bicycle talked to himself .	that bicycle talked to themselves .
that bottle lost himself .	that bottle lost themselves .
these toys had n't worked with themselves .	these toys had n't worked with himself .
these cups scare themselves .	these cups scare himself .
the plate had helped himself .	the plate had helped themselves .
this car should visit herself .	this car should visit themselves .
the pictures had lost themselves .	the pictures had lost herself .
those candles talked to themselves .	those candles talked to herself .
this boat talks to himself .	this boat talks to themselves .
the boat talked to himself .	the boat talked to themselves .
this shoe confused herself .	this shoe confused themselves .
the chairs bothered themselves .	the chairs bothered himself .
these boxes answered themselves .	these boxes answered herself .
these cars visited themselves .	these cars visited herself .
that truck bothered herself .	that truck bothered themselves .
those bowls lost themselves .	those bowls lost herself .
those cups were working with themselves .	those cups were working with herself .
that boat will talk to herself .	that boat will talk to themselves .
these buttons answered themselves .	these buttons answered himself .
the beds worked with themselves .	the beds worked with herself .
those crayons are n't bothering themselves .	those crayons are n't bothering himself .
the cars have n't lost themselves .	the cars have n't lost himself .
the spoons help themselves .	the spoons help himself .
the chairs teach themselves .	the chairs teach herself .
this shirt had n't lost herself .	this shirt had n't lost themselves .
the bowls are talking to themselves .	the bowls are talking to himself .
the plates are talking to themselves .	the plates are talking to herself .
this rocket bothered herself .	this rocket bothered themselves .
the candles teach themselves .	the candles teach himself .
this bed lost herself .	this bed lost themselves .
the bicycle must answer herself .	the bicycle must answer themselves .
this plate has talked to herself .	this plate has talked to themselves .
the couch should n't talk to herself .	the couch should n't talk to themselves .
these books answered themselves .	these books answered herself .
these books listen to themselves .	these books listen to himself .
those spoons were n't bothering themselves .	those spoons were n't bothering herself .
this rocket is visiting herself .	this rocket is visiting themselves .
the ring does n't answer himself .	the ring does n't answer themselves .
those dolls talked to themselves .	those dolls talked to herself .
the crayon was n't teaching himself .	the crayon was n't teaching themselves .
this candle must listen to herself .	this candle must listen to themselves .
these books have n't worked with themselves .	these books have n't worked with himself .
these boats listen to themselves .	these boats listen to herself .
the book is teaching himself .	the book is teaching themselves .
the beds should n't teach themselves .	the beds should n't teach himself .
these plates worked with themselves .	these plates worked with himself .
this plate was talking to himself .	this plate was talking to themselves .
the shoes had confused themselves .	the shoes had confused himself .
this rug worked with himself .	this rug worked with themselves .
those boxes should n't care for themselves .	those boxes should n't care for herself .
that glass talked to herself .	that glass talked to themselves .
the books are n't bothering themselves .	the books are n't bothering herself .
those dishes confused themselves .	those dishes confused himself .
the ring was working with himself .	the ring was working with themselves .
those dolls had n't bothered themselves .	those dolls had n't bothered herself .
that picture is n't visiting herself .	that picture is n't visiting themselves .
the books bother themselves .	the books bother himself .
those cars visit themselves .	those cars visit himself .
the beds care for themselves .	the beds care for himself .
the toy might understand herself .	the toy might understand themselves .
that candle could listen to herself .	that candle could listen to themselves .
these doors taught themselves .	these doors taught herself .
these forks would n't worry themselves .	these forks would n't worry herself .
those crayons answered themselves .	those crayons answered himself .
that hat could n't work with herself .	that hat could n't work with themselves .
this boat scares herself .	this boat scares themselves .
the hats visited themselves .	the hats visited himself .
these shirts have visited themselves .	these shirts have visited himself .
the plates talk to themselves .	the plates talk to herself .
these pictures work with themselves .	these pictures work with himself .
those cars were teaching themselves .	those cars were teaching herself .
these bags were n't talking to themselves .	these bags were n't talking to himself .
that bicycle must scare herself .	that bicycle must scare themselves .
the toys have n't answered themselves .	the toys have n't answered herself .
that glass has scared himself .	that glass has scared themselves .
these books scared themselves .	these books scared himself .
this bag must praise herself .	this bag must praise themselves .
these dolls are teaching themselves .	these dolls are teaching herself .
the toy is teaching himself .	the toy is teaching themselves .
these chairs praise themselves .	these chairs praise himself .
that book has n't talked to herself .	that book has n't talked to themselves .
the book will listen to herself .	the book will listen to themselves .
the candles bother themselves .	the candles bother himself .
the buttons were n't teaching themselves .	the buttons were n't teaching herself .
the dishes lost themselves .	the dishes lost himself .
that bowl visited herself .	that bowl visited themselves .
this ring had n't confused himself .	this ring had n't confused themselves .
that couch was talking to himself .	that couch was talking to themselves .
the boat works with himself .	the boat works with themselves .
this shirt has n't lost himself .	this shirt has n't lost themselves .
those shoes wo n't appreciate themselves .	those shoes wo n't appreciate herself .
the door helps herself .	the door helps themselves .
these chairs were bothering themselves .	these chairs were bothering herself .
those cars teach themselves .	those cars teach herself .
those pictures would n't work with themselves .	those pictures would n't work with herself .
this bag helps himself .	this bag helps themselves .
this book visited herself .	this book visited themselves .
those cars had confused themselves .	those cars had confused himself .
the trucks had worried themselves .	the trucks had worried himself .
this car has bothered himself .	this car has bothered themselves .
those doors visited themselves .	those doors visited himself .
that glass will care for himself .	that glass will care for themselves .
those buttons are n't talking to themselves .	those buttons are n't talking to herself .
those spoons can bother themselves .	those spoons can bother herself .
these pictures scare themselves .	these pictures scare himself .
the chairs had confused themselves .	the chairs had confused herself .
that book is n't working with herself .	that book is n't working with themselves .
the candles will appreciate themselves .	the candles will appreciate himself .
the bottle was n't bothering himself .	the bottle was n't bothering themselves .
those windows did n't visit themselves .	those windows did n't visit herself .
the books had n't scared themselves .	the books had n't scared himself .
the bottle has n't confused himself .	the bottle has n't confused themselves .
these toys can answer themselves .	these toys can answer herself .
the forks worried themselves .	the forks worried himself .
the doors had n't visited themselves .	the doors had n't visited herself .
these rings work with themselves .	these rings work with himself .
the glasses may praise themselves .	the glasses may praise herself .
these windows understand themselves .	these windows understand himself .
those boxes should n't answer themselves .	those boxes should n't answer himself .
those cups are n't bothering themselves .	those cups are n't bothering himself .
these forks talk to themselves .	these forks talk to himself .
these cups were visiting themselves .	these cups were visiting himself .
the spoons had scared themselves .	the spoons had scared herself .
those books help themselves .	those books help himself .
these cups could bother themselves .	these cups could bother himself .
the bowl had answered himself .	the bowl had answered themselves .
the plates helped themselves .	the plates helped himself .
the bowl was visiting himself .	the bowl was visiting themselves .
this chair is bothering himself .	this chair is bothering themselves .
that hat worked with himself .	that hat worked with themselves .
the beds do n't praise themselves .	the beds do n't praise himself .
the hat found himself .	the hat found themselves .
these forks work with themselves .	these forks work with herself .
these bottles did n't scare themselves .	these bottles did n't scare herself .
these dolls lost themselves .	these dolls lost himself .
that crayon has found herself .	that crayon has found themselves .
that fork worried himself .	that fork worried themselves .
those bowls were teaching themselves .	those bowls were teaching himself .
this book can n't listen to herself .	this book can n't listen to themselves .
that picture is helping himself .	that picture is helping themselves .
these hats are bothering themselves .	these hats are bothering himself .
this shoe has n't visited himself .	this shoe has n't visited themselves .
the ship can n't understand himself .	the ship can n't understand themselves .
the candle had n't visited himself .	the candle had n't visited themselves .
these hats can work with themselves .	these hats can work with herself .
the ship could scare himself .	the ship could scare themselves .
the toys had scared themselves .	the toys had scared himself .
that bed had n't scared himself .	that bed had n't scared themselves .
this rug was n't teaching himself .	this rug was n't teaching themselves .
those bowls bother themselves .	those bowls bother herself .
that dish worked with herself .	that dish worked with themselves .
those pictures are n't bothering themselves .	those pictures are n't bothering herself .
this boat is n't teaching herself .	this boat is n't teaching themselves .
that crayon could n't bother herself .	that crayon could n't bother themselves .
this book talked to himself .	this book talked to themselves .
the beds taught themselves .	the beds taught herself .
this door talked to himself .	this door talked to themselves .
the doors visit themselves .	the doors visit himself .
the dolls are working with themselves .	the dolls are working with herself .
this window was listening to herself .	this window was listening to themselves .
that plate has lost himself .	that plate has lost themselves .
that boat was n't working with herself .	that boat was n't working with themselves .
this plate lost himself .	this plate lost themselves .
the chairs will care for themselves .	the chairs will care for herself .
this fork could praise himself .	this fork could praise themselves .
the car lost himself .	the car lost themselves .
this car has n't taught himself .	this car has n't taught themselves .
the bowls work with themselves .	the bowls work with himself .
those cups worry themselves .	those cups worry himself .
the beds were listening to themselves .	the beds were listening to herself .
the buttons scared themselves .	the buttons scared himself .
that ring might worry herself .	that ring might worry themselves .
the boat would teach herself .	the boat would teach themselves .
that book could work with herself .	that book could work with themselves .
the ring must appreciate himself .	the ring must appreciate themselves .
these spoons should praise themselves .	these spoons should praise himself .
the shoe has worked with himself .	the shoe has worked with themselves .
these spoons have n't talked to themselves .	these spoons have n't talked to herself .
the hat is n't listening to herself .	the hat is n't listening to themselves .
these bottles confused themselves .	these bottles confused herself .
this box wo n't praise herself .	this box wo n't praise themselves .
this doll had n't found himself .	this doll had n't found themselves .
that truck lost himself .	that truck lost themselves .
the cars could n't appreciate themselves .	the cars could n't appreciate himself .
these dishes teach themselves .	these dishes teach herself .
this spoon talked to herself .	this spoon talked to themselves .
the rug understands himself .	the rug understands themselves .
the toy should n't bother himself .	the toy should n't bother themselves .
the car confused himself .	the car confused themselves .
those bottles should n't care for themselves .	those bottles should n't care for himself .
the door was n't visiting himself .	the door was n't visiting themselves .
these shoes were n't teaching themselves .	these shoes were n't teaching herself .
the chair is bothering herself .	the chair is bothering themselves .
the glass confused herself .	the glass confused themselves .
the trucks visited themselves .	the trucks visited herself .
the cars scared themselves .	the cars scared herself .
these crayons scare themselves .	these crayons scare herself .
this toy had n't scared herself .	this toy had n't scared themselves .
this rocket has taught himself .	this rocket has taught themselves .
that door worried herself .	that door worried themselves .
those shoes can n't appreciate themselves .	those shoes can n't appreciate himself .
this fork works with herself .	this fork works with themselves .
those chairs had n't talked to themselves .	those chairs had n't talked to himself .
this box had worried himself .	this box had worried themselves .
that bowl could talk to herself .	that bowl could talk to themselves .
the windows are n't talking to themselves .	the windows are n't talking to himself .
those crayons are talking to themselves .	those crayons are talking to himself .
those beds had lost themselves .	those beds had lost herself .
those bottles visited themselves .	those bottles visited himself .
the book had n't worried himself .	the book had n't worried themselves .
those books had n't taught themselves .	those books had n't taught herself .
the plates confused themselves .	the plates confused himself .
the door helps himself .	the door helps themselves .
these crayons found themselves .	these crayons found himself .
those boxes answered themselves .	those boxes answered herself .
those bowls were n't listening to themselves .	those bowls were n't listening to himself .
the boat is working with himself .	the boat is working with themselves .
these rings care for themselves .	these rings care for himself .
the door might worry herself .	the door might worry themselves .
these boxes talked to themselves .	these boxes talked to herself .
this crayon answered herself .	this crayon answered themselves .
the doors could n't teach themselves .	the doors could n't teach himself .
that bag scares himself .	that bag scares themselves .
those chairs have n't bothered themselves .	those chairs have n't bothered himself .
this bicycle is n't working with himself .	this bicycle is n't working with themselves .
these shoes are n't bothering themselves .	these shoes are n't bothering herself .
these doors visited themselves .	these doors visited himself .
those cars confused themselves .	those cars confused herself .
these dolls would n't visit themselves .	these dolls would n't visit himself .
this hat should answer himself .	this hat should answer themselves .
these toys had talked to themselves .	these toys had talked to herself .
that boat was listening to himself .	that boat was listening to themselves .
the bags could answer themselves .	the bags could answer herself .
that ring bothered himself .	that ring bothered themselves .
that boat had scared himself .	that boat had scared themselves .
that box is talking to herself .	that box is talking to themselves .
this shirt talked to himself .	this shirt talked to themselves .
the car is n't helping himself .	the car is n't helping themselves .
this plate could n't answer herself .	this plate could n't answer themselves .
these rings helped themselves .	these rings helped herself .
those forks visit themselves .	those forks visit herself .
this picture helped himself .	this picture helped themselves .
the dishes listen to themselves .	the dishes listen to herself .
this shoe found herself .	this shoe found themselves .
those rings had n't bothered themselves .	those rings had n't bothered himself .
this window visited herself .	this window visited themselves .
that cup was n't helping himself .	that cup was n't helping themselves .
the book is n't visiting himself .	the book is n't visiting themselves .
the truck would worry herself .	the truck would worry themselves .
those shoes visit themselves .	those shoes visit herself .
those books talk to themselves .	those books talk to herself .
the books should n't scare themselves .	the books should n't scare himself .
those plates teach themselves .	those plates teach herself .
that bag may visit himself .	that bag may visit themselves .
the bowl has visited himself .	the bowl has visited themselves .
this couch was working with himself .	this couch was working with themselves .
those rings care for themselves .	those rings care for himself .
the bowls taught themselves .	the bowls taught himself .
the toys should help themselves .	the toys should help himself .
the bottles should n't talk to themselves .	the bottles should n't talk to herself .
the ship could praise herself .	the ship could praise themselves .
these books care for themselves .	these books care for herself .
these beds could n't worry themselves .	these beds could n't worry himself .
that rocket does n't answer himself .	that rocket does n't answer themselves .
these shirts had visited themselves .	these shirts had visited herself .
this bottle wo n't listen to herself .	this bottle wo n't listen to themselves .
the rocket taught himself .	the rocket taught themselves .
that button has n't bothered himself .	that button has n't bothered themselves .
the shirt talked to herself .	the shirt talked to themselves .
the windows could n't praise themselves .	the windows could n't praise herself .
the car is helping herself .	the car is helping themselves .
those dolls had n't found themselves .	those dolls had n't found herself .
the bed helps himself .	the bed helps themselves .
the doll has lost herself .	the doll has lost themselves .
this hat visited himself .	this hat visited themselves .
the car bothered herself .	the car bothered themselves .
the glass worked with himself .	the glass worked with themselves .
these boxes are n't bothering themselves .	these boxes are n't bothering herself .
those buttons understand themselves .	those buttons understand herself .
those boxes answer themselves .	those boxes answer himself .
these boats wo n't worry themselves .	these boats wo n't worry himself .
this bottle should bother herself .	this bottle should bother themselves .
the cars had n't worried themselves .	the cars had n't worried herself .
the shirt has worked with herself .	the shirt has worked with themselves .
this shirt visited herself .	this shirt visited themselves .
this bowl talked to himself .	this bowl talked to themselves .
those cars are visiting themselves .	those cars are visiting herself .
these bottles can n't answer themselves .	these bottles can n't answer herself .
those bowls had scared themselves .	those bowls had scared herself .
the shoe should n't visit herself .	the shoe should n't visit themselves .
those rings do n't help themselves .	those rings do n't help herself .
that rocket was n't visiting herself .	that rocket was n't visiting themselves .
that bottle did n't answer himself .	that bottle did n't answer themselves .
this hat found herself .	this hat found themselves .
the books had found themselves .	the books had found himself .
those plates work with themselves .	those plates work with himself .
these buttons care for themselves .	these buttons care for himself .
the boats should n't talk to themselves .	the boats should n't talk to himself .
the cup was listening to himself .	the cup was listening to themselves .
the candles help themselves .	the candles help himself .
these forks could scare themselves .	these forks could scare herself .
the dish has n't talked to himself .	the dish has n't talked to themselves .
the plate is n't helping himself .	the plate is n't helping themselves .
this bowl has n't worried herself .	this bowl has n't worried themselves .
these bowls found themselves .	these bowls found herself .
the cars have talked to themselves .	the cars have talked to himself .
these windows taught themselves .	these windows taught herself .
that plane can n't bother himself .	that plane can n't bother themselves .
that boat has n't talked to herself .	that boat has n't talked to themselves .
that plane worked with himself .	that plane worked with themselves .
those spoons have n't talked to themselves .	those spoons have n't talked to herself .
the books can n't teach themselves .	the books can n't teach herself .
that truck was n't working with herself .	that truck was n't working with themselves .
the boats found themselves .	the boats found herself .
that ship understands herself .	that ship understands themselves .
that shirt was helping himself .	that shirt was helping themselves .
those windows had n't visited themselves .	those windows had n't visited himself .
the ring lost herself .	the ring lost themselves .
this hat scares himself .	this hat scares themselves .
the ring is bothering herself .	the ring is bothering themselves .
the rings are n't teaching themselves .	the rings are n't teaching herself .
these trucks have n't visited themselves .	these trucks have n't visited himself .
that book has confused herself .	that book has confused themselves .
the truck was working with himself .	the truck was working with themselves .
that ring scares himself .	that ring scares themselves .
this bag might worry herself .	this bag might worry themselves .
that ring was n't teaching himself .	that ring was n't teaching themselves .
that ship did n't answer himself .	that ship did n't answer themselves .
that dish worked with himself .	that dish worked with themselves .
this rocket was n't visiting herself .	this rocket was n't visiting themselves .
that mirror wo n't visit herself .	that mirror wo n't visit themselves .
the cup was talking to herself .	the cup was talking to themselves .
the spoons help themselves .	the spoons help herself .
those spoons could work with themselves .	those spoons could work with herself .
the forks had n't taught themselves .	the forks had n't taught herself .
the spoons helped themselves .	the spoons helped himself .
the spoons talk to themselves .	the spoons talk to himself .
those candles found themselves .	those candles found himself .
that plane should n't listen to herself .	that plane should n't listen to themselves .
the dishes worry themselves .	the dishes worry himself .
the forks had n't answered themselves .	the forks had n't answered himself .
this hat should n't bother himself .	this hat should n't bother themselves .
this chair has n't bothered himself .	this chair has n't bothered themselves .
the glasses do n't worry themselves .	the glasses do n't worry himself .
these forks found themselves .	these forks found himself .
the hat visited himself .	the hat visited themselves .
the doors scare themselves .	the doors scare himself .
this fork can care for herself .	this fork can care for themselves .
that cup should n't listen to herself .	that cup should n't listen to themselves .
those cars had n't taught themselves .	those cars had n't taught himself .
these dolls are n't talking to themselves .	these dolls are n't talking to himself .
that rug would bother herself .	that rug would bother themselves .
this window should n't answer herself .	this window should n't answer themselves .
these plates have n't helped themselves .	these plates have n't helped herself .
these boxes scare themselves .	these boxes scare himself .
the bowls were n't teaching themselves .	the bowls were n't teaching herself .
that rug understands himself .	that rug understands themselves .
that rug did n't listen to himself .	that rug did n't listen to themselves .
this spoon has n't helped himself .	this spoon has n't helped themselves .
these buttons do n't worry themselves .	these buttons do n't worry himself .
these dolls answer themselves .	these dolls answer herself .
these cups have found themselves .	these cups have found himself .
the plate helped herself .	the plate helped themselves .
the books are n't talking to themselves .	the books are n't talking to himself .
the plane was helping herself .	the plane was helping themselves .
the picture could answer himself .	the picture could answer themselves .
the beds can n't help themselves .	the beds can n't help herself .
this car might care for herself .	this car might care for themselves .
this shirt wo n't care for herself .	this shirt wo n't care for themselves .
that plane was n't working with himself .	that plane was n't working with themselves .
that crayon worked with herself .	that crayon worked with themselves .
this bag scares himself .	this bag scares themselves .
the forks were n't teaching themselves .	the forks were n't teaching herself .
the rocket is n't working with herself .	the rocket is n't working with themselves .
those windows help themselves .	those windows help herself .
that bowl wo n't scare himself .	that bowl wo n't scare themselves .
the plates had lost themselves .	the plates had lost himself .
the door was bothering himself .	the door was bothering themselves .
those dishes understand themselves .	those dishes understand himself .
these chairs were n't helping themselves .	these chairs were n't helping herself .
these boats worked with themselves .	these boats worked with herself .
the shoe had n't talked to herself .	the shoe had n't talked to themselves .
the chairs had n't talked to themselves .	the chairs had n't talked to herself .
this toy taught herself .	this toy taught themselves .
the candles will visit themselves .	the candles will visit himself .
the hats care for themselves .	the hats care for herself .
the mirror will visit herself .	the mirror will visit themselves .
the bag is n't helping herself .	the bag is n't helping themselves .
those toys visit themselves .	those toys visit himself .
these trucks answer themselves .	these trucks answer herself .
those boxes are n't visiting themselves .	those boxes are n't visiting herself .
those candles would n't help themselves .	those candles would n't help herself .
this candle has n't lost himself .	this candle has n't lost themselves .
these chairs were n't teaching themselves .	these chairs were n't teaching herself .
these trucks had n't talked to themselves .	these trucks had n't talked to herself .
the cups are listening to themselves .	the cups are listening to herself .
this box talked to herself .	this box talked to themselves .
the toys do n't bother themselves .	the toys do n't bother herself .
the plane would n't listen to herself .	the plane would n't listen to themselves .
that box was n't bothering himself .	that box was n't bothering themselves .
the button has n't talked to himself .	the button has n't talked to themselves .
this truck must teach herself .	this truck must teach themselves .
these bottles will scare themselves .	these bottles will scare himself .
the car has n't worried himself .	the car has n't worried themselves .
those rings teach themselves .	those rings teach herself .
the forks can praise themselves .	the forks can praise himself .
the books did n't teach themselves .	the books did n't teach himself .
this hat lost herself .	this hat lost themselves .
the trucks talked to themselves .	the trucks talked to himself .
these cups could worry themselves .	these cups could worry himself .
those buttons were n't helping themselves .	those buttons were n't helping herself .
the forks could work with themselves .	the forks could work with herself .
the window worked with himself .	the window worked with themselves .
the crayons talk to themselves .	the crayons talk to himself .
this doll is n't helping herself .	this doll is n't helping themselves .
that car had n't bothered herself .	that car had n't bothered themselves .
these books were talking to themselves .	these books were talking to himself .
this boat will talk to herself .	this boat will talk to themselves .
the box may appreciate himself .	the box may appreciate themselves .
that car understands himself .	that car understands themselves .
this plate works with himself .	this plate works with themselves .
the crayon has found himself .	the crayon has found themselves .
this shoe may praise himself .	this shoe may praise themselves .
this bed talks to himself .	this bed talks to themselves .
the button must praise himself .	the button must praise themselves .
the book scares himself .	the book scares themselves .
this couch had n't talked to herself .	this couch had n't talked to themselves .
those doors care for themselves .	those doors care for himself .
that plane scares herself .	that plane scares themselves .
the shoe can visit himself .	the shoe can visit themselves .
that picture had n't scared himself .	that picture had n't scared themselves .
this glass can n't praise herself .	this glass can n't praise themselves .
the crayon worried himself .	the crayon worried themselves .
the bag is working with herself .	the bag is working with themselves .
those beds appreciate themselves .	those beds appreciate herself .
that cup was n't talking to herself .	that cup was n't talking to themselves .
this plate would n't work with herself .	this plate would n't work with themselves .
these forks would appreciate themselves .	these forks would appreciate himself .
the chairs wo n't teach themselves .	the chairs wo n't teach himself .
those pictures work with themselves .	those pictures work with himself .
the bowls must talk to themselves .	the bowls must talk to herself .
those shirts must talk to themselves .	those shirts must talk to herself .
these spoons had lost themselves .	these spoons had lost herself .
those cars bothered themselves .	those cars bothered herself .
the chairs did n't work with themselves .	the chairs did n't work with himself .
these cars wo n't understand themselves .	these cars wo n't understand himself .
those spoons are working with themselves .	those spoons are working with himself .
that rug understands herself .	that rug understands themselves .
this dish has worried herself .	this dish has worried themselves .
this fork has worried herself .	this fork has worried themselves .
the bowl had talked to herself .	the bowl had talked to themselves .
the boxes are visiting themselves .	the boxes are visiting herself .
that bag talked to herself .	that bag talked to themselves .
the cars worried themselves .	the cars worried himself .
the bicycle had scared herself .	the bicycle had scared themselves .
the shoes were n't teaching themselves .	the shoes were n't teaching himself .
these crayons would worry themselves .	these crayons would worry himself .
that ring should n't talk to herself .	that ring should n't talk to themselves .
the cups might talk to themselves .	the cups might talk to herself .
these windows had scared themselves .	these windows had scared himself .
those spoons could n't worry themselves .	those spoons could n't worry himself .
the bottles visited themselves .	the bottles visited himself .
this doll answered herself .	this doll answered themselves .
that truck helps himself .	that truck helps themselves .
these forks were teaching themselves .	these forks were teaching herself .
the buttons work with themselves .	the buttons work with himself .
that car must teach himself .	that car must teach themselves .
these doors had visited themselves .	these doors had visited herself .
this door had n't found herself .	this door had n't found themselves .
this truck visited himself .	this truck visited themselves .
the boat has n't bothered herself .	the boat has n't bothered themselves .
the rocket confused herself .	the rocket confused themselves .
those rings confused themselves .	those rings confused herself .
the car would n't scare herself .	the car would n't scare themselves .
this window might listen to herself .	this window might listen to themselves .
those beds visit themselves .	those beds visit himself .
those boats had talked to themselves .	those boats had talked to herself .
that plate talks to himself .	that plate talks to themselves .
these toys were n't talking to themselves .	these toys were n't talking to himself .
the spoon was helping herself .	the spoon was helping themselves .
the boats have talked to themselves .	the boats have talked to herself .
that rocket talked to herself .	that rocket talked to themselves .
the cars talked to themselves .	the cars talked to himself .
these beds have confused themselves .	these beds have confused herself .
the rings had confused themselves .	the rings had confused himself .
that chair is helping herself .	that chair is helping themselves .
that dish bothered himself .	that dish bothered themselves .
that plate should n't appreciate himself .	that plate should n't appreciate themselves .
the mirror could n't help herself .	the mirror could n't help themselves .
this rocket worked with herself .	this rocket worked with themselves .
these trucks confused themselves .	these trucks confused himself .
those rings helped themselves .	those rings helped himself .
that crayon taught herself .	that crayon taught themselves .
the bicycle had n't scared himself .	the bicycle had n't scared themselves .
this cup has n't bothered herself .	this cup has n't bothered themselves .
that bottle has bothered himself .	that bottle has bothered themselves .
these books had visited themselves .	these books had visited himself .
this car can n't visit herself .	this car can n't visit themselves .
the beds wo n't teach themselves .	the beds wo n't teach herself .
these books are n't bothering themselves .	these books are n't bothering himself .
those shoes found themselves .	those shoes found himself .
those cups work with themselves .	those cups work with himself .
this fork would n't teach himself .	this fork would n't teach themselves .
that truck found himself .	that truck found themselves .
those windows had helped themselves .	those windows had helped herself .
that crayon is n't talking to himself .	that crayon is n't talking to themselves .
these windows bothered themselves .	these windows bothered himself .
the rug answered himself .	the rug answered themselves .
those rings did n't listen to themselves .	those rings did n't listen to himself .
this book had n't answered himself .	this book had n't answered themselves .
these cars had n't visited themselves .	these cars had n't visited himself .
that doll was n't teaching himself .	that doll was n't teaching themselves .
the plates visit themselves .	the plates visit herself .
the shirt understands himself .	the shirt understands themselves .
these doors have lost themselves .	these doors have lost himself .
these forks scare themselves .	these forks scare herself .
the ship talks to himself .	the ship talks to themselves .
the window scared himself .	the window scared themselves .
the picture talks to herself .	the picture talks to themselves .
those cups were n't listening to themselves .	those cups were n't listening to herself .
the crayon lost himself .	the crayon lost themselves .
that window has confused himself .	that window has confused themselves .
these spoons should n't answer themselves .	these spoons should n't answer himself .
these bowls worried themselves .	these bowls worried himself .
those cups should n't answer themselves .	those cups should n't answer himself .
these cars lost themselves .	these cars lost himself .
this window helps himself .	this window helps themselves .
these boats lost themselves .	these boats lost himself .
the candles answer themselves .	the candles answer herself .
those shoes are bothering themselves .	those shoes are bothering himself .
the bag has talked to himself .	the bag has talked to themselves .
these doors visit themselves .	these doors visit herself .
those pictures taught themselves .	those pictures taught herself .
this bottle helped himself .	this bottle helped themselves .
that crayon does n't worry herself .	that crayon does n't worry themselves .
the trucks understand themselves .	the trucks understand herself .
the spoons had n't taught themselves .	the spoons had n't taught herself .
the toy has found herself .	the toy has found themselves .
the bicycle understands herself .	the bicycle understands themselves .
the rug helps herself .	the rug helps themselves .
the doll had visited herself .	the doll had visited themselves .
the rings worked with themselves .	the rings worked with herself .
these spoons were n't talking to themselves .	these spoons were n't talking to herself .
these hats talk to themselves .	these hats talk to herself .
the hats bothered themselves .	the hats bothered herself .
that candle might talk to himself .	that candle might talk to themselves .
this bed bothered himself .	this bed bothered themselves .
this rug found himself .	this rug found themselves .
the cups were listening to themselves .	the cups were listening to himself .
these buttons are n't helping themselves .	these buttons are n't helping himself .
those plates had lost themselves .	those plates had lost himself .
those glasses appreciate themselves .	those glasses appreciate himself .
the ship found himself .	the ship found themselves .
that shoe wo n't scare herself .	that shoe wo n't scare themselves .
those forks should bother themselves .	those forks should bother herself .
that door understands herself .	that door understands themselves .
that crayon had n't talked to himself .	that crayon had n't talked to themselves .
the windows could listen to themselves .	the windows could listen to himself .
that hat does n't worry herself .	that hat does n't worry themselves .
those plates bother themselves .	those plates bother himself .
the cars should understand themselves .	the cars should understand herself .
that candle talked to herself .	that candle talked to themselves .
the trucks wo n't visit themselves .	the trucks wo n't visit herself .
the doll talked to himself .	the doll talked to themselves .
those candles appreciate themselves .	those candles appreciate himself .
the ship would n't scare himself .	the ship would n't scare themselves .
the spoons would help themselves .	the spoons would help himself .
that hat has visited herself .	that hat has visited themselves .
this mirror taught himself .	this mirror taught themselves .
that candle has n't scared herself .	that candle has n't scared themselves .
these chairs will praise themselves .	these chairs will praise herself .
these dolls had worried themselves .	these dolls had worried herself .
the trucks praise themselves .	the trucks praise herself .
these pictures help themselves .	these pictures help herself .
those dolls have helped themselves .	those dolls have helped himself .
this rocket was visiting herself .	this rocket was visiting themselves .
the fork talked to herself .	the fork talked to themselves .
that bowl works with herself .	that bowl works with themselves .
those bags have n't visited themselves .	those bags have n't visited himself .
those chairs had helped themselves .	those chairs had helped himself .
the toys wo n't understand themselves .	the toys wo n't understand himself .
these books worried themselves .	these books worried herself .
the ship is n't helping himself .	the ship is n't helping themselves .
the shoes should help themselves .	the shoes should help himself .
this mirror may help herself .	this mirror may help themselves .
this glass could visit himself .	this glass could visit themselves .
that bottle bothered himself .	that bottle bothered themselves .
those cars work with themselves .	those cars work with himself .
this picture had confused herself .	this picture had confused themselves .
this bag visited himself .	this bag visited themselves .
the cups would help themselves .	the cups would help himself .
these forks had n't visited themselves .	these forks had n't visited himself .
that plane would teach herself .	that plane would teach themselves .
those books listen to themselves .	those books listen to herself .
the spoons work with themselves .	the spoons work with himself .
that mirror taught himself .	that mirror taught themselves .
the bowls should talk to themselves .	the bowls should talk to herself .
these spoons should n't praise themselves .	these spoons should n't praise herself .
those books teach themselves .	those books teach himself .
these hats have scared themselves .	these hats have scared himself .
that cup works with himself .	that cup works with themselves .
those bags answer themselves .	those bags answer herself .
these doors helped themselves .	these doors helped himself .
these dolls had visited themselves .	these dolls had visited himself .
those beds may understand themselves .	those beds may understand himself .
that truck had visited himself .	that truck had visited themselves .
the cups visit themselves .	the cups visit himself .
that couch can bother himself .	that couch can bother themselves .
the cups worked with themselves .	the cups worked with herself .
the plates can help themselves .	the plates can help herself .
that book taught himself .	that book taught themselves .
that bed talks to himself .	that bed talks to themselves .
those chairs would n't care for themselves .	those chairs would n't care for herself .
these cups had n't bothered themselves .	these cups had n't bothered herself .
the books are n't listening to themselves .	the books are n't listening to herself .
the boxes bothered themselves .	the boxes bothered herself .
this car had talked to himself .	this car had talked to themselves .
the rocket talks to himself .	the rocket talks to themselves .
this box has n't talked to himself .	this box has n't talked to themselves .
those cars had bothered themselves .	those cars had bothered himself .
that book scared himself .	that book scared themselves .
those books must teach themselves .	those books must teach herself .
the crayons have n't worked with themselves .	the crayons have n't worked with himself .
this hat was n't teaching himself .	this hat was n't teaching themselves .
this bowl did n't listen to himself .	this bowl did n't listen to themselves .
the ring had bothered herself .	the ring had bothered themselves .
these windows scared themselves .	these windows scared herself .
that fork can n't worry herself .	that fork can n't worry themselves .
these dolls did n't praise themselves .	these dolls did n't praise herself .
those toys scare themselves .	those toys scare himself .
that shoe may care for herself .	that shoe may care for themselves .
those shirts were working with themselves .	those shirts were working with himself .
this hat taught herself .	this hat taught themselves .
this car answered himself .	this car answered themselves .
that ring would n't help herself .	that ring would n't help themselves .
the boats were n't teaching themselves .	the boats were n't teaching herself .
the windows have n't answered themselves .	the windows have n't answered himself .
this truck can n't appreciate herself .	this truck can n't appreciate themselves .
this spoon taught himself .	this spoon taught themselves .
the buttons have lost themselves .	the buttons have lost herself .
this bottle works with herself .	this bottle works with themselves .
the windows are n't helping themselves .	the windows are n't helping herself .
those buttons may listen to themselves .	those buttons may listen to himself .
the dolls listen to themselves .	the dolls listen to herself .
that truck was talking to herself .	that truck was talking to themselves .
that rocket was listening to herself .	that rocket was listening to themselves .
those forks would n't bother themselves .	those forks would n't bother herself .
the hat was n't working with herself .	the hat was n't working with themselves .
these glasses are listening to themselves .	these glasses are listening to herself .
the candles were listening to themselves .	the candles were listening to herself .
these bags work with themselves .	these bags work with herself .
these boxes bother themselves .	these boxes bother herself .
these crayons were n't bothering themselves .	these crayons were n't bothering herself .
these forks had n't bothered themselves .	these forks had n't bothered himself .
these bowls were n't listening to themselves .	these bowls were n't listening to himself .
that ship has n't worried herself .	that ship has n't worried themselves .
these pictures can n't work with themselves .	these pictures can n't work with himself .
the buttons wo n't care for themselves .	the buttons wo n't care for himself .
this truck scares himself .	this truck scares themselves .
those trucks were n't talking to themselves .	those trucks were n't talking to himself .
those hats understand themselves .	those hats understand himself .
this book answered herself .	this book answered themselves .
that cup has answered herself .	that cup has answered themselves .
this couch has n't bothered himself .	this couch has n't bothered themselves .
these pictures had n't answered themselves .	these pictures had n't answered herself .
this crayon wo n't care for himself .	this crayon wo n't care for themselves .
the window visited himself .	the window visited themselves .
this bottle would n't listen to himself .	this bottle would n't listen to themselves .
the couch can n't praise himself .	the couch can n't praise themselves .
those crayons understand themselves .	those crayons understand herself .
these rings work with themselves .	these rings work with herself .
the book confused himself .	the book confused themselves .
that door had n't worked with himself .	that door had n't worked with themselves .
these shirts have worried themselves .	these shirts have worried himself .
those buttons have n't lost themselves .	those buttons have n't lost himself .
these boxes have n't lost themselves .	these boxes have n't lost herself .
these shoes scare themselves .	these shoes scare herself .
these dolls visited themselves .	these dolls visited herself .
this rug would scare himself .	this rug would scare themselves .
that chair helps himself .	that chair helps themselves .
these toys taught themselves .	these toys taught himself .
that picture bothered himself .	that picture bothered themselves .
those bottles may help themselves .	those bottles may help herself .
the plate is visiting herself .	the plate is visiting themselves .
those plates have n't lost themselves .	those plates have n't lost herself .
this window had found herself .	this window had found themselves .
those trucks care for themselves .	those trucks care for himself .
the dolls are bothering themselves .	the dolls are bothering himself .
those windows would bother themselves .	those windows would bother himself .
that fork was n't listening to herself .	that fork was n't listening to themselves .
the mirror helps himself .	the mirror helps themselves .
that candle was bothering herself .	that candle was bothering themselves .
those rings found themselves .	those rings found himself .
those buttons bothered themselves .	those buttons bothered herself .
the boats were teaching themselves .	the boats were teaching himself .
this plane is n't visiting herself .	this plane is n't visiting themselves .
the beds care for themselves .	the beds care for herself .
the hat worked with herself .	the hat worked with themselves .
this plate helps herself .	this plate helps themselves .
these books are bothering themselves .	these books are bothering himself .
these books are working with themselves .	these books are working with herself .
that crayon has n't found himself .	that crayon has n't found themselves .
those books work with themselves .	those books work with himself .
those dolls would help themselves .	those dolls would help herself .
the bicycle worked with herself .	the bicycle worked with themselves .
that window had talked to himself .	that window had talked to themselves .
these bags had n't worked with themselves .	these bags had n't worked with himself .
the boats talk to themselves .	the boats talk to himself .
the windows praise themselves .	the windows praise himself .
this fork has worried himself .	this fork has worried themselves .
the beds are helping themselves .	the beds are helping herself .
these trucks worked with themselves .	these trucks worked with himself .
the couch was talking to himself .	the couch was talking to themselves .
the books talk to themselves .	the books talk to herself .
that ring has n't worked with herself .	that ring has n't worked with themselves .
the pictures talk to themselves .	the pictures talk to himself .
those chairs have scared themselves .	those chairs have scared herself .
the cars taught themselves .	the cars taught himself .
those windows confused themselves .	those windows confused himself .
these cars answered themselves .	these cars answered himself .
those plates talk to themselves .	those plates talk to himself .
the ring was n't bothering herself .	the ring was n't bothering themselves .
the books have n't taught themselves .	the books have n't taught herself .
the candles had n't worried themselves .	the candles had n't worried herself .
those toys will answer themselves .	those toys will answer herself .
that candle had n't visited herself .	that candle had n't visited themselves .
this glass could listen to herself .	this glass could listen to themselves .
these boats had scared themselves .	these boats had scared himself .
this picture lost himself .	this picture lost themselves .
that mirror was visiting himself .	that mirror was visiting themselves .
that rug found herself .	that rug found themselves .
this picture is n't helping himself .	this picture is n't helping themselves .
these forks lost themselves .	these forks lost himself .
the shoes did n't work with themselves .	the shoes did n't work with herself .
those chairs are n't teaching themselves .	those chairs are n't teaching himself .
the truck has n't answered herself .	the truck has n't answered themselves .
that dish helped herself .	that dish helped themselves .
those trucks could work with themselves .	those trucks could work with himself .
those toys should n't help themselves .	those toys should n't help himself .
that plate should answer herself .	that plate should answer themselves .
those pictures can answer themselves .	those pictures can answer herself .
those cups listen to themselves .	those cups listen to himself .
this mirror did n't talk to herself .	this mirror did n't talk to themselves .
the plate was n't helping herself .	the plate was n't helping themselves .
this crayon taught himself .	this crayon taught themselves .
the plates have n't confused themselves .	the plates have n't confused herself .
this couch should bother herself .	this couch should bother themselves .
those cars have helped themselves .	those cars have helped herself .
those chairs were n't visiting themselves .	those chairs were n't visiting himself .
that bicycle has n't worked with himself .	that bicycle has n't worked with themselves .
the forks had n't found themselves .	the forks had n't found herself .
those pictures would n't bother themselves .	those pictures would n't bother himself .
these rings worried themselves .	these rings worried herself .
that bowl works with himself .	that bowl works with themselves .
that bag talks to himself .	that bag talks to themselves .
these windows had taught themselves .	these windows had taught himself .
the chairs had n't scared themselves .	the chairs had n't scared herself .
those bottles are n't visiting themselves .	those bottles are n't visiting herself .
the chair wo n't help himself .	the chair wo n't help themselves .
the truck could help himself .	the truck could help themselves .
these rings had n't confused themselves .	these rings had n't confused himself .
that car can worry himself .	that car can worry themselves .
the cups visited themselves .	the cups visited himself .
this rug has n't helped himself .	this rug has n't helped themselves .
those doors were n't listening to themselves .	those doors were n't listening to himself .
that button was n't visiting herself .	that button was n't visiting themselves .
the dish had n't confused herself .	the dish had n't confused themselves .
these pictures had visited themselves .	these pictures had visited herself .
that candle could worry himself .	that candle could worry themselves .
these dolls praise themselves .	these dolls praise herself .
this window is helping herself .	this window is helping themselves .
the doll worried herself .	the doll worried themselves .
that cup scared himself .	that cup scared themselves .
the picture is listening to himself .	the picture is listening to themselves .
those bottles could n't answer themselves .	those bottles could n't answer herself .
those cups helped themselves .	those cups helped himself .
the boxes worried themselves .	the boxes worried himself .
this mirror is n't helping himself .	this mirror is n't helping themselves .
the bowls worry themselves .	the bowls worry himself .
those rings were n't listening to themselves .	those rings were n't listening to himself .
the buttons must understand themselves .	the buttons must understand herself .
this book has talked to herself .	this book has talked to themselves .
those toys are n't working with themselves .	those toys are n't working with himself .
this toy had n't worried himself .	this toy had n't worried themselves .
the bottles bother themselves .	the bottles bother herself .
that rocket has worried himself .	that rocket has worried themselves .
this picture scared himself .	this picture scared themselves .
that fork wo n't praise himself .	that fork wo n't praise themselves .
that bowl worried herself .	that bowl worried themselves .
these beds worried themselves .	these beds worried himself .
that button may appreciate herself .	that button may appreciate themselves .
those books appreciate themselves .	those books appreciate herself .
the cup answered herself .	the cup answered themselves .
that shirt helped himself .	that shirt helped themselves .
the cars were n't listening to themselves .	the cars were n't listening to herself .
these forks praise themselves .	these forks praise herself .
these shoes bothered themselves .	these shoes bothered herself .
the toy talked to himself .	the toy talked to themselves .
those beds had worked with themselves .	those beds had worked with herself .
those boxes are n't working with themselves .	those boxes are n't working with himself .
the bowl may scare herself .	the bowl may scare themselves .
these trucks were listening to themselves .	these trucks were listening to himself .
the hat should n't help herself .	the hat should n't help themselves .
those buttons work with themselves .	those buttons work with himself .
these buttons worked with themselves .	these buttons worked with himself .
that truck had visited herself .	that truck had visited themselves .
these shoes were n't helping themselves .	these shoes were n't helping himself .
the bags could bother themselves .	the bags could bother herself .
that boat is n't working with himself .	that boat is n't working with themselves .
