that rug the crayons the toys answer praise talks .	that rug the crayons the toys answer praise practice talks .
those shoes this toy this door talks to scares paint .	those shoes this toy this door talks to scares exercises paint .
these dishes this bag that couch works with works with read .	these dishes this bag that couch works with works with cries read .
this shoe the plates the bottles worry visit reads .	this shoe the plates the bottles worry visit cry reads .
the door those beds those glasses help care for talks .	the door those beds those glasses help care for sneeze talks .
that car those doors these pictures praise care for exercises .	that car those doors these pictures praise care for scream exercises .
this plate these hats these toys worry understand waves .	this plate these hats these toys worry understand laugh waves .
the candle those beds these crayons praise bother talks .	the candle those beds these crayons praise bother sing talks .
that candle those beds these beds understand teach exercises .	that candle those beds these beds understand teach scream exercises .
this plate those spoons the books worry help talks .	this plate those spoons the books worry help win talks .
these hats this spoon that ship scares scares sing .	these hats this spoon that ship scares scares exercises sing .
this fork these bags the bottles visit visit cries .	this fork these bags the bottles visit visit talk cries .
the book the boxes these bottles understand bother paints .	the book the boxes these bottles understand bother read paints .
the rocket the hats these bottles care for praise paints .	the rocket the hats these bottles care for praise wave paints .
that book the shirts those chairs listen to scare reads .	that book the shirts those chairs listen to scare scream reads .
this mirror those trucks the bags teach care for waves .	this mirror those trucks the bags teach care for cry waves .
that rocket the candles the spoons appreciate talk to paints .	that rocket the candles the spoons appreciate talk to practice paints .
the fork these cars those spoons talk to worry exercises .	the fork these cars those spoons talk to worry scream exercises .
the toys the shoe that boat understands helps scream .	the toys the shoe that boat understands helps reads scream .
the shirt the dishes these dishes scare scare talks .	the shirt the dishes these dishes scare scare read talks .
that mirror those windows the cars help worry reads .	that mirror those windows the cars help worry lie reads .
this plate these bottles these books help bother talks .	this plate these bottles these books help bother sing talks .
that candle these bags those rings teach talk to cries .	that candle these bags those rings teach talk to practice cries .
these doors that rug that window understands understands sing .	these doors that rug that window understands understands talks sing .
this rug the bowls these forks care for help sings .	this rug the bowls these forks care for help laugh sings .
that book the cups those chairs visit scare waves .	that book the cups those chairs visit scare lie waves .
this fork the dolls the shoes care for care for reads .	this fork the dolls the shoes care for care for laugh reads .
the door the spoons the forks teach scare sings .	the door the spoons the forks teach scare smile sings .
the mirror these spoons these books care for help talks .	the mirror these spoons these books care for help scream talks .
those cups this door this bag helps understands lie .	those cups this door this bag helps understands talks lie .
this doll the cups these spoons understand answer cries .	this doll the cups these spoons understand answer paint cries .
the shirt the boats the windows talk to appreciate cries .	the shirt the boats the windows talk to appreciate cough cries .
the boat those bottles these candles visit worry cries .	the boat those bottles these candles visit worry laugh cries .
this bicycle these candles those cars appreciate care for reads .	this bicycle these candles those cars appreciate care for laugh reads .
this bag those spoons the forks scare teach waves .	this bag those spoons the forks scare teach whisper waves .
the forks the car this box scares talks to sneeze .	the forks the car this box scares talks to talks sneeze .
that doll these plates those trucks listen to help exercises .	that doll these plates those trucks listen to help sing exercises .
this car the boats the beds worry talk to waves .	this car the boats the beds worry talk to practice waves .
the bowl the rings the books listen to help talks .	the bowl the rings the books listen to help whisper talks .
the truck these spoons the shoes work with work with cries .	the truck these spoons the shoes work with work with win cries .
the fork these shirts those trucks worry visit reads .	the fork these shirts those trucks worry visit scream reads .
these cars this chair this boat understands understands win .	these cars this chair this boat understands understands waves win .
the book those plates those crayons worry praise waves .	the book those plates those crayons worry praise whisper waves .
these bottles that shoe the bed talks to scares whisper .	these bottles that shoe the bed talks to scares cries whisper .
this spoon those glasses those pictures work with appreciate exercises .	this spoon those glasses those pictures work with appreciate sneeze exercises .
the book the forks these shirts listen to talk to exercises .	the book the forks these shirts listen to talk to win exercises .
the crayon these cups these cars praise understand waves .	the crayon these cups these cars praise understand cry waves .
this button these buttons those bowls scare worry sings .	this button these buttons those bowls scare worry stretch sings .
the box those boxes those boxes work with help exercises .	the box those boxes those boxes work with help yell exercises .
the candle those buttons these buttons help work with paints .	the candle those buttons these buttons help work with wave paints .
the shirt the bowls these shoes answer care for reads .	the shirt the bowls these shoes answer care for wave reads .
this bag those cars those windows visit care for cries .	this bag those cars those windows visit care for wave cries .
the car the books those spoons listen to help waves .	the car the books those spoons listen to help lose waves .
these glasses the glass that rug scares helps lose .	these glasses the glass that rug scares helps reads lose .
the toy those rings these pictures appreciate scare reads .	the toy those rings these pictures appreciate scare laugh reads .
the shirts this bicycle this shoe scares scares cough .	the shirts this bicycle this shoe scares scares cries cough .
the car these bottles those boxes help work with waves .	the car these bottles those boxes help work with yell waves .
that crayon those hats these cars listen to bother talks .	that crayon those hats these cars listen to bother wave talks .
that door these bottles these windows care for talk to reads .	that door these bottles these windows care for talk to exercise reads .
that plane those boxes those bottles work with visit reads .	that plane those boxes those bottles work with visit smile reads .
the bottle the boats the dolls understand teach waves .	the bottle the boats the dolls understand teach smile waves .
that bed the books the crayons talk to teach waves .	that bed the books the crayons talk to teach win waves .
that book these candles those doors work with appreciate exercises .	that book these candles those doors work with appreciate scream exercises .
this hat the candles these forks visit praise exercises .	this hat the candles these forks visit praise practice exercises .
that truck the shoes these cups help talk to reads .	that truck the shoes these cups help talk to paint reads .
this fork the cups those doors help help exercises .	this fork the cups those doors help help talk exercises .
this bicycle the pictures those boxes understand work with exercises .	this bicycle the pictures those boxes understand work with yell exercises .
that rocket these books those hats visit understand cries .	that rocket these books those hats visit understand whisper cries .
the fork these cups those boats listen to talk to exercises .	the fork these cups those boats listen to talk to yell exercises .
this glass those trucks these boxes visit visit exercises .	this glass those trucks these boxes visit visit sing exercises .
this box these books these chairs work with care for talks .	this box these books these chairs work with care for smile talks .
the cars that door this chair understands helps talk .	the cars that door this chair understands helps cries talk .
this couch the dishes the cars visit scare waves .	this couch the dishes the cars visit scare lose waves .
this ring the toys the rings care for worry talks .	this ring the toys the rings care for worry read talks .
that toy those cars those glasses appreciate help reads .	that toy those cars those glasses appreciate help stretch reads .
the door these pictures those bowls understand talk to paints .	the door these pictures those bowls understand talk to stretch paints .
the fork those shirts those dishes teach teach cries .	the fork those shirts those dishes teach teach smile cries .
the chair the trucks these bowls scare answer reads .	the chair the trucks these bowls scare answer yell reads .
the forks that bag this picture understands helps yell .	the forks that bag this picture understands helps sings yell .
that glass the hats these crayons care for answer exercises .	that glass the hats these crayons care for answer sneeze exercises .
this doll these books these pictures work with visit waves .	this doll these books these pictures work with visit smile waves .
that car those rings those plates help scare cries .	that car those rings those plates help scare laugh cries .
the dish the doors those hats work with work with cries .	the dish the doors those hats work with work with whisper cries .
this picture those dolls those cups bother teach waves .	this picture those dolls those cups bother teach lie waves .
that crayon those windows these pictures scare listen to exercises .	that crayon those windows these pictures scare listen to exercise exercises .
this bag the dolls these trucks help appreciate sings .	this bag the dolls these trucks help appreciate practice sings .
the box those cars those cars understand understand exercises .	the box those cars those cars understand understand sneeze exercises .
the glasses the crayon that door scares helps talk .	the glasses the crayon that door scares helps waves talk .
this couch those books these toys worry visit paints .	this couch those books these toys worry visit sing paints .
those rings this crayon that glass works with scares paint .	those rings this crayon that glass works with scares sings paint .
these glasses this picture this bowl understands understands smile .	these glasses this picture this bowl understands understands exercises smile .
this rug the shoes the doors visit talk to waves .	this rug the shoes the doors visit talk to lose waves .
the windows this boat the hat talks to understands paint .	the windows this boat the hat talks to understands exercises paint .
the bed these cars the trucks listen to scare talks .	the bed these cars the trucks listen to scare lose talks .
the ring the windows these boxes understand answer talks .	the ring the windows these boxes understand answer practice talks .
this rug these bottles the chairs listen to talk to cries .	this rug these bottles the chairs listen to talk to paint cries .
those toys the picture that glass helps talks to talk .	those toys the picture that glass helps talks to talks talk .
the boat these crayons the toys talk to work with sings .	the boat these crayons the toys talk to work with lose sings .
that rocket the trucks those spoons scare scare waves .	that rocket the trucks those spoons scare scare wave waves .
these boxes that fork that bag scares scares practice .	these boxes that fork that bag scares scares exercises practice .
the candle the cars those bowls help appreciate reads .	the candle the cars those bowls help appreciate stretch reads .
the ship the shirts these dolls scare understand reads .	the ship the shirts these dolls scare understand whisper reads .
this button the beds those glasses teach understand reads .	this button the beds those glasses teach understand read reads .
this rug the bottles the boxes teach help paints .	this rug the bottles the boxes teach help exercise paints .
the window those crayons the rings teach visit waves .	the window those crayons the rings teach visit exercise waves .
these hats this window that bag helps talks to lose .	these hats this window that bag helps talks to reads lose .
the pictures that bicycle this bottle helps helps sing .	the pictures that bicycle this bottle helps helps talks sing .
the books this bag the rocket works with understands win .	the books this bag the rocket works with understands paints win .
the bottle these glasses those spoons bother listen to reads .	the bottle these glasses those spoons bother listen to win reads .
the door the beds those cars teach talk to exercises .	the door the beds those cars teach talk to sing exercises .
that chair the glasses these boxes praise appreciate cries .	that chair the glasses these boxes praise appreciate sing cries .
the toy the forks the books teach scare waves .	the toy the forks the books teach scare stretch waves .
this bicycle the cars these dishes scare bother paints .	this bicycle the cars these dishes scare bother sing paints .
the box these dishes the forks work with praise cries .	the box these dishes the forks work with praise talk cries .
the couch the doors those books answer understand cries .	the couch the doors those books answer understand wave cries .
the bed the glasses those beds praise understand exercises .	the bed the glasses those beds praise understand win exercises .
those pictures that truck that button works with talks to talk .	those pictures that truck that button works with talks to sings talk .
the rug the doors these forks bother talk to reads .	the rug the doors these forks bother talk to scream reads .
this button those chairs these cups care for teach cries .	this button those chairs these cups care for teach lose cries .
that rug the candles the dishes appreciate help sings .	that rug the candles the dishes appreciate help cry sings .
this shirt the boxes those shirts understand listen to exercises .	this shirt the boxes those shirts understand listen to paint exercises .
the bowl those cars these dolls bother understand talks .	the bowl those cars these dolls bother understand cry talks .
that ring these shoes these boats worry praise paints .	that ring these shoes these boats worry praise cry paints .
that mirror these windows the bowls appreciate understand waves .	that mirror these windows the bowls appreciate understand lose waves .
the cup those books those plates care for worry exercises .	the cup those books those plates care for worry read exercises .
the bowl those rings these windows teach care for exercises .	the bowl those rings these windows teach care for read exercises .
those spoons the truck that car scares understands scream .	those spoons the truck that car scares understands cries scream .
that bowl these chairs the boats teach scare waves .	that bowl these chairs the boats teach scare yell waves .
that boat those books the books bother praise waves .	that boat those books the books bother praise laugh waves .
that box these trucks those dishes work with listen to talks .	that box these trucks those dishes work with listen to win talks .
the bowl those pictures the boats teach talk to waves .	the bowl those pictures the boats teach talk to paint waves .
that book these candles the hats work with talk to talks .	that book these candles the hats work with talk to talk talks .
the truck these books the cups visit appreciate talks .	the truck these books the cups visit appreciate wave talks .
the car those beds those candles work with listen to paints .	the car those beds those candles work with listen to laugh paints .
this button these cars the pictures worry talk to cries .	this button these cars the pictures worry talk to sneeze cries .
the boat these candles those boats worry answer paints .	the boat these candles those boats worry answer cough paints .
this cup these toys the shoes understand talk to exercises .	this cup these toys the shoes understand talk to win exercises .
that shoe the cars the windows visit teach exercises .	that shoe the cars the windows visit teach paint exercises .
that hat those buttons the shoes help teach reads .	that hat those buttons the shoes help teach scream reads .
that car these windows those forks work with visit waves .	that car these windows those forks work with visit cough waves .
this boat those boats the plates praise praise talks .	this boat those boats the plates praise praise stretch talks .
that bicycle those shoes these cars talk to talk to paints .	that bicycle those shoes these cars talk to talk to cough paints .
that bottle the books the boats appreciate appreciate waves .	that bottle the books the boats appreciate appreciate practice waves .
the rocket these toys the hats understand visit cries .	the rocket these toys the hats understand visit exercise cries .
the car these bowls these books talk to understand paints .	the car these bowls these books talk to understand sneeze paints .
the plane the spoons the candles teach bother talks .	the plane the spoons the candles teach bother scream talks .
this boat those bottles those dolls visit praise talks .	this boat those bottles those dolls visit praise whisper talks .
this couch the plates these books care for answer exercises .	this couch the plates these books care for answer read exercises .
the cups that fork this spoon works with scares cough .	the cups that fork this spoon works with scares exercises cough .
that cup the rings those dishes scare talk to cries .	that cup the rings those dishes scare talk to cough cries .
this plane these candles these candles teach talk to exercises .	this plane these candles these candles teach talk to stretch exercises .
the car the bottles the spoons answer work with sings .	the car the bottles the spoons answer work with talk sings .
the button those beds these shoes help listen to reads .	the button those beds these shoes help listen to sing reads .
this bag the bottles those crayons visit care for reads .	this bag the bottles those crayons visit care for lose reads .
the doll the boats those chairs work with listen to sings .	the doll the boats those chairs work with listen to read sings .
this hat these cars the bottles bother listen to sings .	this hat these cars the bottles bother listen to cry sings .
the crayon these beds the chairs listen to help waves .	the crayon these beds the chairs listen to help cough waves .
the plane those pictures those dolls visit understand exercises .	the plane those pictures those dolls visit understand exercise exercises .
this candle those doors those forks care for talk to talks .	this candle those doors those forks care for talk to win talks .
the glass the candles these rings praise care for cries .	the glass the candles these rings praise care for talk cries .
this button these bowls these books scare answer sings .	this button these bowls these books scare answer stretch sings .
the box those books these candles answer listen to waves .	the box those books these candles answer listen to talk waves .
that bottle these cars those dishes appreciate worry paints .	that bottle these cars those dishes appreciate worry paint paints .
the toy these dishes those books teach appreciate waves .	the toy these dishes those books teach appreciate cry waves .
that button these dishes these toys listen to appreciate cries .	that button these dishes these toys listen to appreciate laugh cries .
that door these trucks these rings praise talk to sings .	that door these trucks these rings praise talk to stretch sings .
that mirror the boats these books listen to answer sings .	that mirror the boats these books listen to answer talk sings .
that chair those buttons those bags understand work with reads .	that chair those buttons those bags understand work with stretch reads .
that ship these boats those beds scare help cries .	that ship these boats those beds scare help smile cries .
this hat these bags those boxes worry help talks .	this hat these bags those boxes worry help lose talks .
this doll these buttons the cups teach scare waves .	this doll these buttons the cups teach scare win waves .
this book these toys these chairs care for teach cries .	this book these toys these chairs care for teach smile cries .
those buttons that toy the bottle helps understands whisper .	those buttons that toy the bottle helps understands reads whisper .
this bag those boats those cars care for talk to cries .	this bag those boats those cars care for talk to exercise cries .
this ship the chairs the bowls care for bother reads .	this ship the chairs the bowls care for bother win reads .
these chairs this bed the bicycle talks to understands scream .	these chairs this bed the bicycle talks to understands reads scream .
that candle these pictures these shoes visit listen to waves .	that candle these pictures these shoes visit listen to cough waves .
that ship the cars the chairs visit listen to reads .	that ship the cars the chairs visit listen to wave reads .
the truck these cars those books teach teach talks .	the truck these cars those books teach teach laugh talks .
that bottle the candles those bowls care for understand cries .	that bottle the candles those bowls care for understand lie cries .
these cars that button that plane talks to talks to sing .	these cars that button that plane talks to talks to reads sing .
the bed the cars the forks answer praise sings .	the bed the cars the forks answer praise cough sings .
that door these cars those rings listen to listen to exercises .	that door these cars those rings listen to listen to exercise exercises .
the crayon these spoons those books help work with exercises .	the crayon these spoons those books help work with sneeze exercises .
the glasses this glass this spoon understands understands lose .	the glasses this glass this spoon understands understands cries lose .
that door those cars the bags understand praise talks .	that door those cars the bags understand praise win talks .
the hat those doors these trucks praise scare talks .	the hat those doors these trucks praise scare stretch talks .
this toy those spoons these dishes listen to praise reads .	this toy those spoons these dishes listen to praise paint reads .
the spoon those bowls these bags praise worry waves .	the spoon those bowls these bags praise worry whisper waves .
that plate the windows the forks scare answer talks .	that plate the windows the forks scare answer talk talks .
the boat those dolls these books answer teach exercises .	the boat those dolls these books answer teach whisper exercises .
that ring those doors these buttons listen to talk to talks .	that ring those doors these buttons listen to talk to talk talks .
the toy the books the books visit worry reads .	the toy the books the books visit worry yell reads .
the shoe these trucks these buttons visit work with exercises .	the shoe these trucks these buttons visit work with stretch exercises .
this toy the spoons those glasses worry visit exercises .	this toy the spoons those glasses worry visit yell exercises .
the doll these cups these boxes visit bother exercises .	the doll these cups these boxes visit bother talk exercises .
that cup the toys these bags praise worry sings .	that cup the toys these bags praise worry smile sings .
those buttons this ship this ring scares understands paint .	those buttons this ship this ring scares understands reads paint .
the rocket these rings the trucks praise care for waves .	the rocket these rings the trucks praise care for read waves .
the book those dolls these beds answer scare paints .	the book those dolls these beds answer scare cry paints .
that spoon those dishes these crayons care for care for sings .	that spoon those dishes these crayons care for care for stretch sings .
the pictures the plate the rug scares talks to lose .	the pictures the plate the rug scares talks to cries lose .
the books this dish this bed helps helps lie .	the books this dish this bed helps helps reads lie .
the mirror the plates these boats worry understand paints .	the mirror the plates these boats worry understand read paints .
the bicycle those dishes those shirts listen to listen to paints .	the bicycle those dishes those shirts listen to listen to laugh paints .
the rings this bed this candle works with talks to win .	the rings this bed this candle works with talks to reads win .
that book these cups those doors understand praise paints .	that book these cups those doors understand praise exercise paints .
this mirror the cups these bottles bother worry waves .	this mirror the cups these bottles bother worry yell waves .
that candle those books these candles understand answer reads .	that candle those books these candles understand answer scream reads .
this toy those bowls those boats help care for exercises .	this toy those bowls those boats help care for win exercises .
this toy these bags these boats talk to scare reads .	this toy these bags these boats talk to scare scream reads .
this ring those shirts these forks help talk to reads .	this ring those shirts these forks help talk to cry reads .
that glass the cars these pictures answer listen to waves .	that glass the cars these pictures answer listen to paint waves .
the mirror these hats the doors visit appreciate waves .	the mirror these hats the doors visit appreciate wave waves .
this button the cars these doors bother understand reads .	this button the cars these doors bother understand talk reads .
the shoe those plates these buttons understand praise cries .	the shoe those plates these buttons understand praise sneeze cries .
that bottle the rings the shoes understand listen to paints .	that bottle the rings the shoes understand listen to whisper paints .
the button these cars the toys appreciate understand waves .	the button these cars the toys appreciate understand cough waves .
this rug these hats those plates visit worry paints .	this rug these hats those plates visit worry practice paints .
this shoe these hats those doors listen to talk to sings .	this shoe these hats those doors listen to talk to smile sings .
the boxes this dish that book scares works with wave .	the boxes this dish that book scares works with waves wave .
that ring those bags these dolls listen to praise paints .	that ring those bags these dolls listen to praise yell paints .
those buttons the fork that glass talks to talks to wave .	those buttons the fork that glass talks to talks to sings wave .
this ship the books the rings help bother talks .	this ship the books the rings help bother yell talks .
the box the plates the beds teach understand reads .	the box the plates the beds teach understand paint reads .
the shirt the cars these bags care for talk to talks .	the shirt the cars these bags care for talk to laugh talks .
that couch those shoes those boats answer talk to waves .	that couch those shoes those boats answer talk to cry waves .
that plane the bottles those hats work with praise exercises .	that plane the bottles those hats work with praise whisper exercises .
that button those chairs the hats answer scare reads .	that button those chairs the hats answer scare cough reads .
the rocket these bottles these trucks answer appreciate paints .	the rocket these bottles these trucks answer appreciate whisper paints .
this toy these plates those trucks visit care for talks .	this toy these plates those trucks visit care for cough talks .
the plate the buttons these dolls appreciate scare reads .	the plate the buttons these dolls appreciate scare cry reads .
this doll the bowls the toys worry understand sings .	this doll the bowls the toys worry understand talk sings .
those rings that doll this bowl works with works with wave .	those rings that doll this bowl works with works with talks wave .
this crayon those dolls those cars help talk to talks .	this crayon those dolls those cars help talk to scream talks .
those chairs that plane the bowl helps helps paint .	those chairs that plane the bowl helps helps cries paint .
this chair these books the glasses scare care for waves .	this chair these books the glasses scare care for exercise waves .
the plane the beds those cups care for teach exercises .	the plane the beds those cups care for teach exercise exercises .
this truck those glasses these plates help visit exercises .	this truck those glasses these plates help visit read exercises .
the bottle these books these trucks answer talk to waves .	the bottle these books these trucks answer talk to sing waves .
this rug the spoons the dishes help help exercises .	this rug the spoons the dishes help help exercise exercises .
this chair these shirts these doors bother bother waves .	this chair these shirts these doors bother bother laugh waves .
these candles that bowl this couch works with works with lie .	these candles that bowl this couch works with works with reads lie .
that bowl these trucks the trucks care for listen to sings .	that bowl these trucks the trucks care for listen to whisper sings .
this hat the spoons the buttons understand talk to reads .	this hat the spoons the buttons understand talk to lose reads .
the bag the rings these toys bother worry sings .	the bag the rings these toys bother worry exercise sings .
that box those buttons these chairs visit visit talks .	that box those buttons these chairs visit visit win talks .
this bicycle the candles those bottles appreciate help talks .	this bicycle the candles those bottles appreciate help sneeze talks .
that shoe the crayons those cars bother answer paints .	that shoe the crayons those cars bother answer exercise paints .
the spoon those cups the dishes care for talk to paints .	the spoon those cups the dishes care for talk to cry paints .
the beds this bed the bag helps works with wave .	the beds this bed the bag helps works with reads wave .
those windows the crayon this candle talks to scares win .	those windows the crayon this candle talks to scares reads win .
the dishes the ring that crayon understands works with stretch .	the dishes the ring that crayon understands works with waves stretch .
the rocket those plates the books visit help talks .	the rocket those plates the books visit help cough talks .
those spoons this rocket this toy understands understands win .	those spoons this rocket this toy understands understands cries win .
that dish the doors these windows teach teach talks .	that dish the doors these windows teach teach cry talks .
this car the doors the forks scare listen to sings .	this car the doors the forks scare listen to sing sings .
those glasses that fork this ship helps scares cry .	those glasses that fork this ship helps scares reads cry .
the chair these buttons these hats visit understand sings .	the chair these buttons these hats visit understand scream sings .
this plate those plates those shoes appreciate teach sings .	this plate those plates those shoes appreciate teach scream sings .
this couch the shirts these bowls help scare reads .	this couch the shirts these bowls help scare laugh reads .
this bed these cars these pictures appreciate bother cries .	this bed these cars these pictures appreciate bother wave cries .
these beds this glass that box helps understands practice .	these beds this glass that box helps understands paints practice .
this shoe the trucks the boxes scare scare exercises .	this shoe the trucks the boxes scare scare wave exercises .
that doll those beds the bags talk to answer paints .	that doll those beds the bags talk to answer cry paints .
the truck the bags the dolls scare praise waves .	the truck the bags the dolls scare praise win waves .
the boat these cups these crayons teach care for exercises .	the boat these cups these crayons teach care for talk exercises .
those crayons this fork the doll understands understands scream .	those crayons this fork the doll understands understands talks scream .
the candle the cups these shoes worry help sings .	the candle the cups these shoes worry help yell sings .
the car those spoons those forks praise visit cries .	the car those spoons those forks praise visit talk cries .
the fork these trucks these shirts worry work with waves .	the fork these trucks these shirts worry work with cough waves .
the boxes that mirror that plate talks to works with stretch .	the boxes that mirror that plate talks to works with reads stretch .
that bicycle the books the doors praise praise exercises .	that bicycle the books the doors praise praise lose exercises .
those dolls that shirt this bowl scares understands lie .	those dolls that shirt this bowl scares understands cries lie .
this rocket those trucks these candles care for answer talks .	this rocket those trucks these candles care for answer stretch talks .
the ring those cars the bags praise worry waves .	the ring those cars the bags praise worry stretch waves .
the shoes this bottle this window helps talks to smile .	the shoes this bottle this window helps talks to sings smile .
this crayon those glasses these bottles work with appreciate waves .	this crayon those glasses these bottles work with appreciate read waves .
that book those glasses these buttons answer worry reads .	that book those glasses these buttons answer worry win reads .
that dish these toys the plates bother bother talks .	that dish these toys the plates bother bother whisper talks .
the shirt the rings those dolls scare care for sings .	the shirt the rings those dolls scare care for whisper sings .
the cars that box that car helps works with win .	the cars that box that car helps works with cries win .
this shirt those plates the boxes understand help talks .	this shirt those plates the boxes understand help sing talks .
this bowl those cars the beds teach appreciate sings .	this bowl those cars the beds teach appreciate exercise sings .
the car these doors the chairs appreciate care for exercises .	the car these doors the chairs appreciate care for scream exercises .
that rocket these beds the bottles answer scare talks .	that rocket these beds the bottles answer scare lie talks .
this crayon the boats those shirts help work with talks .	this crayon the boats those shirts help work with scream talks .
this doll these chairs the trucks work with teach waves .	this doll these chairs the trucks work with teach yell waves .
the glass these buttons those dishes answer listen to cries .	the glass these buttons those dishes answer listen to win cries .
that car these dolls the trucks work with listen to cries .	that car these dolls the trucks work with listen to stretch cries .
the bed these forks those boats answer teach cries .	the bed these forks those boats answer teach exercise cries .
the picture the toys these cups care for help talks .	the picture the toys these cups care for help laugh talks .
that candle these glasses those rings help praise sings .	that candle these glasses those rings help praise smile sings .
this bed these boats those books listen to care for reads .	this bed these boats those books listen to care for lose reads .
those boxes this doll that door scares helps sneeze .	those boxes this doll that door scares helps sings sneeze .
that couch these books the dolls help praise sings .	that couch these books the dolls help praise sneeze sings .
those cars that car the bed understands talks to read .	those cars that car the bed understands talks to waves read .
the truck the beds those boats scare teach waves .	the truck the beds those boats scare teach wave waves .
this button these rings those bowls teach understand waves .	this button these rings those bowls teach understand stretch waves .
this window those crayons those cups bother help waves .	this window those crayons those cups bother help paint waves .
this fork these toys the shirts listen to praise cries .	this fork these toys the shirts listen to praise lie cries .
that car the cups the windows visit help exercises .	that car the cups the windows visit help wave exercises .
this bottle those pictures the glasses understand listen to reads .	this bottle those pictures the glasses understand listen to exercise reads .
this cup these cars the dolls care for visit sings .	this cup these cars the dolls care for visit smile sings .
the car the hats the toys answer answer talks .	the car the hats the toys answer answer smile talks .
this plane the doors these rings visit appreciate talks .	this plane the doors these rings visit appreciate lie talks .
that toy these books these cars work with work with cries .	that toy these books these cars work with work with read cries .
that ring the boxes the bowls care for appreciate sings .	that ring the boxes the bowls care for appreciate smile sings .
those books the fork this crayon works with talks to read .	those books the fork this crayon works with talks to paints read .
the truck those dolls these bowls understand praise exercises .	the truck those dolls these bowls understand praise paint exercises .
that dish those dishes those forks teach worry paints .	that dish those dishes those forks teach worry stretch paints .
that door the beds those bottles talk to care for exercises .	that door the beds those bottles talk to care for lose exercises .
that dish these shoes those forks work with appreciate reads .	that dish these shoes those forks work with appreciate talk reads .
that crayon these boxes the forks work with teach sings .	that crayon these boxes the forks work with teach scream sings .
that book the forks those candles bother work with paints .	that book the forks those candles bother work with lie paints .
that picture the hats these beds help scare cries .	that picture the hats these beds help scare laugh cries .
the couch these cars the rings work with work with cries .	the couch these cars the rings work with work with sneeze cries .
the rings this button this rug works with helps yell .	the rings this button this rug works with helps waves yell .
the shirt the doors those bowls talk to care for waves .	the shirt the doors those bowls talk to care for paint waves .
this bottle those trucks those buttons visit visit waves .	this bottle those trucks those buttons visit visit whisper waves .
that rug these windows those windows teach talk to paints .	that rug these windows those windows teach talk to yell paints .
the bicycle the candles the forks worry care for paints .	the bicycle the candles the forks worry care for practice paints .
this toy these doors the candles listen to care for paints .	this toy these doors the candles listen to care for practice paints .
the chair these pictures those trucks work with understand cries .	the chair these pictures those trucks work with understand cough cries .
this door these cups those candles bother listen to cries .	this door these cups those candles bother listen to sing cries .
the hat these windows those books praise talk to talks .	the hat these windows those books praise talk to win talks .
these books that picture that picture helps helps smile .	these books that picture that picture helps helps sings smile .
the button these bags these shirts praise listen to sings .	the button these bags these shirts praise listen to cry sings .
the bag those boxes the rings worry visit exercises .	the bag those boxes the rings worry visit cry exercises .
the boats the picture the spoon scares understands cough .	the boats the picture the spoon scares understands sings cough .
the bottle these buttons those dishes answer praise exercises .	the bottle these buttons those dishes answer praise paint exercises .
the dolls this boat the crayon understands talks to paint .	the dolls this boat the crayon understands talks to sings paint .
this door those windows the windows answer bother talks .	this door those windows the windows answer bother stretch talks .
the mirror the pictures the cups help listen to reads .	the mirror the pictures the cups help listen to cry reads .
that couch these cups those hats teach worry waves .	that couch these cups those hats teach worry scream waves .
that spoon these cups those chairs listen to bother cries .	that spoon these cups those chairs listen to bother exercise cries .
this bottle these cars these books visit appreciate talks .	this bottle these cars these books visit appreciate wave talks .
the window the toys these bowls appreciate teach talks .	the window the toys these bowls appreciate teach whisper talks .
this rocket these forks those dolls appreciate visit cries .	this rocket these forks those dolls appreciate visit whisper cries .
the shoe the beds the bowls scare scare cries .	the shoe the beds the bowls scare scare whisper cries .
the crayons that box this rocket works with works with smile .	the crayons that box this rocket works with works with sings smile .
the fork the shoes the windows understand help talks .	the fork the shoes the windows understand help stretch talks .
that window these cups these cars work with talk to sings .	that window these cups these cars work with talk to laugh sings .
that mirror those beds those buttons work with care for reads .	that mirror those beds those buttons work with care for scream reads .
that truck those buttons the books visit teach reads .	that truck those buttons the books visit teach yell reads .
the cup the boxes these hats bother work with talks .	the cup the boxes these hats bother work with win talks .
the bottle the pictures these boats understand appreciate waves .	the bottle the pictures these boats understand appreciate cough waves .
the box these crayons these forks work with visit reads .	the box these crayons these forks work with visit read reads .
that bag the chairs these spoons understand listen to reads .	that bag the chairs these spoons understand listen to wave reads .
this mirror those beds these buttons bother listen to talks .	this mirror those beds these buttons bother listen to scream talks .
the fork these chairs those shirts praise care for paints .	the fork these chairs those shirts praise care for cough paints .
that bowl these trucks these glasses bother appreciate paints .	that bowl these trucks these glasses bother appreciate exercise paints .
this doll the cars the forks teach scare cries .	this doll the cars the forks teach scare exercise cries .
this book the cars the plates answer scare paints .	this book the cars the plates answer scare sing paints .
that plate these buttons the beds praise care for sings .	that plate these buttons the beds praise care for talk sings .
the rocket these spoons those books understand praise waves .	the rocket these spoons those books understand praise stretch waves .
that dish these windows the cups worry worry sings .	that dish these windows the cups worry worry laugh sings .
that bowl those cars the crayons scare help exercises .	that bowl those cars the crayons scare help talk exercises .
that spoon the buttons the doors appreciate care for waves .	that spoon the buttons the doors appreciate care for laugh waves .
that plane these crayons those windows visit listen to paints .	that plane these crayons those windows visit listen to sing paints .
this cup the forks these forks listen to help talks .	this cup the forks these forks listen to help win talks .
that window those plates those bottles appreciate talk to sings .	that window those plates those bottles appreciate talk to talk sings .
the shoe the glasses these cups scare scare paints .	the shoe the glasses these cups scare scare cry paints .
the bottle the glasses these candles appreciate visit talks .	the bottle the glasses these candles appreciate visit wave talks .
the bag those hats these crayons praise understand cries .	the bag those hats these crayons praise understand laugh cries .
that mirror these bowls these dolls scare praise sings .	that mirror these bowls these dolls scare praise sneeze sings .
the toy these books these bowls work with scare sings .	the toy these books these bowls work with scare talk sings .
that plane the crayons the rings worry bother exercises .	that plane the crayons the rings worry bother yell exercises .
this plane the beds these hats worry visit talks .	this plane the beds these hats worry visit smile talks .
that truck the boxes these books appreciate worry waves .	that truck the boxes these books appreciate worry yell waves .
that car these rings these cups teach visit sings .	that car these rings these cups teach visit read sings .
this picture the cars these trucks work with scare reads .	this picture the cars these trucks work with scare sneeze reads .
that spoon those doors the windows work with help reads .	that spoon those doors the windows work with help sing reads .
the cars the picture that crayon scares helps stretch .	the cars the picture that crayon scares helps sings stretch .
that couch those cups those bowls visit praise talks .	that couch those cups those bowls visit praise exercise talks .
this truck the bottles the plates answer answer paints .	this truck the bottles the plates answer answer laugh paints .
the cup these buttons those cars answer understand talks .	the cup these buttons those cars answer understand yell talks .
this cup those cups those shirts worry bother talks .	this cup those cups those shirts worry bother win talks .
those books that chair this car scares talks to stretch .	those books that chair this car scares talks to waves stretch .
this bicycle these toys these shirts talk to appreciate waves .	this bicycle these toys these shirts talk to appreciate scream waves .
that fork these shirts the beds worry help exercises .	that fork these shirts the beds worry help exercise exercises .
that fork these dolls these cars appreciate worry sings .	that fork these dolls these cars appreciate worry read sings .
this toy those chairs the cars care for bother exercises .	this toy those chairs the cars care for bother lose exercises .
those spoons this car the shoe understands helps paint .	those spoons this car the shoe understands helps talks paint .
the fork those cars those glasses care for answer talks .	the fork those cars those glasses care for answer exercise talks .
the spoon those dolls those windows scare help paints .	the spoon those dolls those windows scare help cough paints .
those dishes the ship the plane talks to works with wave .	those dishes the ship the plane talks to works with waves wave .
this doll these bottles those beds help talk to exercises .	this doll these bottles those beds help talk to paint exercises .
the candles this fork the bowl talks to scares smile .	the candles this fork the bowl talks to scares reads smile .
that couch the buttons the bags visit praise reads .	that couch the buttons the bags visit praise stretch reads .
the button the boxes these pictures appreciate work with paints .	the button the boxes these pictures appreciate work with talk paints .
these shirts the bag that book understands understands sneeze .	these shirts the bag that book understands understands cries sneeze .
the bed these beds those plates work with talk to waves .	the bed these beds those plates work with talk to cough waves .
this couch the toys those bottles bother scare sings .	this couch the toys those bottles bother scare stretch sings .
that bed these doors those cars praise praise waves .	that bed these doors those cars praise praise stretch waves .
the boat those spoons the glasses understand bother sings .	the boat those spoons the glasses understand bother wave sings .
this dish those buttons the hats care for listen to cries .	this dish those buttons the hats care for listen to lose cries .
the bags that truck that bowl helps scares lie .	the bags that truck that bowl helps scares waves lie .
that boat the boats the pictures listen to praise exercises .	that boat the boats the pictures listen to praise exercise exercises .
this shirt those chairs these bags scare care for cries .	this shirt those chairs these bags scare care for cry cries .
that hat those forks the windows visit worry reads .	that hat those forks the windows visit worry laugh reads .
these buttons that book this shoe helps understands read .	these buttons that book this shoe helps understands sings read .
the bicycle those spoons those boxes bother worry talks .	the bicycle those spoons those boxes bother worry wave talks .
this candle these plates these bowls visit visit waves .	this candle these plates these bowls visit visit sneeze waves .
the glasses this spoon this mirror scares works with yell .	the glasses this spoon this mirror scares works with sings yell .
that bottle the beds those candles scare listen to exercises .	that bottle the beds those candles scare listen to lose exercises .
this chair the shirts the hats care for worry cries .	this chair the shirts the hats care for worry scream cries .
that hat these windows those glasses visit understand sings .	that hat these windows those glasses visit understand lie sings .
the bowls the bottle that spoon helps scares smile .	the bowls the bottle that spoon helps scares cries smile .
that candle these cars these bags understand listen to waves .	that candle these cars these bags understand listen to exercise waves .
that boat the beds those buttons praise praise paints .	that boat the beds those buttons praise praise exercise paints .
this car these dolls the hats listen to bother reads .	this car these dolls the hats listen to bother paint reads .
that chair the pictures the beds help visit reads .	that chair the pictures the beds help visit cry reads .
that bag those glasses the buttons talk to bother cries .	that bag those glasses the buttons talk to bother lie cries .
this doll the boxes the boats understand visit exercises .	this doll the boxes the boats understand visit lie exercises .
the plate those doors the bowls teach worry talks .	the plate those doors the bowls teach worry sneeze talks .
the boat those boats the dishes listen to praise paints .	the boat those boats the dishes listen to praise sing paints .
that book these crayons these buttons scare bother talks .	that book these crayons these buttons scare bother paint talks .
the crayon the buttons the books scare answer sings .	the crayon the buttons the books scare answer stretch sings .
that shoe these hats those shoes teach care for reads .	that shoe these hats those shoes teach care for yell reads .
this picture the windows those dishes scare appreciate talks .	this picture the windows those dishes scare appreciate practice talks .
those trucks the shoe this boat understands works with whisper .	those trucks the shoe this boat understands works with cries whisper .
this shoe these chairs the shirts appreciate listen to sings .	this shoe these chairs the shirts appreciate listen to stretch sings .
the boats this shirt this candle works with talks to smile .	the boats this shirt this candle works with talks to paints smile .
that bed the dolls those glasses work with talk to paints .	that bed the dolls those glasses work with talk to cough paints .
that bag the glasses the hats bother answer exercises .	that bag the glasses the hats bother answer scream exercises .
that book the windows those windows work with talk to waves .	that book the windows those windows work with talk to scream waves .
this car those shirts the shoes appreciate talk to reads .	this car those shirts the shoes appreciate talk to sneeze reads .
the book these chairs those buttons understand work with exercises .	the book these chairs those buttons understand work with yell exercises .
that hat these books these forks work with listen to cries .	that hat these books these forks work with listen to smile cries .
this rug these forks these windows listen to answer sings .	this rug these forks these windows listen to answer sneeze sings .
the boat these dolls these crayons understand answer sings .	the boat these dolls these crayons understand answer yell sings .
that box the bags these pictures appreciate understand cries .	that box the bags these pictures appreciate understand win cries .
that plate the bags those dishes praise praise reads .	that plate the bags those dishes praise praise read reads .
the bag these cars those books understand listen to cries .	the bag these cars those books understand listen to exercise cries .
these boats that plane the chair talks to helps yell .	these boats that plane the chair talks to helps reads yell .
that car those pictures those chairs talk to worry cries .	that car those pictures those chairs talk to worry read cries .
that candle those toys the pictures answer teach waves .	that candle those toys the pictures answer teach exercise waves .
that bicycle these chairs these doors appreciate care for cries .	that bicycle these chairs these doors appreciate care for laugh cries .
the shoe the beds those shirts praise care for reads .	the shoe the beds those shirts praise care for cry reads .
that fork the buttons these shirts teach scare paints .	that fork the buttons these shirts teach scare yell paints .
that plate those bottles the trucks praise talk to paints .	that plate those bottles the trucks praise talk to talk paints .
that bag the bowls these windows answer answer sings .	that bag the bowls these windows answer answer cough sings .
this doll these spoons those doors understand talk to talks .	this doll these spoons those doors understand talk to yell talks .
this plane those forks these shoes care for answer paints .	this plane those forks these shoes care for answer practice paints .
these pictures the cup that doll scares works with stretch .	these pictures the cup that doll scares works with sings stretch .
the button these books those shoes visit appreciate paints .	the button these books those shoes visit appreciate whisper paints .
that rocket the dishes these dishes praise help waves .	that rocket the dishes these dishes praise help cough waves .
the rocket the bags the cups appreciate answer waves .	the rocket the bags the cups appreciate answer win waves .
that spoon these bottles the cars worry understand cries .	that spoon these bottles the cars worry understand read cries .
the door those bottles the cars praise understand exercises .	the door those bottles the cars praise understand yell exercises .
the crayon the bowls those dolls scare answer paints .	the crayon the bowls those dolls scare answer lie paints .
that picture the bottles the windows talk to listen to reads .	that picture the bottles the windows talk to listen to practice reads .
that truck the dolls these forks scare teach sings .	that truck the dolls these forks scare teach lie sings .
the chair those cars these books worry visit sings .	the chair those cars these books worry visit stretch sings .
the bag the shirts those spoons appreciate listen to paints .	the bag the shirts those spoons appreciate listen to lose paints .
that button these cups these doors care for bother exercises .	that button these cups these doors care for bother exercise exercises .
the boat those toys the forks praise worry paints .	the boat those toys the forks praise worry whisper paints .
this glass those trucks the dishes praise praise cries .	this glass those trucks the dishes praise praise scream cries .
this plane those bowls those windows care for praise reads .	this plane those bowls those windows care for praise scream reads .
the ship the trucks those books scare scare reads .	the ship the trucks those books scare scare scream reads .
that ship these dishes those glasses answer bother cries .	that ship these dishes those glasses answer bother laugh cries .
that boat the beds those beds talk to teach sings .	that boat the beds those beds talk to teach yell sings .
this window the forks these windows scare talk to sings .	this window the forks these windows scare talk to sneeze sings .
that cup the cars the boxes work with talk to paints .	that cup the cars the boxes work with talk to stretch paints .
the bed the spoons those cars care for answer reads .	the bed the spoons those cars care for answer cry reads .
the ring those doors the books help work with talks .	the ring those doors the books help work with sing talks .
the bowl these books those windows worry bother exercises .	the bowl these books those windows worry bother scream exercises .
this dish these trucks these glasses talk to talk to waves .	this dish these trucks these glasses talk to talk to sneeze waves .
this fork these books these glasses worry understand talks .	this fork these books these glasses worry understand cry talks .
the mirror those bottles these dishes understand understand exercises .	the mirror those bottles these dishes understand understand wave exercises .
these shirts this shirt this rug helps talks to practice .	these shirts this shirt this rug helps talks to talks practice .
that ring these boxes these windows care for scare reads .	that ring these boxes these windows care for scare paint reads .
this window those dolls these cars talk to appreciate paints .	this window those dolls these cars talk to appreciate stretch paints .
those spoons the picture this ring works with scares smile .	those spoons the picture this ring works with scares waves smile .
the couch these cars the dolls teach praise talks .	the couch these cars the dolls teach praise cough talks .
that button these cars the hats care for scare waves .	that button these cars the hats care for scare lie waves .
this bowl these trucks those trucks appreciate bother paints .	this bowl these trucks those trucks appreciate bother smile paints .
that mirror these hats the plates worry teach talks .	that mirror these hats the plates worry teach laugh talks .
that candle the candles these bags understand teach sings .	that candle the candles these bags understand teach stretch sings .
the box these chairs those spoons bother worry waves .	the box these chairs those spoons bother worry wave waves .
this box these bowls those pictures understand care for paints .	this box these bowls those pictures understand care for read paints .
that shirt the bottles those dishes scare scare cries .	that shirt the bottles those dishes scare scare win cries .
this rug the dolls these boxes teach teach talks .	this rug the dolls these boxes teach teach whisper talks .
this boat the hats those crayons scare answer paints .	this boat the hats those crayons scare answer sneeze paints .
this picture the cars those books bother work with waves .	this picture the cars those books bother work with sneeze waves .
that book these dishes these cars appreciate scare reads .	that book these dishes these cars appreciate scare laugh reads .
these cups the truck that truck understands scares sing .	these cups the truck that truck understands scares reads sing .
the door the cars those forks understand worry cries .	the door the cars those forks understand worry sneeze cries .
the book the dishes these cars scare worry waves .	the book the dishes these cars scare worry wave waves .
this couch these chairs the dolls work with appreciate reads .	this couch these chairs the dolls work with appreciate whisper reads .
this mirror those trucks these boxes care for scare paints .	this mirror those trucks these boxes care for scare sing paints .
this crayon those forks these books visit care for reads .	this crayon those forks these books visit care for yell reads .
the candle these cars the cars visit listen to paints .	the candle these cars the cars visit listen to lose paints .
this ship these chairs these dolls worry listen to talks .	this ship these chairs these dolls worry listen to paint talks .
that picture these spoons those crayons bother worry exercises .	that picture these spoons those crayons bother worry paint exercises .
the beds the cup that mirror talks to understands wave .	the beds the cup that mirror talks to understands paints wave .
this window those plates those cars appreciate bother cries .	this window those plates those cars appreciate bother practice cries .
the books that spoon that book understands helps whisper .	the books that spoon that book understands helps exercises whisper .
this car these bowls these pictures appreciate appreciate exercises .	this car these bowls these pictures appreciate appreciate sneeze exercises .
those spoons this picture that doll understands works with read .	those spoons this picture that doll understands works with exercises read .
these glasses this bottle that button works with scares stretch .	these glasses this bottle that button works with scares cries stretch .
this car the buttons the spoons praise teach paints .	this car the buttons the spoons praise teach laugh paints .
these forks the bowl this boat works with scares laugh .	these forks the bowl this boat works with scares sings laugh .
this mirror those buttons these shirts scare visit paints .	this mirror those buttons these shirts scare visit smile paints .
this ship these cars those crayons work with visit talks .	this ship these cars those crayons work with visit paint talks .
this shirt the dishes the cars care for visit talks .	this shirt the dishes the cars care for visit whisper talks .
this bicycle those spoons the crayons care for help talks .	this bicycle those spoons the crayons care for help whisper talks .
this bed the cars those bowls help answer talks .	this bed the cars those bowls help answer talk talks .
this plate those hats these boats appreciate care for exercises .	this plate those hats these boats appreciate care for paint exercises .
this rocket those boats these books visit praise paints .	this rocket those boats these books visit praise sing paints .
the glass these chairs these bowls visit scare exercises .	the glass these chairs these bowls visit scare sing exercises .
the boxes that doll this bicycle understands works with sneeze .	the boxes that doll this bicycle understands works with talks sneeze .
this mirror those spoons the chairs talk to bother waves .	this mirror those spoons the chairs talk to bother lose waves .
this window the cars these spoons work with teach paints .	this window the cars these spoons work with teach wave paints .
the bottles this rug the window scares scares practice .	the bottles this rug the window scares scares paints practice .
that rocket those bags those beds answer scare talks .	that rocket those bags those beds answer scare laugh talks .
this shoe the trucks these rings visit visit exercises .	this shoe the trucks these rings visit visit win exercises .
the trucks that plate the door scares scares smile .	the trucks that plate the door scares scares waves smile .
the shirt these plates these windows work with talk to paints .	the shirt these plates these windows work with talk to smile paints .
this button the books these plates understand appreciate reads .	this button the books these plates understand appreciate paint reads .
this box these doors those boats teach worry reads .	this box these doors those boats teach worry yell reads .
the plane those forks the doors teach worry paints .	the plane those forks the doors teach worry smile paints .
the book these glasses these cups work with worry talks .	the book these glasses these cups work with worry yell talks .
that glass these books those pictures worry praise reads .	that glass these books those pictures worry praise lose reads .
this bottle the bowls the dolls answer care for talks .	this bottle the bowls the dolls answer care for wave talks .
this hat the shoes these buttons visit work with sings .	this hat the shoes these buttons visit work with sing sings .
the dish these buttons the bottles worry bother talks .	the dish these buttons the bottles worry bother exercise talks .
that shirt these cars the boats visit answer reads .	that shirt these cars the boats visit answer read reads .
this shoe the shoes these cars work with scare reads .	this shoe the shoes these cars work with scare practice reads .
this candle the trucks those trucks answer help exercises .	this candle the trucks those trucks answer help lose exercises .
that couch those bottles those beds praise bother paints .	that couch those bottles those beds praise bother sing paints .
this bed these plates those books worry appreciate sings .	this bed these plates those books worry appreciate talk sings .
the cups the door that boat scares talks to win .	the cups the door that boat scares talks to cries win .
this plane those books these doors understand listen to paints .	this plane those books these doors understand listen to yell paints .
this toy the boxes those forks talk to understand talks .	this toy the boxes those forks talk to understand cry talks .
that toy these books those spoons answer understand paints .	that toy these books those spoons answer understand whisper paints .
this boat these cars these shoes praise visit cries .	this boat these cars these shoes praise visit whisper cries .
this shirt these toys these bowls bother visit exercises .	this shirt these toys these bowls bother visit cry exercises .
those forks the shirt the door helps works with laugh .	those forks the shirt the door helps works with cries laugh .
the candle those shirts the rings work with talk to sings .	the candle those shirts the rings work with talk to whisper sings .
this window these trucks these toys scare help sings .	this window these trucks these toys scare help laugh sings .
that shirt these trucks these plates talk to appreciate paints .	that shirt these trucks these plates talk to appreciate exercise paints .
these books this couch the cup scares talks to lie .	these books this couch the cup scares talks to cries lie .
the dish these boxes the shoes work with work with talks .	the dish these boxes the shoes work with work with lose talks .
the toys that dish the shirt works with helps practice .	the toys that dish the shirt works with helps sings practice .
that doll the windows these trucks bother talk to sings .	that doll the windows these trucks bother talk to laugh sings .
the boat the plates the hats appreciate answer talks .	the boat the plates the hats appreciate answer paint talks .
this window those beds those crayons work with care for talks .	this window those beds those crayons work with care for laugh talks .
the toy those cars these chairs bother listen to exercises .	the toy those cars these chairs bother listen to sneeze exercises .
these books this toy the toy helps helps scream .	these books this toy the toy helps helps sings scream .
the bag those hats those candles worry help talks .	the bag those hats those candles worry help stretch talks .
this ship those trucks those windows praise understand reads .	this ship those trucks those windows praise understand lose reads .
the boxes the button the spoon helps helps wave .	the boxes the button the spoon helps helps reads wave .
this plane the chairs the dishes listen to bother exercises .	this plane the chairs the dishes listen to bother lose exercises .
that doll these cars the books worry work with cries .	that doll these cars the books worry work with yell cries .
that crayon the candles those pictures appreciate praise exercises .	that crayon the candles those pictures appreciate praise stretch exercises .
that bowl these boxes those dishes worry teach cries .	that bowl these boxes those dishes worry teach whisper cries .
that ship those trucks these bags understand talk to talks .	that ship those trucks these bags understand talk to paint talks .
that dish these books the cups scare listen to exercises .	that dish these books the cups scare listen to read exercises .
that dish these beds these cars teach worry cries .	that dish these beds these cars teach worry stretch cries .
the spoon the bowls those glasses worry praise talks .	the spoon the bowls those glasses worry praise yell talks .
those cups that boat this toy talks to understands sneeze .	those cups that boat this toy talks to understands sings sneeze .
that box the rings these buttons worry scare reads .	that box the rings these buttons worry scare laugh reads .
that ship those toys these dishes help bother talks .	that ship those toys these dishes help bother lose talks .
that hat those cups the windows visit talk to reads .	that hat those cups the windows visit talk to paint reads .
these crayons the ring this candle helps helps win .	these crayons the ring this candle helps helps reads win .
these trucks the window that candle works with talks to stretch .	these trucks the window that candle works with talks to cries stretch .
this candle those chairs these bags appreciate answer reads .	this candle those chairs these bags appreciate answer win reads .
that spoon these boats these shoes understand appreciate waves .	that spoon these boats these shoes understand appreciate wave waves .
this mirror those cups the doors talk to appreciate sings .	this mirror those cups the doors talk to appreciate paint sings .
that book those cups these boxes listen to work with reads .	that book those cups these boxes listen to work with smile reads .
this car the doors those spoons praise visit exercises .	this car the doors those spoons praise visit stretch exercises .
the candle the plates the books answer understand sings .	the candle the plates the books answer understand smile sings .
the bag the glasses the boxes praise answer reads .	the bag the glasses the boxes praise answer laugh reads .
the chair those rings those cars appreciate teach cries .	the chair those rings those cars appreciate teach lie cries .
that bowl those buttons the bags bother appreciate exercises .	that bowl those buttons the bags bother appreciate yell exercises .
these beds the crayon this doll scares works with sing .	these beds the crayon this doll scares works with reads sing .
that mirror those chairs these doors appreciate bother cries .	that mirror those chairs these doors appreciate bother sing cries .
this bag these bowls the pictures answer appreciate exercises .	this bag these bowls the pictures answer appreciate exercise exercises .
these pictures the plate this glass scares understands exercise .	these pictures the plate this glass scares understands paints exercise .
this toy those toys the boxes teach worry sings .	this toy those toys the boxes teach worry sing sings .
this book these spoons the boats work with listen to exercises .	this book these spoons the boats work with listen to scream exercises .
this rocket those toys the candles answer scare reads .	this rocket those toys the candles answer scare cough reads .
this cup the toys those chairs bother praise waves .	this cup the toys those chairs bother praise cough waves .
that book the dolls these plates talk to help waves .	that book the dolls these plates talk to help talk waves .
that shoe those books the boats worry scare sings .	that shoe those books the boats worry scare smile sings .
this ring those plates those boats visit teach talks .	this ring those plates those boats visit teach whisper talks .
the truck those toys those doors understand work with sings .	the truck those toys those doors understand work with laugh sings .
this ring those cars these shoes teach visit reads .	this ring those cars these shoes teach visit exercise reads .
that truck these hats those bottles work with scare reads .	that truck these hats those bottles work with scare win reads .
this shoe the boxes the dolls care for talk to talks .	this shoe the boxes the dolls care for talk to smile talks .
the car the shoes those boats praise care for sings .	the car the shoes those boats praise care for sneeze sings .
that book the chairs these pictures work with work with cries .	that book the chairs these pictures work with work with talk cries .
the hat those dishes those hats praise scare sings .	the hat those dishes those hats praise scare exercise sings .
that hat these crayons these chairs visit help reads .	that hat these crayons these chairs visit help lose reads .
this shoe these shirts the spoons worry talk to exercises .	this shoe these shirts the spoons worry talk to wave exercises .
the car those beds those cups teach teach exercises .	the car those beds those cups teach teach read exercises .
this doll those bottles those books listen to worry exercises .	this doll those bottles those books listen to worry exercise exercises .
this book those shoes those dishes listen to understand talks .	this book those shoes those dishes listen to understand lie talks .
the car these glasses those shoes talk to listen to cries .	the car these glasses those shoes talk to listen to scream cries .
the book those boxes the doors understand worry cries .	the book those boxes the doors understand worry sing cries .
this ring those doors those books listen to talk to cries .	this ring those doors those books listen to talk to wave cries .
the beds this bed the shoe scares talks to read .	the beds this bed the shoe scares talks to talks read .
these shirts this mirror the book helps helps paint .	these shirts this mirror the book helps helps sings paint .
those doors that ship the shoe understands understands talk .	those doors that ship the shoe understands understands paints talk .
that glass the cars these dishes talk to worry sings .	that glass the cars these dishes talk to worry sneeze sings .
this mirror those cars these books appreciate understand exercises .	this mirror those cars these books appreciate understand lie exercises .
the rocket those bowls these toys help appreciate reads .	the rocket those bowls these toys help appreciate yell reads .
the car the bottles these buttons talk to scare paints .	the car the bottles these buttons talk to scare sing paints .
that fork those doors the bags praise visit paints .	that fork those doors the bags praise visit wave paints .
this bag the dishes those boxes talk to listen to cries .	this bag the dishes those boxes talk to listen to exercise cries .
those dishes that candle this mirror works with helps lie .	those dishes that candle this mirror works with helps sings lie .
that bed the crayons these hats worry worry reads .	that bed the crayons these hats worry worry cough reads .
these pictures the bowl this box understands works with practice .	these pictures the bowl this box understands works with exercises practice .
this couch those cars those chairs help understand paints .	this couch those cars those chairs help understand talk paints .
this plate those beds the forks answer teach exercises .	this plate those beds the forks answer teach stretch exercises .
the rocket these crayons the cars teach answer talks .	the rocket these crayons the cars teach answer paint talks .
the books this hat that button scares works with cough .	the books this hat that button scares works with paints cough .
that dish those spoons these books visit listen to reads .	that dish those spoons these books visit listen to wave reads .
this box those doors these plates listen to help waves .	this box those doors these plates listen to help lie waves .
the car the crayons the bottles worry appreciate cries .	the car the crayons the bottles worry appreciate lose cries .
the plate those shoes the beds scare bother exercises .	the plate those shoes the beds scare bother sing exercises .
that button the pictures these windows work with visit talks .	that button the pictures these windows work with visit paint talks .
the rug those boats those crayons care for bother cries .	the rug those boats those crayons care for bother talk cries .
the window the doors these spoons work with care for waves .	the window the doors these spoons work with care for read waves .
that chair the cars these boxes bother help waves .	that chair the cars these boxes bother help cry waves .
this book these bowls these plates scare worry talks .	this book these bowls these plates scare worry cry talks .
those plates that spoon the bottle scares helps laugh .	those plates that spoon the bottle scares helps exercises laugh .
the beds the bicycle the plate understands talks to read .	the beds the bicycle the plate understands talks to paints read .
this plate the chairs these hats bother care for talks .	this plate the chairs these hats bother care for read talks .
the door those rings the books scare help paints .	the door those rings the books scare help yell paints .
this hat these hats these hats appreciate help waves .	this hat these hats these hats appreciate help lie waves .
the picture the bottles the cars bother help sings .	the picture the bottles the cars bother help scream sings .
these beds that window that crayon helps scares lose .	these beds that window that crayon helps scares talks lose .
that plane those books these chairs care for scare cries .	that plane those books these chairs care for scare yell cries .
that button those windows these dolls worry worry talks .	that button those windows these dolls worry worry whisper talks .
this plate those dolls the buttons work with answer sings .	this plate those dolls the buttons work with answer wave sings .
that crayon those buttons these forks scare teach exercises .	that crayon those buttons these forks scare teach cough exercises .
this picture the bottles those dolls answer visit talks .	this picture the bottles those dolls answer visit wave talks .
that cup those forks these spoons visit visit sings .	that cup those forks these spoons visit visit sneeze sings .
that crayon those doors those hats care for listen to sings .	that crayon those doors those hats care for listen to whisper sings .
the bag these bowls the doors talk to understand paints .	the bag these bowls the doors talk to understand whisper paints .
this shirt those pictures these shoes listen to worry paints .	this shirt those pictures these shoes listen to worry paint paints .
the spoons this bag this mirror talks to talks to yell .	the spoons this bag this mirror talks to talks to exercises yell .
the dolls this plate that dish talks to understands whisper .	the dolls this plate that dish talks to understands waves whisper .
this picture those spoons these shirts listen to care for waves .	this picture those spoons these shirts listen to care for wave waves .
that rug the cups those cars work with understand reads .	that rug the cups those cars work with understand wave reads .
that button these dolls the spoons care for work with talks .	that button these dolls the spoons care for work with cough talks .
the ship those beds those plates talk to work with talks .	the ship those beds those plates talk to work with lose talks .
the bicycle the rings these bowls talk to understand waves .	the bicycle the rings these bowls talk to understand lose waves .
this toy the cars those boxes care for care for reads .	this toy the cars those boxes care for care for whisper reads .
this bicycle these toys those books scare listen to cries .	this bicycle these toys those books scare listen to exercise cries .
this button those books those rings scare answer talks .	this button those books those rings scare answer sneeze talks .
the candles that shoe the book talks to helps paint .	the candles that shoe the book talks to helps sings paint .
the toys that doll the bowl talks to understands paint .	the toys that doll the bowl talks to understands sings paint .
that bag those doors those cars work with care for waves .	that bag those doors those cars work with care for exercise waves .
this window those buttons those toys praise teach reads .	this window those buttons those toys praise teach lie reads .
that bowl these chairs those toys listen to talk to reads .	that bowl these chairs those toys listen to talk to whisper reads .
the car these forks these shoes understand talk to talks .	the car these forks these shoes understand talk to talk talks .
the dish the dishes those buttons visit bother exercises .	the dish the dishes those buttons visit bother cough exercises .
that ship these bottles those bowls help appreciate reads .	that ship these bottles those bowls help appreciate stretch reads .
that ship these dolls these hats teach listen to cries .	that ship these dolls these hats teach listen to exercise cries .
the shirt these cars those cars work with praise paints .	the shirt these cars those cars work with praise scream paints .
that dish those boxes those boats praise work with reads .	that dish those boxes those boats praise work with practice reads .
the boxes the plane the window scares helps whisper .	the boxes the plane the window scares helps waves whisper .
that picture these candles the shirts answer talk to paints .	that picture these candles the shirts answer talk to sing paints .
this ring these chairs these shirts praise appreciate paints .	this ring these chairs these shirts praise appreciate talk paints .
the ship the cars the trucks worry teach talks .	the ship the cars the trucks worry teach read talks .
this glass the bags these bags worry care for paints .	this glass the bags these bags worry care for wave paints .
that truck the cups those cars appreciate scare reads .	that truck the cups those cars appreciate scare cry reads .
this chair these chairs these rings bother care for waves .	this chair these chairs these rings bother care for smile waves .
that picture those forks these rings understand scare reads .	that picture those forks these rings understand scare stretch reads .
these trucks that button that glass helps scares read .	these trucks that button that glass helps scares cries read .
the bag these beds those chairs understand worry paints .	the bag these beds those chairs understand worry practice paints .
this window these shoes the bottles teach visit sings .	this window these shoes the bottles teach visit sing sings .
that glass these shirts those rings scare worry reads .	that glass these shirts those rings scare worry read reads .
that bag those candles these cars care for help paints .	that bag those candles these cars care for help laugh paints .
these pictures this bag this plane works with understands read .	these pictures this bag this plane works with understands cries read .
this ring these shirts the plates listen to visit reads .	this ring these shirts the plates listen to visit smile reads .
that bottle those windows these glasses worry understand exercises .	that bottle those windows these glasses worry understand yell exercises .
this shirt those chairs the dishes talk to understand reads .	this shirt those chairs the dishes talk to understand wave reads .
this button these pictures the forks teach scare cries .	this button these pictures the forks teach scare cough cries .
the spoons the couch this fork understands talks to paint .	the spoons the couch this fork understands talks to cries paint .
the rocket these rings the plates help scare paints .	the rocket these rings the plates help scare lose paints .
that box these crayons these toys visit work with reads .	that box these crayons these toys visit work with talk reads .
those cars that fork that bicycle understands works with lose .	those cars that fork that bicycle understands works with cries lose .
this bicycle these books the cups help scare paints .	this bicycle these books the cups help scare wave paints .
the couch the books these forks praise visit talks .	the couch the books these forks praise visit sing talks .
this bowl the windows those shoes understand help sings .	this bowl the windows those shoes understand help cough sings .
that plane these plates the dolls teach praise reads .	that plane these plates the dolls teach praise read reads .
this plane those toys the pictures talk to praise paints .	this plane those toys the pictures talk to praise smile paints .
the boat those cars these shirts praise talk to cries .	the boat those cars these shirts praise talk to yell cries .
that ship these books the chairs scare answer paints .	that ship these books the chairs scare answer yell paints .
this bed the dishes these chairs worry help exercises .	this bed the dishes these chairs worry help scream exercises .
the cup the doors those pictures work with appreciate sings .	the cup the doors those pictures work with appreciate lose sings .
this door those buttons the books care for appreciate sings .	this door those buttons the books care for appreciate win sings .
that window these beds those trucks care for understand sings .	that window these beds those trucks care for understand cry sings .
that bowl these shirts the bags answer talk to waves .	that bowl these shirts the bags answer talk to whisper waves .
that toy those beds those bags praise teach cries .	that toy those beds those bags praise teach talk cries .
that chair these windows the dishes care for help waves .	that chair these windows the dishes care for help smile waves .
that ship these doors the books talk to appreciate paints .	that ship these doors the books talk to appreciate scream paints .
that bicycle the bags the trucks praise help reads .	that bicycle the bags the trucks praise help lie reads .
these cups this doll that mirror helps understands yell .	these cups this doll that mirror helps understands paints yell .
this window the bags those cups appreciate teach paints .	this window the bags those cups appreciate teach whisper paints .
the beds that plane the hat scares talks to win .	the beds that plane the hat scares talks to exercises win .
the plate the cars the plates worry appreciate cries .	the plate the cars the plates worry appreciate sing cries .
the bottle those cars the plates praise praise cries .	the bottle those cars the plates praise praise wave cries .
the crayon these crayons the forks care for understand paints .	the crayon these crayons the forks care for understand stretch paints .
the shoe those books the crayons work with appreciate talks .	the shoe those books the crayons work with appreciate read talks .
the truck the cups the pictures appreciate worry cries .	the truck the cups the pictures appreciate worry sneeze cries .
that dish the candles those windows worry answer waves .	that dish the candles those windows worry answer lie waves .
the candle the trucks those cars talk to understand waves .	the candle the trucks those cars talk to understand scream waves .
this bag those bowls the buttons talk to visit sings .	this bag those bowls the buttons talk to visit sing sings .
that dish those spoons those plates scare listen to paints .	that dish those spoons those plates scare listen to exercise paints .
this door the books the hats listen to work with talks .	this door the books the hats listen to work with exercise talks .
this picture the cars these candles praise work with exercises .	this picture the cars these candles praise work with lose exercises .
that plate the bottles these bowls help help cries .	that plate the bottles these bowls help help exercise cries .
this hat these beds these rings listen to talk to waves .	this hat these beds these rings listen to talk to smile waves .
the box the shirts those windows listen to worry cries .	the box the shirts those windows listen to worry win cries .
that truck these pictures these rings praise answer cries .	that truck these pictures these rings praise answer practice cries .
this dish these toys these boats answer help exercises .	this dish these toys these boats answer help stretch exercises .
the bicycle these spoons these crayons visit teach talks .	the bicycle these spoons these crayons visit teach laugh talks .
the bowl these bags these cups bother understand talks .	the bowl these bags these cups bother understand yell talks .
that crayon these bowls the shirts worry praise talks .	that crayon these bowls the shirts worry praise exercise talks .
these pictures that book this bottle understands talks to read .	these pictures that book this bottle understands talks to paints read .
the book these windows these dolls answer answer cries .	the book these windows these dolls answer answer stretch cries .
this mirror those candles those cars help visit reads .	this mirror those candles those cars help visit practice reads .
this book those shirts the windows help understand waves .	this book those shirts the windows help understand cough waves .
the ship those cars the doors help listen to sings .	the ship those cars the doors help listen to smile sings .
that bowl the bowls the plates care for listen to reads .	that bowl the bowls the plates care for listen to smile reads .
that fork those toys these forks scare bother talks .	that fork those toys these forks scare bother smile talks .
the fork these dishes these rings answer bother paints .	the fork these dishes these rings answer bother read paints .
that ship those boxes those glasses visit appreciate waves .	that ship those boxes those glasses visit appreciate wave waves .
the book these trucks these boats visit help reads .	the book these trucks these boats visit help wave reads .
those cars this couch this boat talks to works with lie .	those cars this couch this boat talks to works with waves lie .
this toy those books the glasses listen to understand exercises .	this toy those books the glasses listen to understand talk exercises .
this book the cars the doors worry scare sings .	this book the cars the doors worry scare practice sings .
the couch these spoons those cups appreciate care for sings .	the couch these spoons those cups appreciate care for lose sings .
the books this bicycle that button understands helps scream .	the books this bicycle that button understands helps reads scream .
that candle those bottles those spoons visit help talks .	that candle those bottles those spoons visit help sing talks .
that book these candles the buttons visit bother waves .	that book these candles the buttons visit bother win waves .
this book the windows the plates care for understand exercises .	this book the windows the plates care for understand whisper exercises .
this truck these bags the books appreciate teach waves .	this truck these bags the books appreciate teach scream waves .
this shoe the beds the buttons scare understand cries .	this shoe the beds the buttons scare understand cough cries .
this rocket those cups those cups worry listen to waves .	this rocket those cups those cups worry listen to laugh waves .
this cup the boats the windows talk to work with sings .	this cup the boats the windows talk to work with cry sings .
this plane the books those bottles answer worry reads .	this plane the books those bottles answer worry stretch reads .
that crayon those bags those forks listen to teach paints .	that crayon those bags those forks listen to teach wave paints .
that shoe the books the shirts scare scare waves .	that shoe the books the shirts scare scare paint waves .
that fork the plates these boats help work with reads .	that fork the plates these boats help work with practice reads .
the plates the box the plane understands scares scream .	the plates the box the plane understands scares cries scream .
the hats that mirror that hat helps works with lose .	the hats that mirror that hat helps works with exercises lose .
these beds that rocket this fork talks to understands sing .	these beds that rocket this fork talks to understands waves sing .
this fork these plates the beds appreciate appreciate cries .	this fork these plates the beds appreciate appreciate lose cries .
those dishes the window this ship scares works with lose .	those dishes the window this ship scares works with paints lose .
the doll those hats those boats visit visit waves .	the doll those hats those boats visit visit scream waves .
the hat the dishes these cars praise appreciate reads .	the hat the dishes these cars praise appreciate scream reads .
that crayon the toys the cups visit worry talks .	that crayon the toys the cups visit worry lose talks .
the chair the cars these shirts praise teach sings .	the chair the cars these shirts praise teach cry sings .
this picture these cars those boats visit understand cries .	this picture these cars those boats visit understand laugh cries .
this picture those cups those toys praise visit paints .	this picture those cups those toys praise visit wave paints .
this plane these shoes the windows appreciate care for cries .	this plane these shoes the windows appreciate care for sneeze cries .
the rocket those shirts the toys teach scare exercises .	the rocket those shirts the toys teach scare sing exercises .
this window the toys these bags appreciate care for sings .	this window the toys these bags appreciate care for smile sings .
the dish the plates these beds listen to listen to paints .	the dish the plates these beds listen to listen to stretch paints .
the shoe the forks these shirts listen to worry talks .	the shoe the forks these shirts listen to worry sneeze talks .
these plates this plate that rug helps talks to cough .	these plates this plate that rug helps talks to reads cough .
that plate the trucks the cars praise work with paints .	that plate the trucks the cars praise work with win paints .
the doll the books the rings care for scare paints .	the doll the books the rings care for scare paint paints .
this car those rings those rings listen to bother sings .	this car those rings those rings listen to bother wave sings .
that mirror the crayons the candles answer appreciate waves .	that mirror the crayons the candles answer appreciate lie waves .
those pictures that door the bag helps helps exercise .	those pictures that door the bag helps helps sings exercise .
this hat those glasses those beds talk to scare waves .	this hat those glasses those beds talk to scare smile waves .
those cars that button that hat helps works with win .	those cars that button that hat helps works with reads win .
this crayon those forks the cars scare worry cries .	this crayon those forks the cars scare worry lie cries .
these plates this car that glass scares talks to whisper .	these plates this car that glass scares talks to paints whisper .
the candle the cars these shoes visit visit cries .	the candle the cars these shoes visit visit win cries .
the glass those spoons the cars visit teach exercises .	the glass those spoons the cars visit teach lie exercises .
that toy the toys the boats work with visit sings .	that toy the toys the boats work with visit cough sings .
that glass the cars these dolls praise bother talks .	that glass the cars these dolls praise bother sing talks .
that window the hats those doors work with help reads .	that window the hats those doors work with help wave reads .
this couch the boxes those cups worry appreciate waves .	this couch the boxes those cups worry appreciate yell waves .
that boat the cars the glasses talk to worry paints .	that boat the cars the glasses talk to worry sing paints .
the bicycle those trucks those plates worry care for talks .	the bicycle those trucks those plates worry care for read talks .
the car the bowls those boats help answer reads .	the car the bowls those boats help answer stretch reads .
the plate these shirts these toys care for praise reads .	the plate these shirts these toys care for praise wave reads .
the bed these dolls the dishes worry teach reads .	the bed these dolls the dishes worry teach yell reads .
this toy those shirts those crayons appreciate worry reads .	this toy those shirts those crayons appreciate worry lie reads .
this button the toys the forks understand scare reads .	this button the toys the forks understand scare smile reads .
the crayon these dolls the cups answer worry cries .	the crayon these dolls the cups answer worry sing cries .
this book those boats the dishes answer bother reads .	this book those boats the dishes answer bother wave reads .
this book those boxes the toys teach listen to waves .	this book those boxes the toys teach listen to paint waves .
that crayon those plates these doors talk to worry exercises .	that crayon those plates these doors talk to worry talk exercises .
those hats the glass that hat understands helps talk .	those hats the glass that hat understands helps paints talk .
these cups that toy the toy talks to talks to whisper .	these cups that toy the toy talks to talks to sings whisper .
this cup the chairs those candles scare bother sings .	this cup the chairs those candles scare bother cry sings .
that dish those beds those dolls understand talk to reads .	that dish those beds those dolls understand talk to sneeze reads .
this door these toys those shirts praise teach sings .	this door these toys those shirts praise teach win sings .
the bag the pictures those shoes care for understand reads .	the bag the pictures those shoes care for understand scream reads .
the mirror those shirts those cups worry answer sings .	the mirror those shirts those cups worry answer sing sings .
that plane those forks the toys understand talk to waves .	that plane those forks the toys understand talk to read waves .
this mirror these rings those cups help care for paints .	this mirror these rings those cups help care for exercise paints .
the truck these windows those cars bother listen to exercises .	the truck these windows those cars bother listen to paint exercises .
this rocket these rings the hats care for work with reads .	this rocket these rings the hats care for work with scream reads .
this spoon those buttons the glasses scare teach paints .	this spoon those buttons the glasses scare teach exercise paints .
this truck these cars the books teach worry paints .	this truck these cars the books teach worry wave paints .
this hat the cars these spoons answer care for waves .	this hat the cars these spoons answer care for sing waves .
that spoon the books these forks bother praise waves .	that spoon the books these forks bother praise sneeze waves .
this toy those bags these dishes care for bother waves .	this toy those bags these dishes care for bother whisper waves .
that bowl these chairs those cups bother work with sings .	that bowl these chairs those cups bother work with scream sings .
the shirt the boats the cars teach praise waves .	the shirt the boats the cars teach praise paint waves .
that book these trucks the buttons scare work with waves .	that book these trucks the buttons scare work with smile waves .
that car those cups the glasses visit worry cries .	that car those cups the glasses visit worry practice cries .
this bowl those rings the rings scare talk to exercises .	this bowl those rings the rings scare talk to yell exercises .
the shoe these pictures those books answer praise exercises .	the shoe these pictures those books answer praise talk exercises .
this dish those rings these dolls listen to visit talks .	this dish those rings these dolls listen to visit stretch talks .
the glass the glasses the windows answer work with cries .	the glass the glasses the windows answer work with stretch cries .
this car these boats the books praise appreciate talks .	this car these boats the books praise appreciate cry talks .
that boat these shoes these boxes bother bother waves .	that boat these shoes these boxes bother bother stretch waves .
this doll the beds the spoons answer listen to cries .	this doll the beds the spoons answer listen to cry cries .
the cup these dishes the doors bother talk to exercises .	the cup these dishes the doors bother talk to lose exercises .
that dish the trucks the pictures talk to help reads .	that dish the trucks the pictures talk to help exercise reads .
that spoon these cars these crayons answer care for talks .	that spoon these cars these crayons answer care for smile talks .
the cup these trucks the bags answer scare cries .	the cup these trucks the bags answer scare win cries .
that rocket these spoons the boxes appreciate teach exercises .	that rocket these spoons the boxes appreciate teach paint exercises .
that bottle those rings these buttons understand talk to sings .	that bottle those rings these buttons understand talk to cry sings .
this toy these bags these windows praise praise talks .	this toy these bags these windows praise praise read talks .
these toys this car the candle helps scares cough .	these toys this car the candle helps scares talks cough .
that mirror these trucks these crayons worry talk to waves .	that mirror these trucks these crayons worry talk to sneeze waves .
this plate the chairs the plates scare worry paints .	this plate the chairs the plates scare worry wave paints .
the plate these plates these dishes scare worry cries .	the plate these plates these dishes scare worry scream cries .
the glass those bags these hats worry praise talks .	the glass those bags these hats worry praise lose talks .
that book these rings the pictures listen to visit paints .	that book these rings the pictures listen to visit lie paints .
this toy these trucks those rings scare appreciate sings .	this toy these trucks those rings scare appreciate win sings .
that bowl the glasses those dolls help listen to exercises .	that bowl the glasses those dolls help listen to win exercises .
that candle those cups the chairs scare worry exercises .	that candle those cups the chairs scare worry paint exercises .
this truck these candles those pictures worry work with cries .	this truck these candles those pictures worry work with sing cries .
this doll these rings those books care for visit sings .	this doll these rings those books care for visit read sings .
this car those toys those rings bother understand paints .	this car those toys those rings bother understand win paints .
this button these bottles the hats talk to visit sings .	this button these bottles the hats talk to visit cry sings .
that bottle the boats those trucks understand talk to reads .	that bottle the boats those trucks understand talk to cough reads .
this candle these shirts these glasses scare bother reads .	this candle these shirts these glasses scare bother talk reads .
this truck those buttons those books talk to talk to exercises .	this truck those buttons those books talk to talk to scream exercises .
the doll these chairs these dolls praise appreciate exercises .	the doll these chairs these dolls praise appreciate wave exercises .
that dish those chairs those glasses visit care for reads .	that dish those chairs those glasses visit care for talk reads .
the window those bottles these spoons teach help reads .	the window those bottles these spoons teach help yell reads .
the car the books those forks bother work with sings .	the car the books those forks bother work with practice sings .
this button the dolls these windows scare appreciate paints .	this button the dolls these windows scare appreciate practice paints .
this fork these rings those boats understand listen to paints .	this fork these rings those boats understand listen to lie paints .
the toy these books those glasses scare help sings .	the toy these books those glasses scare help sneeze sings .
the boxes this bed the bicycle works with works with practice .	the boxes this bed the bicycle works with works with talks practice .
that bicycle these bags those doors listen to worry reads .	that bicycle these bags those doors listen to worry wave reads .
that boat the shirts these rings care for help sings .	that boat the shirts these rings care for help sing sings .
the shirt those dishes the books appreciate visit paints .	the shirt those dishes the books appreciate visit win paints .
that book those dolls the pictures answer understand reads .	that book those dolls the pictures answer understand smile reads .
that spoon these bowls those dishes care for appreciate sings .	that spoon these bowls those dishes care for appreciate win sings .
this bicycle those buttons these rings listen to visit waves .	this bicycle those buttons these rings listen to visit cough waves .
this bottle the crayons these bags talk to talk to reads .	this bottle the crayons these bags talk to talk to whisper reads .
the chair the beds the cars care for visit waves .	the chair the beds the cars care for visit stretch waves .
the couch these hats these glasses talk to scare exercises .	the couch these hats these glasses talk to scare practice exercises .
these shoes that mirror the rug helps works with stretch .	these shoes that mirror the rug helps works with talks stretch .
the book these cups the bags bother bother reads .	the book these cups the bags bother bother smile reads .
that dish these books the doors appreciate scare exercises .	that dish these books the doors appreciate scare paint exercises .
this box these plates the spoons praise answer reads .	this box these plates the spoons praise answer sneeze reads .
the candle the cars these plates care for appreciate reads .	the candle the cars these plates care for appreciate talk reads .
the bicycle the books these shirts work with help exercises .	the bicycle the books these shirts work with help talk exercises .
that picture these boxes the rings understand talk to exercises .	that picture these boxes the rings understand talk to sing exercises .
the toy those hats these bowls teach listen to paints .	the toy those hats these bowls teach listen to stretch paints .
the book those spoons those cups appreciate praise waves .	the book those spoons those cups appreciate praise cough waves .
that hat those dolls the pictures help visit talks .	that hat those dolls the pictures help visit talk talks .
these doors that book that glass talks to scares laugh .	these doors that book that glass talks to scares talks laugh .
that chair those forks the shoes visit understand sings .	that chair those forks the shoes visit understand cry sings .
this book those candles those glasses teach worry waves .	this book those candles those glasses teach worry cry waves .
that cup the glasses the dishes worry work with reads .	that cup the glasses the dishes worry work with practice reads .
that doll those pictures the boats worry visit sings .	that doll those pictures the boats worry visit lose sings .
this candle these plates these toys scare worry sings .	this candle these plates these toys scare worry cry sings .
this boat the spoons these boxes care for listen to paints .	this boat the spoons these boxes care for listen to sneeze paints .
this hat these cars the spoons answer appreciate cries .	this hat these cars the spoons answer appreciate scream cries .
the bicycle the books those cars talk to teach sings .	the bicycle the books those cars talk to teach yell sings .
that picture these shoes these candles answer worry reads .	that picture these shoes these candles answer worry laugh reads .
that couch the pictures the windows answer worry reads .	that couch the pictures the windows answer worry win reads .
this plate those cars these boxes understand talk to reads .	this plate those cars these boxes understand talk to exercise reads .
this candle those bottles these forks praise understand sings .	this candle those bottles these forks praise understand stretch sings .
that rocket these glasses those plates talk to care for reads .	that rocket these glasses those plates talk to care for lie reads .
that fork these bottles those forks work with care for paints .	that fork these bottles those forks work with care for sneeze paints .
this truck those dishes the boxes visit talk to waves .	this truck those dishes the boxes visit talk to cough waves .
this bag the bowls these books talk to scare sings .	this bag the bowls these books talk to scare sneeze sings .
this rocket the cars those trucks scare listen to sings .	this rocket the cars those trucks scare listen to sing sings .
this toy these crayons these books bother scare talks .	this toy these crayons these books bother scare read talks .
that window those dishes those toys listen to talk to cries .	that window those dishes those toys listen to talk to exercise cries .
this ship those books the shirts care for understand exercises .	this ship those books the shirts care for understand practice exercises .
those glasses this couch this bag talks to talks to sneeze .	those glasses this couch this bag talks to talks to exercises sneeze .
that spoon those doors these crayons bother work with waves .	that spoon those doors these crayons bother work with smile waves .
these books this car this car works with helps cry .	these books this car this car works with helps reads cry .
those boats this plane that plate understands scares lose .	those boats this plane that plate understands scares exercises lose .
that ring these cups those buttons answer understand cries .	that ring these cups those buttons answer understand talk cries .
the glass those pictures these forks appreciate scare reads .	the glass those pictures these forks appreciate scare lose reads .
the car the books those forks scare listen to sings .	the car the books those forks scare listen to wave sings .
this book these dolls the shirts help care for exercises .	this book these dolls the shirts help care for smile exercises .
this toy those cups these forks appreciate work with exercises .	this toy those cups these forks appreciate work with win exercises .
that window those boxes the candles teach work with waves .	that window those boxes the candles teach work with laugh waves .
that toy those plates the crayons visit appreciate sings .	that toy those plates the crayons visit appreciate exercise sings .
that shoe the doors these rings scare listen to reads .	that shoe the doors these rings scare listen to laugh reads .
this boat the candles these forks work with care for sings .	this boat the candles these forks work with care for talk sings .
the book these bottles the boxes bother praise talks .	the book these bottles the boxes bother praise sneeze talks .
that mirror the dishes those bowls praise bother sings .	that mirror the dishes those bowls praise bother sing sings .
this bag these toys the hats care for understand paints .	this bag these toys the hats care for understand stretch paints .
the ring those books these plates worry worry paints .	the ring those books these plates worry worry sing paints .
this mirror these dishes those doors bother care for cries .	this mirror these dishes those doors bother care for smile cries .
that chair those crayons these cups visit work with exercises .	that chair those crayons these cups visit work with lose exercises .
that shirt these books those spoons understand appreciate sings .	that shirt these books those spoons understand appreciate sing sings .
this hat the chairs these beds understand listen to talks .	this hat the chairs these beds understand listen to cry talks .
the toy these chairs those chairs answer listen to waves .	the toy these chairs those chairs answer listen to read waves .
that door those cars those cars care for talk to reads .	that door those cars those cars care for talk to wave reads .
this shoe those glasses those windows praise answer exercises .	this shoe those glasses those windows praise answer cry exercises .
that boat those rings the cars work with teach exercises .	that boat those rings the cars work with teach laugh exercises .
this cup these plates the bottles work with listen to paints .	this cup these plates the bottles work with listen to paint paints .
the mirror the crayons the cups talk to bother exercises .	the mirror the crayons the cups talk to bother read exercises .
the ship those buttons the windows work with answer talks .	the ship those buttons the windows work with answer lose talks .
these beds the picture the toy works with understands laugh .	these beds the picture the toy works with understands waves laugh .
the bowl these candles these crayons appreciate appreciate exercises .	the bowl these candles these crayons appreciate appreciate lie exercises .
the book those forks those toys appreciate talk to cries .	the book those forks those toys appreciate talk to sneeze cries .
the hats that ship the ring scares talks to sneeze .	the hats that ship the ring scares talks to paints sneeze .
those plates that rug this book scares scares laugh .	those plates that rug this book scares scares waves laugh .
that cup these crayons those toys answer understand cries .	that cup these crayons those toys answer understand lose cries .
that bicycle those books these dolls appreciate teach talks .	that bicycle those books these dolls appreciate teach practice talks .
the fork these toys the toys praise understand paints .	the fork these toys the toys praise understand laugh paints .
this cup those hats those glasses scare worry reads .	this cup those hats those glasses scare worry smile reads .
this car the cars the cups care for praise exercises .	this car the cars the cups care for praise cry exercises .
this picture the glasses those crayons appreciate bother sings .	this picture the glasses those crayons appreciate bother talk sings .
these plates the shoe this rug understands talks to sing .	these plates the shoe this rug understands talks to reads sing .
the ship these buttons these cars scare answer sings .	the ship these buttons these cars scare answer cough sings .
this crayon those trucks the boats answer listen to sings .	this crayon those trucks the boats answer listen to lose sings .
the spoon these glasses the trucks praise help sings .	the spoon these glasses the trucks praise help lie sings .
that spoon the pictures those dishes praise listen to sings .	that spoon the pictures those dishes praise listen to sneeze sings .
that bicycle the spoons the books visit help paints .	that bicycle the spoons the books visit help stretch paints .
the spoon the crayons the trucks visit understand sings .	the spoon the crayons the trucks visit understand sing sings .
this book the hats these cars visit listen to waves .	this book the hats these cars visit listen to practice waves .
this book these bowls the crayons worry teach exercises .	this book these bowls the crayons worry teach cry exercises .
the shirt these bags the bottles listen to worry talks .	the shirt these bags the bottles listen to worry lose talks .
the shoes that hat the hat understands understands talk .	the shoes that hat the hat understands understands paints talk .
that mirror those forks those books appreciate answer cries .	that mirror those forks those books appreciate answer lie cries .
the shoe those toys the toys teach bother paints .	the shoe those toys the toys teach bother cry paints .
this spoon these beds these bowls help bother sings .	this spoon these beds these bowls help bother laugh sings .
that car those trucks these cars understand teach exercises .	that car those trucks these cars understand teach read exercises .
the ring the books the shirts bother worry paints .	the ring the books the shirts bother worry sing paints .
that glass the dolls those plates bother praise cries .	that glass the dolls those plates bother praise paint cries .
this spoon the windows the boxes answer worry talks .	this spoon the windows the boxes answer worry exercise talks .
the bottle those pictures the trucks work with appreciate cries .	the bottle those pictures the trucks work with appreciate cough cries .
the ship these crayons the candles understand scare paints .	the ship these crayons the candles understand scare whisper paints .
that bicycle these shoes those rings listen to understand talks .	that bicycle these shoes those rings listen to understand sneeze talks .
those windows that crayon the door scares works with exercise .	those windows that crayon the door scares works with exercises exercise .
the shoe these dishes those windows care for visit waves .	the shoe these dishes those windows care for visit win waves .
that car those plates those cars teach work with waves .	that car those plates those cars teach work with win waves .
this box the spoons those shoes bother answer sings .	this box the spoons those shoes bother answer talk sings .
the doll these hats those pictures bother understand paints .	the doll these hats those pictures bother understand lie paints .
that car those cars the boxes help help reads .	that car those cars the boxes help help talk reads .
that car those cars the pictures bother talk to exercises .	that car those cars the pictures bother talk to read exercises .
the crayon those bottles those glasses care for listen to paints .	the crayon those bottles those glasses care for listen to stretch paints .
the bicycle these bowls the chairs listen to teach cries .	the bicycle these bowls the chairs listen to teach lie cries .
the candles that glass the book helps helps lie .	the candles that glass the book helps helps waves lie .
this boat the books the pictures praise work with talks .	this boat the books the pictures praise work with win talks .
those books the ship that truck talks to scares lie .	those books the ship that truck talks to scares waves lie .
this bed these glasses those bowls visit care for talks .	this bed these glasses those bowls visit care for talk talks .
this couch these shoes these candles scare praise sings .	this couch these shoes these candles scare praise lie sings .
the fork the hats those forks answer teach cries .	the fork the hats those forks answer teach lose cries .
this button these cups the boxes teach talk to cries .	this button these cups the boxes teach talk to practice cries .
that shirt those books the trucks answer work with exercises .	that shirt those books the trucks answer work with talk exercises .
the books that ship the hat works with talks to exercise .	the books that ship the hat works with talks to cries exercise .
that chair the chairs these shirts teach visit paints .	that chair the chairs these shirts teach visit win paints .
this chair these beds these books listen to teach sings .	this chair these beds these books listen to teach paint sings .
this chair those beds the dolls help scare cries .	this chair those beds the dolls help scare read cries .
those shoes this bowl the box helps scares exercise .	those shoes this bowl the box helps scares waves exercise .
that glass the spoons the chairs scare help paints .	that glass the spoons the chairs scare help stretch paints .
the bottle the bowls the books help care for sings .	the bottle the bowls the books help care for cry sings .
this bottle the shoes the cars care for help sings .	this bottle the shoes the cars care for help paint sings .
the hat the beds these bowls help teach paints .	the hat the beds these bowls help teach laugh paints .
that door those candles those shoes praise listen to cries .	that door those candles those shoes praise listen to yell cries .
the bag those cars those bowls understand understand paints .	the bag those cars those bowls understand understand read paints .
this bicycle the bags the windows visit teach cries .	this bicycle the bags the windows visit teach lie cries .
that bag those bottles these boxes help listen to paints .	that bag those bottles these boxes help listen to smile paints .
that cup these boxes the trucks teach scare reads .	that cup these boxes the trucks teach scare talk reads .
this shoe those boxes these shoes appreciate visit talks .	this shoe those boxes these shoes appreciate visit exercise talks .
the ship these toys these cars care for work with paints .	the ship these toys these cars care for work with cry paints .
that shirt these glasses those cars appreciate talk to exercises .	that shirt these glasses those cars appreciate talk to whisper exercises .
this car the trucks these boxes work with care for reads .	this car the trucks these boxes work with care for sneeze reads .
this plate those bowls these boats answer work with waves .	this plate those bowls these boats answer work with paint waves .
that bed those bowls the beds appreciate answer paints .	that bed those bowls the beds appreciate answer wave paints .
that fork those books those glasses worry answer reads .	that fork those books those glasses worry answer stretch reads .
this shirt these buttons these pictures work with answer paints .	this shirt these buttons these pictures work with answer stretch paints .
these windows this chair that ring talks to understands exercise .	these windows this chair that ring talks to understands sings exercise .
the spoon these cars these cars help worry exercises .	the spoon these cars these cars help worry stretch exercises .
that glass those trucks those windows help help paints .	that glass those trucks those windows help help paint paints .
the plane the books the hats worry bother exercises .	the plane the books the hats worry bother smile exercises .
this bottle those plates those books appreciate listen to exercises .	this bottle those plates those books appreciate listen to wave exercises .
that picture the cars those bottles worry scare talks .	that picture the cars those bottles worry scare smile talks .
the bicycle those doors these rings answer understand exercises .	the bicycle those doors these rings answer understand exercise exercises .
that door those doors the pictures listen to scare sings .	that door those doors the pictures listen to scare cough sings .
the door these shoes the cups talk to work with waves .	the door these shoes the cups talk to work with scream waves .
