the chairs helped these nice boats .	the chairs helped these nice boat .
the bottles must answer these friendly buttons .	the bottles must answer these friendly button .
the picture wo n't listen to those confused bottles .	the picture wo n't listen to those confused bottle .
the book knew that nice doll .	the book knew that nice dolls .
the museum fixed those fine people .	the museum fixed those fine person .
the spoons must clean these dry doctors .	the spoons must clean these dry doctor .
the schools had those cold girls .	the schools had those cold girl .
the cars are n't listening to this excited school .	the cars are n't listening to this excited schools .
the couch scared these upset bags .	the couch scared these upset bag .
the rocket will listen to that boring cup .	the rocket will listen to that boring cups .
the hat brought that blue teacher .	the hat brought that blue teachers .
the book talked to this boring window .	the book talked to this boring windows .
the schools answer these helpful beds .	the schools answer these helpful bed .
the dishes must talk to this boring boat .	the dishes must talk to this boring boats .
the library works with that tall bag .	the library works with that tall bags .
the toys helped this helpful book .	the toys helped this helpful books .
the bottle will fix this black lady .	the bottle will fix this black ladies .
the bottle answered this lucky hat .	the bottle answered this lucky hats .
the book has heard that important shoe .	the book has heard that important shoes .
the school should listen to these sleepy shirts .	the school should listen to these sleepy shirt .
the school can n't work with that curious picture .	the school can n't work with that curious pictures .
the bed kept these great ladies .	the bed kept these great lady .
the plates praise this busy candle .	the plates praise this busy candles .
the bicycle wo n't have those blue doctors .	the bicycle wo n't have those blue doctor .
the shirt worked with that young hat .	the shirt worked with that young hats .
the shoes have scared those hungry glasses .	the shoes have scared those hungry glass .
the bottle knew these confused forks .	the bottle knew these confused fork .
the windows lost those surprised spoons .	the windows lost those surprised spoon .
the dish had scared this confused doll .	the dish had scared this confused dolls .
the trucks know that wrong car .	the trucks know that wrong cars .
the book had n't bought this whole doctor .	the book had n't bought this whole doctors .
the cups must clean those gray women .	the cups must clean those gray woman .
the forks bothered this young bowl .	the forks bothered this young bowls .
the candles have fixed that red child .	the candles have fixed that red children .
the doll had lost this awesome boy .	the doll had lost this awesome boys .
the dolls are listening to these careful rooms .	the dolls are listening to these careful room .
the buttons have confused that happy car .	the buttons have confused that happy cars .
the books do n't help those surprised dolls .	the books do n't help those surprised doll .
the window may bother this busy car .	the window may bother this busy cars .
the candle may teach this tall chair .	the candle may teach this tall chairs .
the bottles wo n't talk to that boring boat .	the bottles wo n't talk to that boring boats .
the mirror might move this white girl .	the mirror might move this white girls .
the dishes are n't shaking those orange women .	the dishes are n't shaking those orange woman .
the bowl is n't helping this confused fork .	the bowl is n't helping this confused forks .
the library would n't praise that clever chair .	the library would n't praise that clever chairs .
the chairs threw those yellow women .	the chairs threw those yellow woman .
the bottles appreciate those helpful trucks .	the bottles appreciate those helpful truck .
the spoons might understand those bored cars .	the spoons might understand those bored car .
the couch was n't fixing those purple people .	the couch was n't fixing those purple person .
the plates teach these lucky dolls .	the plates teach these lucky doll .
the cups worry that confused picture .	the cups worry that confused pictures .
the chair knew these surprised boxes .	the chair knew these surprised box .
the rooms were keeping this boring man .	the rooms were keeping this boring men .
the room has n't heard those quiet glasses .	the room has n't heard those quiet glass .
the doll hears those healthy hats .	the doll hears those healthy hat .
the shoes brought these blue teachers .	the shoes brought these blue teacher .
the cups have heard those helpful cups .	the cups have heard those helpful cup .
the shoe confused this healthy fork .	the shoe confused this healthy forks .
the chair stole this cute child .	the chair stole this cute children .
the book has n't taken this white guy .	the book has n't taken this white guys .
the cars scare this boring door .	the cars scare this boring doors .
the plane could visit these hungry trucks .	the plane could visit these hungry truck .
the window talks to that angry book .	the window talks to that angry books .
the truck heard these healthy rooms .	the truck heard these healthy room .
the window had confused those tall boats .	the window had confused those tall boat .
the bicycle bothered these sleepy dolls .	the bicycle bothered these sleepy doll .
the candle confused those confused books .	the candle confused those confused book .
the rings heard this boring window .	the rings heard this boring windows .
the bowl is n't making that broken child .	the bowl is n't making that broken children .
the dishes hold this awesome guy .	the dishes hold this awesome guys .
the rug takes this great woman .	the rug takes this great women .
the forks are n't cleaning this whole doctor .	the forks are n't cleaning this whole doctors .
the cars visited this nice truck .	the cars visited this nice trucks .
the book talks to these gentle shoes .	the book talks to these gentle shoe .
the schools answer these boring boxes .	the schools answer these boring box .
the boat fixed that new person .	the boat fixed that new people .
the rocket may appreciate that smart doll .	the rocket may appreciate that smart dolls .
the trucks fixed this big teacher .	the trucks fixed this big teachers .
the truck knew this sleepy doll .	the truck knew this sleepy dolls .
the hospital knows that bored car .	the hospital knows that bored cars .
the beds bought that expensive person .	the beds bought that expensive people .
the school has n't taught this young picture .	the school has n't taught this young pictures .
the boat bought these hot doctors .	the boat bought these hot doctor .
the hospital could n't bother those gentle crayons .	the hospital could n't bother those gentle crayon .
the cups made these whole ladies .	the cups made these whole lady .
the crayons may throw that yellow lady .	the crayons may throw that yellow ladies .
the bottle was n't losing those broken girls .	the bottle was n't losing those broken girl .
the bag took those small girls .	the bag took those small girl .
the picture had n't made these whole people .	the picture had n't made these whole person .
the dolls teach these curious dolls .	the dolls teach these curious doll .
the toy is teaching this gentle car .	the toy is teaching this gentle cars .
the bicycle knows those excited chairs .	the bicycle knows those excited chair .
the cars teach those upset bowls .	the cars teach those upset bowl .
the bags had n't held these brown doctors .	the bags had n't held these brown doctor .
the chairs will teach that upset shoe .	the chairs will teach that upset shoes .
the bowl would care for that nice room .	the bowl would care for that nice rooms .
the shirt knows that surprised toy .	the shirt knows that surprised toys .
the hospital held this green teacher .	the hospital held this green teachers .
the rooms may work with those wrong pictures .	the rooms may work with those wrong picture .
the beds talked to these clever toys .	the beds talked to these clever toy .
the chairs are bringing this new man .	the chairs are bringing this new men .
the cup can n't listen to that surprised box .	the cup can n't listen to that surprised boxes .
the shirts could n't care for these boring doors .	the shirts could n't care for these boring door .
the museum had n't heard those busy shirts .	the museum had n't heard those busy shirt .
the dishes have bothered that boring bed .	the dishes have bothered that boring beds .
the couch has dropped those fine children .	the couch has dropped those fine child .
the fork makes those purple women .	the fork makes those purple woman .
the chair did n't listen to that smart glass .	the chair did n't listen to that smart glasses .
the windows will work with these bored boxes .	the windows will work with these bored box .
the bottle is n't helping those smart forks .	the bottle is n't helping those smart fork .
the restaurant did n't scare this nice dish .	the restaurant did n't scare this nice dishes .
the library knew those smart schools .	the library knew those smart school .
the buttons listen to that upset book .	the buttons listen to that upset books .
the library can n't lose this boring boy .	the library can n't lose this boring boys .
the bowls work with these excited bowls .	the bowls work with these excited bowl .
the rooms can n't understand that friendly glass .	the rooms can n't understand that friendly glasses .
the doors are n't teaching those wrong pictures .	the doors are n't teaching those wrong picture .
the cup should n't talk to those helpful shoes .	the cup should n't talk to those helpful shoe .
the schools are n't helping that bored ring .	the schools are n't helping that bored rings .
the boats heard that lucky school .	the boats heard that lucky schools .
the bags care for that careful car .	the bags care for that careful cars .
the car does n't bother this helpful picture .	the car does n't bother this helpful pictures .
the cars were n't bothering this excited button .	the cars were n't bothering this excited buttons .
the beds were listening to that excited button .	the beds were listening to that excited buttons .
the dolls would n't bother those careful hats .	the dolls would n't bother those careful hat .
the shoes shook that white woman .	the shoes shook that white women .
the room had n't thrown these white ladies .	the room had n't thrown these white lady .
the bowls worry that surprised chair .	the bowls worry that surprised chairs .
the box has n't heard this important dish .	the box has n't heard this important dishes .
the school understands those tall bottles .	the school understands those tall bottle .
the kitchen had helped those tall hats .	the kitchen had helped those tall hat .
the school has moved this new person .	the school has moved this new people .
the plate has n't made those missing people .	the plate has n't made those missing person .
the books have n't confused that important room .	the books have n't confused that important rooms .
the bowl could move these red children .	the bowl could move these red child .
the doors did n't lose this boring man .	the doors did n't lose this boring men .
the candle could sell this cool person .	the candle could sell this cool people .
the picture hears that healthy shirt .	the picture hears that healthy shirts .
the candles have worked with these bored cars .	the candles have worked with these bored car .
the shoes might bring these broken girls .	the shoes might bring these broken girl .
the spoon would work with those happy crayons .	the spoon would work with those happy crayon .
the plane wo n't have this big woman .	the plane wo n't have this big women .
the plane was bringing those black guys .	the plane was bringing those black guy .
the car had n't answered these surprised spoons .	the car had n't answered these surprised spoon .
the door did n't understand those smart dolls .	the door did n't understand those smart doll .
the dolls help these important schools .	the dolls help these important school .
the dolls visit these boring shoes .	the dolls visit these boring shoe .
the hat should n't take these big doctors .	the hat should n't take these big doctor .
the rocket had n't answered these helpful boxes .	the rocket had n't answered these helpful box .
the dish is n't helping that young book .	the dish is n't helping that young books .
the mall could n't work with these confused rooms .	the mall could n't work with these confused room .
the windows have n't heard this wrong car .	the windows have n't heard this wrong cars .
the glass moved these whole children .	the glass moved these whole child .
the forks could bother that happy school .	the forks could bother that happy schools .
the hats did n't hear those wrong doors .	the hats did n't hear those wrong door .
the bicycle has heard that strong car .	the bicycle has heard that strong cars .
the pictures do n't praise these busy cars .	the pictures do n't praise these busy car .
the cars answer these friendly pictures .	the cars answer these friendly picture .
the mirror knows those nice glasses .	the mirror knows those nice glass .
the candle fixed this black child .	the candle fixed this black children .
the schools did n't hear these sleepy boxes .	the schools did n't hear these sleepy box .
the button has worried that young book .	the button has worried that young books .
the picture had n't lost these friendly doors .	the picture had n't lost these friendly door .
the bed was n't holding these important children .	the bed was n't holding these important child .
the car can work with this hungry bowl .	the car can work with this hungry bowls .
the restaurant answered those surprised buttons .	the restaurant answered those surprised button .
the crayon moved that orange woman .	the crayon moved that orange women .
the dishes had n't found these strong trucks .	the dishes had n't found these strong truck .
the glass scared that happy chair .	the glass scared that happy chairs .
the beds heard that quiet bowl .	the beds heard that quiet bowls .
the rug scares these strong cups .	the rug scares these strong cup .
the schools had n't made these missing people .	the schools had n't made these missing person .
the ship was n't visiting these important shoes .	the ship was n't visiting these important shoe .
the window hears this quiet bowl .	the window hears this quiet bowls .
the kitchen answered these clever rooms .	the kitchen answered these clever room .
the bags are talking to that angry bag .	the bags are talking to that angry bags .
the museum had found that angry car .	the museum had found that angry cars .
the hats might bother this smart crayon .	the hats might bother this smart crayons .
the cup knows that strong boat .	the cup knows that strong boats .
the bottles have n't found these clever forks .	the bottles have n't found these clever fork .
the boat must appreciate those nice chairs .	the boat must appreciate those nice chair .
the bicycle does n't answer this bored fork .	the bicycle does n't answer this bored forks .
the bags would sell that brown person .	the bags would sell that brown people .
the rings dropped that boring woman .	the rings dropped that boring women .
the boat should n't listen to those confused windows .	the boat should n't listen to those confused window .
the plane scares these busy cars .	the plane scares these busy car .
the box would n't throw that big guy .	the box would n't throw that big guys .
the button lost this busy button .	the button lost this busy buttons .
the mall had n't taught those angry buttons .	the mall had n't taught those angry button .
the school has taken this black guy .	the school has taken this black guys .
the bowl is holding those purple boys .	the bowl is holding those purple boy .
the couch threw those important girls .	the couch threw those important girl .
the room has n't helped those lucky shoes .	the room has n't helped those lucky shoe .
the boat could n't bother this clever book .	the boat could n't bother this clever books .
the boats scared that upset spoon .	the boats scared that upset spoons .
the doors shook that broken child .	the doors shook that broken children .
the cup has n't bothered that quiet glass .	the cup has n't bothered that quiet glasses .
the plates fixed those purple doctors .	the plates fixed those purple doctor .
the picture is n't holding those amazing teachers .	the picture is n't holding those amazing teacher .
the library has brought this dry girl .	the library has brought this dry girls .
the button should n't buy these broken boys .	the button should n't buy these broken boy .
the restaurant has n't held this whole child .	the restaurant has n't held this whole children .
the cup could n't know these tall toys .	the cup could n't know these tall toy .
the bag worked with that bored shoe .	the bag worked with that bored shoes .
the cars may talk to that hungry doll .	the cars may talk to that hungry dolls .
the boxes find those missing women .	the boxes find those missing woman .
the kitchen has n't scared those nice windows .	the kitchen has n't scared those nice window .
the candles would hear that healthy room .	the candles would hear that healthy rooms .
the chair confused these kind shirts .	the chair confused these kind shirt .
the glass would n't teach these healthy forks .	the glass would n't teach these healthy fork .
the couch was teaching these tall books .	the couch was teaching these tall book .
the bicycle will sell those gray ladies .	the bicycle will sell those gray lady .
the box was n't holding that great boy .	the box was n't holding that great boys .
the dishes heard this excited glass .	the dishes heard this excited glasses .
the doors clean this gray boy .	the doors clean this gray boys .
the dolls appreciate that healthy hat .	the dolls appreciate that healthy hats .
the cars made those yellow women .	the cars made those yellow woman .
the book visited this careful plate .	the book visited this careful plates .
the window cleaned those brown men .	the window cleaned those brown man .
the glass is n't bringing those cute doctors .	the glass is n't bringing those cute doctor .
the rings lost that upset candle .	the rings lost that upset candles .
the windows took that red woman .	the windows took that red women .
the boxes were listening to that nice bowl .	the boxes were listening to that nice bowls .
the boats had brought that broken girl .	the boats had brought that broken girls .
the hat shakes these amazing guys .	the hat shakes these amazing guy .
the chair had worried those quiet dolls .	the chair had worried those quiet doll .
the bottle is making those purple ladies .	the bottle is making those purple lady .
the candles hear these boring shoes .	the candles hear these boring shoe .
the hats were n't bothering this excited truck .	the hats were n't bothering this excited trucks .
the school scared this bored book .	the school scared this bored books .
the car is visiting that bored candle .	the car is visiting that bored candles .
the toys helped these curious cars .	the toys helped these curious car .
the school should n't steal those hot girls .	the school should n't steal those hot girl .
the rooms lost those small men .	the rooms lost those small man .
the window knew this tired cup .	the window knew this tired cups .
the bag knows that kind toy .	the bag knows that kind toys .
the ship has n't lost those whole boys .	the ship has n't lost those whole boy .
the box is n't taking that expensive guy .	the box is n't taking that expensive guys .
the plates would n't sell this cute girl .	the plates would n't sell this cute girls .
the chairs were working with these careful boxes .	the chairs were working with these careful box .
the buttons know those busy pictures .	the buttons know those busy picture .
the truck is visiting that strong crayon .	the truck is visiting that strong crayons .
the beds fixed those whole guys .	the beds fixed those whole guy .
the window should help these friendly doors .	the window should help these friendly door .
the bottle did n't clean those important ladies .	the bottle did n't clean those important lady .
the shirt talked to these nice chairs .	the shirt talked to these nice chair .
the schools had n't kept this important boy .	the schools had n't kept this important boys .
the toys worked with this strong doll .	the toys worked with this strong dolls .
the buttons had n't lost those fine men .	the buttons had n't lost those fine man .
the schools are visiting that excited candle .	the schools are visiting that excited candles .
the room did n't lose these whole doctors .	the room did n't lose these whole doctor .
the trucks took those purple girls .	the trucks took those purple girl .
the truck could hold those broken women .	the truck could hold those broken woman .
the shirts were n't losing these fine girls .	the shirts were n't losing these fine girl .
the mirror kept those big guys .	the mirror kept those big guy .
the spoons take this blue guy .	the spoons take this blue guys .
the buttons stole those big children .	the buttons stole those big child .
the doll heard this boring truck .	the doll heard this boring trucks .
the shirt does n't understand this boring room .	the shirt does n't understand this boring rooms .
the hospital does n't drop those missing women .	the hospital does n't drop those missing woman .
the bowl has n't heard that wrong hat .	the bowl has n't heard that wrong hats .
the ring was n't shaking those cool teachers .	the ring was n't shaking those cool teacher .
the schools were teaching that busy fork .	the schools were teaching that busy forks .
the plane can n't throw this awesome doctor .	the plane can n't throw this awesome doctors .
the schools may praise those smart beds .	the schools may praise those smart bed .
the crayon will buy that awesome person .	the crayon will buy that awesome people .
the shirt could scare these surprised hats .	the shirt could scare these surprised hat .
the doors should care for these clever dolls .	the doors should care for these clever doll .
the chairs could n't bother this careful cup .	the chairs could n't bother this careful cups .
the picture might teach this careful hat .	the picture might teach this careful hats .
the schools are working with those tall shirts .	the schools are working with those tall shirt .
the rug knew that surprised school .	the rug knew that surprised schools .
the hat talked to this friendly truck .	the hat talked to this friendly trucks .
the couch could n't move this blue teacher .	the couch could n't move this blue teachers .
the books wo n't help these tall rooms .	the books wo n't help these tall room .
the dolls could n't sell that orange child .	the dolls could n't sell that orange children .
the school had n't made those big ladies .	the school had n't made those big lady .
the shirt wo n't steal those boring men .	the shirt wo n't steal those boring man .
the dolls bother this friendly doll .	the dolls bother this friendly dolls .
the buttons dropped these purple girls .	the buttons dropped these purple girl .
the school knew these surprised hats .	the school knew these surprised hat .
the dolls will listen to this healthy window .	the dolls will listen to this healthy windows .
the forks had n't answered this strong ring .	the forks had n't answered this strong rings .
the hats appreciate that gentle crayon .	the hats appreciate that gentle crayons .
the candles found that broken man .	the candles found that broken men .
the kitchen has n't lost these kind schools .	the kitchen has n't lost these kind school .
the rug did n't know that healthy car .	the rug did n't know that healthy cars .
the buttons had lost this young candle .	the buttons had lost this young candles .
the rooms have n't taught those tired dishes .	the rooms have n't taught those tired dish .
the mall is n't visiting those smart cars .	the mall is n't visiting those smart car .
the library visited that curious book .	the library visited that curious books .
the fork wo n't work with that helpful car .	the fork wo n't work with that helpful cars .
the schools have kept this broken lady .	the schools have kept this broken ladies .
the bicycle visited these wrong boats .	the bicycle visited these wrong boat .
the rug must bother these helpful boats .	the rug must bother these helpful boat .
the bowls were n't talking to that excited hat .	the bowls were n't talking to that excited hats .
the chairs have n't bought this yellow man .	the chairs have n't bought this yellow men .
the shirt has talked to these excited plates .	the shirt has talked to these excited plate .
the bag had lost those gentle pictures .	the bag had lost those gentle picture .
the candle taught that smart toy .	the candle taught that smart toys .
the crayons have talked to these gentle cars .	the crayons have talked to these gentle car .
the plane is n't talking to this strong shoe .	the plane is n't talking to this strong shoes .
the library could fix this yellow guy .	the library could fix this yellow guys .
the room works with this quiet toy .	the room works with this quiet toys .
the bowls had n't worried this strong dish .	the bowls had n't worried this strong dishes .
the bags wo n't bother that surprised room .	the bags wo n't bother that surprised rooms .
the ship may hold those red doctors .	the ship may hold those red doctor .
the windows hear those careful toys .	the windows hear those careful toy .
the schools were n't bothering this upset ring .	the schools were n't bothering this upset rings .
the dishes were listening to these happy dishes .	the dishes were listening to these happy dish .
the hats might answer this healthy shoe .	the hats might answer this healthy shoes .
the car had talked to these tall shirts .	the car had talked to these tall shirt .
the toys understand those surprised chairs .	the toys understand those surprised chair .
the schools visit that healthy book .	the schools visit that healthy books .
the pictures were fixing these dry girls .	the pictures were fixing these dry girl .
the plate was n't losing these cool children .	the plate was n't losing these cool child .
the cars find those small people .	the cars find those small person .
the books answer these quiet cups .	the books answer these quiet cup .
the chair knew these boring shirts .	the chair knew these boring shirt .
the bowls do n't hear this angry book .	the bowls do n't hear this angry books .
the cars dropped this cute doctor .	the cars dropped this cute doctors .
the chair does n't find these hot teachers .	the chair does n't find these hot teacher .
the books were bringing that old lady .	the books were bringing that old ladies .
the cups were talking to this tired book .	the cups were talking to this tired books .
the kitchen could make those new people .	the kitchen could make those new person .
the bicycle moves these yellow teachers .	the bicycle moves these yellow teacher .
the books have n't thrown those cute ladies .	the books have n't thrown those cute lady .
the rocket is cleaning these red people .	the rocket is cleaning these red person .
the room was holding that yellow doctor .	the room was holding that yellow doctors .
the shirt would teach that happy bowl .	the shirt would teach that happy bowls .
the picture shook those gray doctors .	the picture shook those gray doctor .
the doll did n't visit this curious spoon .	the doll did n't visit this curious spoons .
the shirts should n't keep these gray women .	the shirts should n't keep these gray woman .
the cups knew those busy toys .	the cups knew those busy toy .
the crayon would bother this lucky toy .	the crayon would bother this lucky toys .
the bank can n't keep these orange teachers .	the bank can n't keep these orange teacher .
the rocket did n't talk to that wrong room .	the rocket did n't talk to that wrong rooms .
the books must shake these great children .	the books must shake these great child .
the candles have these amazing boys .	the candles have these amazing boy .
the cars could steal those cool women .	the cars could steal those cool woman .
the truck heard that happy crayon .	the truck heard that happy crayons .
the dishes were bothering these happy glasses .	the dishes were bothering these happy glass .
the kitchen answered those careful boats .	the kitchen answered those careful boat .
the glasses were n't helping this boring car .	the glasses were n't helping this boring cars .
the forks worry that excited crayon .	the forks worry that excited crayons .
the bicycle would teach this healthy crayon .	the bicycle would teach this healthy crayons .
the doors understand those important cars .	the doors understand those important car .
the button had heard those curious candles .	the button had heard those curious candle .
the forks help these healthy shirts .	the forks help these healthy shirt .
the dishes dropped that yellow guy .	the dishes dropped that yellow guys .
the doors had n't heard this curious box .	the doors had n't heard this curious boxes .
the books should n't fix that red person .	the books should n't fix that red people .
the spoon hears those careful plates .	the spoon hears those careful plate .
the pictures had heard these busy boxes .	the pictures had heard these busy box .
the bags hear these important plates .	the bags hear these important plate .
the kitchen can talk to that angry spoon .	the kitchen can talk to that angry spoons .
the rug is bothering those tall boxes .	the rug is bothering those tall box .
the book knows this angry doll .	the book knows this angry dolls .
the mall had n't confused this sleepy car .	the mall had n't confused this sleepy cars .
the hospital wo n't teach this upset bottle .	the hospital wo n't teach this upset bottles .
the rings hear this careful button .	the rings hear this careful buttons .
the plates found those excited bottles .	the plates found those excited bottle .
the windows help those gentle bowls .	the windows help those gentle bowl .
the bed might throw those black people .	the bed might throw those black person .
the windows understand these healthy bags .	the windows understand these healthy bag .
the candles held this broken woman .	the candles held this broken women .
the shoes have scared those gentle dolls .	the shoes have scared those gentle doll .
the spoons were bothering this curious bag .	the spoons were bothering this curious bags .
the books fixed that black teacher .	the books fixed that black teachers .
the boats knew these angry books .	the boats knew these angry book .
the bowl is n't teaching that curious truck .	the bowl is n't teaching that curious trucks .
the windows had n't scared this friendly toy .	the windows had n't scared this friendly toys .
the shirt has heard that lucky crayon .	the shirt has heard that lucky crayons .
the kitchen lost that nice window .	the kitchen lost that nice windows .
the windows heard this young doll .	the windows heard this young dolls .
the boat took that cold woman .	the boat took that cold women .
the trucks praise this confused dish .	the trucks praise this confused dishes .
the hats are n't visiting this angry ring .	the hats are n't visiting this angry rings .
the books found this friendly hat .	the books found this friendly hats .
the library has n't answered that friendly plate .	the library has n't answered that friendly plates .
the hats knew this busy window .	the hats knew this busy windows .
the museum has taken these awesome children .	the museum has taken these awesome child .
the book would worry that nice toy .	the book would worry that nice toys .
the buttons hear that healthy room .	the buttons hear that healthy rooms .
the library confused those happy schools .	the library confused those happy school .
the chairs lose this brown doctor .	the chairs lose this brown doctors .
the shirt has n't talked to these strong trucks .	the shirt has n't talked to these strong truck .
the door hears that helpful shoe .	the door hears that helpful shoes .
the buttons have n't talked to that nice fork .	the buttons have n't talked to that nice forks .
the beds were listening to those surprised bowls .	the beds were listening to those surprised bowl .
the window had n't heard this boring hat .	the window had n't heard this boring hats .
the box is bringing that old doctor .	the box is bringing that old doctors .
the ship did n't clean these purple women .	the ship did n't clean these purple woman .
the plate held those great people .	the plate held those great person .
the shoe was n't fixing this gray teacher .	the shoe was n't fixing this gray teachers .
the crayons wo n't buy that big guy .	the crayons wo n't buy that big guys .
the rocket is shaking those green ladies .	the rocket is shaking those green lady .
the bed worked with this surprised window .	the bed worked with this surprised windows .
the schools move this green lady .	the schools move this green ladies .
the rug makes these yellow girls .	the rug makes these yellow girl .
the boxes had n't lost those new people .	the boxes had n't lost those new person .
the books can help those angry cars .	the books can help those angry car .
the spoon brought these small teachers .	the spoon brought these small teacher .
the museum would shake those fine teachers .	the museum would shake those fine teacher .
the hospital holds those dry women .	the hospital holds those dry woman .
the bed should take this cool guy .	the bed should take this cool guys .
the trucks move that big lady .	the trucks move that big ladies .
the boxes heard those bored buttons .	the boxes heard those bored button .
the books do n't teach those tall toys .	the books do n't teach those tall toy .
the rooms bought these cool boys .	the rooms bought these cool boy .
the park had n't heard this boring car .	the park had n't heard this boring cars .
the shirts worried those gentle pictures .	the shirts worried those gentle picture .
the buttons did n't praise that surprised fork .	the buttons did n't praise that surprised forks .
the box has found that helpful school .	the box has found that helpful schools .
the museum wo n't scare these surprised cars .	the museum wo n't scare these surprised car .
the crayon might move that cold girl .	the crayon might move that cold girls .
the shirts were helping that boring fork .	the shirts were helping that boring forks .
the toys found these kind dishes .	the toys found these kind dish .
the bottle had n't dropped these broken children .	the bottle had n't dropped these broken child .
the doll knows this tired book .	the doll knows this tired books .
the rug has n't lost those kind trucks .	the rug has n't lost those kind truck .
the bicycle has n't cleaned those gray people .	the bicycle has n't cleaned those gray person .
the school has lost those quiet bottles .	the school has lost those quiet bottle .
the bank was helping this young car .	the bank was helping this young cars .
the shirts were helping those busy plates .	the shirts were helping those busy plate .
the rings helped these sleepy pictures .	the rings helped these sleepy picture .
the hospital would n't scare this surprised ring .	the hospital would n't scare this surprised rings .
the restaurant is n't helping this healthy fork .	the restaurant is n't helping this healthy forks .
the schools would listen to this smart spoon .	the schools would listen to this smart spoons .
the spoons were n't talking to these clever trucks .	the spoons were n't talking to these clever truck .
the beds were n't teaching this tired crayon .	the beds were n't teaching this tired crayons .
the dish talked to this clever car .	the dish talked to this clever cars .
the spoons teach this confused hat .	the spoons teach this confused hats .
the chair could know that boring dish .	the chair could know that boring dishes .
the hat was n't visiting that hungry car .	the hat was n't visiting that hungry cars .
the restaurant understands this upset glass .	the restaurant understands this upset glasses .
the rooms confused that bored candle .	the rooms confused that bored candles .
the door has brought that green lady .	the door has brought that green ladies .
the doll bothered that happy truck .	the doll bothered that happy trucks .
the schools worry this wrong shoe .	the schools worry this wrong shoes .
the couch is n't bothering those confused spoons .	the couch is n't bothering those confused spoon .
the book would n't work with those happy dishes .	the book would n't work with those happy dish .
the boats made this white lady .	the boats made this white ladies .
the bag knows this happy bowl .	the bag knows this happy bowls .
the bottles have worked with that hungry chair .	the bottles have worked with that hungry chairs .
the buttons will lift those white ladies .	the buttons will lift those white lady .
the glasses are n't dropping those blue guys .	the glasses are n't dropping those blue guy .
the trucks scared those nice forks .	the trucks scared those nice fork .
the kitchen kept this purple girl .	the kitchen kept this purple girls .
the bag is n't cleaning those green boys .	the bag is n't cleaning those green boy .
the book has lost that gentle car .	the book has lost that gentle cars .
the dolls drop this cold doctor .	the dolls drop this cold doctors .
the shirt wo n't sell those orange girls .	the shirt wo n't sell those orange girl .
the bed took this white girl .	the bed took this white girls .
the candle threw this old child .	the candle threw this old children .
the doors bother these healthy shoes .	the doors bother these healthy shoe .
the window answered this angry book .	the window answered this angry books .
the doll answered this boring fork .	the doll answered this boring forks .
the forks bought these cool men .	the forks bought these cool man .
the buttons do n't steal this blue woman .	the buttons do n't steal this blue women .
the hat taught that bored book .	the hat taught that bored books .
the museum is n't teaching that surprised car .	the museum is n't teaching that surprised cars .
the bag knows this important book .	the bag knows this important books .
the books care for those surprised rings .	the books care for those surprised ring .
the shoe knew those happy beds .	the shoe knew those happy bed .
the window talks to these excited dolls .	the window talks to these excited doll .
the boat was n't cleaning that purple man .	the boat was n't cleaning that purple men .
the car must buy these blue guys .	the car must buy these blue guy .
the bottles can take these cool women .	the bottles can take these cool woman .
the cars have lost that surprised glass .	the cars have lost that surprised glasses .
the doll holds those awesome men .	the doll holds those awesome man .
the cup did n't bring this great doctor .	the cup did n't bring this great doctors .
the fork is visiting that clever room .	the fork is visiting that clever rooms .
the bed visited these nice trucks .	the bed visited these nice truck .
the bottle might sell that cute lady .	the bottle might sell that cute ladies .
the plates understand those helpful books .	the plates understand those helpful book .
the doll made that red child .	the doll made that red children .
the library worked with this young ring .	the library worked with this young rings .
the car could appreciate these careful shirts .	the car could appreciate these careful shirt .
the rocket cleaned this great boy .	the rocket cleaned this great boys .
the bank brought those purple teachers .	the bank brought those purple teacher .
the boxes answered these quiet bags .	the boxes answered these quiet bag .
the dish worked with those angry rings .	the dish worked with those angry ring .
the shirt worked with these friendly cups .	the shirt worked with these friendly cup .
the book knew these friendly hats .	the book knew these friendly hat .
the glasses might answer that lucky window .	the glasses might answer that lucky windows .
the crayons had scared that confused car .	the crayons had scared that confused cars .
the bowl does n't hear this upset fork .	the bowl does n't hear this upset forks .
the bowls will move this new girl .	the bowls will move this new girls .
the boat held those small teachers .	the boat held those small teacher .
the museum may move this big guy .	the museum may move this big guys .
the kitchen heard that confused bowl .	the kitchen heard that confused bowls .
the trucks took those amazing children .	the trucks took those amazing child .
the shirts should listen to those confused boxes .	the shirts should listen to those confused box .
the cup talked to this upset book .	the cup talked to this upset books .
the ship does n't find these orange boys .	the ship does n't find these orange boy .
the dolls might praise this careful school .	the dolls might praise this careful schools .
the cars could listen to those important pictures .	the cars could listen to those important picture .
the car had lost this kind boat .	the car had lost this kind boats .
the rooms would know those tired crayons .	the rooms would know those tired crayon .
the truck would n't make these new people .	the truck would n't make these new person .
the bank has n't fixed that big doctor .	the bank has n't fixed that big doctors .
the candles confused those lucky forks .	the candles confused those lucky fork .
the candle took those dry doctors .	the candle took those dry doctor .
the shirt wo n't bring that dry person .	the shirt wo n't bring that dry people .
the museum had n't worried those strong shirts .	the museum had n't worried those strong shirt .
the buttons are n't cleaning this fine teacher .	the buttons are n't cleaning this fine teachers .
the dolls could hold this small teacher .	the dolls could hold this small teachers .
the plane has taken that yellow teacher .	the plane has taken that yellow teachers .
the bags were n't helping this kind ring .	the bags were n't helping this kind rings .
the doors are working with these confused cars .	the doors are working with these confused car .
the picture could hear those sleepy dolls .	the picture could hear those sleepy doll .
the window is n't visiting these boring books .	the window is n't visiting these boring book .
the crayon should know this careful crayon .	the crayon should know this careful crayons .
the crayons have visited this boring book .	the crayons have visited this boring books .
the candle understands that surprised toy .	the candle understands that surprised toys .
the bowls care for these happy cars .	the bowls care for these happy car .
the schools work with these surprised rings .	the schools work with these surprised ring .
the candles buy this green child .	the candles buy this green children .
the doll dropped those old boys .	the doll dropped those old boy .
the spoon was helping that quiet bed .	the spoon was helping that quiet beds .
the doors visited these smart cars .	the doors visited these smart car .
the plates have taken those old people .	the plates have taken those old person .
the boats have found that gentle picture .	the boats have found that gentle pictures .
the dolls can n't work with that excited car .	the dolls can n't work with that excited cars .
the boxes are n't dropping those yellow ladies .	the boxes are n't dropping those yellow lady .
the cup heard this nice candle .	the cup heard this nice candles .
the bank answered these curious spoons .	the bank answered these curious spoon .
the buttons have fixed this hot teacher .	the buttons have fixed this hot teachers .
the shirt confused that confused book .	the shirt confused that confused books .
the glass has n't answered that important spoon .	the glass has n't answered that important spoons .
the restaurant has n't heard these nice trucks .	the restaurant has n't heard these nice truck .
the spoon is n't losing this fine guy .	the spoon is n't losing this fine guys .
the window was working with that sleepy car .	the window was working with that sleepy cars .
the car might steal this blue doctor .	the car might steal this blue doctors .
the picture cleaned this cool doctor .	the picture cleaned this cool doctors .
the bowls made these orange men .	the bowls made these orange man .
the bottles have n't found those boring women .	the bottles have n't found those boring woman .
the box was talking to these quiet boxes .	the box was talking to these quiet box .
the boat can n't work with these happy beds .	the boat can n't work with these happy bed .
the bed is visiting that tired car .	the bed is visiting that tired cars .
the box does n't find this big lady .	the box does n't find this big ladies .
the candles brought that fine person .	the candles brought that fine people .
the school heard those kind dolls .	the school heard those kind doll .
the rooms talked to those helpful trucks .	the rooms talked to those helpful truck .
the door confused these strong glasses .	the door confused these strong glass .
the buttons are talking to these young glasses .	the buttons are talking to these young glass .
the mirror would n't throw that cool lady .	the mirror would n't throw that cool ladies .
the window was bothering these excited beds .	the window was bothering these excited bed .
the candle wo n't answer this busy ring .	the candle wo n't answer this busy rings .
the book wo n't steal those black girls .	the book wo n't steal those black girl .
the plane has found this quiet chair .	the plane has found this quiet chairs .
the forks have n't brought this brown guy .	the forks have n't brought this brown guys .
the cars lost these big doctors .	the cars lost these big doctor .
the cups will answer that kind bag .	the cups will answer that kind bags .
the box would care for that young box .	the box would care for that young boxes .
the truck held these hot girls .	the truck held these hot girl .
the dish knows that tired toy .	the dish knows that tired toys .
the couch had thrown those cute guys .	the couch had thrown those cute guy .
the bottle wo n't find those green men .	the bottle wo n't find those green man .
the bags should keep this expensive guy .	the bags should keep this expensive guys .
the beds have worked with those surprised rings .	the beds have worked with those surprised ring .
the forks hear these bored shoes .	the forks hear these bored shoe .
the shoes visit this tired bottle .	the shoes visit this tired bottles .
the cars have n't found this expensive boy .	the cars have n't found this expensive boys .
the shirts can work with that busy plate .	the shirts can work with that busy plates .
the plates appreciate this hungry door .	the plates appreciate this hungry doors .
the cars hear this bored school .	the cars hear this bored schools .
the plate had lost this curious dish .	the plate had lost this curious dishes .
the bowls do n't scare this quiet button .	the bowls do n't scare this quiet buttons .
the picture must bring these dry teachers .	the picture must bring these dry teacher .
the spoon was n't working with those young chairs .	the spoon was n't working with those young chair .
the glasses know that bored candle .	the glasses know that bored candles .
the spoons would lose this cool lady .	the spoons would lose this cool ladies .
the room has confused this kind car .	the room has confused this kind cars .
the toy drops this new doctor .	the toy drops this new doctors .
the forks should bring that expensive person .	the forks should bring that expensive people .
the shirts would throw those white boys .	the shirts would throw those white boy .
the shirt must worry this bored bed .	the shirt must worry this bored beds .
the candles might keep this brown lady .	the candles might keep this brown ladies .
the glasses were n't bringing that boring boy .	the glasses were n't bringing that boring boys .
the park is n't visiting this hungry toy .	the park is n't visiting this hungry toys .
the bed is making those orange girls .	the bed is making those orange girl .
the books were teaching these young bottles .	the books were teaching these young bottle .
the plate helped this wrong dish .	the plate helped this wrong dishes .
the picture taught those hungry beds .	the picture taught those hungry bed .
the windows stole those big children .	the windows stole those big child .
the boats had talked to that kind school .	the boats had talked to that kind schools .
the box should visit these important toys .	the box should visit these important toy .
the buttons have talked to that excited school .	the buttons have talked to that excited schools .
the hat heard that clever cup .	the hat heard that clever cups .
the chairs have n't worked with these smart toys .	the chairs have n't worked with these smart toy .
the ship is n't working with that upset cup .	the ship is n't working with that upset cups .
the schools cleaned that purple woman .	the schools cleaned that purple women .
the rings lift these hot ladies .	the rings lift these hot lady .
the school understands these curious trucks .	the school understands these curious truck .
the bicycle might praise this young school .	the bicycle might praise this young schools .
the buttons threw those hot people .	the buttons threw those hot person .
the glass held those black girls .	the glass held those black girl .
the bank is n't taking those cute boys .	the bank is n't taking those cute boy .
the schools shook those brown girls .	the schools shook those brown girl .
the chairs were working with these tired rooms .	the chairs were working with these tired room .
the hats are n't holding those big boys .	the hats are n't holding those big boy .
the box had n't fixed these black men .	the box had n't fixed these black man .
the plates are n't visiting these healthy plates .	the plates are n't visiting these healthy plate .
the rug is helping that tall shoe .	the rug is helping that tall shoes .
the kitchen has n't found these lucky schools .	the kitchen has n't found these lucky school .
the restaurant is cleaning that dry doctor .	the restaurant is cleaning that dry doctors .
the ring can n't talk to this sleepy school .	the ring can n't talk to this sleepy schools .
the chair keeps those small women .	the chair keeps those small woman .
the museum must visit this clever bag .	the museum must visit this clever bags .
the mall was teaching this young candle .	the mall was teaching this young candles .
the shirts teach those tired shirts .	the shirts teach those tired shirt .
the schools had dropped these hot ladies .	the schools had dropped these hot lady .
the pictures do n't drop these cold ladies .	the pictures do n't drop these cold lady .
the bicycle had answered that friendly car .	the bicycle had answered that friendly cars .
the rings are throwing those green men .	the rings are throwing those green man .
the hospital found that boring cup .	the hospital found that boring cups .
the picture helps those friendly spoons .	the picture helps those friendly spoon .
the candle had bothered this bored school .	the candle had bothered this bored schools .
the windows could n't make that green child .	the windows could n't make that green children .
the schools heard those busy schools .	the schools heard those busy school .
the dishes know that tall bed .	the dishes know that tall beds .
the schools are shaking these boring women .	the schools are shaking these boring woman .
the boats did n't appreciate those quiet cups .	the boats did n't appreciate those quiet cup .
the boxes would n't shake this orange person .	the boxes would n't shake this orange people .
the fork lost those hot guys .	the fork lost those hot guy .
the plate was n't fixing this cute teacher .	the plate was n't fixing this cute teachers .
the ring had helped this surprised cup .	the ring had helped this surprised cups .
the pictures keep those missing men .	the pictures keep those missing man .
the car is n't buying these expensive children .	the car is n't buying these expensive child .
the rings have n't lost these boring girls .	the rings have n't lost these boring girl .
the school cleaned that big man .	the school cleaned that big men .
the truck was taking those dry people .	the truck was taking those dry person .
the dishes wo n't praise that tall shoe .	the dishes wo n't praise that tall shoes .
the shoes were n't listening to these angry hats .	the shoes were n't listening to these angry hat .
the bowl must visit that friendly school .	the bowl must visit that friendly schools .
the bicycle is helping this tired picture .	the bicycle is helping this tired pictures .
the doll hears those strong cars .	the doll hears those strong car .
the rocket scared this sleepy window .	the rocket scared this sleepy windows .
the cup has answered those nice doors .	the cup has answered those nice door .
the bowls answer those young bowls .	the bowls answer those young bowl .
the mirror works with that happy toy .	the mirror works with that happy toys .
the hats are n't helping those clever candles .	the hats are n't helping those clever candle .
the toys answer that hungry toy .	the toys answer that hungry toys .
the door was n't bothering that friendly plate .	the door was n't bothering that friendly plates .
the school can n't hear those careful beds .	the school can n't hear those careful bed .
the fork heard this hungry car .	the fork heard this hungry cars .
the toy should n't bother that gentle book .	the toy should n't bother that gentle books .
the schools had n't fixed these dry doctors .	the schools had n't fixed these dry doctor .
the schools helped those strong cups .	the schools helped those strong cup .
the spoon wo n't talk to this hungry button .	the spoon wo n't talk to this hungry buttons .
the spoon would n't know that healthy toy .	the spoon would n't know that healthy toys .
the library worked with this healthy plate .	the library worked with this healthy plates .
the doll knows this hungry boat .	the doll knows this hungry boats .
the box makes that cute boy .	the box makes that cute boys .
the shirts work with those lucky cars .	the shirts work with those lucky car .
the spoon must bring those missing people .	the spoon must bring those missing person .
the button is helping that helpful car .	the button is helping that helpful cars .
the cup can know this kind book .	the cup can know this kind books .
the boat has n't heard that kind boat .	the boat has n't heard that kind boats .
the mall taught this gentle box .	the mall taught this gentle boxes .
the bowls had bothered this young bed .	the bowls had bothered this young beds .
the park had dropped these boring teachers .	the park had dropped these boring teacher .
the cars have talked to those happy dishes .	the cars have talked to those happy dish .
the hats have n't answered these quiet forks .	the hats have n't answered these quiet fork .
the rocket has scared those nice books .	the rocket has scared those nice book .
the crayon had n't answered those gentle bags .	the crayon had n't answered those gentle bag .
the rocket had n't scared these smart bottles .	the rocket had n't scared these smart bottle .
the book scared these clever bowls .	the book scared these clever bowl .
the school has confused this helpful candle .	the school has confused this helpful candles .
the cup heard these wrong shoes .	the cup heard these wrong shoe .
the hat understands these helpful trucks .	the hat understands these helpful truck .
the museum may bring these hot doctors .	the museum may bring these hot doctor .
the spoons had heard this curious box .	the spoons had heard this curious boxes .
the mall makes that blue lady .	the mall makes that blue ladies .
the trucks understand this boring book .	the trucks understand this boring books .
the shirt helped that important room .	the shirt helped that important rooms .
the boat keeps those expensive doctors .	the boat keeps those expensive doctor .
the doll had confused those upset rooms .	the doll had confused those upset room .
the dishes confused these young trucks .	the dishes confused these young truck .
the book would n't hear that bored door .	the book would n't hear that bored doors .
the mall was n't teaching that healthy book .	the mall was n't teaching that healthy books .
the rocket scared those kind buttons .	the rocket scared those kind button .
the couch lost those upset boxes .	the couch lost those upset box .
the room might shake those great men .	the room might shake those great man .
the box moves these purple children .	the box moves these purple child .
the buttons keep this cool child .	the buttons keep this cool children .
the crayons may hear that wrong window .	the crayons may hear that wrong windows .
the cars wo n't care for those confused rooms .	the cars wo n't care for those confused room .
the toys visit this smart door .	the toys visit this smart doors .
the pictures answer those friendly boats .	the pictures answer those friendly boat .
the chair cleaned these orange ladies .	the chair cleaned these orange lady .
the bicycle threw that expensive girl .	the bicycle threw that expensive girls .
the rings can n't hear these busy beds .	the rings can n't hear these busy bed .
the crayon had that awesome girl .	the crayon had that awesome girls .
the crayon can move that white guy .	the crayon can move that white guys .
the plane moved this orange lady .	the plane moved this orange ladies .
the cups were n't fixing that cute boy .	the cups were n't fixing that cute boys .
the truck scares this sleepy school .	the truck scares this sleepy schools .
the hats did n't listen to that quiet box .	the hats did n't listen to that quiet boxes .
the pictures have talked to these curious shoes .	the pictures have talked to these curious shoe .
the boats buy these new ladies .	the boats buy these new lady .
the doll talks to that angry dish .	the doll talks to that angry dishes .
the cars hear those lucky dishes .	the cars hear those lucky dish .
the bags visited these boring boats .	the bags visited these boring boat .
the car takes that boring guy .	the car takes that boring guys .
the boats could n't bring this new guy .	the boats could n't bring this new guys .
the car heard those excited cups .	the car heard those excited cup .
the cars wo n't have these great people .	the cars wo n't have these great person .
the bags had n't brought those cool teachers .	the bags had n't brought those cool teacher .
the candles worked with that important candle .	the candles worked with that important candles .
the park threw these red women .	the park threw these red woman .
the bottles may move this yellow man .	the bottles may move this yellow men .
the car might work with that kind shoe .	the car might work with that kind shoes .
the candle bothered these bored schools .	the candle bothered these bored school .
the cars throw these dry women .	the cars throw these dry woman .
the bag hears this friendly bowl .	the bag hears this friendly bowls .
the buttons may help these clever bags .	the buttons may help these clever bag .
the schools teach those angry buttons .	the schools teach those angry button .
the mall has n't dropped those missing women .	the mall has n't dropped those missing woman .
the spoon was shaking that red woman .	the spoon was shaking that red women .
the button helps that clever school .	the button helps that clever schools .
the bottles wo n't steal this boring child .	the bottles wo n't steal this boring children .
the beds lose this important guy .	the beds lose this important guys .
the boxes can fix these dry boys .	the boxes can fix these dry boy .
the candles had n't kept that hot woman .	the candles had n't kept that hot women .
the bag has scared these important dolls .	the bag has scared these important doll .
the chairs scared those helpful boats .	the chairs scared those helpful boat .
the boxes were keeping that small lady .	the boxes were keeping that small ladies .
the toys had n't kept this green guy .	the toys had n't kept this green guys .
the glass kept these important guys .	the glass kept these important guy .
the spoon scared those careful spoons .	the spoon scared those careful spoon .
the truck works with those helpful boxes .	the truck works with those helpful box .
the bicycle had fixed these new teachers .	the bicycle had fixed these new teacher .
the toys will scare that healthy dish .	the toys will scare that healthy dishes .
the books should n't scare that tired bottle .	the books should n't scare that tired bottles .
the window keeps those boring teachers .	the window keeps those boring teacher .
the crayon has that big doctor .	the crayon has that big doctors .
the toy has scared that surprised bed .	the toy has scared that surprised beds .
the schools help this excited plate .	the schools help this excited plates .
the crayons had held this new guy .	the crayons had held this new guys .
the shirt has n't scared those clever beds .	the shirt has n't scared those clever bed .
the cars understand these tired spoons .	the cars understand these tired spoon .
the boats sell that amazing guy .	the boats sell that amazing guys .
the spoon would throw that great man .	the spoon would throw that great men .
the car took that broken lady .	the car took that broken ladies .
the shoe has n't scared those upset glasses .	the shoe has n't scared those upset glass .
the books knew those friendly glasses .	the books knew those friendly glass .
the rings must lose these small girls .	the rings must lose these small girl .
the ring confused those helpful chairs .	the ring confused those helpful chair .
the spoon is fixing those cold women .	the spoon is fixing those cold woman .
the door helps those excited hats .	the door helps those excited hat .
the boxes may answer those happy schools .	the boxes may answer those happy school .
the plate could bring these important girls .	the plate could bring these important girl .
the kitchen brought that purple teacher .	the kitchen brought that purple teachers .
the ring worked with these nice shirts .	the ring worked with these nice shirt .
the car could n't hear those angry buttons .	the car could n't hear those angry button .
the schools lost these whole women .	the schools lost these whole woman .
the chairs have worried those young dolls .	the chairs have worried those young doll .
the door kept those cold women .	the door kept those cold woman .
the chair knew that tall cup .	the chair knew that tall cups .
the bank lost these nice bowls .	the bank lost these nice bowl .
the bank has scared these happy bags .	the bank has scared these happy bag .
the dish does n't bring those old women .	the dish does n't bring those old woman .
the boxes answer these smart boxes .	the boxes answer these smart box .
the chair visited that busy glass .	the chair visited that busy glasses .
the library knew these busy bottles .	the library knew these busy bottle .
the bag understands these healthy bags .	the bag understands these healthy bag .
the museum was n't listening to those tired dolls .	the museum was n't listening to those tired doll .
the shoes have n't heard those tired bowls .	the shoes have n't heard those tired bowl .
the plane has n't confused those excited spoons .	the plane has n't confused those excited spoon .
the shoes were talking to this young boat .	the shoes were talking to this young boats .
the forks were taking this small teacher .	the forks were taking this small teachers .
the plate is n't bringing this green doctor .	the plate is n't bringing this green doctors .
the cars are visiting those tired hats .	the cars are visiting those tired hat .
the hospital wo n't hear this excited crayon .	the hospital wo n't hear this excited crayons .
the cars answer this hungry door .	the cars answer this hungry doors .
the park talks to this boring door .	the park talks to this boring doors .
the dish can bother these helpful shoes .	the dish can bother these helpful shoe .
the toys were helping this careful school .	the toys were helping this careful schools .
the window is helping that excited spoon .	the window is helping that excited spoons .
the room has n't talked to that busy truck .	the room has n't talked to that busy trucks .
the schools understand that surprised dish .	the schools understand that surprised dishes .
the books had n't bothered those clever dishes .	the books had n't bothered those clever dish .
the bed may make that cool teacher .	the bed may make that cool teachers .
the toy must clean this gray lady .	the toy must clean this gray ladies .
the shirt had n't held this green girl .	the shirt had n't held this green girls .
the books have heard this surprised boat .	the books have heard this surprised boats .
the spoons found that friendly shoe .	the spoons found that friendly shoes .
the toy had confused this quiet toy .	the toy had confused this quiet toys .
the trucks have confused these hungry bags .	the trucks have confused these hungry bag .
the rooms did n't throw this hot guy .	the rooms did n't throw this hot guys .
the crayons scare that helpful boat .	the crayons scare that helpful boats .
the library has n't fixed this white lady .	the library has n't fixed this white ladies .
the dolls were n't finding this amazing man .	the dolls were n't finding this amazing men .
the room has n't heard that careful plate .	the room has n't heard that careful plates .
the shoe found these helpful schools .	the shoe found these helpful school .
the hats find that small man .	the hats find that small men .
the park lost these excited dolls .	the park lost these excited doll .
the shirts may have those cold people .	the shirts may have those cold person .
the book had heard those healthy windows .	the book had heard those healthy window .
the rug knew that young car .	the rug knew that young cars .
the restaurant was n't dropping that fine guy .	the restaurant was n't dropping that fine guys .
the window is n't fixing these cool ladies .	the window is n't fixing these cool lady .
the bicycle was n't making these great women .	the bicycle was n't making these great woman .
the school was n't helping this lucky cup .	the school was n't helping this lucky cups .
the windows bother that wrong car .	the windows bother that wrong cars .
the school makes those cold teachers .	the school makes those cold teacher .
the picture has bothered those angry plates .	the picture has bothered those angry plate .
the cars know that clever truck .	the cars know that clever trucks .
the spoons are shaking these gray guys .	the spoons are shaking these gray guy .
the rocket kept these fine boys .	the rocket kept these fine boy .
the cars are n't losing these black guys .	the cars are n't losing these black guy .
the pictures can visit these curious schools .	the pictures can visit these curious school .
the park shakes those dry men .	the park shakes those dry man .
the windows are losing this expensive doctor .	the windows are losing this expensive doctors .
the buttons are helping this friendly crayon .	the buttons are helping this friendly crayons .
the picture is fixing this purple child .	the picture is fixing this purple children .
the cars are working with that bored school .	the cars are working with that bored schools .
the windows do n't scare those smart candles .	the windows do n't scare those smart candle .
the ship made that white woman .	the ship made that white women .
the fork scared this important candle .	the fork scared this important candles .
the schools hear these wrong books .	the schools hear these wrong book .
the shirts are n't finding these dry children .	the shirts are n't finding these dry child .
the bicycle had talked to these happy books .	the bicycle had talked to these happy book .
the car cleaned those purple girls .	the car cleaned those purple girl .
the rocket knew those careful crayons .	the rocket knew those careful crayon .
the car was bothering those kind glasses .	the car was bothering those kind glass .
the schools can n't answer this helpful school .	the schools can n't answer this helpful schools .
the school worried those kind buttons .	the school worried those kind button .
the spoons scared that confused toy .	the spoons scared that confused toys .
the chairs clean this big teacher .	the chairs clean this big teachers .
the bottles make that broken boy .	the bottles make that broken boys .
the crayon worried that angry plate .	the crayon worried that angry plates .
the door knows these friendly bowls .	the door knows these friendly bowl .
the glasses might teach these smart dolls .	the glasses might teach these smart doll .
the dishes wo n't hear this gentle car .	the dishes wo n't hear this gentle cars .
the forks know those confused hats .	the forks know those confused hat .
the windows do n't hear that tired car .	the windows do n't hear that tired cars .
the pictures did n't help that busy book .	the pictures did n't help that busy books .
the fork can n't answer these quiet forks .	the fork can n't answer these quiet fork .
the cars confused that gentle box .	the cars confused that gentle boxes .
the dolls bother that smart car .	the dolls bother that smart cars .
the cups answered those gentle books .	the cups answered those gentle book .
the spoons have n't found those young pictures .	the spoons have n't found those young picture .
the rug can n't take that dry boy .	the rug can n't take that dry boys .
the forks heard that careful picture .	the forks heard that careful pictures .
the bag has n't made that amazing person .	the bag has n't made that amazing people .
the dish is dropping those big women .	the dish is dropping those big woman .
the bag brings those cute men .	the bag brings those cute man .
the restaurant was working with those tall books .	the restaurant was working with those tall book .
the kitchen can bother this gentle window .	the kitchen can bother this gentle windows .
the museum bothered those excited pictures .	the museum bothered those excited picture .
the boxes will clean that important doctor .	the boxes will clean that important doctors .
the rug has found this young toy .	the rug has found this young toys .
the hat was n't cleaning those missing ladies .	the hat was n't cleaning those missing lady .
the cars had talked to that smart shirt .	the cars had talked to that smart shirts .
the car would hear these strong schools .	the car would hear these strong school .
the restaurant knows those excited bowls .	the restaurant knows those excited bowl .
the plate has bothered this helpful shirt .	the plate has bothered this helpful shirts .
the windows had n't worked with that clever window .	the windows had n't worked with that clever windows .
the cups heard those surprised buttons .	the cups heard those surprised button .
the bag bought those broken people .	the bag bought those broken person .
the spoons are dropping these gray teachers .	the spoons are dropping these gray teacher .
the mirror worked with these upset beds .	the mirror worked with these upset bed .
the schools are n't finding those cool boys .	the schools are n't finding those cool boy .
the cars buy those purple girls .	the cars buy those purple girl .
the couch may drop those blue women .	the couch may drop those blue woman .
the doll is n't bothering these surprised doors .	the doll is n't bothering these surprised door .
the car helped this tall shirt .	the car helped this tall shirts .
the books had bought those yellow ladies .	the books had bought those yellow lady .
the bottles know those wrong dishes .	the bottles know those wrong dish .
the forks fix this dry teacher .	the forks fix this dry teachers .
the hats bother that healthy room .	the hats bother that healthy rooms .
the room had n't worried those wrong bags .	the room had n't worried those wrong bag .
the hats will buy this awesome boy .	the hats will buy this awesome boys .
the buttons move this great doctor .	the buttons move this great doctors .
the books would n't help those angry crayons .	the books would n't help those angry crayon .
the rings had n't held that awesome guy .	the rings had n't held that awesome guys .
the dish is n't buying this red boy .	the dish is n't buying this red boys .
the candle lost that gentle shirt .	the candle lost that gentle shirts .
the cars had n't worked with this young crayon .	the cars had n't worked with this young crayons .
the museum would hold that white girl .	the museum would hold that white girls .
the windows may hear those healthy plates .	the windows may hear those healthy plate .
the chair knows that surprised doll .	the chair knows that surprised dolls .
the forks had bothered those upset toys .	the forks had bothered those upset toy .
the cup worked with this young book .	the cup worked with this young books .
the cups worried this young ring .	the cups worried this young rings .
the chair has n't heard these busy hats .	the chair has n't heard these busy hat .
the boats will take these dry boys .	the boats will take these dry boy .
the bag had taught those sleepy boats .	the bag had taught those sleepy boat .
the hats drop those awesome teachers .	the hats drop those awesome teacher .
the candles were n't shaking this brown man .	the candles were n't shaking this brown men .
the crayons would work with these excited boats .	the crayons would work with these excited boat .
the rooms know those strong plates .	the rooms know those strong plate .
the dish fixed this gray teacher .	the dish fixed this gray teachers .
the candle is listening to these angry trucks .	the candle is listening to these angry truck .
the spoon was n't helping that gentle book .	the spoon was n't helping that gentle books .
the rings had bothered those healthy candles .	the rings had bothered those healthy candle .
the schools listen to that young fork .	the schools listen to that young forks .
the books can move that cold guy .	the books can move that cold guys .
the hat can sell that amazing person .	the hat can sell that amazing people .
the crayons move these green girls .	the crayons move these green girl .
the beds make these fine doctors .	the beds make these fine doctor .
the chair should n't know these tall books .	the chair should n't know these tall book .
the fork lost these tired buttons .	the fork lost these tired button .
the dishes fixed these awesome girls .	the dishes fixed these awesome girl .
the cars would n't work with that wrong doll .	the cars would n't work with that wrong dolls .
the car might shake this old man .	the car might shake this old men .
the cup throws this cute boy .	the cup throws this cute boys .
the couch had n't lost that hot child .	the couch had n't lost that hot children .
the shirt should n't understand that boring window .	the shirt should n't understand that boring windows .
the couch lost these broken teachers .	the couch lost these broken teacher .
the shirts are helping those careful dolls .	the shirts are helping those careful doll .
the cars worried those boring rings .	the cars worried those boring ring .
the cars knew this boring spoon .	the cars knew this boring spoons .
the library was working with those healthy books .	the library was working with those healthy book .
the toy may know those gentle rings .	the toy may know those gentle ring .
the window had held that whole boy .	the window had held that whole boys .
the rings can n't buy those big women .	the rings can n't buy those big woman .
the schools are bringing that orange teacher .	the schools are bringing that orange teachers .
the school had n't lost this quiet bed .	the school had n't lost this quiet beds .
the forks have n't scared this curious button .	the forks have n't scared this curious buttons .
the candles hear that smart book .	the candles hear that smart books .
the buttons can lose these boring girls .	the buttons can lose these boring girl .
the chairs have n't confused these surprised hats .	the chairs have n't confused these surprised hat .
the button was n't cleaning those yellow guys .	the button was n't cleaning those yellow guy .
the buttons have n't lost this cold child .	the buttons have n't lost this cold children .
the doors have worked with those excited spoons .	the doors have worked with those excited spoon .
the pictures had moved these amazing teachers .	the pictures had moved these amazing teacher .
the boxes hear this upset shoe .	the boxes hear this upset shoes .
the cup might hear this nice school .	the cup might hear this nice schools .
the book was n't making this brown guy .	the book was n't making this brown guys .
the buttons may bother those upset crayons .	the buttons may bother those upset crayon .
the forks had n't scared these kind spoons .	the forks had n't scared these kind spoon .
the boat is bothering these kind shirts .	the boat is bothering these kind shirt .
the hat is shaking those big guys .	the hat is shaking those big guy .
the dish might take this new teacher .	the dish might take this new teachers .
the toy should hear that friendly box .	the toy should hear that friendly boxes .
the hats found that excited hat .	the hats found that excited hats .
the candles had n't worked with those boring crayons .	the candles had n't worked with those boring crayon .
the room had answered these clever glasses .	the room had answered these clever glass .
the book works with these gentle trucks .	the book works with these gentle truck .
the mall has held that awesome doctor .	the mall has held that awesome doctors .
the library did n't answer those quiet chairs .	the library did n't answer those quiet chair .
the bags have n't made this purple lady .	the bags have n't made this purple ladies .
the box can n't talk to these important spoons .	the box can n't talk to these important spoon .
the bank must hear this hungry window .	the bank must hear this hungry windows .
the toys were n't bothering these surprised bottles .	the toys were n't bothering these surprised bottle .
the toys did n't understand this friendly door .	the toys did n't understand this friendly doors .
the doll knows this upset ring .	the doll knows this upset rings .
the beds do n't shake that fine woman .	the beds do n't shake that fine women .
the rings talk to that angry candle .	the rings talk to that angry candles .
the mall knows those bored doors .	the mall knows those bored door .
the chair must steal this old teacher .	the chair must steal this old teachers .
the crayon works with those sleepy toys .	the crayon works with those sleepy toy .
the trucks could care for those smart bags .	the trucks could care for those smart bag .
the box knows that nice box .	the box knows that nice boxes .
the bank had worked with these helpful rings .	the bank had worked with these helpful ring .
the room had heard those angry dolls .	the room had heard those angry doll .
the car cleaned this red guy .	the car cleaned this red guys .
the plate might answer that excited bag .	the plate might answer that excited bags .
the rings should n't throw those awesome teachers .	the rings should n't throw those awesome teacher .
the cup held these green teachers .	the cup held these green teacher .
the crayon confused this quiet doll .	the crayon confused this quiet dolls .
the window had dropped that broken man .	the window had dropped that broken men .
the cups hear those surprised glasses .	the cups hear those surprised glass .
the boats threw this missing man .	the boats threw this missing men .
the boat has n't found these wrong boats .	the boat has n't found these wrong boat .
the dolls knew that tall book .	the dolls knew that tall books .
the bicycle wo n't fix those big people .	the bicycle wo n't fix those big person .
the shoes wo n't know those important pictures .	the shoes wo n't know those important picture .
the museum would talk to that wrong shoe .	the museum would talk to that wrong shoes .
the shoe knows those curious books .	the shoe knows those curious book .
the buttons sell these small doctors .	the buttons sell these small doctor .
the hats made that expensive guy .	the hats made that expensive guys .
the pictures have those old boys .	the pictures have those old boy .
the chairs were bothering those upset cars .	the chairs were bothering those upset car .
the beds were teaching these curious forks .	the beds were teaching these curious fork .
the schools would n't take these small ladies .	the schools would n't take these small lady .
the books visited these upset candles .	the books visited these upset candle .
the bank has n't heard those healthy schools .	the bank has n't heard those healthy school .
the rocket would n't understand that hungry car .	the rocket would n't understand that hungry cars .
the schools understand those surprised trucks .	the schools understand those surprised truck .
the room was n't visiting these important glasses .	the room was n't visiting these important glass .
the plates moved those big girls .	the plates moved those big girl .
the beds do n't bother this curious button .	the beds do n't bother this curious buttons .
the book has answered those clever forks .	the book has answered those clever fork .
the crayon might steal those cold ladies .	the crayon might steal those cold lady .
the glass does n't talk to those boring forks .	the glass does n't talk to those boring fork .
the shoe had n't helped those boring books .	the shoe had n't helped those boring book .
the rocket was n't moving these cold teachers .	the rocket was n't moving these cold teacher .
the plates made this old woman .	the plates made this old women .
the buttons shake this orange man .	the buttons shake this orange men .
the plates moved these blue boys .	the plates moved these blue boy .
the spoon had n't brought that big doctor .	the spoon had n't brought that big doctors .
the cup has n't heard those young rooms .	the cup has n't heard those young room .
the pictures know this strong bottle .	the pictures know this strong bottles .
the picture talked to those excited cars .	the picture talked to those excited car .
