the truck might praise that careful truck .	the truck might praise those careful truck .
the candles do n't care for that wrong park .	the candles do n't care for those wrong park .
the school was talking to that young book .	the school was talking to those young book .
the hat is n't working with that nice car .	the hat is n't working with those nice car .
the door understands this confused shirt .	the door understands these confused shirt .
the button cleaned that white child .	the button cleaned those white child .
the rug had this big patient .	the rug had these big patient .
the school had n't taken that hot woman .	the school had n't taken those hot woman .
the rooms had kept this orange queen .	the rooms had kept these orange queen .
the cars could n't know these young rings .	the cars could n't know this young rings .
the toy worried those happy cars .	the toy worried that happy cars .
the doors appreciate that friendly library .	the doors appreciate those friendly library .
the fork does n't shake that expensive customer .	the fork does n't shake those expensive customer .
the bag was visiting that important bottle .	the bag was visiting those important bottle .
the doors are helping this gentle room .	the doors are helping these gentle room .
the bowl taught these happy books .	the bowl taught this happy books .
the bowls had n't lost these healthy cups .	the bowls had n't lost this healthy cups .
the shoes are n't listening to this strong spoon .	the shoes are n't listening to these strong spoon .
the door held these missing doctors .	the door held this missing doctors .
the pictures were listening to this hungry window .	the pictures were listening to these hungry window .
the forks could n't steal these small people .	the forks could n't steal this small people .
the spoons had visited these angry bottles .	the spoons had visited this angry bottles .
the shirts are n't throwing these black guys .	the shirts are n't throwing this black guys .
the candles have n't helped that confused window .	the candles have n't helped those confused window .
the room found these hungry pictures .	the room found this hungry pictures .
the kitchen heard those tall pictures .	the kitchen heard that tall pictures .
the toys did n't steal those gray women .	the toys did n't steal that gray women .
the doll has n't bought those hot girls .	the doll has n't bought that hot girls .
the crayon has fixed that great customer .	the crayon has fixed those great customer .
the schools should n't sell these red ladies .	the schools should n't sell this red ladies .
the bowl would n't have that great man .	the bowl would n't have those great man .
the schools know these boring cars .	the schools know this boring cars .
the fork would scare this smart doll .	the fork would scare these smart doll .
the trucks will answer that tall crayon .	the trucks will answer those tall crayon .
the plates have n't held those missing doctors .	the plates have n't held that missing doctors .
the glass is n't throwing this red king .	the glass is n't throwing these red king .
the windows have cleaned that whole man .	the windows have cleaned those whole man .
the schools have heard this gentle candle .	the schools have heard these gentle candle .
the rocket has heard this boring window .	the rocket has heard these boring window .
the box knows this strong restaurant .	the box knows these strong restaurant .
the bicycle wo n't appreciate those curious books .	the bicycle wo n't appreciate that curious books .
the glasses could answer those tired buttons .	the glasses could answer that tired buttons .
the hospital moved this black guy .	the hospital moved these black guy .
the spoons must visit those healthy crayons .	the spoons must visit that healthy crayons .
the bed was dropping this whole person .	the bed was dropping these whole person .
the school is n't losing that cute boy .	the school is n't losing those cute boy .
the toys had made this small king .	the toys had made these small king .
the pictures knew that surprised bowl .	the pictures knew those surprised bowl .
the door had n't found this important king .	the door had n't found these important king .
the park wo n't keep this awesome man .	the park wo n't keep these awesome man .
the schools were n't cleaning those brown girls .	the schools were n't cleaning that brown girls .
the candles had n't scared these strong toys .	the candles had n't scared this strong toys .
the shoes should scare that kind school .	the shoes should scare those kind school .
the hospital brought those gray men .	the hospital brought that gray men .
the books have n't found that surprised bed .	the books have n't found those surprised bed .
the boat has n't confused these wrong bags .	the boat has n't confused this wrong bags .
the books should n't help those strong books .	the books should n't help that strong books .
the plates are n't dropping that cool woman .	the plates are n't dropping those cool woman .
the ship has n't talked to that happy kitchen .	the ship has n't talked to those happy kitchen .
the crayon would throw this whole customer .	the crayon would throw these whole customer .
the park could n't visit that helpful button .	the park could n't visit those helpful button .
the schools clean that fine king .	the schools clean those fine king .
the park does n't hear that healthy hat .	the park does n't hear those healthy hat .
the hats had scared that bored crayon .	the hats had scared those bored crayon .
the bowl is n't bothering these curious rings .	the bowl is n't bothering this curious rings .
the park should shake this old child .	the park should shake these old child .
the couch had found these clever schools .	the couch had found this clever schools .
the plate had heard those strong windows .	the plate had heard that strong windows .
the bottles bother these surprised plates .	the bottles bother this surprised plates .
the chair hears those smart toys .	the chair hears that smart toys .
the crayons might hold this blue adult .	the crayons might hold these blue adult .
the candle found these quiet plates .	the candle found this quiet plates .
the cups have scared this wrong bowl .	the cups have scared these wrong bowl .
the boxes praise that boring mall .	the boxes praise those boring mall .
the candles knew these busy spoons .	the candles knew this busy spoons .
the bottles sell this cute woman .	the bottles sell these cute woman .
the glass held that brown teacher .	the glass held those brown teacher .
the boat does n't hold that expensive guy .	the boat does n't hold those expensive guy .
the book moved this old boy .	the book moved these old boy .
the car might find that cool person .	the car might find those cool person .
the candle works with that wrong truck .	the candle works with those wrong truck .
the ship could n't appreciate these excited rooms .	the ship could n't appreciate this excited rooms .
the rings were n't shaking these great boys .	the rings were n't shaking this great boys .
the window helps those sleepy rooms .	the window helps that sleepy rooms .
the truck was n't listening to that excited crayon .	the truck was n't listening to those excited crayon .
the plates praise that angry ship .	the plates praise those angry ship .
the dolls had n't taught that nice cup .	the dolls had n't taught those nice cup .
the shoes could n't shake these fine people .	the shoes could n't shake this fine people .
the crayons drop that brown woman .	the crayons drop those brown woman .
the cars had taken these black girls .	the cars had taken this black girls .
the books were n't fixing these broken women .	the books were n't fixing this broken women .
the shirt was n't taking this missing guy .	the shirt was n't taking these missing guy .
the cup knew these boring cups .	the cup knew this boring cups .
the chairs cleaned that boring girl .	the chairs cleaned those boring girl .
the glass has n't lost these tall forks .	the glass has n't lost this tall forks .
the room drops that awesome girl .	the room drops those awesome girl .
the mall has n't helped this strong car .	the mall has n't helped these strong car .
the rug has n't fixed that missing girl .	the rug has n't fixed those missing girl .
the schools were n't talking to that hungry box .	the schools were n't talking to those hungry box .
the plane helped this sleepy car .	the plane helped these sleepy car .
the spoons may lift these broken women .	the spoons may lift this broken women .
the plate was n't throwing this fine teacher .	the plate was n't throwing these fine teacher .
the beds are throwing these black people .	the beds are throwing this black people .
the buttons could shake this hot king .	the buttons could shake these hot king .
the bottle understands that gentle shirt .	the bottle understands those gentle shirt .
the plane could work with this helpful hat .	the plane could work with these helpful hat .
the car wo n't praise these sleepy hats .	the car wo n't praise this sleepy hats .
the car has found this sleepy restaurant .	the car has found these sleepy restaurant .
the forks answer this confused chair .	the forks answer these confused chair .
the car confused this gentle bag .	the car confused these gentle bag .
the books wo n't hold this missing man .	the books wo n't hold these missing man .
the windows care for this excited truck .	the windows care for these excited truck .
the library had those cold doctors .	the library had that cold doctors .
the bank had n't dropped that brown customer .	the bank had n't dropped those brown customer .
the bed was making this cold man .	the bed was making these cold man .
the books lost this helpful school .	the books lost these helpful school .
the bank has this green king .	the bank has these green king .
the books have n't visited that nice toy .	the books have n't visited those nice toy .
the mirror throws this expensive woman .	the mirror throws these expensive woman .
the window had n't worked with these helpful candles .	the window had n't worked with this helpful candles .
the rocket could n't lift that black woman .	the rocket could n't lift those black woman .
the mall would help those bored forks .	the mall would help that bored forks .
the shirts have n't moved those purple men .	the shirts have n't moved that purple men .
the box could hear these helpful toys .	the box could hear this helpful toys .
the bowls understand these busy plates .	the bowls understand this busy plates .
the bottle keeps these white children .	the bottle keeps this white children .
the bicycle was n't visiting that sleepy ship .	the bicycle was n't visiting those sleepy ship .
the book may know those busy bags .	the book may know that busy bags .
the truck could n't have those big men .	the truck could n't have that big men .
the bed can n't answer this bored hospital .	the bed can n't answer these bored hospital .
the school is finding that boring customer .	the school is finding those boring customer .
the schools are fixing this dry boy .	the schools are fixing these dry boy .
the hospital moves this blue person .	the hospital moves these blue person .
the mirror was visiting this wrong toy .	the mirror was visiting these wrong toy .
the cars were n't visiting this careful truck .	the cars were n't visiting these careful truck .
the bottle is n't moving this black driver .	the bottle is n't moving these black driver .
the plane helped this tired button .	the plane helped these tired button .
the bicycle would drop this black driver .	the bicycle would drop these black driver .
the bowl worried that clever toy .	the bowl worried those clever toy .
the boxes wo n't understand those wrong schools .	the boxes wo n't understand that wrong schools .
the buttons had n't answered those important shirts .	the buttons had n't answered that important shirts .
the toys appreciate this sleepy boat .	the toys appreciate these sleepy boat .
the book can n't answer that quiet bed .	the book can n't answer those quiet bed .
the chair is talking to this confused restaurant .	the chair is talking to these confused restaurant .
the glasses can understand these tall candles .	the glasses can understand this tall candles .
the shirts clean this big girl .	the shirts clean these big girl .
the plate has n't thrown that great dentist .	the plate has n't thrown those great dentist .
the crayon had n't heard those kind cars .	the crayon had n't heard that kind cars .
the doll could n't know these careful cars .	the doll could n't know this careful cars .
the spoons listen to those surprised bowls .	the spoons listen to that surprised bowls .
the museum is helping this helpful bank .	the museum is helping these helpful bank .
the museum could n't make those old girls .	the museum could n't make that old girls .
the ship lost these kind plates .	the ship lost this kind plates .
the bicycle has brought this old child .	the bicycle has brought these old child .
the bicycle has n't taken that important dancer .	the bicycle has n't taken those important dancer .
the dishes were working with these lucky toys .	the dishes were working with this lucky toys .
the school lost these healthy glasses .	the school lost this healthy glasses .
the beds find that cold person .	the beds find those cold person .
the box is teaching that tired window .	the box is teaching those tired window .
the toys worried these boring crayons .	the toys worried this boring crayons .
the school had answered that busy bicycle .	the school had answered those busy bicycle .
the pictures are bothering that bored car .	the pictures are bothering those bored car .
the candles heard that lucky rocket .	the candles heard those lucky rocket .
the beds would sell this expensive dancer .	the beds would sell these expensive dancer .
the shirt cleaned that new adult .	the shirt cleaned those new adult .
the books visited that bored car .	the books visited those bored car .
the plane might help these happy cars .	the plane might help this happy cars .
the pictures fix that fine man .	the pictures fix those fine man .
the bag scared this confused chair .	the bag scared these confused chair .
the doors should visit that strong car .	the doors should visit those strong car .
the button will buy those whole women .	the button will buy that whole women .
the spoon heard this hungry box .	the spoon heard these hungry box .
the spoon knew this clever fork .	the spoon knew these clever fork .
the chair did n't make this red dancer .	the chair did n't make these red dancer .
the boats were n't bothering that kind button .	the boats were n't bothering those kind button .
the shoes threw that expensive child .	the shoes threw those expensive child .
the toys wo n't work with these busy toys .	the toys wo n't work with this busy toys .
the toys threw that new woman .	the toys threw those new woman .
the rooms were n't losing that green king .	the rooms were n't losing those green king .
the car worried that wrong candle .	the car worried those wrong candle .
the bed should n't help these strong rooms .	the bed should n't help this strong rooms .
the rocket understands those tired doors .	the rocket understands that tired doors .
the spoons can hear this helpful school .	the spoons can hear these helpful school .
the mirror is visiting those strong rings .	the mirror is visiting that strong rings .
the hat bought these hot people .	the hat bought this hot people .
the kitchen can sell that dry adult .	the kitchen can sell those dry adult .
the boats have n't found these busy schools .	the boats have n't found this busy schools .
the glasses were working with that gentle ring .	the glasses were working with those gentle ring .
the library could n't steal those great women .	the library could n't steal that great women .
the cups found this strong bed .	the cups found these strong bed .
the car lost that angry doll .	the car lost those angry doll .
the schools are n't making that awesome lady .	the schools are n't making those awesome lady .
the boats are throwing that cold lady .	the boats are throwing those cold lady .
the books had those fine women .	the books had that fine women .
the door is throwing that old driver .	the door is throwing those old driver .
the restaurant had worked with these wrong rooms .	the restaurant had worked with this wrong rooms .
the shoe may hold these red boys .	the shoe may hold this red boys .
the mirror answered this boring cup .	the mirror answered these boring cup .
the book heard that boring car .	the book heard those boring car .
the plates have answered that wrong shoe .	the plates have answered those wrong shoe .
the door knew that excited ship .	the door knew those excited ship .
the plane works with that gentle school .	the plane works with those gentle school .
the glasses are working with this tired car .	the glasses are working with these tired car .
the spoon held these hot people .	the spoon held this hot people .
the cups were shaking those new ladies .	the cups were shaking that new ladies .
the truck understands those busy cars .	the truck understands that busy cars .
the toy was n't throwing these important boys .	the toy was n't throwing this important boys .
the school is n't working with that bored museum .	the school is n't working with those bored museum .
the cars bothered that helpful mall .	the cars bothered those helpful mall .
the books understand these wrong schools .	the books understand this wrong schools .
the rooms were bringing this purple person .	the rooms were bringing these purple person .
the books have n't scared this surprised picture .	the books have n't scared these surprised picture .
the bed bought those boring doctors .	the bed bought that boring doctors .
the chairs were talking to these strong boxes .	the chairs were talking to this strong boxes .
the crayons must scare this clever museum .	the crayons must scare these clever museum .
the mirror should sell that boring patient .	the mirror should sell those boring patient .
the truck moves these green people .	the truck moves this green people .
the schools hold this hot doctor .	the schools hold these hot doctor .
the crayons were listening to this bored couch .	the crayons were listening to these bored couch .
the car is n't buying those awesome people .	the car is n't buying that awesome people .
the museum had bothered that kind button .	the museum had bothered those kind button .
the forks had n't found that orange person .	the forks had n't found those orange person .
the glasses had n't confused this young school .	the glasses had n't confused these young school .
the rooms did n't help these curious windows .	the rooms did n't help this curious windows .
the bank bothered this busy car .	the bank bothered these busy car .
the dishes could lift these orange people .	the dishes could lift this orange people .
the cars could care for those confused toys .	the cars could care for that confused toys .
the plates do n't visit that kind kitchen .	the plates do n't visit those kind kitchen .
the doors take these boring people .	the doors take this boring people .
the rug had found that sleepy shirt .	the rug had found those sleepy shirt .
the cars buy this purple child .	the cars buy these purple child .
the doors bothered this healthy truck .	the doors bothered these healthy truck .
the picture is n't keeping this cold lady .	the picture is n't keeping these cold lady .
the car wo n't bring this dry child .	the car wo n't bring these dry child .
the bicycle should hear this kind ship .	the bicycle should hear these kind ship .
the pictures might drop these dry boys .	the pictures might drop this dry boys .
the bowl can hear this wrong hat .	the bowl can hear these wrong hat .
the mall kept this gray girl .	the mall kept these gray girl .
the candles are visiting that curious hospital .	the candles are visiting those curious hospital .
the boxes are n't bringing these broken ladies .	the boxes are n't bringing this broken ladies .
the rocket had held this cute child .	the rocket had held these cute child .
the rooms had n't kept this great lady .	the rooms had n't kept these great lady .
the mirror is n't listening to that gentle spoon .	the mirror is n't listening to those gentle spoon .
the rug has n't moved this cool customer .	the rug has n't moved these cool customer .
the car visited these wrong schools .	the car visited this wrong schools .
the door did n't find this whole adult .	the door did n't find these whole adult .
the cup helps this helpful ring .	the cup helps these helpful ring .
the ship knows this tired truck .	the ship knows these tired truck .
the toy must care for these surprised chairs .	the toy must care for this surprised chairs .
the rings can n't hear this clever car .	the rings can n't hear these clever car .
the dolls have cleaned this cool customer .	the dolls have cleaned these cool customer .
the trucks know that careful candle .	the trucks know those careful candle .
the bag knew this young chair .	the bag knew these young chair .
the plate is listening to this healthy kitchen .	the plate is listening to these healthy kitchen .
the dolls praise this nice cup .	the dolls praise these nice cup .
the school cleaned this broken woman .	the school cleaned these broken woman .
the hat was helping this tired crayon .	the hat was helping these tired crayon .
the rug was n't bothering that confused window .	the rug was n't bothering those confused window .
the spoons were n't talking to those upset schools .	the spoons were n't talking to that upset schools .
the picture scares this angry plane .	the picture scares these angry plane .
the library might hear that happy library .	the library might hear those happy library .
the toy lost these tired spoons .	the toy lost this tired spoons .
the couch lost that bored restaurant .	the couch lost those bored restaurant .
the car brought those black girls .	the car brought that black girls .
the shoe lost those careful cars .	the shoe lost that careful cars .
the picture found these careful bowls .	the picture found this careful bowls .
the bank could make these green children .	the bank could make this green children .
the shirts should n't shake that awesome doctor .	the shirts should n't shake those awesome doctor .
the pictures were helping that strong crayon .	the pictures were helping those strong crayon .
the plate taught these boring books .	the plate taught this boring books .
the bottles stole this white boy .	the bottles stole these white boy .
the plates must take that awesome girl .	the plates must take those awesome girl .
the glasses steal this green dancer .	the glasses steal these green dancer .
the crayons will lose that big driver .	the crayons will lose those big driver .
the button lost this confused car .	the button lost these confused car .
the plane should n't visit these sleepy chairs .	the plane should n't visit this sleepy chairs .
the shirt has talked to those sleepy cars .	the shirt has talked to that sleepy cars .
the crayon would keep this important child .	the crayon would keep these important child .
the crayon would clean that red king .	the crayon would clean those red king .
the button found that curious doll .	the button found those curious doll .
the button would help those upset windows .	the button would help that upset windows .
the couch keeps this amazing boy .	the couch keeps these amazing boy .
the trucks have worried those sleepy beds .	the trucks have worried that sleepy beds .
the kitchen was making those gray teachers .	the kitchen was making that gray teachers .
the kitchen has n't visited this wrong museum .	the kitchen has n't visited these wrong museum .
the chairs have scared that bored museum .	the chairs have scared those bored museum .
the dolls can hear that tall box .	the dolls can hear those tall box .
the trucks have worried this bored school .	the trucks have worried these bored school .
the school is making these amazing people .	the school is making this amazing people .
the crayon has held these brown women .	the crayon has held this brown women .
the mall may teach this young toy .	the mall may teach these young toy .
the car bothered that curious kitchen .	the car bothered those curious kitchen .
the dolls are n't helping those bored bowls .	the dolls are n't helping that bored bowls .
the box has helped these boring pictures .	the box has helped this boring pictures .
the car is n't making this new driver .	the car is n't making these new driver .
the cups move that cold woman .	the cups move those cold woman .
the glasses have n't talked to that clever crayon .	the glasses have n't talked to those clever crayon .
the school makes that boring dancer .	the school makes those boring dancer .
the mirror was throwing that small driver .	the mirror was throwing those small driver .
the cars lose these cute people .	the cars lose this cute people .
the rug takes this red doctor .	the rug takes these red doctor .
the rooms have n't brought this small customer .	the rooms have n't brought these small customer .
the bowls appreciate these happy rings .	the bowls appreciate this happy rings .
the mall brings this white customer .	the mall brings these white customer .
the window has n't found that green boy .	the window has n't found those green boy .
the bowls knew that hungry fork .	the bowls knew those hungry fork .
the crayon found those clever dolls .	the crayon found that clever dolls .
the museum has n't confused this smart doll .	the museum has n't confused these smart doll .
the library shakes these boring children .	the library shakes this boring children .
the bags did n't talk to these friendly doors .	the bags did n't talk to this friendly doors .
the cars moved that whole guy .	the cars moved those whole guy .
the boxes bother those kind toys .	the boxes bother that kind toys .
the bowl is fixing that black driver .	the bowl is fixing those black driver .
the buttons may care for those confused forks .	the buttons may care for that confused forks .
the candles take those important people .	the candles take that important people .
the pictures brought that whole guy .	the pictures brought those whole guy .
the restaurant was throwing these great teachers .	the restaurant was throwing this great teachers .
the books wo n't keep that old adult .	the books wo n't keep those old adult .
the beds find those small teachers .	the beds find that small teachers .
the spoons listen to those young shirts .	the spoons listen to that young shirts .
the dish keeps this yellow child .	the dish keeps these yellow child .
the rings help this quiet glass .	the rings help these quiet glass .
the bed worked with that angry shoe .	the bed worked with those angry shoe .
the rooms lost this cold customer .	the rooms lost these cold customer .
the plate stole these green ladies .	the plate stole this green ladies .
the rocket stole this fine teacher .	the rocket stole these fine teacher .
the truck was visiting these boring glasses .	the truck was visiting this boring glasses .
the car cleaned those awesome boys .	the car cleaned that awesome boys .
the picture might appreciate those surprised dolls .	the picture might appreciate that surprised dolls .
the crayon was bothering these hungry rooms .	the crayon was bothering this hungry rooms .
the cars scared these boring rooms .	the cars scared this boring rooms .
the cars bring these great ladies .	the cars bring this great ladies .
the rooms talk to those bored spoons .	the rooms talk to that bored spoons .
the plates find this missing doctor .	the plates find these missing doctor .
the fork shook that cool girl .	the fork shook those cool girl .
the shirts bothered this boring ship .	the shirts bothered these boring ship .
the ring moves this green child .	the ring moves these green child .
the dolls worry those strong dishes .	the dolls worry that strong dishes .
the bank should appreciate this kind spoon .	the bank should appreciate these kind spoon .
the shoes had worked with this smart box .	the shoes had worked with these smart box .
the park kept those yellow ladies .	the park kept that yellow ladies .
the shirts appreciate that excited car .	the shirts appreciate those excited car .
the bowl shakes that gray king .	the bowl shakes those gray king .
the rings should n't hold those broken men .	the rings should n't hold that broken men .
the candles know those strong crayons .	the candles know that strong crayons .
the spoons were buying that small person .	the spoons were buying those small person .
the cups have confused those careful spoons .	the cups have confused that careful spoons .
the hat has kept these awesome women .	the hat has kept this awesome women .
the mirror would help that careful mall .	the mirror would help those careful mall .
the rooms have n't lost this dry woman .	the rooms have n't lost these dry woman .
the plane would n't make this dry girl .	the plane would n't make these dry girl .
the books visited this upset shirt .	the books visited these upset shirt .
the room does n't buy that new child .	the room does n't buy those new child .
the cars answer this careful kitchen .	the cars answer these careful kitchen .
the toys would talk to that gentle mall .	the toys would talk to those gentle mall .
the book has n't scared those strong schools .	the book has n't scared that strong schools .
the bottle has n't dropped that cool boy .	the bottle has n't dropped those cool boy .
the ship visited these tired cups .	the ship visited this tired cups .
the chair lost these new children .	the chair lost this new children .
the schools praise that boring room .	the schools praise those boring room .
the library had n't answered that friendly chair .	the library had n't answered those friendly chair .
the bags care for this wrong rug .	the bags care for these wrong rug .
the glass should teach these excited glasses .	the glass should teach this excited glasses .
the library worried that quiet dish .	the library worried those quiet dish .
the windows did n't know those sleepy toys .	the windows did n't know that sleepy toys .
the shoes fixed this gray patient .	the shoes fixed these gray patient .
the rug did n't understand that strong mall .	the rug did n't understand those strong mall .
the forks were n't working with these hungry trucks .	the forks were n't working with this hungry trucks .
the bicycle had scared this friendly bag .	the bicycle had scared these friendly bag .
the dolls will listen to those helpful plates .	the dolls will listen to that helpful plates .
the toys are bringing that green boy .	the toys are bringing those green boy .
the glasses are teaching this kind book .	the glasses are teaching these kind book .
the boats have n't made that amazing doctor .	the boats have n't made those amazing doctor .
the school keeps that gray man .	the school keeps those gray man .
the rug answered those sleepy buttons .	the rug answered that sleepy buttons .
the plate could n't have those gray children .	the plate could n't have that gray children .
the button talked to those lucky dolls .	the button talked to that lucky dolls .
the box hears that quiet mirror .	the box hears those quiet mirror .
the rug was n't talking to that young shirt .	the rug was n't talking to those young shirt .
the book helped these boring bags .	the book helped this boring bags .
the truck has talked to these kind boxes .	the truck has talked to this kind boxes .
the glass could n't scare those young bottles .	the glass could n't scare that young bottles .
the hat can know this bored toy .	the hat can know these bored toy .
the dishes are working with this tired shoe .	the dishes are working with these tired shoe .
the hat is keeping that boring king .	the hat is keeping those boring king .
the fork hears those helpful chairs .	the fork hears that helpful chairs .
the schools worked with those boring glasses .	the schools worked with that boring glasses .
the mirror had n't heard this hungry bowl .	the mirror had n't heard these hungry bowl .
the books would n't shake these green guys .	the books would n't shake this green guys .
the spoons have worked with that curious picture .	the spoons have worked with those curious picture .
the crayon did n't know this kind rug .	the crayon did n't know these kind rug .
the rocket talks to that helpful plane .	the rocket talks to those helpful plane .
the mirror should n't keep those gray ladies .	the mirror should n't keep that gray ladies .
the boat knew these confused trucks .	the boat knew this confused trucks .
the bed helped that healthy bicycle .	the bed helped those healthy bicycle .
the library could n't know this strong shoe .	the library could n't know these strong shoe .
the toy was n't dropping those boring women .	the toy was n't dropping that boring women .
the dish should understand this bored mirror .	the dish should understand these bored mirror .
the door is n't talking to that important museum .	the door is n't talking to those important museum .
the rings are n't cleaning this old dancer .	the rings are n't cleaning these old dancer .
the dishes knew this nice mall .	the dishes knew these nice mall .
the fork would understand these busy doors .	the fork would understand this busy doors .
the bags know that confused box .	the bags know those confused box .
the ring confused these clever windows .	the ring confused this clever windows .
the bank was bothering these boring schools .	the bank was bothering this boring schools .
the bottle can bother those helpful boats .	the bottle can bother that helpful boats .
the car was teaching these busy spoons .	the car was teaching this busy spoons .
the park answered this smart library .	the park answered these smart library .
the glass keeps this fine person .	the glass keeps these fine person .
the doors have n't found that amazing teacher .	the doors have n't found those amazing teacher .
the boats were n't talking to that lucky school .	the boats were n't talking to those lucky school .
the toys are n't taking this amazing driver .	the toys are n't taking these amazing driver .
the candle found that confused window .	the candle found those confused window .
the plane is n't helping that clever glass .	the plane is n't helping those clever glass .
the schools must find that gray patient .	the schools must find those gray patient .
the glasses taught that kind bank .	the glasses taught those kind bank .
the shoes scared those angry cars .	the shoes scared that angry cars .
the boxes do n't teach this kind window .	the boxes do n't teach these kind window .
the book had n't cleaned those red guys .	the book had n't cleaned that red guys .
the bags had n't heard those young books .	the bags had n't heard that young books .
the door helped that clever shirt .	the door helped those clever shirt .
the rocket would n't care for this strong spoon .	the rocket would n't care for these strong spoon .
the car moved those awesome teachers .	the car moved that awesome teachers .
the cups have n't heard those sleepy cars .	the cups have n't heard that sleepy cars .
the boxes were n't visiting that curious bottle .	the boxes were n't visiting those curious bottle .
the book was throwing that whole doctor .	the book was throwing those whole doctor .
the trucks took this amazing girl .	the trucks took these amazing girl .
the shirts might drop these hot girls .	the shirts might drop this hot girls .
the doll lost this curious kitchen .	the doll lost these curious kitchen .
the candle was listening to those surprised boxes .	the candle was listening to that surprised boxes .
the forks hear this boring boat .	the forks hear these boring boat .
the boxes might know these upset hats .	the boxes might know this upset hats .
the door would find this yellow dentist .	the door would find these yellow dentist .
the bags are taking that purple person .	the bags are taking those purple person .
the book will hear these busy chairs .	the book will hear this busy chairs .
the forks should teach that confused plate .	the forks should teach those confused plate .
the bank hears those angry books .	the bank hears that angry books .
the shoe does n't steal that small dancer .	the shoe does n't steal those small dancer .
the toy scares those lucky bottles .	the toy scares that lucky bottles .
the rings do n't bring this purple man .	the rings do n't bring these purple man .
the shirt is n't bringing this white dancer .	the shirt is n't bringing these white dancer .
the ship could n't sell those yellow men .	the ship could n't sell that yellow men .
the school made that fine doctor .	the school made those fine doctor .
the plane held that big dancer .	the plane held those big dancer .
the school drops this blue lady .	the school drops these blue lady .
the car might understand this sleepy box .	the car might understand these sleepy box .
the windows have n't found that red boy .	the windows have n't found those red boy .
the dolls have n't taught this wrong couch .	the dolls have n't taught these wrong couch .
the car understands these tired forks .	the car understands this tired forks .
the fork found these helpful doors .	the fork found this helpful doors .
the room had n't kept those fine ladies .	the room had n't kept that fine ladies .
the candle would n't appreciate this smart book .	the candle would n't appreciate these smart book .
the mirror understands those kind cars .	the mirror understands that kind cars .
the dishes scared that smart door .	the dishes scared those smart door .
the cup had n't helped this curious book .	the cup had n't helped these curious book .
the cars should n't praise those lucky cars .	the cars should n't praise that lucky cars .
the pictures work with this hungry rug .	the pictures work with these hungry rug .
the fork is helping these healthy beds .	the fork is helping this healthy beds .
the library had taken this gray dancer .	the library had taken these gray dancer .
the shirts had bought those boring ladies .	the shirts had bought that boring ladies .
the toys scare these kind shoes .	the toys scare this kind shoes .
the cup makes those fine teachers .	the cup makes that fine teachers .
the bank should have that black child .	the bank should have those black child .
the hats hear this wrong truck .	the hats hear these wrong truck .
the car should listen to those bored schools .	the car should listen to that bored schools .
the trucks bothered this smart bicycle .	the trucks bothered these smart bicycle .
the cars have n't taken this awesome king .	the cars have n't taken these awesome king .
the mall hears this nice box .	the mall hears these nice box .
the ship was n't working with those friendly chairs .	the ship was n't working with that friendly chairs .
the bicycle could hear these friendly shoes .	the bicycle could hear this friendly shoes .
the forks stole this whole doctor .	the forks stole these whole doctor .
the picture was listening to that happy truck .	the picture was listening to those happy truck .
the button heard these healthy plates .	the button heard this healthy plates .
the mirror fixed this brown lady .	the mirror fixed these brown lady .
the windows have n't cleaned these amazing doctors .	the windows have n't cleaned this amazing doctors .
the rooms knew those curious beds .	the rooms knew that curious beds .
the cups listen to this angry book .	the cups listen to these angry book .
the candles take that purple adult .	the candles take those purple adult .
the bottle has those red guys .	the bottle has that red guys .
the hats scare these tired shirts .	the hats scare this tired shirts .
the dolls are bothering this smart crayon .	the dolls are bothering these smart crayon .
the dolls can n't worry that tall fork .	the dolls can n't worry those tall fork .
the books lost these small men .	the books lost this small men .
the bowls lift these great doctors .	the bowls lift this great doctors .
the forks had n't scared that friendly button .	the forks had n't scared those friendly button .
the pictures bring these amazing teachers .	the pictures bring this amazing teachers .
the park may hear that smart spoon .	the park may hear those smart spoon .
the plate could n't scare those boring dishes .	the plate could n't scare that boring dishes .
the bag hears that excited candle .	the bag hears those excited candle .
the school will move those green ladies .	the school will move that green ladies .
the school drops these dry boys .	the school drops this dry boys .
the ship can keep these new boys .	the ship can keep this new boys .
the hats do n't understand these surprised cups .	the hats do n't understand this surprised cups .
the plane was n't working with this gentle plane .	the plane was n't working with these gentle plane .
the car does n't work with this helpful couch .	the car does n't work with these helpful couch .
the doll has n't talked to that busy door .	the doll has n't talked to those busy door .
the door has n't moved that whole customer .	the door has n't moved those whole customer .
the dolls had these broken ladies .	the dolls had this broken ladies .
the toys know this lucky picture .	the toys know these lucky picture .
the bags had worried that quiet bank .	the bags had worried those quiet bank .
the school has n't worked with those strong cars .	the school has n't worked with that strong cars .
the chairs were n't bothering this hungry school .	the chairs were n't bothering these hungry school .
the car is n't holding this amazing boy .	the car is n't holding these amazing boy .
the rings wo n't hear this lucky car .	the rings wo n't hear these lucky car .
the book was throwing that broken child .	the book was throwing those broken child .
the cups visited these strong books .	the cups visited this strong books .
the crayons bothered that healthy plane .	the crayons bothered those healthy plane .
the library was holding this broken woman .	the library was holding these broken woman .
the shirt will know this curious door .	the shirt will know these curious door .
the dish had n't found that careful school .	the dish had n't found those careful school .
the restaurant wo n't understand these upset boxes .	the restaurant wo n't understand this upset boxes .
the boxes are finding that cute customer .	the boxes are finding those cute customer .
the doll must hold these old girls .	the doll must hold this old girls .
the mirror would n't appreciate those tall schools .	the mirror would n't appreciate that tall schools .
the boxes could visit those friendly bowls .	the boxes could visit that friendly bowls .
the hats must buy this red patient .	the hats must buy these red patient .
the rug made these purple boys .	the rug made this purple boys .
the schools were n't teaching this bored school .	the schools were n't teaching these bored school .
the school hears this bored ship .	the school hears these bored ship .
the bicycle talks to these tall bowls .	the bicycle talks to this tall bowls .
the cars worry that young mall .	the cars worry those young mall .
the room might have those boring doctors .	the room might have that boring doctors .
the bowl cleaned those hot doctors .	the bowl cleaned that hot doctors .
the bags cleaned that expensive woman .	the bags cleaned those expensive woman .
the bottles can keep this white teacher .	the bottles can keep these white teacher .
the forks are n't talking to these kind windows .	the forks are n't talking to this kind windows .
the couch talks to those confused doors .	the couch talks to that confused doors .
the buttons made these brown women .	the buttons made this brown women .
the fork is n't moving those red ladies .	the fork is n't moving that red ladies .
the car was listening to this angry car .	the car was listening to these angry car .
the bag is fixing those gray ladies .	the bag is fixing that gray ladies .
the mirror moves those cute girls .	the mirror moves that cute girls .
the plates confused this friendly bowl .	the plates confused these friendly bowl .
the rings have worked with these excited bowls .	the rings have worked with this excited bowls .
the buttons have bought those yellow people .	the buttons have bought that yellow people .
the chair has n't lost those happy cups .	the chair has n't lost that happy cups .
the school wo n't steal these gray people .	the school wo n't steal this gray people .
the cars had held that black doctor .	the cars had held those black doctor .
the bank taught this confused shirt .	the bank taught these confused shirt .
the crayons clean this fine woman .	the crayons clean these fine woman .
the toys are visiting this wrong truck .	the toys are visiting these wrong truck .
the cars are listening to that happy restaurant .	the cars are listening to those happy restaurant .
the book was n't helping those busy buttons .	the book was n't helping that busy buttons .
the hats have n't bothered that healthy library .	the hats have n't bothered those healthy library .
the plate was moving those old people .	the plate was moving that old people .
the museum hears those wrong beds .	the museum hears that wrong beds .
the bed had n't taught that upset glass .	the bed had n't taught those upset glass .
the ring would know these tired toys .	the ring would know this tired toys .
the windows had n't heard that kind library .	the windows had n't heard those kind library .
the dishes found this small doctor .	the dishes found these small doctor .
the bed scared that clever truck .	the bed scared those clever truck .
the school knows those young schools .	the school knows that young schools .
the beds are n't shaking these black teachers .	the beds are n't shaking this black teachers .
the doll should listen to that young rocket .	the doll should listen to those young rocket .
the schools can n't praise this smart mirror .	the schools can n't praise these smart mirror .
the schools did n't buy that hot lady .	the schools did n't buy those hot lady .
the plates are making this gray king .	the plates are making these gray king .
the picture wo n't teach those nice schools .	the picture wo n't teach that nice schools .
the crayons bothered those curious books .	the crayons bothered that curious books .
the bowls help these strong chairs .	the bowls help this strong chairs .
the dish should hold that important dentist .	the dish should hold those important dentist .
the candle scared that sleepy bowl .	the candle scared those sleepy bowl .
the book may know those lucky dishes .	the book may know that lucky dishes .
the books scared that surprised hospital .	the books scared those surprised hospital .
the school is n't talking to those curious buttons .	the school is n't talking to that curious buttons .
the schools have n't confused these wrong boxes .	the schools have n't confused this wrong boxes .
the shoes should n't scare this healthy rocket .	the shoes should n't scare these healthy rocket .
the cups had n't heard those sleepy trucks .	the cups had n't heard that sleepy trucks .
the book has held that cool guy .	the book has held those cool guy .
the mall found those helpful dolls .	the mall found that helpful dolls .
the door will find this cool dancer .	the door will find these cool dancer .
the toys have fixed this hot king .	the toys have fixed these hot king .
the dishes should n't know these curious pictures .	the dishes should n't know this curious pictures .
the forks help that wrong rocket .	the forks help those wrong rocket .
the plane is n't visiting this nice rug .	the plane is n't visiting these nice rug .
the chairs visit those helpful glasses .	the chairs visit that helpful glasses .
the bed was n't bothering that confused kitchen .	the bed was n't bothering those confused kitchen .
the bicycle hears this boring hospital .	the bicycle hears these boring hospital .
the pictures made this orange teacher .	the pictures made these orange teacher .
the forks visit that tired room .	the forks visit those tired room .
the cup would n't teach those nice hats .	the cup would n't teach that nice hats .
the cars scared these lucky bowls .	the cars scared this lucky bowls .
the boxes have heard this curious bag .	the boxes have heard these curious bag .
the library wo n't scare this upset ship .	the library wo n't scare these upset ship .
the box had taken that cold child .	the box had taken those cold child .
the book knows these sleepy shoes .	the book knows this sleepy shoes .
the toy could n't have that cute dancer .	the toy could n't have those cute dancer .
the shirts are n't finding this cold woman .	the shirts are n't finding these cold woman .
the library would n't care for these healthy bottles .	the library would n't care for this healthy bottles .
the spoon had n't confused that tired button .	the spoon had n't confused those tired button .
the books appreciate these sleepy windows .	the books appreciate this sleepy windows .
the cars should n't care for those quiet hats .	the cars should n't care for that quiet hats .
the toys may work with those boring bags .	the toys may work with that boring bags .
the bottle knows those young books .	the bottle knows that young books .
the books knew these excited boxes .	the books knew this excited boxes .
the bags fix that white dentist .	the bags fix those white dentist .
the chairs buy those important boys .	the chairs buy that important boys .
the boats had n't scared these boring chairs .	the boats had n't scared this boring chairs .
the plates should n't work with these careful chairs .	the plates should n't work with this careful chairs .
the button cleaned these orange women .	the button cleaned this orange women .
the boat may lift these important men .	the boat may lift this important men .
the spoons should buy those hot ladies .	the spoons should buy that hot ladies .
the buttons held this awesome lady .	the buttons held these awesome lady .
the rug understands that healthy fork .	the rug understands those healthy fork .
the museum can n't appreciate these lucky rings .	the museum can n't appreciate this lucky rings .
the park is n't making that important adult .	the park is n't making those important adult .
the hats have found this tired window .	the hats have found these tired window .
the button can n't worry these gentle shoes .	the button can n't worry this gentle shoes .
the plane holds those white girls .	the plane holds that white girls .
the shirts were n't losing this orange queen .	the shirts were n't losing these orange queen .
the cups were n't helping those strong chairs .	the cups were n't helping that strong chairs .
the room can understand those confused trucks .	the room can understand that confused trucks .
the school scares this important shoe .	the school scares these important shoe .
the ship hears that sleepy kitchen .	the ship hears those sleepy kitchen .
the plane found those purple women .	the plane found that purple women .
the fork heard this hungry bag .	the fork heard these hungry bag .
the window drops that important queen .	the window drops those important queen .
the hospital scares those boring candles .	the hospital scares that boring candles .
the school drops these small doctors .	the school drops this small doctors .
the bed did n't move these yellow teachers .	the bed did n't move this yellow teachers .
the dolls are n't visiting these tall cars .	the dolls are n't visiting this tall cars .
the shoes could n't shake this orange patient .	the shoes could n't shake these orange patient .
the book talks to those tired bowls .	the book talks to that tired bowls .
the toy talked to these kind toys .	the toy talked to this kind toys .
the dolls fixed this brown guy .	the dolls fixed these brown guy .
the schools care for these young spoons .	the schools care for this young spoons .
the bicycle was teaching this boring school .	the bicycle was teaching these boring school .
the doors wo n't talk to these smart dolls .	the doors wo n't talk to this smart dolls .
the picture has n't bothered these careful forks .	the picture has n't bothered this careful forks .
the museum talked to that hungry crayon .	the museum talked to those hungry crayon .
the window taught this curious fork .	the window taught these curious fork .
the candle had n't taught this tired school .	the candle had n't taught these tired school .
the schools bother those confused bottles .	the schools bother that confused bottles .
the doors were n't listening to that quiet school .	the doors were n't listening to those quiet school .
the shirts have this blue dentist .	the shirts have these blue dentist .
the glasses know that hungry toy .	the glasses know those hungry toy .
the rooms had found those purple men .	the rooms had found that purple men .
the pictures heard that boring doll .	the pictures heard those boring doll .
the book was n't taking these boring girls .	the book was n't taking this boring girls .
the candle knew this gentle shoe .	the candle knew these gentle shoe .
the rings understand these smart boats .	the rings understand this smart boats .
the bottles talk to these quiet books .	the bottles talk to this quiet books .
the toys had heard that wrong bank .	the toys had heard those wrong bank .
the books brought these fine women .	the books brought this fine women .
the library wo n't hold these blue ladies .	the library wo n't hold this blue ladies .
the rings fix these boring girls .	the rings fix this boring girls .
the boat would answer this kind window .	the boat would answer these kind window .
the mall found that happy crayon .	the mall found those happy crayon .
the dishes have scared these hungry shoes .	the dishes have scared this hungry shoes .
the ship talks to this clever plate .	the ship talks to these clever plate .
the library did n't worry that young glass .	the library did n't worry those young glass .
the forks should answer that kind school .	the forks should answer those kind school .
the chairs worked with that friendly spoon .	the chairs worked with those friendly spoon .
the cup had lost these excited schools .	the cup had lost this excited schools .
the book knew these friendly dishes .	the book knew this friendly dishes .
the window has n't brought this fine doctor .	the window has n't brought these fine doctor .
the bed heard these happy candles .	the bed heard this happy candles .
the bowl threw those new boys .	the bowl threw that new boys .
the schools have found this white queen .	the schools have found these white queen .
the books worried that young box .	the books worried those young box .
the spoon had n't found these smart candles .	the spoon had n't found this smart candles .
the button knows that sleepy book .	the button knows those sleepy book .
the spoon stole those white doctors .	the spoon stole that white doctors .
the toy confused that angry cup .	the toy confused those angry cup .
the spoons listen to this careful museum .	the spoons listen to these careful museum .
the couch shakes that orange boy .	the couch shakes those orange boy .
the window had found that amazing guy .	the window had found those amazing guy .
the rooms shake this cold driver .	the rooms shake these cold driver .
the boats talked to that important window .	the boats talked to those important window .
the schools might lift this blue lady .	the schools might lift these blue lady .
the truck should hear that surprised glass .	the truck should hear those surprised glass .
the bed should worry this healthy crayon .	the bed should worry these healthy crayon .
the hat throws that green person .	the hat throws those green person .
the couch has n't confused that surprised shoe .	the couch has n't confused those surprised shoe .
the windows lost this healthy button .	the windows lost these healthy button .
the truck hears that important fork .	the truck hears those important fork .
the trucks had n't heard these tired crayons .	the trucks had n't heard this tired crayons .
the bottles were taking those fine doctors .	the bottles were taking that fine doctors .
the bags do n't bring that old child .	the bags do n't bring those old child .
the cups heard these upset rings .	the cups heard this upset rings .
the kitchen could n't know these bored rings .	the kitchen could n't know this bored rings .
the rocket had n't talked to that quiet chair .	the rocket had n't talked to those quiet chair .
the door hears this confused window .	the door hears these confused window .
the shirt had lost that upset book .	the shirt had lost those upset book .
the button must teach this gentle plate .	the button must teach these gentle plate .
the trucks are visiting this upset plane .	the trucks are visiting these upset plane .
the bicycle held those blue guys .	the bicycle held that blue guys .
the candle takes this awesome woman .	the candle takes these awesome woman .
the kitchen is n't taking that boring doctor .	the kitchen is n't taking those boring doctor .
the glasses had n't thrown that black doctor .	the glasses had n't thrown those black doctor .
the bank is n't taking that broken patient .	the bank is n't taking those broken patient .
the schools know this healthy book .	the schools know these healthy book .
the button keeps that gray doctor .	the button keeps those gray doctor .
the chairs have n't found these surprised toys .	the chairs have n't found this surprised toys .
the button brings those awesome girls .	the button brings that awesome girls .
the bowl should n't steal this fine customer .	the bowl should n't steal these fine customer .
the bags were shaking these hot women .	the bags were shaking this hot women .
the dish could worry these hungry candles .	the dish could worry this hungry candles .
the bank found those sleepy bottles .	the bank found that sleepy bottles .
the doors did n't talk to these curious schools .	the doors did n't talk to this curious schools .
the forks answer that happy bicycle .	the forks answer those happy bicycle .
the doors have n't helped that excited mall .	the doors have n't helped those excited mall .
the trucks will worry that important rug .	the trucks will worry those important rug .
the rooms knew that helpful ring .	the rooms knew those helpful ring .
the ring lost these sleepy doors .	the ring lost this sleepy doors .
the beds have n't moved these red girls .	the beds have n't moved this red girls .
the hat might teach this friendly candle .	the hat might teach these friendly candle .
the rocket has held these great teachers .	the rocket has held this great teachers .
the park visited that helpful shoe .	the park visited those helpful shoe .
the window is listening to those healthy spoons .	the window is listening to that healthy spoons .
the museum is n't losing this whole dentist .	the museum is n't losing these whole dentist .
the mirror knew these hungry cars .	the mirror knew this hungry cars .
the shirts are visiting that helpful museum .	the shirts are visiting those helpful museum .
the bottles had n't kept those black boys .	the bottles had n't kept that black boys .
the mirror knew this sleepy kitchen .	the mirror knew these sleepy kitchen .
the dishes knew this upset chair .	the dishes knew these upset chair .
the doors take this small woman .	the doors take these small woman .
the cups are helping this wrong rocket .	the cups are helping these wrong rocket .
the truck heard that busy ring .	the truck heard those busy ring .
the candle heard that helpful hospital .	the candle heard those helpful hospital .
the museum had n't thrown that cold boy .	the museum had n't thrown those cold boy .
the forks find this cute queen .	the forks find these cute queen .
the boats would n't understand that helpful bottle .	the boats would n't understand those helpful bottle .
the forks help those kind rings .	the forks help that kind rings .
the toys made those blue doctors .	the toys made that blue doctors .
the forks bother these helpful books .	the forks bother this helpful books .
the toy makes that black person .	the toy makes those black person .
the beds worry these friendly glasses .	the beds worry this friendly glasses .
the door is n't making those blue ladies .	the door is n't making that blue ladies .
the rug has n't taken this black guy .	the rug has n't taken these black guy .
the bowl has n't scared this sleepy room .	the bowl has n't scared these sleepy room .
the school had heard that lucky spoon .	the school had heard those lucky spoon .
the couch had cleaned that small adult .	the couch had cleaned those small adult .
the spoons might scare this nice plane .	the spoons might scare these nice plane .
the cups would visit that careful bowl .	the cups would visit those careful bowl .
the box can bother this busy bicycle .	the box can bother these busy bicycle .
the button has taught that nice ship .	the button has taught those nice ship .
the plane had kept this cold guy .	the plane had kept these cold guy .
the shoes had thrown this brown boy .	the shoes had thrown these brown boy .
the window knew this healthy room .	the window knew these healthy room .
the bicycle might bother those surprised glasses .	the bicycle might bother that surprised glasses .
the kitchen wo n't bother this confused school .	the kitchen wo n't bother these confused school .
the chairs confused that wrong bicycle .	the chairs confused those wrong bicycle .
the schools should hold that missing dancer .	the schools should hold those missing dancer .
the school could n't take this cute dancer .	the school could n't take these cute dancer .
the buttons taught these clever beds .	the buttons taught this clever beds .
the boats might work with those wrong bowls .	the boats might work with that wrong bowls .
the restaurant found this whole dentist .	the restaurant found these whole dentist .
the toy is n't finding that important woman .	the toy is n't finding those important woman .
the kitchen had n't visited this curious window .	the kitchen had n't visited these curious window .
the car taught those tired shirts .	the car taught that tired shirts .
the doors answer this excited book .	the doors answer these excited book .
the ring throws those cool children .	the ring throws that cool children .
the book should n't understand these busy bottles .	the book should n't understand this busy bottles .
the beds lift these missing people .	the beds lift this missing people .
the rooms had n't moved those dry ladies .	the rooms had n't moved that dry ladies .
the window can n't know this confused car .	the window can n't know these confused car .
the cups have n't worked with these clever forks .	the cups have n't worked with this clever forks .
the car talks to those boring shirts .	the car talks to that boring shirts .
the car hears that angry button .	the car hears those angry button .
the hats taught these kind schools .	the hats taught this kind schools .
the picture has that hot queen .	the picture has those hot queen .
the window is talking to that kind candle .	the window is talking to those kind candle .
the truck heard those excited buttons .	the truck heard that excited buttons .
the mirror has n't found that expensive child .	the mirror has n't found those expensive child .
the couch would make this awesome dentist .	the couch would make these awesome dentist .
the cars stole those awesome teachers .	the cars stole that awesome teachers .
the glasses have bought these cold girls .	the glasses have bought this cold girls .
the button scares that helpful hospital .	the button scares those helpful hospital .
the rocket moves this cool child .	the rocket moves these cool child .
the crayons drop that cool dancer .	the crayons drop those cool dancer .
the spoons might hear that helpful doll .	the spoons might hear those helpful doll .
the school worked with those boring rings .	the school worked with that boring rings .
the rug helped this wrong plane .	the rug helped these wrong plane .
the candle has n't bothered that quiet bag .	the candle has n't bothered those quiet bag .
the box wo n't understand these upset plates .	the box wo n't understand this upset plates .
the cup will fix this amazing girl .	the cup will fix these amazing girl .
the car had helped that tall toy .	the car had helped those tall toy .
the shirts hear this kind bowl .	the shirts hear these kind bowl .
the room would work with these healthy dishes .	the room would work with this healthy dishes .
the bowls were n't helping these friendly dolls .	the bowls were n't helping this friendly dolls .
the toys have worked with that upset spoon .	the toys have worked with those upset spoon .
the plane wo n't hear those angry cars .	the plane wo n't hear that angry cars .
the shoes find that small woman .	the shoes find those small woman .
the spoons heard that upset restaurant .	the spoons heard those upset restaurant .
the bags are n't bothering this strong library .	the bags are n't bothering these strong library .
the restaurant could bother that healthy car .	the restaurant could bother those healthy car .
the dishes know that lucky plate .	the dishes know those lucky plate .
the book threw those purple people .	the book threw that purple people .
the ship should take those missing women .	the ship should take that missing women .
the book may know that tired cup .	the book may know those tired cup .
the cups could n't hear that sleepy kitchen .	the cups could n't hear those sleepy kitchen .
the mall can steal those hot children .	the mall can steal that hot children .
the bank was n't bringing this hot person .	the bank was n't bringing these hot person .
the rocket had helped those upset pictures .	the rocket had helped that upset pictures .
the boxes brought this green customer .	the boxes brought these green customer .
the cars worry those busy books .	the cars worry that busy books .
the book understands that healthy toy .	the book understands those healthy toy .
the shoes have moved those cold men .	the shoes have moved that cold men .
the dish heard this friendly mall .	the dish heard these friendly mall .
the candles had n't bothered this curious button .	the candles had n't bothered these curious button .
the school is helping that wrong crayon .	the school is helping those wrong crayon .
the candle will praise that important plate .	the candle will praise those important plate .
the bottles were n't talking to this strong chair .	the bottles were n't talking to these strong chair .
the bowls can worry this lucky bag .	the bowls can worry these lucky bag .
the boat talks to these bored schools .	the boat talks to this bored schools .
the toy has n't bothered that happy museum .	the toy has n't bothered those happy museum .
the shirts will clean those amazing boys .	the shirts will clean that amazing boys .
the rug had taught that bored hat .	the rug had taught those bored hat .
the windows could n't throw those red people .	the windows could n't throw that red people .
the beds could n't steal this great woman .	the beds could n't steal these great woman .
the school is n't talking to that excited plane .	the school is n't talking to those excited plane .
the crayons are n't dropping this yellow patient .	the crayons are n't dropping these yellow patient .
the rings had talked to this excited picture .	the rings had talked to these excited picture .
the school scares those clever crayons .	the school scares that clever crayons .
the dolls scare these helpful bowls .	the dolls scare this helpful bowls .
the school had n't held that whole girl .	the school had n't held those whole girl .
the doors should n't sell this green teacher .	the doors should n't sell these green teacher .
the book worried this excited boat .	the book worried these excited boat .
the spoon can n't answer these lucky rooms .	the spoon can n't answer this lucky rooms .
the buttons would make those missing ladies .	the buttons would make that missing ladies .
the dishes may worry that upset couch .	the dishes may worry those upset couch .
the forks kept these awesome men .	the forks kept this awesome men .
the room had n't taught this important park .	the room had n't taught these important park .
the hats can know that friendly hat .	the hats can know those friendly hat .
the room had n't taken those expensive children .	the room had n't taken that expensive children .
the spoon worked with that careful ship .	the spoon worked with those careful ship .
the fork could n't know those wrong windows .	the fork could n't know that wrong windows .
the hospital had n't moved that amazing lady .	the hospital had n't moved those amazing lady .
the rooms can n't know those smart books .	the rooms can n't know that smart books .
the room has n't visited these angry buttons .	the room has n't visited this angry buttons .
the bottle had heard that busy mirror .	the bottle had heard those busy mirror .
the candle can hear this clever restaurant .	the candle can hear these clever restaurant .
the chairs made this orange dancer .	the chairs made these orange dancer .
the truck had worried this surprised hospital .	the truck had worried these surprised hospital .
the forks work with that excited bag .	the forks work with those excited bag .
the cup can know that tired button .	the cup can know those tired button .
the shirt understands those bored schools .	the shirt understands that bored schools .
the bowls could find that expensive driver .	the bowls could find those expensive driver .
the dishes help those curious books .	the dishes help that curious books .
the kitchen talked to this upset ring .	the kitchen talked to these upset ring .
the button must bother these gentle glasses .	the button must bother this gentle glasses .
the doll was n't talking to this surprised crayon .	the doll was n't talking to these surprised crayon .
the windows hear this wrong window .	the windows hear these wrong window .
the room made that important girl .	the room made those important girl .
the fork had n't helped those bored rooms .	the fork had n't helped that bored rooms .
the boxes are n't visiting this kind chair .	the boxes are n't visiting these kind chair .
the boxes are buying this purple king .	the boxes are buying these purple king .
the truck drops this dry doctor .	the truck drops these dry doctor .
the door may teach these healthy buttons .	the door may teach this healthy buttons .
the bags were n't helping these quiet boats .	the bags were n't helping this quiet boats .
the boats hear these careful plates .	the boats hear this careful plates .
the cars would understand this busy bowl .	the cars would understand these busy bowl .
the plane could n't teach this clever school .	the plane could n't teach these clever school .
the schools buy this green man .	the schools buy these green man .
the dishes cleaned this new dentist .	the dishes cleaned these new dentist .
the boat should n't steal these orange doctors .	the boat should n't steal this orange doctors .
the bottle had cleaned that cool king .	the bottle had cleaned those cool king .
the couch should bother this healthy couch .	the couch should bother these healthy couch .
the rug could fix these gray men .	the rug could fix this gray men .
the ship has heard these friendly shoes .	the ship has heard this friendly shoes .
the picture is n't helping these busy bowls .	the picture is n't helping this busy bowls .
the picture taught this curious kitchen .	the picture taught these curious kitchen .
the bottle had n't confused this surprised box .	the bottle had n't confused these surprised box .
the couch talks to those nice cars .	the couch talks to that nice cars .
the bicycle has n't heard these friendly trucks .	the bicycle has n't heard this friendly trucks .
the shoes are n't listening to these tired forks .	the shoes are n't listening to this tired forks .
the bowl wo n't take that cold girl .	the bowl wo n't take those cold girl .
the cup has n't dropped that fine woman .	the cup has n't dropped those fine woman .
the toys must bother this curious cup .	the toys must bother these curious cup .
the bottles bought those small teachers .	the bottles bought that small teachers .
the crayon bought that cute dancer .	the crayon bought those cute dancer .
the bed lost those confused dolls .	the bed lost that confused dolls .
the bowl wo n't lose this green man .	the bowl wo n't lose these green man .
the shoe lost this cute king .	the shoe lost these cute king .
the library might work with that tall restaurant .	the library might work with those tall restaurant .
the books are n't taking this yellow man .	the books are n't taking these yellow man .
the plane has n't heard this gentle museum .	the plane has n't heard these gentle museum .
the book should scare this excited ring .	the book should scare these excited ring .
the books have talked to that busy bank .	the books have talked to those busy bank .
the candles throw that yellow adult .	the candles throw those yellow adult .
the beds are n't taking that whole woman .	the beds are n't taking those whole woman .
the mirror has taken this cute person .	the mirror has taken these cute person .
the door has answered those strong doors .	the door has answered that strong doors .
the glasses were buying this old lady .	the glasses were buying these old lady .
the candle heard that bored doll .	the candle heard those bored doll .
the car held those gray girls .	the car held that gray girls .
the rocket taught this young bag .	the rocket taught these young bag .
the buttons had n't dropped those whole teachers .	the buttons had n't dropped that whole teachers .
the cups were helping this nice hospital .	the cups were helping these nice hospital .
the candle threw this old dentist .	the candle threw these old dentist .
the cars were n't shaking that important girl .	the cars were n't shaking those important girl .
the cars will shake these big women .	the cars will shake this big women .
the cars did n't care for those confused bowls .	the cars did n't care for that confused bowls .
the chairs had n't scared those healthy shirts .	the chairs had n't scared that healthy shirts .
the rocket should visit those angry cups .	the rocket should visit that angry cups .
the picture is n't working with that kind glass .	the picture is n't working with those kind glass .
the schools were dropping that broken lady .	the schools were dropping those broken lady .
the spoons hear this nice bicycle .	the spoons hear these nice bicycle .
the bowls have n't cleaned this small lady .	the bowls have n't cleaned these small lady .
the dish was n't bothering this careful restaurant .	the dish was n't bothering these careful restaurant .
the crayons should move these brown women .	the crayons should move this brown women .
the hospital scares those hungry cars .	the hospital scares that hungry cars .
the bottle has n't moved this hot person .	the bottle has n't moved these hot person .
the doors had n't made those red boys .	the doors had n't made that red boys .
the beds buy this purple queen .	the beds buy these purple queen .
the spoon was n't talking to this smart mirror .	the spoon was n't talking to these smart mirror .
the spoon can scare those kind hats .	the spoon can scare that kind hats .
the forks could n't hold these new men .	the forks could n't hold this new men .
the mall has cleaned that big doctor .	the mall has cleaned those big doctor .
the mall is n't finding that green patient .	the mall is n't finding those green patient .
the cup was n't cleaning this black dancer .	the cup was n't cleaning these black dancer .
the rooms worried these bored buttons .	the rooms worried this bored buttons .
the boats can n't scare those angry rooms .	the boats can n't scare that angry rooms .
the crayons scare those kind shoes .	the crayons scare that kind shoes .
the book has scared that tired bank .	the book has scared those tired bank .
the shirt is n't bothering that excited dish .	the shirt is n't bothering those excited dish .
the ring will answer that tall shirt .	the ring will answer those tall shirt .
the bowl is bothering that nice room .	the bowl is bothering those nice room .
the window must have that brown guy .	the window must have those brown guy .
the bank has n't kept this red king .	the bank has n't kept these red king .
the schools had made that great adult .	the schools had made those great adult .
the rocket was losing that green child .	the rocket was losing those green child .
the plates visited these tired spoons .	the plates visited this tired spoons .
the park threw that missing teacher .	the park threw those missing teacher .
the dolls were losing these expensive children .	the dolls were losing this expensive children .
the cups should find those great ladies .	the cups should find that great ladies .
the toys made this cool driver .	the toys made these cool driver .
the room had n't worked with these healthy windows .	the room had n't worked with this healthy windows .
the boats wo n't steal this dry man .	the boats wo n't steal these dry man .
the plates had bothered those important schools .	the plates had bothered that important schools .
the bottle knew this bored museum .	the bottle knew these bored museum .
the car had n't scared those careful toys .	the car had n't scared that careful toys .
the box can bring these red ladies .	the box can bring this red ladies .
the beds are n't helping this angry boat .	the beds are n't helping these angry boat .
the dishes can keep that red guy .	the dishes can keep those red guy .
the button had n't lost this dry girl .	the button had n't lost these dry girl .
the crayon shakes this awesome lady .	the crayon shakes these awesome lady .
the door should n't hear that sleepy kitchen .	the door should n't hear those sleepy kitchen .
the book could n't have that cold teacher .	the book could n't have those cold teacher .
the chair confused those kind books .	the chair confused that kind books .
the car fixed that green girl .	the car fixed those green girl .
the park scared this hungry doll .	the park scared these hungry doll .
the bottle moves that cold boy .	the bottle moves those cold boy .
the rings would n't work with these confused bottles .	the rings would n't work with this confused bottles .
the library can n't know those happy books .	the library can n't know that happy books .
the plane has brought this awesome queen .	the plane has brought these awesome queen .
the car has n't heard those healthy plates .	the car has n't heard that healthy plates .
the rooms would praise that confused spoon .	the rooms would praise those confused spoon .
the book would n't help that friendly plate .	the book would n't help those friendly plate .
the boxes helped these smart bags .	the boxes helped this smart bags .
the books wo n't know these sleepy chairs .	the books wo n't know this sleepy chairs .
the mirror has n't lost that happy couch .	the mirror has n't lost those happy couch .
the park was n't helping that smart plate .	the park was n't helping those smart plate .
the bicycle does n't praise those kind cars .	the bicycle does n't praise that kind cars .
the toy was n't fixing these dry men .	the toy was n't fixing this dry men .
the windows are talking to that bored truck .	the windows are talking to those bored truck .
the forks are making this orange dancer .	the forks are making these orange dancer .
the boxes hear that boring museum .	the boxes hear those boring museum .
the bowl has that dry girl .	the bowl has those dry girl .
the rings praise these bored books .	the rings praise this bored books .
the picture brought these red girls .	the picture brought this red girls .
the windows heard this gentle shoe .	the windows heard these gentle shoe .
the pictures stole this green woman .	the pictures stole these green woman .
the rings appreciate those strong forks .	the rings appreciate that strong forks .
the button might bother this upset bed .	the button might bother these upset bed .
the cups are visiting this lucky shoe .	the cups are visiting these lucky shoe .
the bed was bringing those broken men .	the bed was bringing that broken men .
the doors knew these tall cups .	the doors knew this tall cups .
the toys should teach that happy bed .	the toys should teach those happy bed .
the dishes have n't bothered this surprised ship .	the dishes have n't bothered these surprised ship .
the glass may understand this excited room .	the glass may understand these excited room .
the books fixed those blue children .	the books fixed that blue children .
the school has confused that gentle window .	the school has confused those gentle window .
the bowl visited this confused glass .	the bowl visited these confused glass .
the car was dropping this big doctor .	the car was dropping these big doctor .
the rings moved these broken boys .	the rings moved this broken boys .
the books are taking these orange ladies .	the books are taking this orange ladies .
the bicycle had this great adult .	the bicycle had these great adult .
the buttons heard this bored school .	the buttons heard these bored school .
the cup helped this angry button .	the cup helped these angry button .
the boat had brought that hot customer .	the boat had brought those hot customer .
the shoes lift that purple boy .	the shoes lift those purple boy .
the beds might know these important shoes .	the beds might know this important shoes .
the bags have taught this curious fork .	the bags have taught these curious fork .
the windows have n't dropped those small men .	the windows have n't dropped that small men .
the book could hear that nice door .	the book could hear those nice door .
the dolls lose this small boy .	the dolls lose these small boy .
the hat had heard this quiet cup .	the hat had heard these quiet cup .
the hospital confused this important crayon .	the hospital confused these important crayon .
the dishes found that strong park .	the dishes found those strong park .
the room shook those fine doctors .	the room shook that fine doctors .
the mall is talking to that wrong plane .	the mall is talking to those wrong plane .
the car has taught that healthy chair .	the car has taught those healthy chair .
the forks could understand that excited button .	the forks could understand those excited button .
the school wo n't know these careful glasses .	the school wo n't know this careful glasses .
the room is cleaning those red people .	the room is cleaning that red people .
the book was taking that big dentist .	the book was taking those big dentist .
the doors had n't cleaned this yellow child .	the doors had n't cleaned these yellow child .
the ship drops this whole driver .	the ship drops these whole driver .
