the rug is making two fine girls , and this car is making five .	the rug is making two girls , and this car is making five fine .
this car can answer five curious doors , and that cup can answer four .	this car can answer five doors , and that cup can answer four curious .
the spoons might know four careful boats , and these plates might know three .	the spoons might know four boats , and these plates might know three careful .
that box must drop two boring men , and that doll must drop five .	that box must drop two men , and that doll must drop five boring .
the hospital must lift two orange children , and the toy must lift five .	the hospital must lift two children , and the toy must lift five orange .
the dolls appreciate two upset boats , and these beds appreciate five .	the dolls appreciate two boats , and these beds appreciate five upset .
these cars must bother three strong shoes , and these spoons must bother four .	these cars must bother three shoes , and these spoons must bother four strong .
the bag will talk to four excited bottles , and the candle will talk to one .	the bag will talk to four bottles , and the candle will talk to one excited .
this dish has brought two expensive ladies , and the picture has brought three .	this dish has brought two ladies , and the picture has brought three expensive .
the crayon was working with three wrong dolls , and the bank was working with two .	the crayon was working with three dolls , and the bank was working with two wrong .
the fork holds four red girls , and the car holds five .	the fork holds four girls , and the car holds five red .
the crayons bring four white doctors , and the forks bring three .	the crayons bring four doctors , and the forks bring three white .
that library was visiting three curious books , and this spoon was visiting four .	that library was visiting three books , and this spoon was visiting four curious .
this toy was holding three awesome doctors , and that plate was holding five .	this toy was holding three doctors , and that plate was holding five awesome .
those hats could help two happy crayons , and the rings could help three .	those hats could help two crayons , and the rings could help three happy .
the windows have bothered one upset toy , and these cups have bothered two .	the windows have bothered one toy , and these cups have bothered two upset .
that restaurant might steal two orange teachers , and that doll might steal five .	that restaurant might steal two teachers , and that doll might steal five orange .
those boxes were finding two brown teachers , and those dishes were finding four .	those boxes were finding two teachers , and those dishes were finding four brown .
those bowls might appreciate four friendly shoes , and these trucks might appreciate two .	those bowls might appreciate four shoes , and these trucks might appreciate two friendly .
these windows teach five tired dishes , and those buttons teach three .	these windows teach five dishes , and those buttons teach three tired .
those toys understand three hungry dolls , and these bags understand five .	those toys understand three dolls , and these bags understand five hungry .
this window has made five missing men , and the plate has made one .	this window has made five men , and the plate has made one missing .
those rooms had lost one green boy , and these cars had lost two .	those rooms had lost one boy , and these cars had lost two green .
this car had worked with five strong boats , and that hospital had worked with three .	this car had worked with five boats , and that hospital had worked with three strong .
the cars were visiting two happy cups , and those spoons were visiting three .	the cars were visiting two cups , and those spoons were visiting three happy .
this bed had talked to three nice beds , and this window had talked to five .	this bed had talked to three beds , and this window had talked to five nice .
the glass was buying three great ladies , and the spoon was buying four .	the glass was buying three ladies , and the spoon was buying four great .
the car has heard three friendly cars , and that kitchen has heard five .	the car has heard three cars , and that kitchen has heard five friendly .
this museum should find one purple customer , and the car should find three .	this museum should find one customer , and the car should find three purple .
those toys know one smart bag , and the hats know four .	those toys know one bag , and the hats know four smart .
these toys might worry four excited bottles , and the chairs might worry three .	these toys might worry four bottles , and the chairs might worry three excited .
the school is talking to four healthy rooms , and the mirror is talking to two .	the school is talking to four rooms , and the mirror is talking to two healthy .
this bank may hold three fine girls , and that bowl may hold four .	this bank may hold three girls , and that bowl may hold four fine .
those dishes have heard five happy forks , and the pictures have heard four .	those dishes have heard five forks , and the pictures have heard four happy .
the school had heard one quiet rocket , and the box had heard four .	the school had heard one rocket , and the box had heard four quiet .
those bags were finding three green guys , and these bowls were finding two .	those bags were finding three guys , and these bowls were finding two green .
these boxes have talked to two smart schools , and these bags have talked to four .	these boxes have talked to two schools , and these bags have talked to four smart .
this shoe might buy one black woman , and that kitchen might buy two .	this shoe might buy one woman , and that kitchen might buy two black .
the dish is losing five dry women , and that candle is losing one .	the dish is losing five women , and that candle is losing one dry .
the spoon will drop four cool people , and the bicycle will drop two .	the spoon will drop four people , and the bicycle will drop two cool .
that kitchen must answer one strong shirt , and this toy must answer three .	that kitchen must answer one shirt , and this toy must answer three strong .
those trucks must care for three kind pictures , and those candles must care for one .	those trucks must care for three pictures , and those candles must care for one kind .
these trucks help two friendly trucks , and those cars help three .	these trucks help two trucks , and those cars help three friendly .
the hat has lost one cold woman , and that boat has lost five .	the hat has lost one woman , and that boat has lost five cold .
this mirror should clean one cold doctor , and that bank should clean three .	this mirror should clean one doctor , and that bank should clean three cold .
this bag was bothering four surprised bowls , and this bank was bothering five .	this bag was bothering four bowls , and this bank was bothering five surprised .
those bags scare five happy books , and those bottles scare four .	those bags scare five books , and those bottles scare four happy .
the dishes were bothering four bored cars , and those crayons were bothering one .	the dishes were bothering four cars , and those crayons were bothering one bored .
those spoons had confused two sleepy bowls , and these boxes had confused five .	those spoons had confused two bowls , and these boxes had confused five sleepy .
this park should take one cool woman , and the plate should take four .	this park should take one woman , and the plate should take four cool .
this shirt would appreciate one smart school , and that door would appreciate three .	this shirt would appreciate one school , and that door would appreciate three smart .
that window was bothering three friendly shirts , and this restaurant was bothering one .	that window was bothering three shirts , and this restaurant was bothering one friendly .
the bottle makes three blue guys , and this mall makes five .	the bottle makes three guys , and this mall makes five blue .
the rocket is holding two small teachers , and the ring is holding one .	the rocket is holding two teachers , and the ring is holding one small .
the bottles have visited two curious spoons , and the cars have visited four .	the bottles have visited two spoons , and the cars have visited four curious .
those hats bother five helpful shirts , and those spoons bother one .	those hats bother five shirts , and those spoons bother one helpful .
this hat might drop three broken boys , and this couch might drop four .	this hat might drop three boys , and this couch might drop four broken .
those rings might know one wrong truck , and these candles might know four .	those rings might know one truck , and these candles might know four wrong .
that couch has helped four strong shoes , and that picture has helped two .	that couch has helped four shoes , and that picture has helped two strong .
that plane would teach two lucky schools , and that shirt would teach three .	that plane would teach two schools , and that shirt would teach three lucky .
this rocket has bothered five busy bags , and this bowl has bothered two .	this rocket has bothered five bags , and this bowl has bothered two busy .
the books have taken two gray children , and those windows have taken three .	the books have taken two children , and those windows have taken three gray .
the glass would shake two amazing boys , and the truck would shake five .	the glass would shake two boys , and the truck would shake five amazing .
the pictures were cleaning four important men , and these candles were cleaning two .	the pictures were cleaning four men , and these candles were cleaning two important .
the doors answer three friendly windows , and those cars answer five .	the doors answer three windows , and those cars answer five friendly .
that shoe could listen to five excited dolls , and this window could listen to two .	that shoe could listen to five dolls , and this window could listen to two excited .
the picture could clean five amazing teachers , and the fork could clean three .	the picture could clean five teachers , and the fork could clean three amazing .
those plates had made one gray guy , and those dishes had made two .	those plates had made one guy , and those dishes had made two gray .
the car was working with five happy boxes , and the window was working with four .	the car was working with five boxes , and the window was working with four happy .
the crayon is shaking five yellow people , and that boat is shaking four .	the crayon is shaking five people , and that boat is shaking four yellow .
those glasses will understand five confused books , and those boxes will understand two .	those glasses will understand five books , and those boxes will understand two confused .
this doll talks to two careful forks , and this museum talks to one .	this doll talks to two forks , and this museum talks to one careful .
this hat takes two new women , and that car takes four .	this hat takes two women , and that car takes four new .
the dish was moving one boring girl , and the chair was moving four .	the dish was moving one girl , and the chair was moving four boring .
that chair must care for one nice restaurant , and the doll must care for three .	that chair must care for one restaurant , and the doll must care for three nice .
that window is fixing two gray girls , and the spoon is fixing five .	that window is fixing two girls , and the spoon is fixing five gray .
these schools may visit five gentle candles , and these shoes may visit one .	these schools may visit five candles , and these shoes may visit one gentle .
that candle could hear three strong glasses , and the chair could hear two .	that candle could hear three glasses , and the chair could hear two strong .
those beds have one gray dentist , and the forks have five .	those beds have one dentist , and the forks have five gray .
the shirts will understand five happy candles , and those bowls will understand four .	the shirts will understand five candles , and those bowls will understand four happy .
this bag should hear one upset hat , and this ship should hear five .	this bag should hear one hat , and this ship should hear five upset .
this bottle must hold five broken boys , and that room must hold two .	this bottle must hold five boys , and that room must hold two broken .
these toys shake three orange doctors , and the doors shake four .	these toys shake three doctors , and the doors shake four orange .
the shoes are helping three healthy rings , and the bottles are helping two .	the shoes are helping three rings , and the bottles are helping two healthy .
that bank had heard two healthy forks , and that bank had heard one .	that bank had heard two forks , and that bank had heard one healthy .
the mall understands three helpful bottles , and the library understands four .	the mall understands three bottles , and the library understands four helpful .
those boats had kept two gray girls , and the buttons had kept one .	those boats had kept two girls , and the buttons had kept one gray .
those beds praise two helpful buttons , and the spoons praise five .	those beds praise two buttons , and the spoons praise five helpful .
the doors have taken three new guys , and those windows have taken four .	the doors have taken three guys , and those windows have taken four new .
those dolls were teaching one bored restaurant , and these hats were teaching four .	those dolls were teaching one restaurant , and these hats were teaching four bored .
that bowl shakes five cold boys , and that rocket shakes one .	that bowl shakes five boys , and that rocket shakes one cold .
the mirror had confused one quiet bottle , and the bank had confused three .	the mirror had confused one bottle , and the bank had confused three quiet .
the school must bother two kind forks , and the school must bother one .	the school must bother two forks , and the school must bother one kind .
this plane scares one confused car , and this bottle scares two .	this plane scares one car , and this bottle scares two confused .
the book will visit two tall beds , and that bag will visit four .	the book will visit two beds , and that bag will visit four tall .
the window has found three blue boys , and this fork has found five .	the window has found three boys , and this fork has found five blue .
those spoons were losing five whole girls , and those books were losing two .	those spoons were losing five girls , and those books were losing two whole .
the rug is finding one cold woman , and the rug is finding five .	the rug is finding one woman , and the rug is finding five cold .
that glass had heard four helpful windows , and that bank had heard five .	that glass had heard four windows , and that bank had heard five helpful .
the schools would bother three happy doors , and these toys would bother five .	the schools would bother three doors , and these toys would bother five happy .
that fork had answered four careful bottles , and this picture had answered one .	that fork had answered four bottles , and this picture had answered one careful .
this bottle must talk to two curious trucks , and that room must talk to one .	this bottle must talk to two trucks , and that room must talk to one curious .
these bottles hear two wrong bowls , and the glasses hear four .	these bottles hear two bowls , and the glasses hear four wrong .
that mirror should move one cool queen , and this plane should move two .	that mirror should move one queen , and this plane should move two cool .
that mirror should lose one fine lady , and that ship should lose three .	that mirror should lose one lady , and that ship should lose three fine .
the mall will keep five big people , and that plane will keep four .	the mall will keep five people , and that plane will keep four big .
that bank was working with three friendly cars , and that dish was working with one .	that bank was working with three cars , and that dish was working with one friendly .
the spoons have worked with one young restaurant , and the bags have worked with four .	the spoons have worked with one restaurant , and the bags have worked with four young .
this spoon may answer one bored book , and this toy may answer four .	this spoon may answer one book , and this toy may answer four bored .
these schools can talk to five boring glasses , and these forks can talk to one .	these schools can talk to five glasses , and these forks can talk to one boring .
this candle can listen to five young schools , and that shirt can listen to four .	this candle can listen to five schools , and that shirt can listen to four young .
this school is taking two red doctors , and that toy is taking five .	this school is taking two doctors , and that toy is taking five red .
the doll will listen to two busy plates , and the kitchen will listen to three .	the doll will listen to two plates , and the kitchen will listen to three busy .
that crayon was holding one whole dancer , and the museum was holding four .	that crayon was holding one dancer , and the museum was holding four whole .
the bags might care for five angry dolls , and those boxes might care for three .	the bags might care for five dolls , and those boxes might care for three angry .
this hat is visiting five young books , and this school is visiting one .	this hat is visiting five books , and this school is visiting one young .
this chair was bothering five bored trucks , and the bag was bothering three .	this chair was bothering five trucks , and the bag was bothering three bored .
this car would buy one red person , and this toy would buy three .	this car would buy one person , and this toy would buy three red .
the chair had fixed one old woman , and that toy had fixed three .	the chair had fixed one woman , and that toy had fixed three old .
these cars were fixing one purple man , and those books were fixing four .	these cars were fixing one man , and those books were fixing four purple .
the bags had heard one wrong crayon , and the candles had heard five .	the bags had heard one crayon , and the candles had heard five wrong .
that museum may lose two awesome girls , and that boat may lose three .	that museum may lose two girls , and that boat may lose three awesome .
that book makes three blue women , and that school makes four .	that book makes three women , and that school makes four blue .
the rooms are talking to four helpful toys , and those books are talking to five .	the rooms are talking to four toys , and those books are talking to five helpful .
this toy was helping one strong rug , and the picture was helping two .	this toy was helping one rug , and the picture was helping two strong .
this restaurant works with three upset spoons , and the museum works with four .	this restaurant works with three spoons , and the museum works with four upset .
the books have helped five confused schools , and these hats have helped one .	the books have helped five schools , and these hats have helped one confused .
that candle helps four wrong dishes , and this bowl helps two .	that candle helps four dishes , and this bowl helps two wrong .
this plane knows five lucky doors , and this bicycle knows four .	this plane knows five doors , and this bicycle knows four lucky .
that bicycle had talked to one important couch , and that dish had talked to three .	that bicycle had talked to one couch , and that dish had talked to three important .
that toy was listening to two strong bowls , and this book was listening to five .	that toy was listening to two bowls , and this book was listening to five strong .
this shoe takes five purple women , and the hat takes one .	this shoe takes five women , and the hat takes one purple .
this crayon must know five healthy crayons , and that plane must know three .	this crayon must know five crayons , and that plane must know three healthy .
this bottle must appreciate one excited crayon , and the boat must appreciate two .	this bottle must appreciate one crayon , and the boat must appreciate two excited .
the bank may listen to one strong book , and the bag may listen to five .	the bank may listen to one book , and the bag may listen to five strong .
the couch could lose three red boys , and this plate could lose one .	the couch could lose three boys , and this plate could lose one red .
the hat had confused four lucky bottles , and that rocket had confused three .	the hat had confused four bottles , and that rocket had confused three lucky .
those books visit two hungry boats , and those cars visit four .	those books visit two boats , and those cars visit four hungry .
this library has two old men , and the shoe has one .	this library has two men , and the shoe has one old .
this toy will work with five careful candles , and that mirror will work with two .	this toy will work with five candles , and that mirror will work with two careful .
that bank had held three great ladies , and that hat had held one .	that bank had held three ladies , and that hat had held one great .
these doors might bother three gentle plates , and the shirts might bother two .	these doors might bother three plates , and the shirts might bother two gentle .
this doll has thrown five boring boys , and this shirt has thrown three .	this doll has thrown five boys , and this shirt has thrown three boring .
the mirror is making one big dentist , and this library is making five .	the mirror is making one dentist , and this library is making five big .
these hats had found one wrong box , and the pictures had found five .	these hats had found one box , and the pictures had found five wrong .
that bed would visit one hungry bottle , and that ship would visit two .	that bed would visit one bottle , and that ship would visit two hungry .
the bottles had bothered five smart forks , and those doors had bothered three .	the bottles had bothered five forks , and those doors had bothered three smart .
this hat will keep three black people , and that room will keep four .	this hat will keep three people , and that room will keep four black .
that bicycle can bother two bored hats , and this bank can bother five .	that bicycle can bother two hats , and this bank can bother five bored .
this book is bringing five red men , and the toy is bringing one .	this book is bringing five men , and the toy is bringing one red .
that school talks to four bored bags , and that hat talks to one .	that school talks to four bags , and that hat talks to one bored .
these chairs bring three cold girls , and those plates bring two .	these chairs bring three girls , and those plates bring two cold .
the crayons had worried two curious spoons , and the books had worried one .	the crayons had worried two spoons , and the books had worried one curious .
this doll could hear one quiet rocket , and the fork could hear four .	this doll could hear one rocket , and the fork could hear four quiet .
these plates have taught five healthy candles , and the bags have taught two .	these plates have taught five candles , and the bags have taught two healthy .
those cups lift one hot doctor , and those cars lift four .	those cups lift one doctor , and those cars lift four hot .
that plate takes one cool king , and that library takes four .	that plate takes one king , and that library takes four cool .
that restaurant is dropping one whole queen , and this crayon is dropping five .	that restaurant is dropping one queen , and this crayon is dropping five whole .
those schools praise five upset plates , and those books praise two .	those schools praise five plates , and those books praise two upset .
the couch has lost one boring queen , and that shoe has lost three .	the couch has lost one queen , and that shoe has lost three boring .
this toy has confused two bored pictures , and that truck has confused five .	this toy has confused two pictures , and that truck has confused five bored .
those chairs must know one tired room , and those shoes must know three .	those chairs must know one room , and those shoes must know three tired .
the hats will scare three upset toys , and those cars will scare four .	the hats will scare three toys , and those cars will scare four upset .
that bicycle is bothering one angry couch , and the spoon is bothering two .	that bicycle is bothering one couch , and the spoon is bothering two angry .
those rooms are buying five purple doctors , and the books are buying three .	those rooms are buying five doctors , and the books are buying three purple .
this car moves one great guy , and the toy moves three .	this car moves one guy , and the toy moves three great .
the bowl has scared four young bags , and that school has scared three .	the bowl has scared four bags , and that school has scared three young .
those pictures may clean three fine women , and those shirts may clean two .	those pictures may clean three women , and those shirts may clean two fine .
the doors clean four green teachers , and these trucks clean two .	the doors clean four teachers , and these trucks clean two green .
this ship hears one surprised mirror , and this dish hears two .	this ship hears one mirror , and this dish hears two surprised .
the boxes lift five green girls , and those boxes lift three .	the boxes lift five girls , and those boxes lift three green .
the bed had kept two missing women , and the couch had kept three .	the bed had kept two women , and the couch had kept three missing .
this candle is fixing one big girl , and this kitchen is fixing five .	this candle is fixing one girl , and this kitchen is fixing five big .
this door might keep five green guys , and this room might keep two .	this door might keep five guys , and this room might keep two green .
these forks have heard four bored buttons , and the dolls have heard two .	these forks have heard four buttons , and the dolls have heard two bored .
this glass brings two awesome men , and that door brings three .	this glass brings two men , and that door brings three awesome .
that school hears two important crayons , and that candle hears three .	that school hears two crayons , and that candle hears three important .
the bottles will hold one cute patient , and the candles will hold five .	the bottles will hold one patient , and the candles will hold five cute .
these bottles visit three surprised bottles , and those cups visit five .	these bottles visit three bottles , and those cups visit five surprised .
those cars have visited two important boxes , and the buttons have visited five .	those cars have visited two boxes , and the buttons have visited five important .
the shoe hears three smart rooms , and that dish hears five .	the shoe hears three rooms , and that dish hears five smart .
that shirt understands three nice bags , and this cup understands one .	that shirt understands three bags , and this cup understands one nice .
that crayon holds two dry doctors , and this book holds one .	that crayon holds two doctors , and this book holds one dry .
the hospital had heard two happy boats , and that cup had heard four .	the hospital had heard two boats , and that cup had heard four happy .
this car was buying three missing guys , and this window was buying four .	this car was buying three guys , and this window was buying four missing .
those glasses steal four orange doctors , and these schools steal three .	those glasses steal four doctors , and these schools steal three orange .
those beds have answered two angry bowls , and the schools have answered one .	those beds have answered two bowls , and the schools have answered one angry .
this hat has confused two tall bowls , and the bed has confused three .	this hat has confused two bowls , and the bed has confused three tall .
the picture must know four curious buttons , and this school must know five .	the picture must know four buttons , and this school must know five curious .
this door can care for two upset bowls , and this book can care for one .	this door can care for two bowls , and this book can care for one upset .
the shirt has visited five clever bowls , and this couch has visited four .	the shirt has visited five bowls , and this couch has visited four clever .
this crayon was visiting one careful park , and the bed was visiting two .	this crayon was visiting one park , and the bed was visiting two careful .
the buttons teach three nice books , and the books teach two .	the buttons teach three books , and the books teach two nice .
the bottle should answer four happy books , and this chair should answer five .	the bottle should answer four books , and this chair should answer five happy .
the plates make five green guys , and these hats make two .	the plates make five guys , and these hats make two green .
that box has bought four cool people , and that bottle has bought two .	that box has bought four people , and that bottle has bought two cool .
this boat shakes four important people , and this boat shakes one .	this boat shakes four people , and this boat shakes one important .
that hospital is buying one yellow man , and this crayon is buying five .	that hospital is buying one man , and this crayon is buying five yellow .
the schools are talking to one important picture , and these chairs are talking to five .	the schools are talking to one picture , and these chairs are talking to five important .
this button may talk to two happy windows , and that shirt may talk to three .	this button may talk to two windows , and that shirt may talk to three happy .
the candle can know four confused glasses , and that cup can know five .	the candle can know four glasses , and that cup can know five confused .
this plane had taught five nice shirts , and the bag had taught four .	this plane had taught five shirts , and the bag had taught four nice .
those chairs may talk to two gentle candles , and the toys may talk to five .	those chairs may talk to two candles , and the toys may talk to five gentle .
this car may hear one happy shirt , and the crayon may hear two .	this car may hear one shirt , and the crayon may hear two happy .
that bicycle has bothered one strong toy , and that car has bothered three .	that bicycle has bothered one toy , and that car has bothered three strong .
these candles were teaching three young hats , and the chairs were teaching two .	these candles were teaching three hats , and the chairs were teaching two young .
the cup has found five awesome girls , and this box has found two .	the cup has found five girls , and this box has found two awesome .
the spoons had heard three wrong beds , and those rings had heard four .	the spoons had heard three beds , and those rings had heard four wrong .
this fork is throwing one red patient , and the bag is throwing five .	this fork is throwing one patient , and the bag is throwing five red .
that box has held one orange driver , and this hat has held five .	that box has held one driver , and this hat has held five orange .
that book knows one strong hat , and that plate knows five .	that book knows one hat , and that plate knows five strong .
the crayon brings four orange children , and that shirt brings two .	the crayon brings four children , and that shirt brings two orange .
that hat works with one important car , and the book works with four .	that hat works with one car , and the book works with four important .
these bags bother one important truck , and these cars bother four .	these bags bother one truck , and these cars bother four important .
the bottle is listening to one boring doll , and that plane is listening to four .	the bottle is listening to one doll , and that plane is listening to four boring .
that window had lost two tired cups , and this candle had lost four .	that window had lost two cups , and this candle had lost four tired .
that shirt should teach one healthy shirt , and this button should teach three .	that shirt should teach one shirt , and this button should teach three healthy .
the window was finding five cool people , and the fork was finding one .	the window was finding five people , and the fork was finding one cool .
that doll helps five careful trucks , and this cup helps four .	that doll helps five trucks , and this cup helps four careful .
that mall is teaching five friendly beds , and the bag is teaching four .	that mall is teaching five beds , and the bag is teaching four friendly .
this book knows two important cars , and that shoe knows one .	this book knows two cars , and that shoe knows one important .
these cups may have three great doctors , and those glasses may have two .	these cups may have three doctors , and those glasses may have two great .
that bag moves two orange girls , and this ring moves one .	that bag moves two girls , and this ring moves one orange .
the cups will scare five quiet boxes , and those rings will scare four .	the cups will scare five boxes , and those rings will scare four quiet .
those shirts hear two smart boats , and the dishes hear five .	those shirts hear two boats , and the dishes hear five smart .
these cars bother two tired chairs , and those shirts bother five .	these cars bother two chairs , and those shirts bother five tired .
the doll is bothering four nice shirts , and that door is bothering two .	the doll is bothering four shirts , and that door is bothering two nice .
this chair could make two fine teachers , and this kitchen could make one .	this chair could make two teachers , and this kitchen could make one fine .
these rooms would understand three surprised shoes , and the cars would understand two .	these rooms would understand three shoes , and the cars would understand two surprised .
the couch has moved one awesome girl , and the mall has moved four .	the couch has moved one girl , and the mall has moved four awesome .
the car is losing two cold doctors , and the toy is losing three .	the car is losing two doctors , and the toy is losing three cold .
the windows are bothering four nice plates , and these plates are bothering one .	the windows are bothering four plates , and these plates are bothering one nice .
those cars must take one black dancer , and these boxes must take three .	those cars must take one dancer , and these boxes must take three black .
the couch scares one surprised crayon , and the toy scares three .	the couch scares one crayon , and the toy scares three surprised .
these toys have found one upset spoon , and these plates have found three .	these toys have found one spoon , and these plates have found three upset .
the candles had cleaned four brown people , and the glasses had cleaned one .	the candles had cleaned four people , and the glasses had cleaned one brown .
the windows would lose four cool ladies , and these glasses would lose two .	the windows would lose four ladies , and these glasses would lose two cool .
the bed has cleaned five new children , and the kitchen has cleaned one .	the bed has cleaned five children , and the kitchen has cleaned one new .
that restaurant must work with two clever candles , and this room must work with one .	that restaurant must work with two candles , and this room must work with one clever .
these rooms are working with four young boxes , and the shirts are working with two .	these rooms are working with four boxes , and the shirts are working with two young .
those beds hear two busy schools , and those cups hear five .	those beds hear two schools , and those cups hear five busy .
the spoon can lift five cute teachers , and the room can lift three .	the spoon can lift five teachers , and the room can lift three cute .
that restaurant understands three busy toys , and the kitchen understands two .	that restaurant understands three toys , and the kitchen understands two busy .
that bank could help one tall cup , and that library could help five .	that bank could help one cup , and that library could help five tall .
this spoon could keep three amazing children , and that bicycle could keep one .	this spoon could keep three children , and that bicycle could keep one amazing .
this fork is visiting four bored dolls , and this mirror is visiting one .	this fork is visiting four dolls , and this mirror is visiting one bored .
the box is taking one white customer , and the boat is taking two .	the box is taking one customer , and the boat is taking two white .
the mirror might work with four gentle forks , and this bed might work with five .	the mirror might work with four forks , and this bed might work with five gentle .
this button would visit four busy cups , and the book would visit five .	this button would visit four cups , and the book would visit five busy .
the picture understands one helpful cup , and that shoe understands five .	the picture understands one cup , and that shoe understands five helpful .
the library has lost one hungry restaurant , and this toy has lost two .	the library has lost one restaurant , and this toy has lost two hungry .
this picture had taken three green doctors , and this bed had taken five .	this picture had taken three doctors , and this bed had taken five green .
that bed had taught one happy boat , and that school had taught two .	that bed had taught one boat , and that school had taught two happy .
that picture is working with five nice shirts , and the picture is working with three .	that picture is working with five shirts , and the picture is working with three nice .
that box scares one quiet fork , and the museum scares two .	that box scares one fork , and the museum scares two quiet .
this couch had brought one purple customer , and this bowl had brought two .	this couch had brought one customer , and this bowl had brought two purple .
the shirt can work with two hungry dolls , and the cup can work with three .	the shirt can work with two dolls , and the cup can work with three hungry .
this fork can hear three wrong bowls , and this picture can hear four .	this fork can hear three bowls , and this picture can hear four wrong .
the rocket has taught four bored plates , and the ship has taught three .	the rocket has taught four plates , and the ship has taught three bored .
that park has bothered one boring spoon , and the fork has bothered five .	that park has bothered one spoon , and the fork has bothered five boring .
these cars had found three yellow guys , and those boxes had found four .	these cars had found three guys , and those boxes had found four yellow .
these buttons appreciate one smart bank , and those cars appreciate three .	these buttons appreciate one bank , and those cars appreciate three smart .
this toy is teaching five angry forks , and this book is teaching two .	this toy is teaching five forks , and this book is teaching two angry .
that car can listen to one gentle picture , and this car can listen to two .	that car can listen to one picture , and this car can listen to two gentle .
those rings are bothering three angry cars , and these toys are bothering two .	those rings are bothering three cars , and these toys are bothering two angry .
that bottle had worked with one tall restaurant , and this picture had worked with three .	that bottle had worked with one restaurant , and this picture had worked with three tall .
the chair was helping one gentle ring , and the mirror was helping three .	the chair was helping one ring , and the mirror was helping three gentle .
the cups are working with three wrong pictures , and those dolls are working with one .	the cups are working with three pictures , and those dolls are working with one wrong .
the mirror is talking to three surprised boxes , and that room is talking to two .	the mirror is talking to three boxes , and that room is talking to two surprised .
these dolls must teach one confused chair , and the boats must teach two .	these dolls must teach one chair , and the boats must teach two confused .
that doll hears four helpful bottles , and the museum hears one .	that doll hears four bottles , and the museum hears one helpful .
this mirror keeps three great boys , and that boat keeps two .	this mirror keeps three boys , and that boat keeps two great .
the school was throwing two cute boys , and that bowl was throwing four .	the school was throwing two boys , and that bowl was throwing four cute .
these dishes should lift one white queen , and those trucks should lift four .	these dishes should lift one queen , and those trucks should lift four white .
this dish has taught four strong cars , and the boat has taught three .	this dish has taught four cars , and the boat has taught three strong .
those toys are listening to two nice chairs , and those bags are listening to five .	those toys are listening to two chairs , and those bags are listening to five nice .
the rings throw five broken teachers , and the rooms throw three .	the rings throw five teachers , and the rooms throw three broken .
that car moves two brown people , and the ship moves four .	that car moves two people , and the ship moves four brown .
that museum should take five boring teachers , and this picture should take three .	that museum should take five teachers , and this picture should take three boring .
the rug makes one dry king , and this restaurant makes two .	the rug makes one king , and this restaurant makes two dry .
that mall has helped five bored books , and the hat has helped one .	that mall has helped five books , and the hat has helped one bored .
these boats have five old guys , and those books have three .	these boats have five guys , and those books have three old .
that door might help four confused trucks , and the spoon might help three .	that door might help four trucks , and the spoon might help three confused .
the school might worry five busy rooms , and this plate might worry two .	the school might worry five rooms , and this plate might worry two busy .
the couch was losing one new king , and the hat was losing three .	the couch was losing one king , and the hat was losing three new .
this bottle has made two new teachers , and this ship has made four .	this bottle has made two teachers , and this ship has made four new .
these cars clean three big teachers , and these pictures clean five .	these cars clean three teachers , and these pictures clean five big .
that ring was visiting two quiet boats , and that park was visiting four .	that ring was visiting two boats , and that park was visiting four quiet .
those hats were cleaning one white girl , and the toys were cleaning two .	those hats were cleaning one girl , and the toys were cleaning two white .
the library had visited one bored dish , and that toy had visited four .	the library had visited one dish , and that toy had visited four bored .
this hospital had thrown two red men , and that plate had thrown four .	this hospital had thrown two men , and that plate had thrown four red .
the crayons care for three wrong shirts , and those shoes care for two .	the crayons care for three shirts , and those shoes care for two wrong .
this doll might understand four nice boxes , and this toy might understand two .	this doll might understand four boxes , and this toy might understand two nice .
this library had visited five sleepy buttons , and the spoon had visited four .	this library had visited five buttons , and the spoon had visited four sleepy .
this rug might steal one old teacher , and that kitchen might steal four .	this rug might steal one teacher , and that kitchen might steal four old .
the forks can bring one amazing lady , and those boats can bring two .	the forks can bring one lady , and those boats can bring two amazing .
the chairs could fix four yellow people , and those bottles could fix one .	the chairs could fix four people , and those bottles could fix one yellow .
these boxes have four blue women , and these hats have two .	these boxes have four women , and these hats have two blue .
the cars had bought two missing girls , and those pictures had bought one .	the cars had bought two girls , and those pictures had bought one missing .
the plates should understand two healthy cups , and those cars should understand one .	the plates should understand two cups , and those cars should understand one healthy .
this picture might teach five nice bowls , and that ship might teach two .	this picture might teach five bowls , and that ship might teach two nice .
the school has one big customer , and that car has four .	the school has one customer , and that car has four big .
this toy takes three brown children , and this bed takes one .	this toy takes three children , and this bed takes one brown .
the shoe works with five busy cars , and this bicycle works with two .	the shoe works with five cars , and this bicycle works with two busy .
that ring can care for two sleepy plates , and that bank can care for four .	that ring can care for two plates , and that bank can care for four sleepy .
those chairs had talked to five clever candles , and those bags had talked to four .	those chairs had talked to five candles , and those bags had talked to four clever .
that picture has dropped two amazing men , and that boat has dropped five .	that picture has dropped two men , and that boat has dropped five amazing .
the books bother two surprised buttons , and these books bother four .	the books bother two buttons , and these books bother four surprised .
those dolls have kept five dry men , and these dishes have kept two .	those dolls have kept five men , and these dishes have kept two dry .
the rings have cleaned two brown boys , and those crayons have cleaned five .	the rings have cleaned two boys , and those crayons have cleaned five brown .
the book would care for four boring bottles , and the room would care for five .	the book would care for four bottles , and the room would care for five boring .
the pictures bring five black women , and the doors bring four .	the pictures bring five women , and the doors bring four black .
these trucks are losing three cute women , and these plates are losing one .	these trucks are losing three women , and these plates are losing one cute .
the book will teach four friendly windows , and this dish will teach three .	the book will teach four windows , and this dish will teach three friendly .
that car is teaching four important boats , and this chair is teaching one .	that car is teaching four boats , and this chair is teaching one important .
those candles can know four angry cars , and the windows can know one .	those candles can know four cars , and the windows can know one angry .
this kitchen is teaching three busy plates , and the glass is teaching two .	this kitchen is teaching three plates , and the glass is teaching two busy .
the rug had scared one smart picture , and this button had scared three .	the rug had scared one picture , and this button had scared three smart .
this picture had cleaned two black ladies , and the bed had cleaned one .	this picture had cleaned two ladies , and the bed had cleaned one black .
the box could hear three tired cups , and this bottle could hear two .	the box could hear three cups , and this bottle could hear two tired .
that rug had moved two dry women , and the spoon had moved three .	that rug had moved two women , and the spoon had moved three dry .
that crayon could clean four small doctors , and the room could clean two .	that crayon could clean four doctors , and the room could clean two small .
the couch had answered one strong couch , and that ring had answered five .	the couch had answered one couch , and that ring had answered five strong .
those chairs could hear four clever books , and those schools could hear one .	those chairs could hear four books , and those schools could hear one clever .
that book had helped one wrong shirt , and that shirt had helped five .	that book had helped one shirt , and that shirt had helped five wrong .
that restaurant is holding four red teachers , and the glass is holding two .	that restaurant is holding four teachers , and the glass is holding two red .
the picture could steal two red guys , and this bowl could steal three .	the picture could steal two guys , and this bowl could steal three red .
those books might make three great girls , and these dolls might make five .	those books might make three girls , and these dolls might make five great .
the bed could scare two strong beds , and that truck could scare one .	the bed could scare two beds , and that truck could scare one strong .
these rooms had lost one sleepy picture , and the forks had lost four .	these rooms had lost one picture , and the forks had lost four sleepy .
this ship has found three amazing children , and that dish has found five .	this ship has found three children , and that dish has found five amazing .
these hats scare one friendly park , and these boxes scare four .	these hats scare one park , and these boxes scare four friendly .
this kitchen works with five helpful chairs , and that rug works with four .	this kitchen works with five chairs , and that rug works with four helpful .
the candle has moved one black doctor , and that ship has moved four .	the candle has moved one doctor , and that ship has moved four black .
the boats praise three young chairs , and the bags praise two .	the boats praise three chairs , and the bags praise two young .
this hat could lift five expensive doctors , and the kitchen could lift three .	this hat could lift five doctors , and the kitchen could lift three expensive .
these windows would worry five helpful shirts , and the books would worry four .	these windows would worry five shirts , and the books would worry four helpful .
this shirt drops five old women , and this bicycle drops three .	this shirt drops five women , and this bicycle drops three old .
the dish would praise two excited schools , and that chair would praise three .	the dish would praise two schools , and that chair would praise three excited .
the bag talks to one important bank , and that book talks to five .	the bag talks to one bank , and that book talks to five important .
this spoon was bringing one white patient , and the toy was bringing three .	this spoon was bringing one patient , and the toy was bringing three white .
that chair knows three quiet hats , and that bicycle knows one .	that chair knows three hats , and that bicycle knows one quiet .
the shirts have heard two young rings , and those cars have heard four .	the shirts have heard two rings , and those cars have heard four young .
those plates can steal one orange child , and these rooms can steal two .	those plates can steal one child , and these rooms can steal two orange .
that button had brought one brown person , and that bottle had brought five .	that button had brought one person , and that bottle had brought five brown .
the couch should scare three clever boxes , and this plane should scare four .	the couch should scare three boxes , and this plane should scare four clever .
the cars had bothered three busy glasses , and those schools had bothered four .	the cars had bothered three glasses , and those schools had bothered four busy .
that candle had dropped five new boys , and this door had dropped two .	that candle had dropped five boys , and this door had dropped two new .
the boxes are bothering one helpful bowl , and the boats are bothering four .	the boxes are bothering one bowl , and the boats are bothering four helpful .
this hospital has answered three curious beds , and this ship has answered one .	this hospital has answered three beds , and this ship has answered one curious .
those shoes might bring two broken ladies , and the boats might bring five .	those shoes might bring two ladies , and the boats might bring five broken .
this mirror would worry two tired bags , and that plane would worry three .	this mirror would worry two bags , and that plane would worry three tired .
that shoe had found five old ladies , and this candle had found three .	that shoe had found five ladies , and this candle had found three old .
that window has heard two important dishes , and the park has heard five .	that window has heard two dishes , and the park has heard five important .
the rooms had visited four angry doors , and the beds had visited one .	the rooms had visited four doors , and the beds had visited one angry .
this bag could talk to one bored bank , and this bag could talk to two .	this bag could talk to one bank , and this bag could talk to two bored .
the glasses could take five fine girls , and those candles could take two .	the glasses could take five girls , and those candles could take two fine .
the bowl had lost four kind pictures , and the rocket had lost five .	the bowl had lost four pictures , and the rocket had lost five kind .
that kitchen works with one sleepy bottle , and the glass works with four .	that kitchen works with one bottle , and the glass works with four sleepy .
this truck drops one yellow boy , and that chair drops five .	this truck drops one boy , and that chair drops five yellow .
the doll is taking one gray person , and that bed is taking five .	the doll is taking one person , and that bed is taking five gray .
the fork has heard five careful windows , and the dish has heard two .	the fork has heard five windows , and the dish has heard two careful .
that doll is fixing three black guys , and that mirror is fixing four .	that doll is fixing three guys , and that mirror is fixing four black .
that car is dropping five expensive women , and this library is dropping three .	that car is dropping five women , and this library is dropping three expensive .
those trucks had talked to two young bags , and these boats had talked to five .	those trucks had talked to two bags , and these boats had talked to five young .
this picture will move one big man , and the button will move three .	this picture will move one man , and the button will move three big .
this hospital had bought five expensive men , and this ring had bought two .	this hospital had bought five men , and this ring had bought two expensive .
this museum was working with four quiet cars , and that car was working with three .	this museum was working with four cars , and that car was working with three quiet .
this shoe must praise four friendly buttons , and that mirror must praise two .	this shoe must praise four buttons , and that mirror must praise two friendly .
those boxes praise two bored doors , and the doors praise five .	those boxes praise two doors , and the doors praise five bored .
this shirt had lost four quiet boats , and the bed had lost one .	this shirt had lost four boats , and the bed had lost one quiet .
the rooms could listen to one busy truck , and the crayons could listen to two .	the rooms could listen to one truck , and the crayons could listen to two busy .
those plates had worked with four careful cars , and those crayons had worked with three .	those plates had worked with four cars , and those crayons had worked with three careful .
those rooms should hear one friendly mall , and these doors should hear five .	those rooms should hear one mall , and these doors should hear five friendly .
that bicycle would hear two smart doors , and the room would hear five .	that bicycle would hear two doors , and the room would hear five smart .
that library should hear four wrong shoes , and this ship should hear three .	that library should hear four shoes , and this ship should hear three wrong .
the plane has thrown two blue teachers , and the ship has thrown three .	the plane has thrown two teachers , and the ship has thrown three blue .
this picture should visit three angry buttons , and the book should visit five .	this picture should visit three buttons , and the book should visit five angry .
those cars scare two sleepy dishes , and those cups scare four .	those cars scare two dishes , and those cups scare four sleepy .
the shirts had talked to two tall windows , and those shirts had talked to four .	the shirts had talked to two windows , and those shirts had talked to four tall .
the shoes will know two young beds , and these toys will know four .	the shoes will know two beds , and these toys will know four young .
this bag was visiting one young mirror , and this bed was visiting three .	this bag was visiting one mirror , and this bed was visiting three young .
those plates have taught one surprised doll , and the shirts have taught two .	those plates have taught one doll , and the shirts have taught two surprised .
this glass has held one white woman , and the school has held four .	this glass has held one woman , and the school has held four white .
this ship knows four tall spoons , and this hospital knows three .	this ship knows four spoons , and this hospital knows three tall .
that shirt is fixing one awesome child , and that bank is fixing three .	that shirt is fixing one child , and that bank is fixing three awesome .
that bicycle has moved one red woman , and this candle has moved two .	that bicycle has moved one woman , and this candle has moved two red .
the school helps two upset forks , and this park helps three .	the school helps two forks , and this park helps three upset .
the hat can keep five awesome men , and the shirt can keep three .	the hat can keep five men , and the shirt can keep three awesome .
this kitchen can buy two red men , and the truck can buy three .	this kitchen can buy two men , and the truck can buy three red .
the mall has worked with five young glasses , and that rug has worked with one .	the mall has worked with five glasses , and that rug has worked with one young .
the doors lift three whole ladies , and these rings lift five .	the doors lift three ladies , and these rings lift five whole .
those rooms teach two nice toys , and these forks teach four .	those rooms teach two toys , and these forks teach four nice .
this truck should bring four great girls , and that museum should bring two .	this truck should bring four girls , and that museum should bring two great .
that book may bother two boring toys , and that library may bother three .	that book may bother two toys , and that library may bother three boring .
these cars praise three tired beds , and the toys praise one .	these cars praise three beds , and the toys praise one tired .
this rug had brought five cool women , and that box had brought one .	this rug had brought five women , and that box had brought one cool .
those rings may keep one missing patient , and those cups may keep four .	those rings may keep one patient , and those cups may keep four missing .
the couch is talking to two kind rings , and this boat is talking to one .	the couch is talking to two rings , and this boat is talking to one kind .
these pictures bother five happy windows , and the doors bother three .	these pictures bother five windows , and the doors bother three happy .
these plates keep three dry boys , and those windows keep one .	these plates keep three boys , and those windows keep one dry .
this room is taking four yellow women , and this shoe is taking two .	this room is taking four women , and this shoe is taking two yellow .
the shirt had lost four old boys , and the cup had lost five .	the shirt had lost four boys , and the cup had lost five old .
the cars had worked with five helpful windows , and the dishes had worked with three .	the cars had worked with five windows , and the dishes had worked with three helpful .
those boats help two tired cars , and the trucks help four .	those boats help two cars , and the trucks help four tired .
the book had heard five gentle spoons , and that mall had heard three .	the book had heard five spoons , and that mall had heard three gentle .
those chairs may know one tired picture , and the glasses may know three .	those chairs may know one picture , and the glasses may know three tired .
the bowl had bought two new guys , and that library had bought three .	the bowl had bought two guys , and that library had bought three new .
this dish is talking to four wrong doors , and this spoon is talking to two .	this dish is talking to four doors , and this spoon is talking to two wrong .
this plane should visit four happy books , and the kitchen should visit three .	this plane should visit four books , and the kitchen should visit three happy .
those cars had answered three tall bags , and those pictures had answered two .	those cars had answered three bags , and those pictures had answered two tall .
this truck might listen to three friendly bowls , and this bag might listen to five .	this truck might listen to three bowls , and this bag might listen to five friendly .
those chairs work with two confused dishes , and those trucks work with three .	those chairs work with two dishes , and those trucks work with three confused .
these rooms answer four curious rooms , and these buttons answer five .	these rooms answer four rooms , and these buttons answer five curious .
the mirror might scare one smart hat , and the hat might scare five .	the mirror might scare one hat , and the hat might scare five smart .
that cup can praise four smart windows , and this candle can praise two .	that cup can praise four windows , and this candle can praise two smart .
those glasses have answered five smart bowls , and the shoes have answered three .	those glasses have answered five bowls , and the shoes have answered three smart .
that boat is keeping two gray women , and that room is keeping one .	that boat is keeping two women , and that room is keeping one gray .
this bowl knows one friendly bicycle , and that school knows five .	this bowl knows one bicycle , and that school knows five friendly .
this fork was finding five small doctors , and this car was finding two .	this fork was finding five doctors , and this car was finding two small .
those windows could have four missing ladies , and these books could have one .	those windows could have four ladies , and these books could have one missing .
these spoons steal three new guys , and those schools steal one .	these spoons steal three guys , and those schools steal one new .
that museum has visited one smart hat , and the boat has visited five .	that museum has visited one hat , and the boat has visited five smart .
the museum knows three hungry hats , and this boat knows four .	the museum knows three hats , and this boat knows four hungry .
the hat is shaking one small teacher , and this fork is shaking four .	the hat is shaking one teacher , and this fork is shaking four small .
this box had worried two boring beds , and the shoe had worried five .	this box had worried two beds , and the shoe had worried five boring .
the kitchen knows three young pictures , and this bank knows five .	the kitchen knows three pictures , and this bank knows five young .
the mall moves two cool girls , and that cup moves one .	the mall moves two girls , and that cup moves one cool .
these windows should understand two careful boxes , and those spoons should understand five .	these windows should understand two boxes , and those spoons should understand five careful .
the candles answer five wrong toys , and those cups answer one .	the candles answer five toys , and those cups answer one wrong .
these spoons may hear four surprised candles , and these buttons may hear one .	these spoons may hear four candles , and these buttons may hear one surprised .
these chairs were helping two wrong plates , and these schools were helping five .	these chairs were helping two plates , and these schools were helping five wrong .
that door was keeping three cold teachers , and that shoe was keeping five .	that door was keeping three teachers , and that shoe was keeping five cold .
this candle should hear one excited glass , and this bowl should hear three .	this candle should hear one glass , and this bowl should hear three excited .
those boats are taking five amazing women , and the shirts are taking three .	those boats are taking five women , and the shirts are taking three amazing .
this glass had kept one black lady , and the ring had kept three .	this glass had kept one lady , and the ring had kept three black .
these toys have bought two small women , and those candles have bought one .	these toys have bought two women , and those candles have bought one small .
these bags worry five quiet plates , and these beds worry one .	these bags worry five plates , and these beds worry one quiet .
the restaurant was teaching five tired shirts , and that hospital was teaching three .	the restaurant was teaching five shirts , and that hospital was teaching three tired .
that kitchen makes five important children , and the picture makes two .	that kitchen makes five children , and the picture makes two important .
this restaurant had taught four busy trucks , and this mirror had taught three .	this restaurant had taught four trucks , and this mirror had taught three busy .
those toys would hold one green child , and those glasses would hold four .	those toys would hold one child , and those glasses would hold four green .
the shirt has thrown one awesome queen , and that truck has thrown four .	the shirt has thrown one queen , and that truck has thrown four awesome .
the cars talk to three friendly books , and these rings talk to one .	the cars talk to three books , and these rings talk to one friendly .
this plate would know four quiet cups , and this car would know five .	this plate would know four cups , and this car would know five quiet .
that school talks to four boring books , and the shoe talks to five .	that school talks to four books , and the shoe talks to five boring .
this bottle can make three black men , and that room can make two .	this bottle can make three men , and that room can make two black .
the rocket was listening to four excited books , and this mirror was listening to two .	the rocket was listening to four books , and this mirror was listening to two excited .
those plates will care for three excited windows , and these hats will care for four .	those plates will care for three windows , and these hats will care for four excited .
the boat might make three old women , and that truck might make five .	the boat might make three women , and that truck might make five old .
this hat could praise two excited boxes , and the rug could praise five .	this hat could praise two boxes , and the rug could praise five excited .
the rooms were visiting one healthy boat , and these schools were visiting five .	the rooms were visiting one boat , and these schools were visiting five healthy .
that shirt had found four hungry shoes , and the park had found one .	that shirt had found four shoes , and the park had found one hungry .
those cars move one missing child , and these windows move four .	those cars move one child , and these windows move four missing .
the forks have two purple men , and these rings have one .	the forks have two men , and these rings have one purple .
those plates appreciate three kind spoons , and the windows appreciate two .	those plates appreciate three spoons , and the windows appreciate two kind .
the box will hear one lucky dish , and that doll will hear five .	the box will hear one dish , and that doll will hear five lucky .
the couch has heard four friendly trucks , and the plate has heard two .	the couch has heard four trucks , and the plate has heard two friendly .
those doors clean three dry ladies , and these shoes clean one .	those doors clean three ladies , and these shoes clean one dry .
that fork must keep one important doctor , and the button must keep five .	that fork must keep one doctor , and the button must keep five important .
that park shakes four small doctors , and that park shakes two .	that park shakes four doctors , and that park shakes two small .
that boat will answer five confused trucks , and that bank will answer two .	that boat will answer five trucks , and that bank will answer two confused .
the candles are teaching three careful doors , and the candles are teaching four .	the candles are teaching three doors , and the candles are teaching four careful .
that plane is holding one red dentist , and that plane is holding four .	that plane is holding one dentist , and that plane is holding four red .
those glasses know one careful bank , and the chairs know five .	those glasses know one bank , and the chairs know five careful .
these schools could hold two yellow ladies , and those dolls could hold one .	these schools could hold two ladies , and those dolls could hold one yellow .
the bag had worried four lucky shoes , and this rug had worried one .	the bag had worried four shoes , and this rug had worried one lucky .
the candle will worry four hungry chairs , and that plate will worry three .	the candle will worry four chairs , and that plate will worry three hungry .
the hat moves one broken patient , and this boat moves two .	the hat moves one patient , and this boat moves two broken .
this hospital is dropping five broken doctors , and this window is dropping four .	this hospital is dropping five doctors , and this window is dropping four broken .
these cars could understand five lucky chairs , and these crayons could understand one .	these cars could understand five chairs , and these crayons could understand one lucky .
this doll talks to four smart bottles , and that car talks to one .	this doll talks to four bottles , and that car talks to one smart .
that shirt might find five fine teachers , and the truck might find three .	that shirt might find five teachers , and the truck might find three fine .
the book has thrown two whole ladies , and the library has thrown one .	the book has thrown two ladies , and the library has thrown one whole .
this box has heard three sleepy glasses , and this ship has heard four .	this box has heard three glasses , and this ship has heard four sleepy .
the truck was helping five surprised rooms , and this book was helping one .	the truck was helping five rooms , and this book was helping one surprised .
these shirts shake two missing women , and these doors shake three .	these shirts shake two women , and these doors shake three missing .
the museum would know one boring picture , and this rug would know five .	the museum would know one picture , and this rug would know five boring .
those rooms were buying five big girls , and the toys were buying one .	those rooms were buying five girls , and the toys were buying one big .
that school had made four great boys , and that car had made two .	that school had made four boys , and that car had made two great .
this school has worried one helpful kitchen , and that museum has worried three .	this school has worried one kitchen , and that museum has worried three helpful .
that fork had kept five hot girls , and the box had kept two .	that fork had kept five girls , and the box had kept two hot .
those glasses must know five surprised cars , and those spoons must know two .	those glasses must know five cars , and those spoons must know two surprised .
the schools have bothered five gentle crayons , and those boxes have bothered three .	the schools have bothered five crayons , and those boxes have bothered three gentle .
the car has bought one old person , and that chair has bought two .	the car has bought one person , and that chair has bought two old .
those candles are talking to three tall cups , and those glasses are talking to five .	those candles are talking to three cups , and those glasses are talking to five tall .
that ship is bothering one nice bicycle , and that button is bothering five .	that ship is bothering one bicycle , and that button is bothering five nice .
this plate could clean five hot men , and the fork could clean two .	this plate could clean five men , and the fork could clean two hot .
this glass was keeping two fine ladies , and this crayon was keeping five .	this glass was keeping two ladies , and this crayon was keeping five fine .
the toys drop one fine person , and these trucks drop three .	the toys drop one person , and these trucks drop three fine .
the rooms keep two hot boys , and the bottles keep four .	the rooms keep two boys , and the bottles keep four hot .
the couch scares four gentle cars , and the bowl scares one .	the couch scares four cars , and the bowl scares one gentle .
the ring was bothering three kind boats , and that boat was bothering two .	the ring was bothering three boats , and that boat was bothering two kind .
the dish can know four friendly shirts , and this cup can know one .	the dish can know four shirts , and this cup can know one friendly .
these books have bothered one kind picture , and the windows have bothered five .	these books have bothered one picture , and the windows have bothered five kind .
those glasses were cleaning three brown guys , and these hats were cleaning five .	those glasses were cleaning three guys , and these hats were cleaning five brown .
the windows are bringing four new teachers , and those cars are bringing one .	the windows are bringing four teachers , and those cars are bringing one new .
those cups were holding four yellow boys , and the windows were holding three .	those cups were holding four boys , and the windows were holding three yellow .
this car will clean two green ladies , and that bottle will clean five .	this car will clean two ladies , and that bottle will clean five green .
that school was keeping one small queen , and the shoe was keeping four .	that school was keeping one queen , and the shoe was keeping four small .
the bed will answer five lucky shoes , and the bottle will answer three .	the bed will answer five shoes , and the bottle will answer three lucky .
the dishes had helped five important books , and the bags had helped three .	the dishes had helped five books , and the bags had helped three important .
those dishes had scared three strong boxes , and these spoons had scared five .	those dishes had scared three boxes , and these spoons had scared five strong .
this ring drops two great people , and this candle drops one .	this ring drops two people , and this candle drops one great .
these glasses worry one surprised dish , and these spoons worry two .	these glasses worry one dish , and these spoons worry two surprised .
this boat was teaching one upset hospital , and the kitchen was teaching two .	this boat was teaching one hospital , and the kitchen was teaching two upset .
the box has scared five angry books , and this shirt has scared two .	the box has scared five books , and this shirt has scared two angry .
the library has helped three healthy windows , and the button has helped one .	the library has helped three windows , and the button has helped one healthy .
these pictures teach three angry shirts , and those boats teach five .	these pictures teach three shirts , and those boats teach five angry .
those shoes had lost one orange dentist , and these pictures had lost two .	those shoes had lost one dentist , and these pictures had lost two orange .
that book will scare three nice books , and this ring will scare five .	that book will scare three books , and this ring will scare five nice .
this picture was bothering three curious plates , and the boat was bothering four .	this picture was bothering three plates , and the boat was bothering four curious .
the hats were dropping two yellow women , and these trucks were dropping three .	the hats were dropping two women , and these trucks were dropping three yellow .
these chairs had taught one happy bank , and those shirts had taught five .	these chairs had taught one bank , and those shirts had taught five happy .
the box might hear five kind doors , and this window might hear three .	the box might hear five doors , and this window might hear three kind .
these cars teach two friendly rooms , and the rings teach four .	these cars teach two rooms , and the rings teach four friendly .
that box shakes four hot ladies , and the shoe shakes one .	that box shakes four ladies , and the shoe shakes one hot .
the box has confused one sleepy shirt , and this school has confused three .	the box has confused one shirt , and this school has confused three sleepy .
this bottle was buying one green child , and the book was buying two .	this bottle was buying one child , and the book was buying two green .
the car was taking two brown children , and this rocket was taking five .	the car was taking two children , and this rocket was taking five brown .
that chair is listening to one healthy couch , and this ring is listening to four .	that chair is listening to one couch , and this ring is listening to four healthy .
that cup was teaching one happy book , and the hat was teaching four .	that cup was teaching one book , and the hat was teaching four happy .
that truck can hear five happy books , and the crayon can hear two .	that truck can hear five books , and the crayon can hear two happy .
this boat could talk to five busy books , and that car could talk to one .	this boat could talk to five books , and that car could talk to one busy .
this shoe could fix four whole guys , and this glass could fix three .	this shoe could fix four guys , and this glass could fix three whole .
that chair brings one black patient , and that museum brings three .	that chair brings one patient , and that museum brings three black .
that window might answer three helpful boxes , and that door might answer five .	that window might answer three boxes , and that door might answer five helpful .
this picture may care for two wrong boats , and this plate may care for four .	this picture may care for two boats , and this plate may care for four wrong .
these boxes may visit two upset glasses , and those plates may visit one .	these boxes may visit two glasses , and those plates may visit one upset .
this mall is visiting two sleepy cars , and this boat is visiting five .	this mall is visiting two cars , and this boat is visiting five sleepy .
the museum has bought four cool guys , and this truck has bought five .	the museum has bought four guys , and this truck has bought five cool .
the bowl should hold one orange adult , and this school should hold three .	the bowl should hold one adult , and this school should hold three orange .
that truck is cleaning one black king , and this bicycle is cleaning five .	that truck is cleaning one king , and this bicycle is cleaning five black .
the book might bother two lucky rooms , and this car might bother three .	the book might bother two rooms , and this car might bother three lucky .
the plane was visiting three careful cups , and this shirt was visiting one .	the plane was visiting three cups , and this shirt was visiting one careful .
these shirts had scared one strong library , and the books had scared three .	these shirts had scared one library , and the books had scared three strong .
this cup might fix three awesome people , and that plate might fix one .	this cup might fix three people , and that plate might fix one awesome .
the boxes listen to four important schools , and the chairs listen to two .	the boxes listen to four schools , and the chairs listen to two important .
that crayon had brought three boring teachers , and that bank had brought one .	that crayon had brought three teachers , and that bank had brought one boring .
the spoon hears five upset forks , and that bank hears four .	the spoon hears five forks , and that bank hears four upset .
this plane knows four healthy plates , and that library knows three .	this plane knows four plates , and that library knows three healthy .
those cars help three confused bags , and these shoes help four .	those cars help three bags , and these shoes help four confused .
those boxes answer five hungry cars , and these trucks answer one .	those boxes answer five cars , and these trucks answer one hungry .
these schools will throw four black women , and those boxes will throw five .	these schools will throw four women , and those boxes will throw five black .
these dishes have dropped two whole women , and the crayons have dropped four .	these dishes have dropped two women , and the crayons have dropped four whole .
these crayons are working with four angry buttons , and these dolls are working with three .	these crayons are working with four buttons , and these dolls are working with three angry .
these boats will visit three upset bowls , and those rings will visit four .	these boats will visit three bowls , and those rings will visit four upset .
the rug brings two orange children , and this door brings four .	the rug brings two children , and this door brings four orange .
these doors are dropping one black customer , and those shirts are dropping three .	these doors are dropping one customer , and those shirts are dropping three black .
these rings had answered three boring boats , and those candles had answered five .	these rings had answered three boats , and those candles had answered five boring .
that shoe can scare one hungry fork , and the doll can scare four .	that shoe can scare one fork , and the doll can scare four hungry .
that rocket can teach three tall glasses , and the car can teach five .	that rocket can teach three glasses , and the car can teach five tall .
the bed had moved one cute man , and this bag had moved three .	the bed had moved one man , and this bag had moved three cute .
those schools hear four lucky toys , and the boats hear five .	those schools hear four toys , and the boats hear five lucky .
these cars had kept five yellow boys , and those bottles had kept two .	these cars had kept five boys , and those bottles had kept two yellow .
the rug understands five happy bottles , and that mall understands one .	the rug understands five bottles , and that mall understands one happy .
that school knows three lucky books , and this library knows five .	that school knows three books , and this library knows five lucky .
the doors must bring two awesome women , and those books must bring one .	the doors must bring two women , and those books must bring one awesome .
that ship can hold five gray guys , and this boat can hold four .	that ship can hold five guys , and this boat can hold four gray .
those shirts scare one sleepy car , and these boats scare two .	those shirts scare one car , and these boats scare two sleepy .
those trucks could fix three cute ladies , and those dishes could fix five .	those trucks could fix three ladies , and those dishes could fix five cute .
that car has taught three quiet bags , and that bowl has taught five .	that car has taught three bags , and that bowl has taught five quiet .
that plane may hear five young spoons , and this restaurant may hear three .	that plane may hear five spoons , and this restaurant may hear three young .
this hospital might talk to one gentle cup , and that hat might talk to three .	this hospital might talk to one cup , and that hat might talk to three gentle .
that museum holds one amazing king , and the dish holds four .	that museum holds one king , and the dish holds four amazing .
those candles buy one small queen , and these buttons buy three .	those candles buy one queen , and these buttons buy three small .
that couch had bothered one confused car , and that bowl had bothered two .	that couch had bothered one car , and that bowl had bothered two confused .
these shoes are visiting one gentle book , and those forks are visiting four .	these shoes are visiting one book , and those forks are visiting four gentle .
those toys are losing four brown people , and the toys are losing two .	those toys are losing four people , and the toys are losing two brown .
those buttons can buy two fine ladies , and the chairs can buy five .	those buttons can buy two ladies , and the chairs can buy five fine .
the bags are helping two curious cars , and those spoons are helping four .	the bags are helping two cars , and those spoons are helping four curious .
the plate had visited one kind boat , and that car had visited three .	the plate had visited one boat , and that car had visited three kind .
the bowls had lost three gray ladies , and these bottles had lost five .	the bowls had lost three ladies , and these bottles had lost five gray .
the bag will worry four important candles , and that fork will worry five .	the bag will worry four candles , and that fork will worry five important .
that room had bought four blue teachers , and that car had bought three .	that room had bought four teachers , and that car had bought three blue .
the truck was cleaning three cold doctors , and the car was cleaning one .	the truck was cleaning three doctors , and the car was cleaning one cold .
this bag drops one brown man , and this bag drops four .	this bag drops one man , and this bag drops four brown .
that doll has lost three nice doors , and that bag has lost one .	that doll has lost three doors , and that bag has lost one nice .
the trucks have moved one expensive teacher , and those pictures have moved five .	the trucks have moved one teacher , and those pictures have moved five expensive .
that picture should listen to four young books , and the hat should listen to three .	that picture should listen to four books , and the hat should listen to three young .
the room was listening to one excited rug , and this crayon was listening to five .	the room was listening to one rug , and this crayon was listening to five excited .
this dish was shaking one green teacher , and the picture was shaking three .	this dish was shaking one teacher , and the picture was shaking three green .
this book has held five red men , and the book has held two .	this book has held five men , and the book has held two red .
this window could care for one angry spoon , and this restaurant could care for three .	this window could care for one spoon , and this restaurant could care for three angry .
the schools appreciate two friendly pictures , and the doors appreciate one .	the schools appreciate two pictures , and the doors appreciate one friendly .
this bowl would know two excited bowls , and that car would know five .	this bowl would know two bowls , and that car would know five excited .
the glass could know five young schools , and that bicycle could know one .	the glass could know five schools , and that bicycle could know one young .
this bank will talk to four nice hats , and the mirror will talk to one .	this bank will talk to four hats , and the mirror will talk to one nice .
this boat has heard one sleepy toy , and this bank has heard five .	this boat has heard one toy , and this bank has heard five sleepy .
the chairs were fixing two expensive doctors , and those rings were fixing five .	the chairs were fixing two doctors , and those rings were fixing five expensive .
this fork had made four old people , and that hat had made two .	this fork had made four people , and that hat had made two old .
the park has taught one hungry kitchen , and this school has taught four .	the park has taught one kitchen , and this school has taught four hungry .
the rocket had moved five new women , and the rocket had moved one .	the rocket had moved five women , and the rocket had moved one new .
that truck helps one smart mall , and that bowl helps three .	that truck helps one mall , and that bowl helps three smart .
the windows worry one curious library , and those chairs worry five .	the windows worry one library , and those chairs worry five curious .
that bicycle could appreciate four healthy schools , and the cup could appreciate two .	that bicycle could appreciate four schools , and the cup could appreciate two healthy .
the pictures understand two helpful doors , and those books understand five .	the pictures understand two doors , and those books understand five helpful .
those rings must bring three blue girls , and those doors must bring one .	those rings must bring three girls , and those doors must bring one blue .
those crayons praise five lucky rings , and those crayons praise one .	those crayons praise five rings , and those crayons praise one lucky .
this button is bothering five young schools , and the crayon is bothering one .	this button is bothering five schools , and the crayon is bothering one young .
that mall would visit one careful glass , and this museum would visit two .	that mall would visit one glass , and this museum would visit two careful .
this box has answered four wrong beds , and the hat has answered one .	this box has answered four beds , and the hat has answered one wrong .
this bottle has confused four tall pictures , and that plate has confused three .	this bottle has confused four pictures , and that plate has confused three tall .
the car hears four helpful dishes , and the truck hears three .	the car hears four dishes , and the truck hears three helpful .
that shirt was visiting three curious bags , and the truck was visiting five .	that shirt was visiting three bags , and the truck was visiting five curious .
this plane moves four important ladies , and that bowl moves five .	this plane moves four ladies , and that bowl moves five important .
the bed had worked with four bored glasses , and that chair had worked with five .	the bed had worked with four glasses , and that chair had worked with five bored .
that crayon may help four excited crayons , and that bank may help two .	that crayon may help four crayons , and that bank may help two excited .
these dolls must throw three small teachers , and those hats must throw four .	these dolls must throw three teachers , and those hats must throw four small .
the ship will hear two confused bottles , and this book will hear five .	the ship will hear two bottles , and this book will hear five confused .
that hospital had brought five gray people , and this cup had brought four .	that hospital had brought five people , and this cup had brought four gray .
this bed may appreciate five tall rooms , and that rocket may appreciate three .	this bed may appreciate five rooms , and that rocket may appreciate three tall .
the bicycle keeps four hot ladies , and this kitchen keeps one .	the bicycle keeps four ladies , and this kitchen keeps one hot .
that mirror can clean one fine girl , and this bicycle can clean three .	that mirror can clean one girl , and this bicycle can clean three fine .
these windows scare five tired bottles , and these schools scare one .	these windows scare five bottles , and these schools scare one tired .
those plates have talked to five important shoes , and the pictures have talked to four .	those plates have talked to five shoes , and the pictures have talked to four important .
this book had found five lucky bowls , and this ship had found two .	this book had found five bowls , and this ship had found two lucky .
that couch understands five excited schools , and that book understands four .	that couch understands five schools , and that book understands four excited .
these glasses hold one black driver , and these cars hold two .	these glasses hold one driver , and these cars hold two black .
this spoon is visiting three tall cars , and the book is visiting two .	this spoon is visiting three cars , and the book is visiting two tall .
that box is making three new teachers , and this bicycle is making two .	that box is making three teachers , and this bicycle is making two new .
the spoons are making one cold dentist , and the books are making two .	the spoons are making one dentist , and the books are making two cold .
those cars bring three old children , and the books bring two .	those cars bring three children , and the books bring two old .
that window had worked with four strong bowls , and this spoon had worked with five .	that window had worked with four bowls , and this spoon had worked with five strong .
that park might care for two nice cars , and this car might care for five .	that park might care for two cars , and this car might care for five nice .
those bottles have moved one expensive dancer , and these rooms have moved two .	those bottles have moved one dancer , and these rooms have moved two expensive .
this ring has lost three new men , and this spoon has lost two .	this ring has lost three men , and this spoon has lost two new .
this bag makes one red queen , and that bag makes two .	this bag makes one queen , and that bag makes two red .
that park is throwing one cool queen , and this truck is throwing four .	that park is throwing one queen , and this truck is throwing four cool .
that toy will help two nice spoons , and this book will help five .	that toy will help two spoons , and this book will help five nice .
this dish may listen to one bored car , and the cup may listen to four .	this dish may listen to one car , and the cup may listen to four bored .
that rocket must work with four kind buttons , and this bag must work with two .	that rocket must work with four buttons , and this bag must work with two kind .
this bicycle had lost two expensive doctors , and the glass had lost five .	this bicycle had lost two doctors , and the glass had lost five expensive .
the rug should help five surprised doors , and that button should help three .	the rug should help five doors , and that button should help three surprised .
that restaurant is shaking five dry men , and that bottle is shaking one .	that restaurant is shaking five men , and that bottle is shaking one dry .
this picture might work with one friendly school , and this candle might work with three .	this picture might work with one school , and this candle might work with three friendly .
the schools could bring three cute children , and those rooms could bring one .	the schools could bring three children , and those rooms could bring one cute .
this bottle moves two cool men , and the book moves one .	this bottle moves two men , and the book moves one cool .
the restaurant was working with five confused boats , and this hat was working with three .	the restaurant was working with five boats , and this hat was working with three confused .
the window was shaking two yellow doctors , and this doll was shaking four .	the window was shaking two doctors , and this doll was shaking four yellow .
the rooms have heard three confused spoons , and those rings have heard one .	the rooms have heard three spoons , and those rings have heard one confused .
these boats were cleaning four black guys , and those bowls were cleaning two .	these boats were cleaning four guys , and those bowls were cleaning two black .
these books have lost five purple doctors , and these rooms have lost one .	these books have lost five doctors , and these rooms have lost one purple .
this shirt has heard five clever boats , and that picture has heard one .	this shirt has heard five boats , and that picture has heard one clever .
the cars might talk to two confused boats , and these rooms might talk to five .	the cars might talk to two boats , and these rooms might talk to five confused .
these cups were working with two curious forks , and those cars were working with five .	these cups were working with two forks , and those cars were working with five curious .
this fork may care for two upset bags , and this car may care for four .	this fork may care for two bags , and this car may care for four upset .
the ring had taught two young cups , and the bowl had taught one .	the ring had taught two cups , and the bowl had taught one young .
that picture has kept two great ladies , and that hat has kept five .	that picture has kept two ladies , and that hat has kept five great .
that fork knows four tired schools , and this mirror knows five .	that fork knows four schools , and this mirror knows five tired .
the bank will hold four black people , and that button will hold three .	the bank will hold four people , and that button will hold three black .
this bank knows four wrong pictures , and this door knows two .	this bank knows four pictures , and this door knows two wrong .
the car had heard two tall bags , and this shirt had heard three .	the car had heard two bags , and this shirt had heard three tall .
that restaurant has confused one careful fork , and the shirt has confused five .	that restaurant has confused one fork , and the shirt has confused five careful .
the restaurant would visit five careful beds , and the button would visit two .	the restaurant would visit five beds , and the button would visit two careful .
this book had bought four broken teachers , and the window had bought five .	this book had bought four teachers , and the window had bought five broken .
these bowls lose five blue boys , and those cars lose one .	these bowls lose five boys , and those cars lose one blue .
this bicycle will know one sleepy bank , and that hat will know four .	this bicycle will know one bank , and that hat will know four sleepy .
those trucks had heard one young glass , and these chairs had heard five .	those trucks had heard one glass , and these chairs had heard five young .
those hats can hear one tired shoe , and those shoes can hear four .	those hats can hear one shoe , and those shoes can hear four tired .
that plane had taught two bored bottles , and that rug had taught five .	that plane had taught two bottles , and that rug had taught five bored .
that kitchen might teach five busy bags , and this door might teach one .	that kitchen might teach five bags , and this door might teach one busy .
that bicycle will praise two confused cars , and the rug will praise four .	that bicycle will praise two cars , and the rug will praise four confused .
these rooms have helped five quiet chairs , and the hats have helped one .	these rooms have helped five chairs , and the hats have helped one quiet .
those dishes hear two upset chairs , and the forks hear five .	those dishes hear two chairs , and the forks hear five upset .
that mirror had confused three excited shoes , and this crayon had confused two .	that mirror had confused three shoes , and this crayon had confused two excited .
these hats have bothered one important boat , and these schools have bothered three .	these hats have bothered one boat , and these schools have bothered three important .
that shirt hears four angry shirts , and this box hears three .	that shirt hears four shirts , and this box hears three angry .
the glass must bring three yellow teachers , and that bowl must bring five .	the glass must bring three teachers , and that bowl must bring five yellow .
those toys had scared three tall books , and the plates had scared four .	those toys had scared three books , and the plates had scared four tall .
those cups should keep one expensive woman , and these shirts should keep four .	those cups should keep one woman , and these shirts should keep four expensive .
this crayon had lost one boring plate , and the boat had lost five .	this crayon had lost one plate , and the boat had lost five boring .
these beds had confused five confused spoons , and these glasses had confused two .	these beds had confused five spoons , and these glasses had confused two confused .
this chair had taken four fine doctors , and this rocket had taken two .	this chair had taken four doctors , and this rocket had taken two fine .
that bottle knows three important boats , and the museum knows two .	that bottle knows three boats , and the museum knows two important .
that restaurant knows five angry bottles , and this book knows one .	that restaurant knows five bottles , and this book knows one angry .
the doll was keeping five red doctors , and that bag was keeping four .	the doll was keeping five doctors , and that bag was keeping four red .
the museum may lose three awesome children , and the mirror may lose two .	the museum may lose three children , and the mirror may lose two awesome .
the book has lost one boring teacher , and that picture has lost two .	the book has lost one teacher , and that picture has lost two boring .
the toy is holding one big driver , and this bicycle is holding two .	the toy is holding one driver , and this bicycle is holding two big .
this school can hold one gray adult , and that window can hold two .	this school can hold one adult , and that window can hold two gray .
these windows were listening to one smart plane , and those rooms were listening to five .	these windows were listening to one plane , and those rooms were listening to five smart .
the hospital works with five tired bags , and this rug works with two .	the hospital works with five bags , and this rug works with two tired .
those crayons have cleaned three orange teachers , and these toys have cleaned four .	those crayons have cleaned three teachers , and these toys have cleaned four orange .
the hospital could lift one important lady , and the car could lift three .	the hospital could lift one lady , and the car could lift three important .
this bowl was shaking five expensive teachers , and this spoon was shaking three .	this bowl was shaking five teachers , and this spoon was shaking three expensive .
that fork had dropped one fine boy , and the button had dropped two .	that fork had dropped one boy , and the button had dropped two fine .
the button had heard three hungry crayons , and that library had heard four .	the button had heard three crayons , and that library had heard four hungry .
this glass has heard three sleepy rings , and this car has heard one .	this glass has heard three rings , and this car has heard one sleepy .
that mirror takes five red people , and the car takes one .	that mirror takes five people , and the car takes one red .
those bottles have answered one surprised toy , and the chairs have answered four .	those bottles have answered one toy , and the chairs have answered four surprised .
those pictures listen to four excited cars , and these bags listen to five .	those pictures listen to four cars , and these bags listen to five excited .
the library has thrown four dry women , and this kitchen has thrown one .	the library has thrown four women , and this kitchen has thrown one dry .
the dish has scared two boring crayons , and that glass has scared one .	the dish has scared two crayons , and that glass has scared one boring .
this museum is buying one purple dentist , and the rug is buying four .	this museum is buying one dentist , and the rug is buying four purple .
the book was talking to four sleepy windows , and that door was talking to three .	the book was talking to four windows , and that door was talking to three sleepy .
that plane should bring two orange girls , and this rug should bring five .	that plane should bring two girls , and this rug should bring five orange .
the beds talk to two upset buttons , and those chairs talk to four .	the beds talk to two buttons , and those chairs talk to four upset .
that book must teach three nice shirts , and this window must teach four .	that book must teach three shirts , and this window must teach four nice .
that school is helping three strong boats , and this candle is helping one .	that school is helping three boats , and this candle is helping one strong .
this library keeps four missing women , and this truck keeps five .	this library keeps four women , and this truck keeps five missing .
this spoon hears one hungry restaurant , and that cup hears three .	this spoon hears one restaurant , and that cup hears three hungry .
this couch drops five cute women , and the mirror drops one .	this couch drops five women , and the mirror drops one cute .
that ring may take one broken dentist , and the button may take two .	that ring may take one dentist , and the button may take two broken .
the mall may know two tall buttons , and this hat may know one .	the mall may know two buttons , and this hat may know one tall .
these shirts had heard four healthy dishes , and the bags had heard two .	these shirts had heard four dishes , and the bags had heard two healthy .
this plane had thrown one cold person , and this bag had thrown five .	this plane had thrown one person , and this bag had thrown five cold .
the bags should buy one brown queen , and these rooms should buy two .	the bags should buy one queen , and these rooms should buy two brown .
these books may bother one busy boat , and the shoes may bother five .	these books may bother one boat , and the shoes may bother five busy .
that hat should care for five lucky pictures , and the book should care for one .	that hat should care for five pictures , and the book should care for one lucky .
that fork is bothering three gentle bags , and the room is bothering one .	that fork is bothering three bags , and the room is bothering one gentle .
the chair would teach five careful schools , and the room would teach one .	the chair would teach five schools , and the room would teach one careful .
that crayon has thrown four cool boys , and this truck has thrown two .	that crayon has thrown four boys , and this truck has thrown two cool .
the buttons were cleaning one cute man , and those shoes were cleaning two .	the buttons were cleaning one man , and those shoes were cleaning two cute .
the couch had found one friendly toy , and the doll had found two .	the couch had found one toy , and the doll had found two friendly .
the mall shakes one great doctor , and this boat shakes five .	the mall shakes one doctor , and this boat shakes five great .
those bowls are shaking three purple doctors , and these cars are shaking five .	those bowls are shaking three doctors , and these cars are shaking five purple .
this car is bothering one tall mirror , and this mall is bothering three .	this car is bothering one mirror , and this mall is bothering three tall .
the books can keep three great people , and the shirts can keep two .	the books can keep three people , and the shirts can keep two great .
these pictures can help four friendly buttons , and those schools can help one .	these pictures can help four buttons , and those schools can help one friendly .
the school is taking one brown customer , and the kitchen is taking five .	the school is taking one customer , and the kitchen is taking five brown .
those plates can hear three surprised bottles , and those cars can hear two .	those plates can hear three bottles , and those cars can hear two surprised .
this dish may answer three bored schools , and that mall may answer four .	this dish may answer three schools , and that mall may answer four bored .
those forks were buying five amazing children , and those bags were buying one .	those forks were buying five children , and those bags were buying one amazing .
this chair moves five dry girls , and that kitchen moves four .	this chair moves five girls , and that kitchen moves four dry .
the bottle had kept one white woman , and this mirror had kept three .	the bottle had kept one woman , and this mirror had kept three white .
the rug should appreciate three gentle schools , and the candle should appreciate five .	the rug should appreciate three schools , and the candle should appreciate five gentle .
these rings were bothering two kind boats , and these toys were bothering five .	these rings were bothering two boats , and these toys were bothering five kind .
this hospital might sell one great boy , and the plate might sell five .	this hospital might sell one boy , and the plate might sell five great .
that shoe should understand one careful kitchen , and this boat should understand four .	that shoe should understand one kitchen , and this boat should understand four careful .
those shoes were visiting five busy shoes , and the glasses were visiting one .	those shoes were visiting five shoes , and the glasses were visiting one busy .
those bags help five busy bags , and the trucks help one .	those bags help five bags , and the trucks help one busy .
the door helps two tired bowls , and that picture helps four .	the door helps two bowls , and that picture helps four tired .
that ring should listen to one kind bowl , and that hospital should listen to three .	that ring should listen to one bowl , and that hospital should listen to three kind .
this fork knows two lucky rooms , and this bowl knows four .	this fork knows two rooms , and this bowl knows four lucky .
those shoes were fixing one orange customer , and the rings were fixing three .	those shoes were fixing one customer , and the rings were fixing three orange .
the bowls were buying two boring ladies , and those crayons were buying five .	the bowls were buying two ladies , and those crayons were buying five boring .
these shoes are finding five white teachers , and those cars are finding four .	these shoes are finding five teachers , and those cars are finding four white .
this truck may hold one cute lady , and this mirror may hold four .	this truck may hold one lady , and this mirror may hold four cute .
these bottles drop one whole girl , and those crayons drop three .	these bottles drop one girl , and those crayons drop three whole .
the plates were talking to three smart dishes , and the pictures were talking to two .	the plates were talking to three dishes , and the pictures were talking to two smart .
this glass might teach three bored crayons , and that fork might teach four .	this glass might teach three crayons , and that fork might teach four bored .
those glasses can keep two awesome guys , and those cars can keep one .	those glasses can keep two guys , and those cars can keep one awesome .
this book holds one red man , and this ship holds four .	this book holds one man , and this ship holds four red .
this rocket had answered one kind mall , and the plane had answered three .	this rocket had answered one mall , and the plane had answered three kind .
the hats have worried three lucky chairs , and these rings have worried one .	the hats have worried three chairs , and these rings have worried one lucky .
these windows praise two kind chairs , and those shoes praise three .	these windows praise two chairs , and those shoes praise three kind .
this bank helps four curious windows , and that kitchen helps one .	this bank helps four windows , and that kitchen helps one curious .
this library has bought one yellow teacher , and the bicycle has bought three .	this library has bought one teacher , and the bicycle has bought three yellow .
those windows had found one gray girl , and these trucks had found five .	those windows had found one girl , and these trucks had found five gray .
those cars had dropped four old boys , and these candles had dropped one .	those cars had dropped four boys , and these candles had dropped one old .
that plane had made five white ladies , and the bank had made four .	that plane had made five ladies , and the bank had made four white .
the room had taken two cool people , and this car had taken five .	the room had taken two people , and this car had taken five cool .
those trucks should answer two young cars , and these schools should answer three .	those trucks should answer two cars , and these schools should answer three young .
that box knows one strong doll , and this doll knows five .	that box knows one doll , and this doll knows five strong .
that plane may know three tired cups , and the cup may know two .	that plane may know three cups , and the cup may know two tired .
these schools visit four healthy boats , and those forks visit three .	these schools visit four boats , and those forks visit three healthy .
the spoon had heard two lucky bowls , and this book had heard five .	the spoon had heard two bowls , and this book had heard five lucky .
that mall was dropping two amazing people , and this button was dropping three .	that mall was dropping two people , and this button was dropping three amazing .
that box would know one healthy doll , and the bed would know three .	that box would know one doll , and the bed would know three healthy .
that dish will lift two purple guys , and this toy will lift four .	that dish will lift two guys , and this toy will lift four purple .
those shoes might hear one hungry plane , and the forks might hear three .	those shoes might hear one plane , and the forks might hear three hungry .
that book hears two excited candles , and the hospital hears five .	that book hears two candles , and the hospital hears five excited .
that crayon had found two missing women , and this fork had found five .	that crayon had found two women , and this fork had found five missing .
the ship was helping two smart boxes , and this doll was helping three .	the ship was helping two boxes , and this doll was helping three smart .
that hat would take three blue teachers , and the doll would take four .	that hat would take three teachers , and the doll would take four blue .
that doll will buy one big patient , and the bed will buy four .	that doll will buy one patient , and the bed will buy four big .
this bed is teaching one upset toy , and that doll is teaching five .	this bed is teaching one toy , and that doll is teaching five upset .
that hat has confused three nice beds , and this bag has confused five .	that hat has confused three beds , and this bag has confused five nice .
this bank had worked with two nice pictures , and this couch had worked with three .	this bank had worked with two pictures , and this couch had worked with three nice .
those plates care for four clever shirts , and these toys care for one .	those plates care for four shirts , and these toys care for one clever .
the doll had thrown one important guy , and that bottle had thrown two .	the doll had thrown one guy , and that bottle had thrown two important .
that boat had lost three clever rooms , and the picture had lost four .	that boat had lost three rooms , and the picture had lost four clever .
that bowl is shaking one small child , and that picture is shaking five .	that bowl is shaking one child , and that picture is shaking five small .
those dishes had worked with five boring pictures , and these beds had worked with three .	those dishes had worked with five pictures , and these beds had worked with three boring .
this door understands three careful shoes , and this book understands four .	this door understands three shoes , and this book understands four careful .
this dish works with four sleepy bowls , and that car works with three .	this dish works with four bowls , and that car works with three sleepy .
the button should keep three hot women , and the ship should keep two .	the button should keep three women , and the ship should keep two hot .
the dolls may know two lucky schools , and these toys may know five .	the dolls may know two schools , and these toys may know five lucky .
this dish could help one tired school , and that doll could help three .	this dish could help one school , and that doll could help three tired .
that room is listening to two curious dolls , and that chair is listening to four .	that room is listening to two dolls , and that chair is listening to four curious .
this mall may sell three boring men , and that candle may sell two .	this mall may sell three men , and that candle may sell two boring .
the box is bothering five hungry windows , and the box is bothering two .	the box is bothering five windows , and the box is bothering two hungry .
that bed will work with one tall book , and that button will work with four .	that bed will work with one book , and that button will work with four tall .
the candle will clean one purple dancer , and that museum will clean four .	the candle will clean one dancer , and that museum will clean four purple .
the bicycle is bringing one big guy , and the hat is bringing two .	the bicycle is bringing one guy , and the hat is bringing two big .
the boats would find two old ladies , and the plates would find five .	the boats would find two ladies , and the plates would find five old .
that hat has bothered four clever crayons , and that hospital has bothered two .	that hat has bothered four crayons , and that hospital has bothered two clever .
the windows are moving five small girls , and those spoons are moving three .	the windows are moving five girls , and those spoons are moving three small .
the museum shakes one small adult , and that rocket shakes four .	the museum shakes one adult , and that rocket shakes four small .
these dishes appreciate three hungry schools , and the plates appreciate four .	these dishes appreciate three schools , and the plates appreciate four hungry .
that bank had held one new queen , and that mirror had held four .	that bank had held one queen , and that mirror had held four new .
the cup can understand three kind windows , and this candle can understand four .	the cup can understand three windows , and this candle can understand four kind .
this hospital can hold one old customer , and this bowl can hold three .	this hospital can hold one customer , and this bowl can hold three old .
these rooms had found two cool people , and these hats had found one .	these rooms had found two people , and these hats had found one cool .
this boat had bought one green dentist , and that boat had bought four .	this boat had bought one dentist , and that boat had bought four green .
that plate may teach two clever cars , and the plate may teach five .	that plate may teach two cars , and the plate may teach five clever .
those boats might help three lucky plates , and these hats might help one .	those boats might help three plates , and these hats might help one lucky .
the rocket works with five curious windows , and the bag works with two .	the rocket works with five windows , and the bag works with two curious .
that hospital may hear four helpful bowls , and this park may hear one .	that hospital may hear four bowls , and this park may hear one helpful .
this library will worry one busy school , and this button will worry four .	this library will worry one school , and this button will worry four busy .
that park understands five confused cars , and this window understands three .	that park understands five cars , and this window understands three confused .
the books bring five green ladies , and these glasses bring two .	the books bring five ladies , and these glasses bring two green .
this fork works with one boring shoe , and the boat works with two .	this fork works with one shoe , and the boat works with two boring .
those doors had helped four upset chairs , and these shoes had helped two .	those doors had helped four chairs , and these shoes had helped two upset .
the hat works with two important books , and that museum works with five .	the hat works with two books , and that museum works with five important .
that plate had lost five strong hats , and this dish had lost four .	that plate had lost five hats , and this dish had lost four strong .
the books lift three missing girls , and those shirts lift five .	the books lift three girls , and those shirts lift five missing .
that museum has heard four healthy rings , and that fork has heard five .	that museum has heard four rings , and that fork has heard five healthy .
that rug is finding one boring patient , and the ship is finding four .	that rug is finding one patient , and the ship is finding four boring .
this bottle had heard two happy rooms , and this rocket had heard four .	this bottle had heard two rooms , and this rocket had heard four happy .
the pictures were dropping five new teachers , and the cars were dropping four .	the pictures were dropping five teachers , and the cars were dropping four new .
that plate might drop one black boy , and this doll might drop three .	that plate might drop one boy , and this doll might drop three black .
the beds are taking three hot guys , and those bags are taking five .	the beds are taking three guys , and those bags are taking five hot .
those boxes will know four friendly shoes , and these schools will know five .	those boxes will know four shoes , and these schools will know five friendly .
the cars listen to three young shirts , and these dishes listen to one .	the cars listen to three shirts , and these dishes listen to one young .
this room was teaching two surprised cars , and the picture was teaching four .	this room was teaching two cars , and the picture was teaching four surprised .
that hospital was taking five great guys , and this picture was taking one .	that hospital was taking five guys , and this picture was taking one great .
those chairs should appreciate two confused glasses , and those shoes should appreciate three .	those chairs should appreciate two glasses , and those shoes should appreciate three confused .
the park knows one boring dish , and the couch knows four .	the park knows one dish , and the couch knows four boring .
these toys should move two dry guys , and these books should move three .	these toys should move two guys , and these books should move three dry .
that door has four whole teachers , and that box has three .	that door has four teachers , and that box has three whole .
that school should sell five black girls , and this restaurant should sell three .	that school should sell five girls , and this restaurant should sell three black .
the picture may fix one great boy , and that window may fix two .	the picture may fix one boy , and that window may fix two great .
the bicycle had lost two tall shoes , and the button had lost four .	the bicycle had lost two shoes , and the button had lost four tall .
the bowls have lost four gray people , and these cars have lost two .	the bowls have lost four people , and these cars have lost two gray .
the mall understands four careful trucks , and that library understands three .	the mall understands four trucks , and that library understands three careful .
these shirts hear one healthy kitchen , and these candles hear four .	these shirts hear one kitchen , and these candles hear four healthy .
the chairs should make one blue queen , and these windows should make five .	the chairs should make one queen , and these windows should make five blue .
that book must shake four red children , and that cup must shake five .	that book must shake four children , and that cup must shake five red .
the kitchen knows five gentle plates , and the toy knows four .	the kitchen knows five plates , and the toy knows four gentle .
this chair talks to three kind windows , and this door talks to one .	this chair talks to three windows , and this door talks to one kind .
that car has scared two important books , and that couch has scared five .	that car has scared two books , and that couch has scared five important .
the shoe is shaking three green teachers , and the candle is shaking five .	the shoe is shaking three teachers , and the candle is shaking five green .
the park is bothering four surprised cups , and the window is bothering one .	the park is bothering four cups , and the window is bothering one surprised .
that button could appreciate four lucky candles , and the spoon could appreciate one .	that button could appreciate four candles , and the spoon could appreciate one lucky .
those windows can answer one wrong hospital , and these plates can answer two .	those windows can answer one hospital , and these plates can answer two wrong .
those shoes are listening to four helpful chairs , and the spoons are listening to two .	those shoes are listening to four chairs , and the spoons are listening to two helpful .
this park is working with one tired chair , and that rug is working with two .	this park is working with one chair , and that rug is working with two tired .
that library was working with five angry dishes , and that room was working with two .	that library was working with five dishes , and that room was working with two angry .
that bank helps one hungry glass , and that bed helps three .	that bank helps one glass , and that bed helps three hungry .
that spoon may scare two busy bowls , and that toy may scare four .	that spoon may scare two bowls , and that toy may scare four busy .
those shirts were finding five important girls , and these beds were finding one .	those shirts were finding five girls , and these beds were finding one important .
those dolls keep five important men , and the spoons keep three .	those dolls keep five men , and the spoons keep three important .
the glasses talk to three young dishes , and these bowls talk to one .	the glasses talk to three dishes , and these bowls talk to one young .
this plane was moving five new doctors , and that museum was moving one .	this plane was moving five doctors , and that museum was moving one new .
that cup is bothering three hungry shoes , and that bicycle is bothering one .	that cup is bothering three shoes , and that bicycle is bothering one hungry .
the shoes had talked to one busy fork , and those hats had talked to five .	the shoes had talked to one fork , and those hats had talked to five busy .
this rug might find four old ladies , and this chair might find three .	this rug might find four ladies , and this chair might find three old .
the candles should answer three important beds , and the candles should answer two .	the candles should answer three beds , and the candles should answer two important .
that hat makes three whole men , and the museum makes two .	that hat makes three men , and the museum makes two whole .
this book is visiting one careful door , and this couch is visiting four .	this book is visiting one door , and this couch is visiting four careful .
that box may talk to three strong buttons , and this toy may talk to four .	that box may talk to three buttons , and this toy may talk to four strong .
that library moves one broken doctor , and that ship moves four .	that library moves one doctor , and that ship moves four broken .
those pictures were finding four old teachers , and the cars were finding three .	those pictures were finding four teachers , and the cars were finding three old .
this bed was moving two fine women , and this dish was moving three .	this bed was moving two women , and this dish was moving three fine .
that room should hear three friendly boxes , and that doll should hear one .	that room should hear three boxes , and that doll should hear one friendly .
that candle was talking to five smart books , and this car was talking to four .	that candle was talking to five books , and this car was talking to four smart .
those bags have brought three hot guys , and these crayons have brought two .	those bags have brought three guys , and these crayons have brought two hot .
that truck has lost two nice rooms , and the bed has lost four .	that truck has lost two rooms , and the bed has lost four nice .
that boat was teaching three hungry plates , and the rug was teaching two .	that boat was teaching three plates , and the rug was teaching two hungry .
this boat was listening to one tall book , and the park was listening to two .	this boat was listening to one book , and the park was listening to two tall .
the bicycle can shake four white doctors , and this hat can shake two .	the bicycle can shake four doctors , and this hat can shake two white .
the toy may understand one surprised crayon , and that restaurant may understand two .	the toy may understand one crayon , and that restaurant may understand two surprised .
this crayon was bringing two small doctors , and this kitchen was bringing five .	this crayon was bringing two doctors , and this kitchen was bringing five small .
that shirt should know five curious books , and the school should know one .	that shirt should know five books , and the school should know one curious .
those books have lost two young rooms , and these boats have lost three .	those books have lost two rooms , and these boats have lost three young .
that book had found three nice bags , and the plane had found one .	that book had found three bags , and the plane had found one nice .
these toys hear three wrong shoes , and those glasses hear five .	these toys hear three shoes , and those glasses hear five wrong .
those schools were working with three angry trucks , and the trucks were working with two .	those schools were working with three trucks , and the trucks were working with two angry .
the pictures help five friendly bowls , and those spoons help four .	the pictures help five bowls , and those spoons help four friendly .
the school had helped four gentle cars , and the museum had helped one .	the school had helped four cars , and the museum had helped one gentle .
this plate must clean three blue children , and the cup must clean five .	this plate must clean three children , and the cup must clean five blue .
that bicycle can answer four important windows , and the candle can answer one .	that bicycle can answer four windows , and the candle can answer one important .
this button takes four important girls , and this plate takes three .	this button takes four girls , and this plate takes three important .
this truck holds five expensive people , and this couch holds two .	this truck holds five people , and this couch holds two expensive .
these trucks were making three missing women , and the boats were making five .	these trucks were making three women , and the boats were making five missing .
this toy has talked to five busy plates , and this fork has talked to two .	this toy has talked to five plates , and this fork has talked to two busy .
this crayon would drop one brown king , and that bag would drop three .	this crayon would drop one king , and that bag would drop three brown .
these candles lose one expensive guy , and these pictures lose two .	these candles lose one guy , and these pictures lose two expensive .
the bowl scares three young cups , and the kitchen scares four .	the bowl scares three cups , and the kitchen scares four young .
that spoon had worked with two lucky candles , and that bank had worked with five .	that spoon had worked with two candles , and that bank had worked with five lucky .
the glasses have helped one busy school , and these rings have helped three .	the glasses have helped one school , and these rings have helped three busy .
this door must make two important teachers , and this window must make one .	this door must make two teachers , and this window must make one important .
that book can drop three hot people , and the dish can drop one .	that book can drop three people , and the dish can drop one hot .
these windows will talk to five angry bowls , and those hats will talk to one .	these windows will talk to five bowls , and those hats will talk to one angry .
this bottle had confused four confused candles , and that bank had confused two .	this bottle had confused four candles , and that bank had confused two confused .
these toys would bother four kind toys , and the chairs would bother three .	these toys would bother four toys , and the chairs would bother three kind .
this rocket was finding one great person , and that truck was finding three .	this rocket was finding one person , and that truck was finding three great .
the plates could worry one tall museum , and the buttons could worry five .	the plates could worry one museum , and the buttons could worry five tall .
that school will throw three missing children , and the toy will throw two .	that school will throw three children , and the toy will throw two missing .
this crayon was keeping four cute people , and the book was keeping five .	this crayon was keeping four people , and the book was keeping five cute .
those glasses bother one quiet museum , and these dolls bother three .	those glasses bother one museum , and these dolls bother three quiet .
the car understands three busy books , and this kitchen understands five .	the car understands three books , and this kitchen understands five busy .
the trucks had bothered five kind windows , and the schools had bothered one .	the trucks had bothered five windows , and the schools had bothered one kind .
the restaurant can appreciate two confused boats , and the toy can appreciate five .	the restaurant can appreciate two boats , and the toy can appreciate five confused .
this book had scared two confused dishes , and the door had scared five .	this book had scared two dishes , and the door had scared five confused .
the crayon had worked with five hungry dolls , and this boat had worked with four .	the crayon had worked with five dolls , and this boat had worked with four hungry .
these books would steal two black people , and these trucks would steal one .	these books would steal two people , and these trucks would steal one black .
the books might hear three lucky cars , and these rings might hear five .	the books might hear three cars , and these rings might hear five lucky .
that boat might listen to three kind bags , and the school might listen to one .	that boat might listen to three bags , and the school might listen to one kind .
this car was losing two big children , and this shirt was losing three .	this car was losing two children , and this shirt was losing three big .
that fork had heard five smart spoons , and this picture had heard two .	that fork had heard five spoons , and this picture had heard two smart .
that library can help two clever schools , and that bed can help one .	that library can help two schools , and that bed can help one clever .
that crayon may care for two smart schools , and that kitchen may care for four .	that crayon may care for two schools , and that kitchen may care for four smart .
these dolls steal five gray ladies , and those chairs steal three .	these dolls steal five ladies , and those chairs steal three gray .
this spoon has one important patient , and that plane has four .	this spoon has one patient , and that plane has four important .
this couch can praise two curious cars , and the ship can praise five .	this couch can praise two cars , and the ship can praise five curious .
the shirt is buying two small teachers , and the boat is buying one .	the shirt is buying two teachers , and the boat is buying one small .
the couch has found four old ladies , and that restaurant has found two .	the couch has found four ladies , and that restaurant has found two old .
this window must take one boring woman , and the book must take five .	this window must take one woman , and the book must take five boring .
those cups are bothering five excited beds , and those hats are bothering one .	those cups are bothering five beds , and those hats are bothering one excited .
that school brings three awesome children , and that shirt brings two .	that school brings three children , and that shirt brings two awesome .
that button can hear one quiet fork , and the book can hear five .	that button can hear one fork , and the book can hear five quiet .
this bed would steal two big teachers , and that school would steal four .	this bed would steal two teachers , and that school would steal four big .
that bowl was talking to four friendly pictures , and this hospital was talking to one .	that bowl was talking to four pictures , and this hospital was talking to one friendly .
the boats are cleaning two old ladies , and these rings are cleaning five .	the boats are cleaning two ladies , and these rings are cleaning five old .
that ring may scare one quiet museum , and that fork may scare two .	that ring may scare one museum , and that fork may scare two quiet .
the bag keeps four hot ladies , and the crayon keeps five .	the bag keeps four ladies , and the crayon keeps five hot .
the library might scare one helpful ship , and that shoe might scare three .	the library might scare one ship , and that shoe might scare three helpful .
the dolls could appreciate three boring plates , and those boxes could appreciate one .	the dolls could appreciate three plates , and those boxes could appreciate one boring .
that plane had found one tall bottle , and the box had found five .	that plane had found one bottle , and the box had found five tall .
that cup will move five expensive men , and that bottle will move three .	that cup will move five men , and that bottle will move three expensive .
the button may take two white teachers , and this bag may take one .	the button may take two teachers , and this bag may take one white .
that library was working with four wrong cars , and that park was working with five .	that library was working with four cars , and that park was working with five wrong .
the shoes should know three surprised windows , and those cars should know five .	the shoes should know three windows , and those cars should know five surprised .
this hat had heard five upset books , and this car had heard two .	this hat had heard five books , and this car had heard two upset .
the dish must help one tall hat , and this kitchen must help five .	the dish must help one hat , and this kitchen must help five tall .
the bags sell three great guys , and these forks sell five .	the bags sell three guys , and these forks sell five great .
the button will hear five bored dishes , and that kitchen will hear three .	the button will hear five dishes , and that kitchen will hear three bored .
this museum may answer one confused museum , and that door may answer five .	this museum may answer one museum , and that door may answer five confused .
those bags are visiting two sleepy shirts , and the hats are visiting four .	those bags are visiting two shirts , and the hats are visiting four sleepy .
that toy was bothering one confused hat , and this kitchen was bothering five .	that toy was bothering one hat , and this kitchen was bothering five confused .
that toy is helping two angry books , and the window is helping four .	that toy is helping two books , and the window is helping four angry .
that doll is listening to three boring bottles , and the bottle is listening to five .	that doll is listening to three bottles , and the bottle is listening to five boring .
that bottle should fix five blue men , and this couch should fix one .	that bottle should fix five men , and this couch should fix one blue .
this bottle talks to five tired boats , and that ship talks to one .	this bottle talks to five boats , and that ship talks to one tired .
this hat has heard five tired shirts , and that button has heard one .	this hat has heard five shirts , and that button has heard one tired .
this truck may lift one red man , and the bed may lift four .	this truck may lift one man , and the bed may lift four red .
the spoon has worried one strong rocket , and the park has worried four .	the spoon has worried one rocket , and the park has worried four strong .
the crayon is teaching one strong ship , and this rocket is teaching four .	the crayon is teaching one ship , and this rocket is teaching four strong .
that school had lost two missing guys , and this dish had lost four .	that school had lost two guys , and this dish had lost four missing .
those cars are visiting one hungry bicycle , and these cars are visiting five .	those cars are visiting one bicycle , and these cars are visiting five hungry .
the bottle was bringing one missing girl , and the shoe was bringing five .	the bottle was bringing one girl , and the shoe was bringing five missing .
these forks had taught five excited buttons , and these crayons had taught four .	these forks had taught five buttons , and these crayons had taught four excited .
these candles fix one big dancer , and those rooms fix three .	these candles fix one dancer , and those rooms fix three big .
the shirt is bringing one dry boy , and this crayon is bringing five .	the shirt is bringing one boy , and this crayon is bringing five dry .
those dolls have moved five cute men , and those boats have moved three .	those dolls have moved five men , and those boats have moved three cute .
this bank had answered five surprised shirts , and that library had answered three .	this bank had answered five shirts , and that library had answered three surprised .
that glass would answer two curious crayons , and the window would answer four .	that glass would answer two crayons , and the window would answer four curious .
those rooms have bothered one boring plate , and those glasses have bothered five .	those rooms have bothered one plate , and those glasses have bothered five boring .
the car has talked to one curious fork , and this room has talked to two .	the car has talked to one fork , and this room has talked to two curious .
those rings have bothered two boring bowls , and these hats have bothered one .	those rings have bothered two bowls , and these hats have bothered one boring .
that dish has bought four small men , and that mall has bought one .	that dish has bought four men , and that mall has bought one small .
that fork might praise four important glasses , and the shirt might praise one .	that fork might praise four glasses , and the shirt might praise one important .
that plate was taking one cool boy , and this park was taking five .	that plate was taking one boy , and this park was taking five cool .
those bowls take one whole customer , and these forks take three .	those bowls take one customer , and these forks take three whole .
the bottle was bothering five bored crayons , and that ship was bothering three .	the bottle was bothering five crayons , and that ship was bothering three bored .
these pictures have made one important adult , and those windows have made two .	these pictures have made one adult , and those windows have made two important .
these bottles would take two great women , and those pictures would take three .	these bottles would take two women , and those pictures would take three great .
the door is making three old people , and this picture is making one .	the door is making three people , and this picture is making one old .
this ring has heard two kind crayons , and this door has heard one .	this ring has heard two crayons , and this door has heard one kind .
the bowls were cleaning four hot ladies , and the schools were cleaning three .	the bowls were cleaning four ladies , and the schools were cleaning three hot .
this bank may help two curious boxes , and that ring may help four .	this bank may help two boxes , and that ring may help four curious .
the hospital had heard three gentle books , and the rug had heard five .	the hospital had heard three books , and the rug had heard five gentle .
these forks were taking four boring people , and these bowls were taking five .	these forks were taking four people , and these bowls were taking five boring .
this ship could answer three quiet chairs , and the bed could answer two .	this ship could answer three chairs , and the bed could answer two quiet .
the rooms help five confused shirts , and these shoes help two .	the rooms help five shirts , and these shoes help two confused .
the plane must worry four curious boats , and this bank must worry two .	the plane must worry four boats , and this bank must worry two curious .
this bed has five red ladies , and this hat has four .	this bed has five ladies , and this hat has four red .
the books help one confused hospital , and those dishes help four .	the books help one hospital , and those dishes help four confused .
this museum may visit four curious boxes , and that plate may visit one .	this museum may visit four boxes , and that plate may visit one curious .
these rings would listen to one lucky ring , and the dolls would listen to four .	these rings would listen to one ring , and the dolls would listen to four lucky .
the window was helping five nice forks , and the bed was helping four .	the window was helping five forks , and the bed was helping four nice .
those bowls scare four excited schools , and these bags scare one .	those bowls scare four schools , and these bags scare one excited .
the button is keeping one cold dancer , and this crayon is keeping four .	the button is keeping one dancer , and this crayon is keeping four cold .
those glasses take one blue dancer , and the hats take four .	those glasses take one dancer , and the hats take four blue .
that school knows two wrong spoons , and that room knows three .	that school knows two spoons , and that room knows three wrong .
these plates may know three hungry crayons , and the windows may know five .	these plates may know three crayons , and the windows may know five hungry .
that car had heard two kind bags , and this couch had heard three .	that car had heard two bags , and this couch had heard three kind .
the doors had worried two young schools , and those shoes had worried five .	the doors had worried two schools , and those shoes had worried five young .
the pictures appreciate four helpful dolls , and these rooms appreciate one .	the pictures appreciate four dolls , and these rooms appreciate one helpful .
that bicycle has visited one upset bag , and the restaurant has visited five .	that bicycle has visited one bag , and the restaurant has visited five upset .
those bags had dropped three amazing doctors , and those rooms had dropped four .	those bags had dropped three doctors , and those rooms had dropped four amazing .
those crayons care for four excited dishes , and the doors care for five .	those crayons care for four dishes , and the doors care for five excited .
the school is finding five big people , and that museum is finding one .	the school is finding five people , and that museum is finding one big .
this shoe is moving four orange men , and the picture is moving one .	this shoe is moving four men , and the picture is moving one orange .
these dishes listen to four confused bags , and those hats listen to five .	these dishes listen to four bags , and those hats listen to five confused .
that ring has confused five angry boxes , and that library has confused three .	that ring has confused five boxes , and that library has confused three angry .
the door knows one angry shoe , and this book knows five .	the door knows one shoe , and this book knows five angry .
the button hears three important windows , and this ship hears four .	the button hears three windows , and this ship hears four important .
the candles have two cold doctors , and the boats have four .	the candles have two doctors , and the boats have four cold .
that shirt was fixing three old children , and this cup was fixing four .	that shirt was fixing three children , and this cup was fixing four old .
the bag is talking to five curious spoons , and this car is talking to two .	the bag is talking to five spoons , and this car is talking to two curious .
the car has lost five upset schools , and the car has lost four .	the car has lost five schools , and the car has lost four upset .
these crayons had taken three new boys , and the pictures had taken five .	these crayons had taken three boys , and the pictures had taken five new .
the rings would know four helpful schools , and the windows would know two .	the rings would know four schools , and the windows would know two helpful .
the bed helps four kind cars , and that dish helps one .	the bed helps four cars , and that dish helps one kind .
that chair holds five whole men , and this rug holds three .	that chair holds five men , and this rug holds three whole .
that car keeps two green ladies , and that shoe keeps one .	that car keeps two ladies , and that shoe keeps one green .
