kind cars stretch carefully .	stretch kind carefully cars .
tired spoons wave quietly .	wave quietly spoons tired .
clever spoons sing carefully .	clever carefully sing spoons .
smart forks yell perfectly .	smart perfectly yell forks .
clever dolls read perfectly .	dolls read clever perfectly .
strong books yell carefully .	books carefully strong yell .
hungry bowls lie carefully .	lie carefully bowls hungry .
bored shirts cough slowly .	slowly shirts bored cough .
hungry bags lose carefully .	bags carefully hungry lose .
wrong forks sing quickly .	forks quickly sing wrong .
busy forks smile quickly .	forks smile busy quickly .
healthy shirts exercise quickly .	quickly exercise shirts healthy .
tall bags practice slowly .	slowly tall practice bags .
helpful crayons sneeze perfectly .	crayons sneeze perfectly helpful .
strong doors stretch slowly .	slowly stretch doors strong .
strong bottles wave perfectly .	bottles perfectly strong wave .
clever dishes sing quietly .	quietly clever sing dishes .
tired windows wave quietly .	wave quietly windows tired .
wrong glasses stretch quietly .	quietly glasses stretch wrong .
tired trucks cough quietly .	quietly trucks cough tired .
smart trucks lose slowly .	smart lose slowly trucks .
clever pictures lie carefully .	lie clever pictures carefully .
kind beds win quietly .	beds win kind quietly .
angry rings smile carefully .	smile carefully angry rings .
excited cups wave slowly .	wave excited slowly cups .
confused rings sing slowly .	slowly rings sing confused .
careful windows stretch quickly .	careful stretch quickly windows .
kind bags laugh carefully .	kind carefully bags laugh .
wrong bowls laugh slowly .	slowly laugh bowls wrong .
clever buttons laugh quietly .	quietly laugh buttons clever .
boring books talk quickly .	boring talk books quickly .
helpful crayons practice quickly .	helpful quickly practice crayons .
busy bags wave quickly .	bags wave quickly busy .
curious bottles wave quickly .	quickly bottles wave curious .
strong toys cough quickly .	cough quickly strong toys .
important candles cough perfectly .	important perfectly cough candles .
bored plates paint quickly .	quickly plates paint bored .
tired bags smile perfectly .	smile bags tired perfectly .
excited books practice quietly .	practice books quietly excited .
hungry trucks cry quietly .	trucks hungry quietly cry .
angry books yell perfectly .	perfectly angry yell books .
confused cars exercise carefully .	confused carefully exercise cars .
surprised trucks whisper quickly .	whisper trucks quickly surprised .
surprised dolls lie perfectly .	lie perfectly surprised dolls .
wrong beds yell slowly .	beds yell slowly wrong .
tired candles lose quickly .	candles quickly tired lose .
wrong trucks scream slowly .	scream wrong trucks slowly .
busy books sing quickly .	quickly sing busy books .
happy bottles cough carefully .	bottles happy carefully cough .
nice shoes read quickly .	read nice quickly shoes .
careful plates win quietly .	careful win quietly plates .
wrong shoes lose quietly .	quietly lose shoes wrong .
hungry shirts talk perfectly .	shirts perfectly hungry talk .
kind buttons stretch slowly .	slowly buttons stretch kind .
confused crayons sneeze carefully .	confused carefully sneeze crayons .
young forks exercise slowly .	slowly exercise young forks .
busy cars stretch carefully .	busy carefully cars stretch .
hungry dishes scream carefully .	carefully hungry scream dishes .
tall candles sing carefully .	sing candles carefully tall .
lucky beds yell quickly .	quickly yell beds lucky .
hungry bowls sing carefully .	hungry carefully sing bowls .
healthy cars paint perfectly .	paint cars perfectly healthy .
gentle rings laugh quickly .	quickly rings gentle laugh .
healthy buttons laugh slowly .	buttons healthy slowly laugh .
curious boxes smile slowly .	boxes curious smile slowly .
lucky windows cough perfectly .	perfectly lucky cough windows .
confused toys wave quickly .	toys quickly confused wave .
gentle shoes smile quickly .	smile shoes quickly gentle .
surprised spoons whisper quickly .	whisper surprised spoons quickly .
excited pictures yell quietly .	quietly pictures yell excited .
upset cars paint perfectly .	paint perfectly cars upset .
quiet plates sing slowly .	slowly plates sing quiet .
important spoons lie carefully .	lie important spoons carefully .
excited books smile slowly .	excited slowly books smile .
healthy hats talk quickly .	healthy talk quickly hats .
nice books exercise perfectly .	exercise nice perfectly books .
surprised dishes cry slowly .	dishes cry surprised slowly .
tall cars whisper quietly .	quietly cars whisper tall .
friendly glasses cry quietly .	friendly cry quietly glasses .
curious bottles win slowly .	win curious slowly bottles .
angry bottles cry slowly .	bottles cry slowly angry .
tired boxes yell carefully .	boxes tired yell carefully .
sleepy glasses sing quickly .	quickly sing sleepy glasses .
kind windows lose carefully .	lose kind carefully windows .
happy bowls sneeze carefully .	bowls happy sneeze carefully .
careful books sneeze perfectly .	perfectly books careful sneeze .
boring toys practice quickly .	toys quickly practice boring .
nice glasses whisper quickly .	quickly whisper nice glasses .
gentle doors win slowly .	doors win slowly gentle .
confused windows talk carefully .	windows confused carefully talk .
upset forks stretch quickly .	stretch forks quickly upset .
angry hats lie slowly .	slowly hats angry lie .
young crayons smile quickly .	smile young quickly crayons .
careful toys wave quickly .	quickly careful wave toys .
careful plates sneeze perfectly .	careful perfectly plates sneeze .
young books lie slowly .	young slowly lie books .
wrong dishes scream carefully .	carefully wrong scream dishes .
quiet shoes lose quietly .	lose shoes quietly quiet .
friendly bowls talk slowly .	friendly talk bowls slowly .
young chairs wave perfectly .	young wave chairs perfectly .
busy cups talk slowly .	talk cups busy slowly .
helpful bags scream quietly .	quietly bags helpful scream .
smart bottles yell slowly .	yell slowly smart bottles .
surprised boxes wave carefully .	surprised wave boxes carefully .
busy candles scream quietly .	scream busy quietly candles .
kind buttons win slowly .	kind slowly buttons win .
sleepy forks laugh carefully .	sleepy laugh forks carefully .
clever trucks paint carefully .	carefully paint clever trucks .
bored hats whisper quietly .	hats whisper bored quietly .
bored hats lose perfectly .	bored perfectly hats lose .
important cars sneeze carefully .	cars important carefully sneeze .
helpful cars cough slowly .	cough cars helpful slowly .
healthy chairs cough perfectly .	perfectly cough healthy chairs .
helpful pictures paint perfectly .	perfectly paint pictures helpful .
bored spoons talk perfectly .	spoons talk perfectly bored .
important trucks cry quietly .	cry trucks quietly important .
happy beds stretch slowly .	beds stretch happy slowly .
happy bottles cry perfectly .	bottles cry perfectly happy .
healthy crayons paint quietly .	paint quietly healthy crayons .
busy chairs wave quickly .	wave chairs quickly busy .
nice chairs lie quietly .	chairs quietly nice lie .
tired pictures wave quietly .	pictures tired wave quietly .
lucky boxes cry quickly .	quickly boxes lucky cry .
confused beds win perfectly .	confused win beds perfectly .
wrong doors win perfectly .	perfectly wrong win doors .
smart dishes practice carefully .	practice smart dishes carefully .
friendly windows paint quickly .	windows paint friendly quickly .
surprised cups whisper slowly .	cups surprised whisper slowly .
sleepy windows talk slowly .	windows talk slowly sleepy .
busy trucks practice slowly .	trucks busy practice slowly .
tired buttons smile quietly .	buttons smile quietly tired .
confused plates talk perfectly .	talk plates confused perfectly .
angry cups paint quietly .	paint cups quietly angry .
healthy cars whisper slowly .	cars whisper healthy slowly .
healthy cups laugh quickly .	cups laugh quickly healthy .
smart crayons cry carefully .	cry smart carefully crayons .
upset glasses read quickly .	quickly read glasses upset .
confused books cry quickly .	confused quickly books cry .
confused shirts cry carefully .	cry carefully confused shirts .
angry rings laugh perfectly .	angry perfectly laugh rings .
tired crayons laugh carefully .	tired carefully laugh crayons .
happy plates laugh slowly .	laugh plates happy slowly .
helpful boats talk perfectly .	talk perfectly boats helpful .
busy trucks stretch quietly .	busy stretch quietly trucks .
confused bags laugh quickly .	confused laugh bags quickly .
quiet shoes lie slowly .	shoes slowly lie quiet .
helpful cars read slowly .	cars slowly read helpful .
angry candles sing carefully .	angry sing candles carefully .
smart bags wave slowly .	slowly wave smart bags .
confused glasses practice perfectly .	confused practice perfectly glasses .
smart crayons laugh carefully .	crayons smart carefully laugh .
healthy shoes cough slowly .	slowly cough shoes healthy .
nice crayons exercise perfectly .	nice exercise crayons perfectly .
busy books laugh quietly .	books quietly laugh busy .
surprised windows yell quickly .	surprised quickly windows yell .
curious glasses read quietly .	curious read quietly glasses .
hungry hats lose carefully .	hats hungry lose carefully .
bored chairs cough perfectly .	cough chairs bored perfectly .
happy crayons lose perfectly .	crayons perfectly happy lose .
kind dishes talk slowly .	kind slowly talk dishes .
tired cars scream quickly .	quickly scream cars tired .
confused windows stretch carefully .	stretch carefully confused windows .
clever boxes paint slowly .	boxes paint clever slowly .
gentle shirts lose quietly .	gentle quietly shirts lose .
young cars scream carefully .	young scream carefully cars .
wrong doors practice quietly .	practice doors wrong quietly .
strong dishes talk perfectly .	perfectly dishes talk strong .
friendly hats sing perfectly .	sing hats perfectly friendly .
busy glasses whisper perfectly .	whisper busy glasses perfectly .
quiet shirts talk quickly .	talk quickly shirts quiet .
friendly doors lie carefully .	friendly carefully lie doors .
important toys practice quickly .	practice quickly important toys .
bored rings cry quietly .	cry rings bored quietly .
boring books cry perfectly .	books boring cry perfectly .
tired bags read perfectly .	bags perfectly tired read .
young beds lose quietly .	young lose quietly beds .
angry crayons smile quietly .	angry smile crayons quietly .
gentle bowls laugh carefully .	carefully laugh gentle bowls .
quiet candles win quickly .	win candles quiet quickly .
angry boats lie slowly .	angry lie slowly boats .
helpful crayons whisper slowly .	slowly whisper crayons helpful .
confused boxes practice slowly .	slowly boxes practice confused .
curious windows laugh slowly .	curious slowly laugh windows .
tired shoes laugh perfectly .	laugh shoes tired perfectly .
boring windows win carefully .	carefully boring win windows .
helpful trucks read perfectly .	helpful read trucks perfectly .
busy toys paint slowly .	toys busy paint slowly .
angry boats practice quickly .	practice boats angry quickly .
sleepy boats cough quietly .	quietly boats sleepy cough .
quiet dolls win quietly .	win quietly dolls quiet .
busy cars exercise quietly .	exercise cars busy quietly .
smart boxes sneeze perfectly .	smart perfectly boxes sneeze .
surprised chairs talk quietly .	talk surprised chairs quietly .
strong dolls paint perfectly .	dolls strong perfectly paint .
tall doors scream perfectly .	perfectly scream tall doors .
busy shoes lie carefully .	carefully shoes busy lie .
angry hats laugh perfectly .	angry laugh hats perfectly .
gentle bags yell perfectly .	yell gentle bags perfectly .
boring glasses yell slowly .	boring slowly glasses yell .
busy bags sing carefully .	carefully sing busy bags .
nice chairs cry carefully .	nice cry carefully chairs .
bored chairs exercise carefully .	chairs carefully bored exercise .
smart hats paint perfectly .	perfectly smart paint hats .
confused boxes sneeze perfectly .	boxes perfectly sneeze confused .
tall cars whisper perfectly .	cars tall whisper perfectly .
lucky chairs talk quietly .	talk quietly chairs lucky .
clever boats sneeze perfectly .	perfectly sneeze boats clever .
quiet plates exercise carefully .	exercise carefully plates quiet .
upset doors talk quickly .	upset quickly talk doors .
wrong crayons sneeze quickly .	sneeze quickly crayons wrong .
boring dishes stretch quietly .	quietly stretch dishes boring .
kind cars cough slowly .	cars kind slowly cough .
friendly buttons sing quietly .	friendly sing buttons quietly .
careful books sing perfectly .	sing perfectly careful books .
kind rings whisper perfectly .	rings perfectly kind whisper .
boring boxes cry quietly .	cry quietly boxes boring .
careful doors read quickly .	quickly careful read doors .
wrong rings cry quietly .	rings quietly cry wrong .
gentle doors sneeze slowly .	gentle sneeze doors slowly .
upset toys yell quickly .	upset yell toys quickly .
strong chairs stretch quietly .	quietly chairs stretch strong .
kind bowls yell slowly .	slowly yell kind bowls .
nice chairs stretch carefully .	stretch carefully chairs nice .
careful dolls lie quickly .	quickly lie careful dolls .
careful hats whisper carefully .	hats whisper careful carefully .
nice buttons smile carefully .	carefully buttons nice smile .
curious trucks read carefully .	read trucks carefully curious .
busy spoons stretch slowly .	spoons busy slowly stretch .
hungry dolls wave quickly .	quickly hungry wave dolls .
important books yell quietly .	quietly important yell books .
careful dolls win carefully .	dolls carefully win careful .
clever forks read perfectly .	perfectly clever read forks .
clever books smile slowly .	clever smile books slowly .
friendly forks read carefully .	forks friendly carefully read .
tall hats practice quickly .	quickly practice hats tall .
smart spoons paint carefully .	paint smart carefully spoons .
wrong doors paint quietly .	quietly doors wrong paint .
excited boats practice perfectly .	practice excited perfectly boats .
helpful beds lose perfectly .	lose helpful beds perfectly .
surprised boats sneeze quickly .	boats sneeze surprised quickly .
helpful spoons laugh slowly .	slowly spoons helpful laugh .
curious hats lose quickly .	curious lose hats quickly .
surprised bottles cough quietly .	cough bottles surprised quietly .
bored dolls win carefully .	win carefully dolls bored .
busy beds whisper carefully .	busy carefully whisper beds .
busy pictures smile carefully .	smile carefully busy pictures .
tall candles cry quickly .	tall cry quickly candles .
sleepy trucks talk slowly .	trucks slowly sleepy talk .
friendly bags exercise carefully .	bags carefully exercise friendly .
confused hats practice quickly .	practice confused hats quickly .
friendly boxes laugh quickly .	quickly laugh friendly boxes .
excited windows exercise quickly .	quickly windows excited exercise .
excited candles lose perfectly .	perfectly lose excited candles .
confused pictures paint quickly .	pictures paint confused quickly .
excited beds lose perfectly .	beds excited lose perfectly .
clever cups win carefully .	clever win carefully cups .
helpful chairs win slowly .	win helpful chairs slowly .
tired candles smile perfectly .	tired smile perfectly candles .
busy forks paint carefully .	busy paint carefully forks .
kind hats exercise quietly .	kind exercise hats quietly .
friendly books cough slowly .	friendly slowly books cough .
tall boxes scream slowly .	tall slowly scream boxes .
curious books read quickly .	read curious quickly books .
sleepy plates lie carefully .	lie carefully sleepy plates .
kind hats cry quickly .	quickly cry kind hats .
tired windows sing quietly .	windows tired quietly sing .
tired dolls sing quickly .	tired quickly dolls sing .
confused dolls scream carefully .	scream confused dolls carefully .
confused plates win quietly .	win confused plates quietly .
excited beds talk quietly .	beds talk excited quietly .
confused bowls sneeze slowly .	sneeze bowls confused slowly .
gentle crayons smile slowly .	crayons gentle slowly smile .
gentle rings sing quietly .	quietly rings sing gentle .
happy rings yell slowly .	rings happy yell slowly .
careful doors laugh perfectly .	perfectly careful laugh doors .
confused books paint slowly .	books slowly confused paint .
happy cars wave carefully .	cars carefully wave happy .
hungry cups laugh quickly .	hungry quickly laugh cups .
curious bowls stretch carefully .	carefully bowls curious stretch .
busy bottles lose perfectly .	busy perfectly lose bottles .
young boats lose slowly .	lose boats young slowly .
hungry buttons lose carefully .	lose hungry buttons carefully .
clever plates sneeze slowly .	slowly plates clever sneeze .
smart shirts sing perfectly .	shirts perfectly sing smart .
healthy dolls sneeze perfectly .	perfectly healthy sneeze dolls .
boring dolls lie carefully .	carefully lie dolls boring .
friendly chairs lose perfectly .	chairs perfectly lose friendly .
hungry cups practice perfectly .	perfectly practice cups hungry .
kind books cry carefully .	kind carefully books cry .
kind books lie quickly .	lie kind books quickly .
tired doors smile perfectly .	tired smile doors perfectly .
angry cups exercise perfectly .	angry perfectly exercise cups .
boring forks laugh carefully .	boring laugh forks carefully .
kind bowls practice perfectly .	perfectly bowls practice kind .
bored glasses paint carefully .	bored carefully paint glasses .
sleepy cars cry slowly .	cry slowly cars sleepy .
bored crayons cry perfectly .	perfectly crayons cry bored .
important glasses paint quietly .	glasses important quietly paint .
busy forks practice slowly .	practice slowly busy forks .
surprised crayons cry carefully .	crayons cry surprised carefully .
clever plates lose quietly .	plates quietly lose clever .
gentle crayons talk quickly .	crayons gentle quickly talk .
careful beds lie slowly .	beds careful slowly lie .
angry dolls exercise slowly .	angry slowly dolls exercise .
kind spoons cough carefully .	kind cough carefully spoons .
happy cars wave quickly .	cars quickly wave happy .
sleepy boxes wave perfectly .	wave perfectly boxes sleepy .
quiet cars laugh quickly .	cars quickly laugh quiet .
sleepy shirts yell slowly .	yell sleepy shirts slowly .
sleepy beds lose perfectly .	lose sleepy beds perfectly .
happy cars yell quickly .	yell cars happy quickly .
gentle dolls paint perfectly .	dolls gentle perfectly paint .
tired cars wave quickly .	wave cars quickly tired .
smart shoes read quickly .	shoes smart quickly read .
gentle books yell perfectly .	perfectly books yell gentle .
young bottles read perfectly .	perfectly bottles young read .
important plates exercise slowly .	plates slowly exercise important .
important shirts stretch quickly .	quickly shirts important stretch .
important books stretch carefully .	books stretch important carefully .
helpful buttons read slowly .	read slowly buttons helpful .
boring forks yell quickly .	forks yell boring quickly .
careful bags cry carefully .	carefully cry bags careful .
tired cars sing perfectly .	cars tired perfectly sing .
helpful toys stretch carefully .	carefully stretch toys helpful .
helpful bowls paint quickly .	bowls quickly helpful paint .
strong books sing slowly .	books sing slowly strong .
friendly dishes read carefully .	carefully dishes friendly read .
curious boxes exercise perfectly .	curious exercise boxes perfectly .
sleepy spoons stretch quietly .	sleepy quietly spoons stretch .
important chairs stretch slowly .	slowly stretch chairs important .
tired crayons lose quickly .	lose quickly crayons tired .
strong glasses talk quietly .	talk glasses strong quietly .
surprised books wave carefully .	books carefully wave surprised .
lucky bowls lose quietly .	quietly lose lucky bowls .
tired trucks read quietly .	trucks tired read quietly .
boring toys laugh quickly .	boring laugh toys quickly .
confused cars wave perfectly .	cars perfectly confused wave .
young chairs yell slowly .	slowly chairs young yell .
tired beds read quickly .	read quickly tired beds .
quiet doors cough perfectly .	doors quiet perfectly cough .
clever forks practice quietly .	clever practice quietly forks .
important shoes scream quietly .	important scream quietly shoes .
friendly toys lose slowly .	lose friendly slowly toys .
boring doors yell perfectly .	doors boring yell perfectly .
curious rings cry carefully .	curious carefully cry rings .
tall books sing perfectly .	books sing perfectly tall .
hungry hats read quickly .	quickly hungry read hats .
nice chairs practice quickly .	practice chairs quickly nice .
friendly cars lose quickly .	lose cars friendly quickly .
wrong books sing quietly .	sing quietly wrong books .
helpful plates read carefully .	carefully helpful read plates .
curious bowls sneeze perfectly .	curious sneeze bowls perfectly .
friendly beds exercise carefully .	exercise friendly beds carefully .
important chairs wave quickly .	chairs quickly important wave .
gentle chairs read quickly .	gentle read quickly chairs .
nice crayons lie slowly .	slowly lie nice crayons .
excited books yell carefully .	carefully excited yell books .
busy books sing carefully .	carefully busy sing books .
clever spoons cough perfectly .	perfectly spoons clever cough .
hungry candles read quietly .	candles hungry read quietly .
bored bags paint quickly .	bored quickly bags paint .
smart books read slowly .	books smart slowly read .
quiet cars lie slowly .	lie quiet cars slowly .
busy bottles sing quietly .	sing busy bottles quietly .
sleepy bowls laugh perfectly .	perfectly bowls laugh sleepy .
busy bags exercise carefully .	carefully exercise busy bags .
friendly plates cry slowly .	friendly slowly plates cry .
friendly books lie perfectly .	books perfectly lie friendly .
angry bags practice quietly .	quietly bags angry practice .
sleepy books sing carefully .	sleepy carefully sing books .
happy spoons lose carefully .	lose carefully happy spoons .
tired cars smile perfectly .	tired smile perfectly cars .
lucky forks paint slowly .	lucky slowly paint forks .
busy bowls yell perfectly .	bowls busy perfectly yell .
important plates smile perfectly .	perfectly smile important plates .
angry bottles stretch carefully .	angry carefully stretch bottles .
happy books lose quickly .	books happy quickly lose .
friendly windows cough perfectly .	cough windows friendly perfectly .
helpful dishes cough quickly .	cough dishes helpful quickly .
angry candles scream carefully .	candles carefully scream angry .
hungry forks lie slowly .	forks slowly lie hungry .
upset pictures cry quietly .	upset quietly cry pictures .
sleepy shoes yell quickly .	yell sleepy shoes quickly .
young crayons win perfectly .	perfectly win young crayons .
angry books laugh quietly .	quietly books laugh angry .
clever glasses exercise quietly .	exercise clever quietly glasses .
happy shoes read slowly .	slowly read shoes happy .
strong cars exercise perfectly .	strong perfectly cars exercise .
bored forks cough carefully .	bored carefully cough forks .
upset cars wave quickly .	wave upset quickly cars .
important doors lose slowly .	slowly doors lose important .
happy windows yell quietly .	windows quietly yell happy .
happy crayons whisper quietly .	happy quietly whisper crayons .
smart toys yell slowly .	smart slowly yell toys .
clever boxes practice quickly .	boxes practice clever quickly .
clever bottles scream quietly .	quietly clever scream bottles .
wrong bags wave quickly .	bags quickly wrong wave .
kind cars laugh perfectly .	perfectly laugh kind cars .
surprised forks wave perfectly .	perfectly surprised wave forks .
curious books cough slowly .	books slowly curious cough .
surprised boxes whisper carefully .	carefully whisper surprised boxes .
busy crayons cry perfectly .	crayons cry perfectly busy .
upset trucks practice perfectly .	trucks practice perfectly upset .
tall books yell quietly .	yell tall books quietly .
tired glasses wave quickly .	tired quickly glasses wave .
smart candles lie carefully .	lie smart carefully candles .
healthy beds wave carefully .	beds healthy wave carefully .
strong bottles paint quietly .	strong quietly bottles paint .
busy cups paint carefully .	carefully cups busy paint .
excited pictures sing quickly .	sing quickly excited pictures .
quiet shoes wave perfectly .	shoes perfectly wave quiet .
nice rings paint slowly .	slowly rings nice paint .
gentle cars exercise quickly .	quickly gentle exercise cars .
lucky dishes sneeze quickly .	dishes quickly sneeze lucky .
wrong crayons smile perfectly .	crayons wrong smile perfectly .
hungry shirts yell carefully .	hungry carefully yell shirts .
kind buttons scream quickly .	scream kind buttons quickly .
surprised plates paint quickly .	plates surprised quickly paint .
wrong chairs wave quickly .	wave chairs wrong quickly .
nice cars practice quietly .	practice quietly cars nice .
hungry trucks lose quietly .	trucks lose quietly hungry .
young hats lose carefully .	young lose carefully hats .
busy candles wave quietly .	quietly candles busy wave .
hungry candles cough quietly .	hungry quietly cough candles .
kind books wave slowly .	kind slowly books wave .
smart hats win quickly .	hats quickly win smart .
gentle windows sing perfectly .	perfectly sing gentle windows .
boring spoons cough carefully .	cough spoons boring carefully .
smart shirts paint perfectly .	smart paint shirts perfectly .
boring plates laugh quietly .	laugh boring quietly plates .
bored boxes whisper slowly .	slowly boxes whisper bored .
angry shirts whisper perfectly .	angry perfectly shirts whisper .
tired chairs exercise slowly .	slowly exercise chairs tired .
hungry cars win perfectly .	perfectly cars win hungry .
important dolls scream carefully .	dolls scream carefully important .
happy cars win quickly .	quickly win happy cars .
excited cars whisper quietly .	excited whisper cars quietly .
tired spoons win quickly .	spoons win tired quickly .
helpful forks talk carefully .	carefully talk helpful forks .
upset bowls practice perfectly .	bowls perfectly upset practice .
upset pictures practice slowly .	pictures slowly practice upset .
surprised buttons cry quietly .	cry quietly surprised buttons .
sleepy pictures cry perfectly .	perfectly cry sleepy pictures .
nice plates win carefully .	nice carefully win plates .
nice dolls exercise carefully .	exercise dolls carefully nice .
hungry spoons laugh quietly .	quietly laugh hungry spoons .
upset chairs cough slowly .	chairs cough slowly upset .
careful cars sing carefully .	carefully sing careful cars .
helpful shoes cough quickly .	helpful quickly cough shoes .
angry shoes cry quickly .	cry quickly angry shoes .
bored cars cry slowly .	slowly cars cry bored .
tired trucks smile quietly .	quietly trucks tired smile .
important candles smile perfectly .	perfectly candles smile important .
nice boats read carefully .	nice carefully boats read .
strong dolls practice perfectly .	dolls perfectly practice strong .
wrong rings wave carefully .	rings wrong carefully wave .
wrong boxes exercise quietly .	wrong quietly exercise boxes .
lucky boxes sing slowly .	lucky slowly boxes sing .
tired trucks lose quickly .	lose trucks quickly tired .
boring hats sing quickly .	hats quickly sing boring .
tired buttons cry carefully .	carefully buttons cry tired .
important boats cry quietly .	boats cry quietly important .
smart hats talk slowly .	slowly talk smart hats .
tall books wave perfectly .	perfectly books tall wave .
quiet boxes wave slowly .	quiet wave slowly boxes .
friendly cars stretch perfectly .	friendly stretch perfectly cars .
tired crayons laugh perfectly .	perfectly laugh tired crayons .
young cars stretch quietly .	stretch quietly young cars .
careful hats win carefully .	hats win careful carefully .
surprised spoons scream quickly .	surprised scream spoons quickly .
wrong hats lose quickly .	quickly wrong lose hats .
excited chairs sing quietly .	quietly chairs excited sing .
healthy forks yell quickly .	yell quickly forks healthy .
bored spoons yell slowly .	bored slowly yell spoons .
upset shoes sing perfectly .	upset sing perfectly shoes .
tired cars sing slowly .	slowly cars sing tired .
sleepy hats cry perfectly .	cry perfectly hats sleepy .
careful trucks sing quietly .	trucks quietly careful sing .
busy boats practice perfectly .	perfectly practice busy boats .
happy trucks practice quickly .	happy practice trucks quickly .
helpful spoons sneeze quickly .	sneeze helpful quickly spoons .
young candles talk slowly .	young talk slowly candles .
gentle beds practice carefully .	practice carefully beds gentle .
confused spoons exercise quietly .	quietly spoons exercise confused .
surprised plates sing carefully .	plates sing carefully surprised .
nice boats sing quietly .	quietly boats nice sing .
busy rings whisper slowly .	whisper slowly busy rings .
important buttons read quickly .	read important buttons quickly .
smart shoes cry slowly .	shoes smart slowly cry .
lucky toys lose quietly .	lucky lose quietly toys .
tired dolls cough quickly .	cough tired dolls quickly .
quiet beds laugh carefully .	quiet laugh carefully beds .
tired cups sing quickly .	cups quickly sing tired .
helpful cars lose carefully .	lose helpful cars carefully .
careful windows exercise slowly .	windows slowly careful exercise .
young bowls stretch perfectly .	bowls perfectly stretch young .
curious chairs cry quietly .	cry curious quietly chairs .
angry boats exercise quickly .	exercise boats angry quickly .
smart cars yell perfectly .	smart yell cars perfectly .
kind boxes sing carefully .	carefully sing kind boxes .
tired cars cry perfectly .	cry cars perfectly tired .
boring books talk perfectly .	boring talk perfectly books .
confused cars practice slowly .	cars practice slowly confused .
tired hats exercise quickly .	quickly exercise hats tired .
tired toys exercise slowly .	tired exercise slowly toys .
busy buttons smile quietly .	quietly smile buttons busy .
careful spoons lose quietly .	lose spoons quietly careful .
lucky buttons talk quickly .	quickly buttons talk lucky .
busy books whisper perfectly .	books perfectly busy whisper .
healthy buttons stretch quietly .	quietly healthy stretch buttons .
surprised cars whisper quickly .	cars whisper surprised quickly .
tall candles yell carefully .	carefully yell candles tall .
kind glasses wave perfectly .	wave glasses kind perfectly .
confused toys lie carefully .	toys carefully lie confused .
quiet hats lose perfectly .	quiet perfectly hats lose .
wrong books paint quickly .	books paint quickly wrong .
angry bags lose quickly .	lose bags quickly angry .
helpful candles stretch perfectly .	helpful stretch perfectly candles .
angry doors paint carefully .	paint doors angry carefully .
surprised crayons practice quickly .	practice crayons quickly surprised .
surprised rings stretch carefully .	rings carefully stretch surprised .
smart dolls lie perfectly .	lie dolls perfectly smart .
quiet shirts yell quickly .	shirts quickly yell quiet .
boring spoons whisper quietly .	whisper boring spoons quietly .
tired boats talk slowly .	talk boats slowly tired .
boring buttons win quickly .	win quickly boring buttons .
nice cars lose slowly .	lose cars slowly nice .
careful books yell quickly .	books quickly yell careful .
helpful cars cough quickly .	cough quickly cars helpful .
excited boats whisper carefully .	carefully boats excited whisper .
tall books wave carefully .	wave books carefully tall .
healthy books wave quietly .	quietly books healthy wave .
quiet spoons scream quietly .	quietly spoons scream quiet .
confused cars win perfectly .	perfectly cars win confused .
angry beds lie quietly .	quietly beds lie angry .
busy glasses lose quietly .	busy quietly glasses lose .
gentle shoes paint quickly .	paint gentle shoes quickly .
curious bottles sing slowly .	sing slowly bottles curious .
clever shirts smile quietly .	quietly shirts clever smile .
clever cars whisper slowly .	slowly cars whisper clever .
smart crayons win quietly .	win quietly crayons smart .
healthy doors sneeze quickly .	healthy quickly doors sneeze .
bored hats laugh quickly .	bored quickly hats laugh .
healthy bags lie quickly .	healthy lie bags quickly .
nice bags lose quickly .	nice lose bags quickly .
tired bags scream perfectly .	bags tired perfectly scream .
angry hats wave perfectly .	hats angry perfectly wave .
curious candles cry perfectly .	curious perfectly cry candles .
friendly pictures lose carefully .	friendly carefully lose pictures .
important buttons cry perfectly .	perfectly buttons important cry .
wrong dolls sneeze quietly .	dolls wrong quietly sneeze .
nice boats sing slowly .	slowly sing nice boats .
sleepy shoes exercise slowly .	exercise shoes sleepy slowly .
careful beds scream perfectly .	beds perfectly scream careful .
busy dishes lose perfectly .	lose busy perfectly dishes .
nice plates wave quietly .	quietly wave nice plates .
lucky forks talk slowly .	forks slowly lucky talk .
smart cars read carefully .	smart read cars carefully .
curious spoons whisper quietly .	curious whisper spoons quietly .
quiet dolls lose quietly .	quiet quietly dolls lose .
kind cars talk perfectly .	kind perfectly cars talk .
angry hats wave slowly .	wave slowly hats angry .
happy books exercise quickly .	exercise books quickly happy .
wrong pictures practice quickly .	wrong practice pictures quickly .
careful dolls practice quietly .	careful quietly practice dolls .
lucky windows sing carefully .	carefully lucky sing windows .
surprised candles talk quickly .	talk surprised quickly candles .
upset cars wave quickly .	cars wave upset quickly .
young dishes lose perfectly .	young lose perfectly dishes .
busy doors cry quickly .	busy cry quickly doors .
curious cars stretch slowly .	stretch cars curious slowly .
wrong boats exercise perfectly .	boats wrong perfectly exercise .
young books read quietly .	quietly read young books .
busy hats whisper quickly .	busy quickly whisper hats .
young books cough carefully .	cough books young carefully .
young chairs paint slowly .	young paint slowly chairs .
important candles win slowly .	win candles slowly important .
busy doors sing slowly .	sing slowly busy doors .
excited boats wave slowly .	excited wave boats slowly .
surprised dolls talk quickly .	dolls surprised quickly talk .
healthy shoes sing perfectly .	shoes sing healthy perfectly .
gentle dishes yell carefully .	dishes gentle carefully yell .
healthy bottles paint carefully .	paint healthy bottles carefully .
angry cups talk quietly .	quietly talk angry cups .
sleepy bowls yell quickly .	quickly bowls yell sleepy .
busy boxes yell perfectly .	perfectly boxes busy yell .
healthy plates whisper slowly .	whisper slowly healthy plates .
quiet forks win slowly .	forks slowly win quiet .
lucky bowls paint quietly .	paint quietly lucky bowls .
careful books cry carefully .	careful cry carefully books .
bored bottles sing carefully .	bored carefully sing bottles .
surprised boats sing carefully .	carefully boats sing surprised .
bored boxes cry perfectly .	perfectly cry boxes bored .
curious bowls talk carefully .	bowls talk carefully curious .
gentle cups cough quickly .	quickly cough cups gentle .
smart plates exercise carefully .	plates carefully smart exercise .
clever beds lose quickly .	clever lose beds quickly .
upset buttons lose perfectly .	buttons lose perfectly upset .
important shirts cough perfectly .	important perfectly cough shirts .
friendly toys scream quietly .	quietly toys friendly scream .
careful beds lose slowly .	slowly beds careful lose .
tall windows practice quickly .	quickly windows practice tall .
bored rings sing perfectly .	perfectly rings sing bored .
tall shirts cry quietly .	cry quietly tall shirts .
friendly chairs sing quietly .	chairs friendly quietly sing .
tired books practice perfectly .	practice books perfectly tired .
boring glasses lie slowly .	glasses lie boring slowly .
curious glasses scream quickly .	scream quickly glasses curious .
bored doors stretch quickly .	quickly bored stretch doors .
helpful candles scream quickly .	candles scream helpful quickly .
careful beds cough quietly .	cough beds quietly careful .
careful doors smile quietly .	quietly smile careful doors .
young plates whisper carefully .	plates carefully whisper young .
confused bowls lose quietly .	confused quietly bowls lose .
nice books practice perfectly .	books perfectly nice practice .
curious forks read perfectly .	curious read perfectly forks .
helpful windows sneeze slowly .	sneeze helpful windows slowly .
curious spoons exercise quietly .	curious quietly exercise spoons .
important shirts practice perfectly .	practice shirts perfectly important .
boring glasses wave quickly .	glasses boring quickly wave .
busy dolls sing quickly .	busy quickly sing dolls .
confused toys smile slowly .	smile slowly confused toys .
wrong forks talk carefully .	forks carefully talk wrong .
smart dolls sneeze quickly .	quickly sneeze smart dolls .
lucky beds win carefully .	carefully beds win lucky .
curious pictures talk perfectly .	perfectly pictures curious talk .
healthy bags win slowly .	win healthy slowly bags .
smart rings talk slowly .	rings smart talk slowly .
strong forks exercise slowly .	exercise strong forks slowly .
kind shoes talk quietly .	kind talk quietly shoes .
tired cars smile quietly .	smile quietly cars tired .
smart buttons scream perfectly .	scream perfectly smart buttons .
wrong toys sneeze quickly .	toys sneeze quickly wrong .
nice buttons talk carefully .	buttons nice talk carefully .
upset rings cry perfectly .	upset cry perfectly rings .
kind dolls exercise quickly .	dolls quickly exercise kind .
quiet bowls exercise quickly .	exercise quickly bowls quiet .
lucky beds exercise slowly .	lucky slowly exercise beds .
tired books sing perfectly .	perfectly sing tired books .
hungry crayons whisper slowly .	hungry whisper slowly crayons .
happy candles smile slowly .	happy smile candles slowly .
young shirts wave carefully .	young wave shirts carefully .
healthy forks paint quickly .	paint quickly forks healthy .
careful beds paint perfectly .	perfectly beds careful paint .
important rings lie slowly .	slowly lie rings important .
healthy books sneeze quietly .	sneeze books quietly healthy .
quiet windows sing quickly .	windows quiet sing quickly .
happy buttons cry quickly .	cry buttons quickly happy .
helpful pictures yell quietly .	helpful yell quietly pictures .
young boats laugh quietly .	quietly young laugh boats .
young shirts yell quickly .	shirts quickly yell young .
young windows laugh carefully .	carefully windows young laugh .
important dishes sneeze quickly .	quickly dishes sneeze important .
quiet bowls lie slowly .	bowls slowly lie quiet .
happy bags win slowly .	bags slowly happy win .
healthy trucks smile perfectly .	healthy perfectly smile trucks .
clever crayons cough perfectly .	crayons perfectly cough clever .
helpful cups stretch quickly .	quickly stretch cups helpful .
boring bags scream quietly .	boring quietly scream bags .
excited cars talk quietly .	excited talk cars quietly .
upset crayons cry slowly .	slowly upset cry crayons .
kind doors sing quietly .	kind quietly sing doors .
wrong dolls laugh slowly .	slowly wrong laugh dolls .
busy beds sneeze carefully .	busy carefully beds sneeze .
boring cups laugh slowly .	slowly laugh cups boring .
confused rings scream carefully .	carefully confused scream rings .
young bowls wave carefully .	carefully wave young bowls .
quiet candles yell carefully .	quiet yell carefully candles .
young trucks exercise quietly .	trucks quietly exercise young .
young forks practice slowly .	slowly practice forks young .
tall plates read carefully .	read plates carefully tall .
hungry windows sneeze slowly .	slowly hungry sneeze windows .
quiet spoons laugh perfectly .	perfectly quiet laugh spoons .
excited boxes cry quietly .	excited cry quietly boxes .
wrong glasses cough quietly .	quietly cough glasses wrong .
confused books smile quietly .	quietly books confused smile .
tall boats lose quietly .	lose quietly tall boats .
confused chairs smile quietly .	confused quietly chairs smile .
friendly toys lie perfectly .	perfectly toys friendly lie .
smart buttons sneeze carefully .	buttons carefully sneeze smart .
smart bottles exercise quietly .	bottles exercise quietly smart .
kind doors exercise carefully .	kind carefully exercise doors .
strong books cry perfectly .	books perfectly cry strong .
healthy crayons practice quietly .	practice crayons quietly healthy .
hungry books paint quickly .	paint quickly books hungry .
nice dishes lose slowly .	slowly lose dishes nice .
healthy books wave perfectly .	wave books perfectly healthy .
busy shirts lie quickly .	shirts quickly lie busy .
confused shoes sing carefully .	sing confused carefully shoes .
helpful candles cough slowly .	cough candles helpful slowly .
surprised candles lie perfectly .	candles surprised perfectly lie .
nice boxes smile slowly .	slowly smile boxes nice .
tall toys practice carefully .	practice carefully tall toys .
tall books lie quickly .	books tall lie quickly .
sleepy cars practice quickly .	sleepy practice cars quickly .
young doors sneeze quickly .	sneeze quickly young doors .
tall crayons smile carefully .	tall carefully crayons smile .
busy cars lie quietly .	busy quietly lie cars .
important dolls stretch perfectly .	perfectly dolls stretch important .
smart glasses stretch carefully .	carefully glasses stretch smart .
upset rings practice quietly .	quietly practice rings upset .
upset hats stretch slowly .	slowly hats upset stretch .
boring beds lose quickly .	boring quickly beds lose .
clever pictures sneeze carefully .	pictures carefully sneeze clever .
wrong pictures laugh quietly .	wrong laugh pictures quietly .
confused boxes read slowly .	boxes confused slowly read .
tired rings wave quickly .	rings tired quickly wave .
helpful crayons cry perfectly .	crayons cry helpful perfectly .
quiet windows laugh carefully .	carefully windows laugh quiet .
tired cars win quietly .	quietly win cars tired .
bored forks stretch carefully .	forks carefully bored stretch .
careful glasses sing quickly .	quickly glasses careful sing .
hungry cars stretch quietly .	cars hungry stretch quietly .
tall bowls read quickly .	bowls tall read quickly .
nice trucks cry perfectly .	trucks cry nice perfectly .
tired cups sing quietly .	sing quietly cups tired .
curious cups win carefully .	cups carefully win curious .
lucky plates wave slowly .	plates lucky wave slowly .
hungry toys lose slowly .	hungry lose toys slowly .
wrong beds sing quickly .	sing quickly beds wrong .
careful bowls smile perfectly .	smile careful perfectly bowls .
helpful bags smile slowly .	helpful slowly smile bags .
hungry cars win perfectly .	win perfectly cars hungry .
helpful doors practice slowly .	practice slowly helpful doors .
upset hats smile perfectly .	perfectly hats smile upset .
bored bowls smile quietly .	quietly bowls bored smile .
important hats lie slowly .	slowly lie hats important .
hungry windows wave slowly .	hungry wave windows slowly .
busy hats exercise carefully .	exercise busy carefully hats .
hungry crayons lie carefully .	crayons lie carefully hungry .
kind cars stretch quickly .	stretch kind cars quickly .
lucky books cough slowly .	cough books lucky slowly .
hungry doors yell carefully .	doors carefully yell hungry .
hungry plates whisper slowly .	slowly plates hungry whisper .
smart toys lose quietly .	toys lose smart quietly .
healthy shoes read quietly .	shoes quietly healthy read .
healthy shirts stretch slowly .	stretch slowly healthy shirts .
important cars stretch perfectly .	cars stretch perfectly important .
confused cups read perfectly .	read perfectly confused cups .
angry dolls read quickly .	quickly dolls read angry .
lucky buttons smile quietly .	quietly smile lucky buttons .
helpful dolls lie perfectly .	perfectly helpful lie dolls .
surprised boats smile slowly .	boats surprised slowly smile .
strong bottles stretch carefully .	carefully stretch strong bottles .
confused shirts win quietly .	shirts confused quietly win .
friendly cars whisper quickly .	friendly quickly whisper cars .
wrong cups yell carefully .	carefully wrong yell cups .
tired chairs lie slowly .	chairs lie slowly tired .
strong cups whisper perfectly .	cups perfectly strong whisper .
wrong beds laugh slowly .	beds laugh wrong slowly .
lucky spoons laugh quietly .	quietly laugh lucky spoons .
kind windows smile perfectly .	perfectly smile kind windows .
happy chairs scream carefully .	scream happy carefully chairs .
confused trucks laugh quickly .	confused quickly laugh trucks .
curious buttons read perfectly .	buttons perfectly curious read .
bored candles whisper quickly .	candles quickly whisper bored .
smart spoons sneeze quietly .	sneeze smart spoons quietly .
bored books practice carefully .	books carefully practice bored .
angry doors sneeze quickly .	doors angry quickly sneeze .
excited buttons wave slowly .	wave excited buttons slowly .
upset candles stretch quietly .	quietly stretch upset candles .
tall shoes cough perfectly .	shoes cough tall perfectly .
quiet spoons read quietly .	read quietly quiet spoons .
nice beds paint carefully .	carefully beds paint nice .
excited plates lie quietly .	quietly lie excited plates .
healthy windows talk quickly .	healthy talk quickly windows .
upset doors exercise perfectly .	exercise upset doors perfectly .
clever boats read quietly .	read quietly clever boats .
important trucks scream quickly .	trucks important scream quickly .
busy bottles practice quickly .	quickly bottles busy practice .
hungry glasses sing carefully .	carefully glasses hungry sing .
friendly dolls practice carefully .	dolls practice carefully friendly .
bored crayons cry quickly .	crayons cry bored quickly .
upset rings yell slowly .	upset yell rings slowly .
quiet books lose slowly .	lose quiet books slowly .
kind cars talk quickly .	quickly cars talk kind .
boring trucks wave quickly .	trucks boring wave quickly .
quiet toys smile quickly .	smile quiet quickly toys .
smart crayons cry carefully .	carefully cry crayons smart .
curious cars cry slowly .	cars cry slowly curious .
happy books stretch slowly .	stretch slowly happy books .
nice glasses wave quietly .	glasses wave quietly nice .
quiet trucks whisper quickly .	quiet whisper trucks quickly .
careful crayons whisper carefully .	whisper careful carefully crayons .
surprised boats stretch carefully .	carefully surprised stretch boats .
smart crayons yell quietly .	crayons quietly yell smart .
upset beds read slowly .	slowly beds read upset .
boring forks exercise quickly .	quickly boring exercise forks .
excited dolls sneeze carefully .	dolls excited sneeze carefully .
healthy cups talk perfectly .	talk healthy cups perfectly .
important boxes exercise quickly .	quickly exercise important boxes .
quiet trucks stretch perfectly .	stretch trucks quiet perfectly .
confused rings wave quietly .	quietly rings confused wave .
confused bottles whisper perfectly .	perfectly whisper bottles confused .
kind shoes talk carefully .	carefully shoes talk kind .
excited pictures talk carefully .	excited carefully talk pictures .
hungry shirts scream quietly .	scream hungry quietly shirts .
important books win quickly .	win important books quickly .
sleepy dishes yell perfectly .	sleepy yell perfectly dishes .
kind books lose quietly .	lose kind books quietly .
angry doors scream slowly .	scream slowly angry doors .
friendly cups yell quickly .	yell friendly cups quickly .
surprised doors lose quietly .	doors lose quietly surprised .
nice cars read perfectly .	read perfectly cars nice .
curious boxes cough quickly .	curious cough boxes quickly .
strong cars stretch carefully .	stretch cars carefully strong .
wrong boxes sing carefully .	boxes wrong sing carefully .
helpful books practice slowly .	practice books helpful slowly .
clever shirts practice quickly .	clever practice quickly shirts .
bored pictures lose carefully .	pictures bored carefully lose .
happy doors smile quickly .	smile quickly happy doors .
important shirts practice carefully .	important practice carefully shirts .
strong buttons cry slowly .	slowly cry buttons strong .
kind shoes yell perfectly .	shoes perfectly yell kind .
confused glasses lie quickly .	quickly glasses confused lie .
boring books win quietly .	quietly win boring books .
excited windows exercise quickly .	excited quickly windows exercise .
clever books sing quietly .	sing books clever quietly .
confused crayons wave quietly .	crayons wave confused quietly .
angry bottles sneeze perfectly .	angry sneeze perfectly bottles .
sleepy windows lie perfectly .	windows sleepy perfectly lie .
angry toys yell perfectly .	toys yell perfectly angry .
boring rings sing quickly .	rings sing boring quickly .
curious glasses cry quickly .	quickly glasses curious cry .
quiet bowls win slowly .	quiet slowly bowls win .
clever boxes sneeze carefully .	sneeze boxes clever carefully .
surprised hats scream perfectly .	scream perfectly hats surprised .
upset rings sing perfectly .	rings sing upset perfectly .
happy beds laugh carefully .	beds laugh happy carefully .
happy rings lie slowly .	lie slowly happy rings .
friendly buttons win slowly .	buttons win friendly slowly .
clever rings whisper quickly .	whisper clever rings quickly .
boring books read perfectly .	perfectly read books boring .
surprised chairs exercise quietly .	exercise surprised quietly chairs .
quiet shirts read slowly .	quiet read shirts slowly .
tall boxes stretch perfectly .	boxes tall perfectly stretch .
busy boxes wave carefully .	boxes wave carefully busy .
tired chairs cough slowly .	chairs tired slowly cough .
smart cars laugh carefully .	cars carefully laugh smart .
healthy books practice slowly .	books healthy slowly practice .
busy dolls yell slowly .	dolls busy slowly yell .
quiet bottles yell carefully .	bottles carefully yell quiet .
strong shirts whisper carefully .	whisper strong shirts carefully .
tired trucks yell carefully .	trucks yell carefully tired .
happy buttons sing quickly .	sing happy buttons quickly .
nice books read slowly .	books read slowly nice .
important shirts talk carefully .	shirts talk carefully important .
tired bags wave quietly .	quietly wave tired bags .
clever plates wave quickly .	plates quickly clever wave .
friendly dolls laugh quickly .	friendly laugh quickly dolls .
angry dishes wave quickly .	quickly dishes angry wave .
helpful boats smile quietly .	smile helpful boats quietly .
surprised doors win quietly .	doors surprised quietly win .
confused toys whisper quietly .	whisper confused quietly toys .
clever shirts whisper quietly .	clever whisper shirts quietly .
quiet boxes lose perfectly .	quiet perfectly boxes lose .
happy spoons stretch perfectly .	spoons perfectly happy stretch .
confused books sneeze slowly .	slowly sneeze confused books .
sleepy cars cry perfectly .	perfectly cry sleepy cars .
friendly books paint carefully .	friendly paint books carefully .
busy plates win quickly .	win quickly plates busy .
gentle chairs talk perfectly .	talk gentle perfectly chairs .
nice boxes exercise carefully .	carefully nice exercise boxes .
clever bags smile slowly .	smile slowly clever bags .
clever books cry quietly .	clever quietly books cry .
helpful dolls read quickly .	quickly read dolls helpful .
quiet shirts cough slowly .	slowly cough shirts quiet .
upset beds cough quietly .	cough upset beds quietly .
careful pictures cough quietly .	pictures careful cough quietly .
sleepy crayons stretch perfectly .	stretch sleepy perfectly crayons .
upset cars lose quietly .	upset lose cars quietly .
quiet toys paint quietly .	toys quietly quiet paint .
boring spoons talk quickly .	quickly spoons talk boring .
helpful rings lie carefully .	carefully lie helpful rings .
surprised boats talk perfectly .	boats surprised perfectly talk .
angry doors practice slowly .	slowly doors angry practice .
tall cars wave slowly .	wave slowly cars tall .
boring shoes paint carefully .	paint boring carefully shoes .
excited rings smile slowly .	excited slowly rings smile .
careful hats win quietly .	win quietly hats careful .
strong dishes paint slowly .	slowly strong paint dishes .
kind bowls lie carefully .	kind carefully lie bowls .
healthy cars win perfectly .	perfectly healthy win cars .
tired candles cry carefully .	cry candles tired carefully .
helpful books wave quietly .	wave quietly books helpful .
busy dolls smile slowly .	busy slowly smile dolls .
surprised dolls practice carefully .	dolls practice surprised carefully .
busy toys scream quietly .	scream toys quietly busy .
excited rings smile carefully .	smile rings carefully excited .
busy crayons practice perfectly .	practice busy crayons perfectly .
important bags lie quietly .	quietly important lie bags .
tall forks stretch slowly .	stretch slowly forks tall .
hungry candles stretch slowly .	hungry slowly candles stretch .
young windows yell carefully .	yell carefully windows young .
strong dishes lose slowly .	dishes strong lose slowly .
confused candles exercise quickly .	exercise candles quickly confused .
sleepy trucks exercise perfectly .	sleepy perfectly trucks exercise .
quiet dolls sing quietly .	sing quietly quiet dolls .
gentle buttons cry quietly .	buttons cry gentle quietly .
happy shoes sing quickly .	shoes sing happy quickly .
friendly books lose quietly .	books lose quietly friendly .
clever rings sneeze perfectly .	rings sneeze perfectly clever .
smart dolls win carefully .	carefully dolls win smart .
gentle chairs stretch quietly .	chairs stretch gentle quietly .
sleepy cups lie quickly .	lie sleepy cups quickly .
excited cars sneeze carefully .	carefully excited sneeze cars .
busy shoes sneeze slowly .	shoes slowly sneeze busy .
excited bags wave quietly .	quietly bags excited wave .
bored boats talk quickly .	talk quickly boats bored .
smart cups cry perfectly .	perfectly cups smart cry .
tired books read perfectly .	books perfectly read tired .
busy forks lose carefully .	carefully forks lose busy .
quiet shirts cry carefully .	shirts carefully cry quiet .
important boats lie perfectly .	perfectly boats lie important .
hungry dolls cry slowly .	dolls cry hungry slowly .
tall rings yell perfectly .	yell tall perfectly rings .
wrong windows lie perfectly .	perfectly lie wrong windows .
lucky boxes scream quietly .	quietly boxes scream lucky .
excited plates talk slowly .	talk plates excited slowly .
smart bottles sing perfectly .	perfectly smart sing bottles .
excited books smile quickly .	quickly smile excited books .
tired crayons paint perfectly .	perfectly crayons tired paint .
clever shoes read quietly .	shoes read clever quietly .
healthy windows scream carefully .	windows carefully scream healthy .
hungry buttons read quickly .	read buttons hungry quickly .
hungry windows win carefully .	windows hungry carefully win .
bored shirts wave perfectly .	bored wave shirts perfectly .
busy candles smile quickly .	smile candles busy quickly .
curious spoons smile quickly .	spoons smile curious quickly .
hungry forks lose quietly .	forks quietly hungry lose .
tall bottles sing quickly .	sing bottles tall quickly .
healthy books lose carefully .	carefully lose healthy books .
excited hats wave perfectly .	perfectly wave hats excited .
quiet doors win perfectly .	quiet perfectly win doors .
careful chairs talk carefully .	chairs talk careful carefully .
confused doors lose perfectly .	lose confused perfectly doors .
boring pictures lose slowly .	boring slowly lose pictures .
strong boats stretch carefully .	boats carefully strong stretch .
wrong dolls laugh carefully .	dolls carefully wrong laugh .
bored trucks exercise slowly .	slowly bored exercise trucks .
gentle bags lie slowly .	gentle lie slowly bags .
surprised dishes lose slowly .	lose surprised dishes slowly .
clever boats scream quickly .	quickly scream clever boats .
important books whisper quickly .	books important whisper quickly .
quiet forks laugh slowly .	slowly quiet laugh forks .
nice boats wave quietly .	boats wave nice quietly .
strong spoons win quietly .	win strong quietly spoons .
wrong cups laugh quietly .	laugh wrong cups quietly .
lucky doors exercise quickly .	exercise quickly lucky doors .
quiet bottles sneeze perfectly .	sneeze perfectly quiet bottles .
tired doors exercise carefully .	exercise doors carefully tired .
tired buttons sneeze quietly .	buttons tired sneeze quietly .
kind pictures smile quickly .	kind smile quickly pictures .
nice candles win quietly .	quietly win nice candles .
smart books cough quietly .	smart quietly books cough .
strong dolls yell perfectly .	perfectly strong yell dolls .
nice windows cough carefully .	windows nice cough carefully .
hungry cars wave carefully .	wave hungry carefully cars .
bored crayons wave quickly .	crayons bored wave quickly .
smart dolls win slowly .	smart slowly dolls win .
upset buttons talk carefully .	buttons talk carefully upset .
lucky chairs read quickly .	read quickly lucky chairs .
tired windows yell carefully .	carefully tired yell windows .
hungry boxes laugh quickly .	boxes hungry quickly laugh .
nice doors smile perfectly .	smile perfectly nice doors .
lucky books talk quickly .	quickly lucky talk books .
friendly dolls cough perfectly .	cough friendly dolls perfectly .
important hats yell quietly .	quietly yell hats important .
quiet toys talk quietly .	quiet talk toys quietly .
tall trucks cough perfectly .	cough perfectly trucks tall .
angry doors read perfectly .	angry read doors perfectly .
boring bottles cry carefully .	cry carefully bottles boring .
friendly cars win perfectly .	friendly win perfectly cars .
tired toys cough slowly .	slowly cough tired toys .
curious hats read carefully .	carefully read curious hats .
excited dishes read carefully .	excited carefully read dishes .
lucky toys sing slowly .	lucky sing slowly toys .
tired rings whisper quickly .	rings quickly whisper tired .
lucky hats laugh slowly .	slowly hats lucky laugh .
kind pictures exercise quietly .	pictures exercise quietly kind .
tall dishes sneeze slowly .	dishes slowly tall sneeze .
bored cars smile carefully .	cars carefully smile bored .
young doors exercise carefully .	doors young carefully exercise .
busy hats practice quietly .	quietly practice hats busy .
surprised crayons exercise quietly .	exercise crayons quietly surprised .
gentle hats cry carefully .	gentle carefully cry hats .
strong bowls lie quietly .	lie bowls quietly strong .
nice bowls scream quickly .	quickly scream bowls nice .
tired pictures stretch slowly .	pictures tired stretch slowly .
friendly forks sing quickly .	sing friendly quickly forks .
wrong beds sneeze perfectly .	beds wrong sneeze perfectly .
important shoes cry carefully .	cry shoes carefully important .
sleepy trucks yell slowly .	sleepy slowly yell trucks .
sleepy boxes lie quickly .	lie quickly boxes sleepy .
kind beds cough quietly .	cough beds kind quietly .
excited bags sing quietly .	quietly excited sing bags .
strong glasses win slowly .	slowly glasses strong win .
smart spoons scream perfectly .	perfectly spoons smart scream .
tired toys wave carefully .	carefully toys tired wave .
tired bowls smile slowly .	tired slowly bowls smile .
