only that shirt who would yell can ever understand these schools .	that shirt who would only yell can ever understand these schools .
only these bowls who those books had heard should ever lose .	these bowls who only those books had heard should ever lose .
only those boats who might know those pictures could ever teach those bowls .	those boats who might only know those pictures could ever teach those bowls .
only those schools who would smile have ever heard those buttons .	those schools who would only smile have ever heard those buttons .
only the museum who might lie has ever found that driver .	the museum who might only lie has ever found that driver .
only the glasses who had cleaned those doctors can ever help the rooms .	the glasses who had only cleaned those doctors can ever help the rooms .
only the school who may cry would ever find the adult .	the school who may only cry would ever find the adult .
only this hospital who should hear the bowl should ever scare those cars .	this hospital who should only hear the bowl should ever scare those cars .
only the bicycle who that candle will know should ever fix the child .	the bicycle who only that candle will know should ever fix the child .
only the bowls who will scream could ever win .	the bowls who will only scream could ever win .
only the schools who will drop this person should ever throw these guys .	the schools who will only drop this person should ever throw these guys .
only the cars who had cried have ever helped those rooms .	the cars who had only cried have ever helped those rooms .
only the pictures who must clean these teachers had ever bought that customer .	the pictures who must only clean these teachers had ever bought that customer .
only the bottle who has cried had ever kept the boys .	the bottle who has only cried had ever kept the boys .
only the shirts who can lie had ever scared the kitchen .	the shirts who can only lie had ever scared the kitchen .
only the cups who should win have ever heard these glasses .	the cups who should only win have ever heard these glasses .
only the fork who will read will ever whisper .	the fork who will only read will ever whisper .
only this glass who that hat must know will ever sing .	this glass who only that hat must know will ever sing .
only that kitchen who had kept this man would ever read .	that kitchen who had only kept this man would ever read .
only that shirt who might read had ever won .	that shirt who might only read had ever won .
only that picture who must hear this restaurant can ever sing .	that picture who must only hear this restaurant can ever sing .
only that hospital who that car had heard had ever thrown that man .	that hospital who only that car had heard had ever thrown that man .
only the plates that have learned would ever eat .	the plates that have only learned would ever eat .
only this book who has fixed these men had ever made those boys .	this book who has only fixed these men had ever made those boys .
only the boat who could take these women had ever heard this school .	the boat who could only take these women had ever heard this school .
only these bowls who should hear this picture would ever talk .	these bowls who should only hear this picture would ever talk .
only the museum who should move this driver had ever heard the truck .	the museum who should only move this driver had ever heard the truck .
only those dolls who the crayons had heard had ever worried the box .	those dolls who only the crayons had heard had ever worried the box .
only those dishes who might talk had ever laughed .	those dishes who might only talk had ever laughed .
only that library who must bring the customer would ever bother this crayon .	that library who must only bring the customer would ever bother this crayon .
only that bicycle that must learn has ever learned .	that bicycle that must only learn has ever learned .
only those spoons who the toys have heard could ever lie .	those spoons who only the toys have heard could ever lie .
only the boats who have fixed those people will ever lie .	the boats who have only fixed those people will ever lie .
only that hospital who has moved the girl had ever talked .	that hospital who has only moved the girl had ever talked .
only this school who this box has heard will ever hold the woman .	this school who only this box has heard will ever hold the woman .
only this plate who had laughed could ever find that person .	this plate who had only laughed could ever find that person .
only the chairs who had laughed would ever practice .	the chairs who had only laughed would ever practice .
only this crayon who the toy must know has ever talked to the door .	this crayon who only the toy must know has ever talked to the door .
only this boat who would know this rocket can ever yell .	this boat who would only know this rocket can ever yell .
only this candle who must know that car can ever laugh .	this candle who must only know that car can ever laugh .
only this doll who may yell has ever lost that mirror .	this doll who may only yell has ever lost that mirror .
only this couch who the door might hear would ever hear that rug .	this couch who only the door might hear would ever hear that rug .
only these bottles who had yelled can ever buy that person .	these bottles who had only yelled can ever buy that person .
only this fork who has painted can ever exercise .	this fork who has only painted can ever exercise .
only that rocket who must scream would ever talk .	that rocket who must only scream would ever talk .
only the shoes who may win have ever heard this restaurant .	the shoes who may only win have ever heard this restaurant .
only that car who that ring has heard could ever understand this bicycle .	that car who only that ring has heard could ever understand this bicycle .
only the fork who might sneeze could ever paint .	the fork who might only sneeze could ever paint .
only that picture who will scream will ever visit the beds .	that picture who will only scream will ever visit the beds .
only the cup who could sing can ever answer this library .	the cup who could only sing can ever answer this library .
only this bowl who that ring has heard has ever made that driver .	this bowl who only that ring has heard has ever made that driver .
only that window who must hold this adult has ever worried that candle .	that window who must only hold this adult has ever worried that candle .
only this dish who would exercise had ever found the teacher .	this dish who would only exercise had ever found the teacher .
only that fork who could stretch has ever worried those windows .	that fork who could only stretch has ever worried those windows .
only the pictures who could hear these shirts should ever work with the toys .	the pictures who could only hear these shirts should ever work with the toys .
only the toys who have read could ever bother the boat .	the toys who have only read could ever bother the boat .
only those books who must laugh will ever worry the rings .	those books who must only laugh will ever worry the rings .
only the beds who would hear the restaurant should ever bring the king .	the beds who would only hear the restaurant should ever bring the king .
only this school that must hear those schools had ever learned .	this school that must only hear those schools had ever learned .
only this book who that picture can know has ever waved .	this book who only that picture can know has ever waved .
only the bicycle who had talked has ever lost the patient .	the bicycle who had only talked has ever lost the patient .
only these rings who had read have ever helped this box .	these rings who had only read have ever helped this box .
only this doll who this hospital had heard should ever fix this driver .	this doll who only this hospital had heard should ever fix this driver .
only this ring who has painted has ever taught that couch .	this ring who has only painted has ever taught that couch .
only the doll who the plane had heard had ever held these women .	the doll who only the plane had heard had ever held these women .
only the hats who might bring that driver had ever helped that room .	the hats who might only bring that driver had ever helped that room .
only that couch who has brought those guys should ever win .	that couch who has only brought those guys should ever win .
only the truck who could practice would ever lie .	the truck who could only practice would ever lie .
only that toy who had made this man has ever found those buttons .	that toy who had only made this man has ever found those buttons .
only the books who can know the bowls will ever sing .	the books who can only know the bowls will ever sing .
only this rocket who would wave can ever praise the bottles .	this rocket who would only wave can ever praise the bottles .
only this library who may talk has ever bought the king .	this library who may only talk has ever bought the king .
only the crayons who will win can ever sneeze .	the crayons who will only win can ever sneeze .
only these candles who had found the guy can ever hear these schools .	these candles who had only found the guy can ever hear these schools .
only the boats who should throw that doctor had ever answered this shirt .	the boats who should only throw that doctor had ever answered this shirt .
only those boats who these rooms would know would ever wave .	those boats who only these rooms would know would ever wave .
only those glasses who will yell should ever throw this boy .	those glasses who will only yell should ever throw this boy .
only the museum who can wave had ever visited the plates .	the museum who can only wave had ever visited the plates .
only these toys that had run would ever eat .	these toys that had only run would ever eat .
only the windows who have heard those candles would ever cry .	the windows who have only heard those candles would ever cry .
only this boat who has talked could ever work with the box .	this boat who has only talked could ever work with the box .
only that doll that had run should ever eat .	that doll that had only run should ever eat .
only those doors that had eaten had ever eaten .	those doors that had only eaten had ever eaten .
only this door who may know that truck would ever hold this lady .	this door who may only know that truck would ever hold this lady .
only this rug who has waved will ever fix that patient .	this rug who has only waved will ever fix that patient .
only this bank who had read can ever appreciate those beds .	this bank who had only read can ever appreciate those beds .
only the fork who that cup should hear will ever scream .	the fork who only that cup should hear will ever scream .
only that ring who had talked can ever have this woman .	that ring who had only talked can ever have this woman .
only that door who will exercise will ever keep the dentist .	that door who will only exercise will ever keep the dentist .
only that kitchen who has heard this glass can ever scream .	that kitchen who has only heard this glass can ever scream .
only the chairs who had yelled could ever help the ring .	the chairs who had only yelled could ever help the ring .
only this park who this crayon might know will ever lift that girl .	this park who only this crayon might know will ever lift that girl .
only this rug who can sell the patient would ever steal the guy .	this rug who can only sell the patient would ever steal the guy .
only this car who could know the cups had ever talked .	this car who could only know the cups had ever talked .
only the pictures who can laugh have ever laughed .	the pictures who can only laugh have ever laughed .
only the toy who will paint should ever help these plates .	the toy who will only paint should ever help these plates .
only this car who may cry could ever talk .	this car who may only cry could ever talk .
only these cars who will know the glasses could ever read .	these cars who will only know the glasses could ever read .
only the truck who should cry will ever bring this king .	the truck who should only cry will ever bring this king .
only this glass who this crayon should hear would ever clean this customer .	this glass who only this crayon should hear would ever clean this customer .
only the candle who that plane had heard should ever appreciate those schools .	the candle who only that plane had heard should ever appreciate those schools .
only these windows who must know the schools could ever talk to the hat .	these windows who must only know the schools could ever talk to the hat .
only the cups who could yell will ever take the king .	the cups who could only yell will ever take the king .
only the rug who can scream should ever win .	the rug who can only scream should ever win .
only that car who that rocket had heard could ever lose .	that car who only that rocket had heard could ever lose .
only those schools who have brought that girl have ever talked .	those schools who have only brought that girl have ever talked .
only the school who must laugh could ever paint .	the school who must only laugh could ever paint .
only the bicycle who the mall may hear will ever lie .	the bicycle who only the mall may hear will ever lie .
only that doll who had lost had ever heard this bottle .	that doll who had only lost had ever heard this bottle .
only this park who will know the couch had ever won .	this park who will only know the couch had ever won .
only that box who must practice should ever know the ring .	that box who must only practice should ever know the ring .
only these rings who could win will ever hear the books .	these rings who could only win will ever hear the books .
only this museum that can know the cars can ever learn .	this museum that can only know the cars can ever learn .
only that candle who the mall had heard had ever visited that book .	that candle who only the mall had heard had ever visited that book .
only those shirts who have won have ever found that cup .	those shirts who have only won have ever found that cup .
only this plate who had fixed that king can ever teach this glass .	this plate who had only fixed that king can ever teach this glass .
only those toys who should lie had ever read .	those toys who should only lie had ever read .
only the dish who will exercise will ever throw the teacher .	the dish who will only exercise will ever throw the teacher .
only those candles who might paint would ever clean that driver .	those candles who might only paint would ever clean that driver .
only the bowls who might scream have ever made the teacher .	the bowls who might only scream have ever made the teacher .
only that glass who the window had heard had ever taken this boy .	that glass who only the window had heard had ever taken this boy .
only that crayon who had lost had ever scared those forks .	that crayon who had only lost had ever scared those forks .
only the kitchen who had heard that candle should ever care for that ship .	the kitchen who had only heard that candle should ever care for that ship .
only these doors who may sing can ever hear this kitchen .	these doors who may only sing can ever hear this kitchen .
only this cup who had moved these girls should ever whisper .	this cup who had only moved these girls should ever whisper .
only that museum who may hear the rug has ever taken those ladies .	that museum who may only hear the rug has ever taken those ladies .
only these bags who may move this lady had ever cleaned these teachers .	these bags who may only move this lady had ever cleaned these teachers .
only the fork who the ring may hear has ever helped these schools .	the fork who only the ring may hear has ever helped these schools .
only the plate who can find this person had ever answered those shirts .	the plate who can only find this person had ever answered those shirts .
only the spoons who have heard the rocket will ever fix these people .	the spoons who have only heard the rocket will ever fix these people .
only that spoon who should hear the school has ever taken the people .	that spoon who should only hear the school has ever taken the people .
only that toy who this room had heard had ever confused these windows .	that toy who only this room had heard had ever confused these windows .
only those books who may lift this person should ever make the child .	those books who may only lift this person should ever make the child .
only the couch who had bought this girl could ever paint .	the couch who had only bought this girl could ever paint .
only those schools that these rooms had heard had ever learned .	those schools that only these rooms had heard had ever learned .
only those boats who would lie can ever laugh .	those boats who would only lie can ever laugh .
only those cups who had heard the hat could ever lose .	those cups who had only heard the hat could ever lose .
only the bottles who have heard the fork will ever lose .	the bottles who have only heard the fork will ever lose .
only those windows who would fix these teachers have ever helped that button .	those windows who would only fix these teachers have ever helped that button .
only the bottle who has kept those boys had ever painted .	the bottle who has only kept those boys had ever painted .
only that school who should sneeze would ever stretch .	that school who should only sneeze would ever stretch .
only that book who this rug has heard can ever shake that customer .	that book who only this rug has heard can ever shake that customer .
only those bowls who should shake those children could ever move that teacher .	those bowls who should only shake those children could ever move that teacher .
only this shirt who that crayon could hear can ever bother the fork .	this shirt who only that crayon could hear can ever bother the fork .
only the pictures who have yelled could ever praise that car .	the pictures who have only yelled could ever praise that car .
only the glass who has read will ever cough .	the glass who has only read will ever cough .
only this button that had run has ever learned .	this button that had only run has ever learned .
only this bank who might lose this patient can ever visit those glasses .	this bank who might only lose this patient can ever visit those glasses .
only the bottle who this doll should know should ever worry this ring .	the bottle who only this doll should know should ever worry this ring .
only those bowls who must move the queen would ever bring the boy .	those bowls who must only move the queen would ever bring the boy .
only the school who may buy the boys had ever answered those hats .	the school who may only buy the boys had ever answered those hats .
only these glasses who must lie could ever fix those ladies .	these glasses who must only lie could ever fix those ladies .
only the door who must hear this button would ever lift the guys .	the door who must only hear this button would ever lift the guys .
only these dolls who would know the rocket would ever care for that plate .	these dolls who would only know the rocket would ever care for that plate .
only this museum who might throw this dancer had ever won .	this museum who might only throw this dancer had ever won .
only the plane who may hear that candle could ever laugh .	the plane who may only hear that candle could ever laugh .
only the candles who could win could ever understand that library .	the candles who could only win could ever understand that library .
only the bottles who could exercise could ever practice .	the bottles who could only exercise could ever practice .
only these crayons who may hear the school can ever lose the king .	these crayons who may only hear the school can ever lose the king .
only this ring that might eat has ever grown .	this ring that might only eat has ever grown .
only those chairs who could scream have ever lost this boat .	those chairs who could only scream have ever lost this boat .
only the bank who the dish has heard had ever read .	the bank who only the dish has heard had ever read .
only the toy who could know those buttons can ever stretch .	the toy who could only know those buttons can ever stretch .
only this school who the door had heard has ever helped these toys .	this school who only the door had heard has ever helped these toys .
only this dish who that fork had heard had ever visited that bicycle .	this dish who only that fork had heard had ever visited that bicycle .
only this bank who this ship had heard has ever heard that kitchen .	this bank who only this ship had heard has ever heard that kitchen .
only those bags who might exercise could ever hear the trucks .	those bags who might only exercise could ever hear the trucks .
only the restaurant who had lost those girls should ever scream .	the restaurant who had only lost those girls should ever scream .
only the shoe who might hold the patient can ever fix the queen .	the shoe who might only hold the patient can ever fix the queen .
only that picture who has heard that picture could ever care for these books .	that picture who has only heard that picture could ever care for these books .
only the mall who had fixed these teachers could ever listen to the chair .	the mall who had only fixed these teachers could ever listen to the chair .
only the trucks who could wave have ever worried this hat .	the trucks who could only wave have ever worried this hat .
only that couch that must learn should ever learn .	that couch that must only learn should ever learn .
only those books that may hear the ship have ever run .	those books that may only hear the ship have ever run .
only that cup who the mirror must hear will ever appreciate that bottle .	that cup who only the mirror must hear will ever appreciate that bottle .
only those forks who could wave would ever steal this dentist .	those forks who could only wave would ever steal this dentist .
only this box who might stretch would ever visit this mall .	this box who might only stretch would ever visit this mall .
only that bowl who the bottle has heard had ever talked to these rings .	that bowl who only the bottle has heard had ever talked to these rings .
only these forks who would sing will ever bother the car .	these forks who would only sing will ever bother the car .
only those shirts who should whisper can ever help this library .	those shirts who should only whisper can ever help this library .
only the toys who those bowls could know would ever lose the girls .	the toys who only those bowls could know would ever lose the girls .
only this glass who should cry has ever lost those schools .	this glass who should only cry has ever lost those schools .
only those cars who had found the guy will ever read .	those cars who had only found the guy will ever read .
only that dish who must hear that picture could ever sell this adult .	that dish who must only hear that picture could ever sell this adult .
only the cup who has heard the dish could ever scare these boxes .	the cup who has only heard the dish could ever scare these boxes .
only those dolls who have brought the doctors had ever yelled .	those dolls who have only brought the doctors had ever yelled .
only those beds who could stretch have ever cried .	those beds who could only stretch have ever cried .
only the bed who the boat has heard has ever visited the bag .	the bed who only the boat has heard has ever visited the bag .
only the shirts who can know that museum would ever whisper .	the shirts who can only know that museum would ever whisper .
only this plate who should fix that boy had ever thrown the adult .	this plate who should only fix that boy had ever thrown the adult .
only these windows who may shake these boys could ever hear that rug .	these windows who may only shake these boys could ever hear that rug .
only the fork who would know the shirt should ever cough .	the fork who would only know the shirt should ever cough .
only the chair that the spoon has heard can ever grow .	the chair that only the spoon has heard can ever grow .
only these cars who should stretch could ever sell that patient .	these cars who should only stretch could ever sell that patient .
only this shirt that must learn should ever eat .	this shirt that must only learn should ever eat .
only the glasses who could find that person will ever steal that teacher .	the glasses who could only find that person will ever steal that teacher .
only these beds who the cars could know have ever held the queen .	these beds who only the cars could know have ever held the queen .
only these crayons who had cried had ever cleaned the adult .	these crayons who had only cried had ever cleaned the adult .
only the dishes that would know this library had ever eaten .	the dishes that would only know this library had ever eaten .
only those dolls who may whisper would ever listen to these cars .	those dolls who may only whisper would ever listen to these cars .
only that bowl who can hear the window would ever read .	that bowl who can only hear the window would ever read .
only that toy that has heard the crayons should ever learn .	that toy that has only heard the crayons should ever learn .
only this shoe who might stretch can ever shake that driver .	this shoe who might only stretch can ever shake that driver .
only the boat that the spoon would know will ever grow .	the boat that only the spoon would know will ever grow .
only this shirt who will fix those girls should ever hear this mirror .	this shirt who will only fix those girls should ever hear this mirror .
only that candle who that ring may hear has ever answered the shirt .	that candle who only that ring may hear has ever answered the shirt .
only that toy who should move this customer will ever scream .	that toy who should only move this customer will ever scream .
only these pictures who had heard those cars should ever talk to this ring .	these pictures who had only heard those cars should ever talk to this ring .
only those boats who might fix the person can ever yell .	those boats who might only fix the person can ever yell .
only the restaurant who had talked can ever know this book .	the restaurant who had only talked can ever know this book .
only the shirt who could cough has ever laughed .	the shirt who could only cough has ever laughed .
only that spoon who must know the glasses should ever fix this child .	that spoon who must only know the glasses should ever fix this child .
only that mall who the hospital might know would ever wave .	that mall who only the hospital might know would ever wave .
only the pictures who would hear the bottles will ever visit that ship .	the pictures who would only hear the bottles will ever visit that ship .
only this book who this doll could hear could ever scare those windows .	this book who only this doll could hear could ever scare those windows .
only that button who might lie has ever brought the boy .	that button who might only lie has ever brought the boy .
only these cars who those shirts have heard should ever work with the window .	these cars who only those shirts have heard should ever work with the window .
only the park who must win had ever taught this plate .	the park who must only win had ever taught this plate .
only the bottle who may make the children would ever paint .	the bottle who may only make the children would ever paint .
only the bottle who that boat had heard could ever hear the crayons .	the bottle who only that boat had heard could ever hear the crayons .
only the park who this spoon will hear should ever help that bank .	the park who only this spoon will hear should ever help that bank .
only that hospital who the ring would know has ever found the rug .	that hospital who only the ring would know has ever found the rug .
only the shoe who would know the dishes will ever win .	the shoe who would only know the dishes will ever win .
only the buttons that have run would ever learn .	the buttons that have only run would ever learn .
only those beds who these windows have heard had ever worried the hospital .	those beds who only these windows have heard had ever worried the hospital .
only the boxes who could move that guy had ever won .	the boxes who could only move that guy had ever won .
only those hats who have waved have ever scared this candle .	those hats who have only waved have ever scared this candle .
only those doors who may know this picture have ever heard this shirt .	those doors who may only know this picture have ever heard this shirt .
only that school who had bought this king should ever lose .	that school who had only bought this king should ever lose .
only the rooms who the beds should hear have ever bothered this shirt .	the rooms who only the beds should hear have ever bothered this shirt .
only this button who could fix the guys can ever practice .	this button who could only fix the guys can ever practice .
only that mall who the plane should hear can ever sing .	that mall who only the plane should hear can ever sing .
only that plane who could make those boys should ever yell .	that plane who could only make those boys should ever yell .
only this car who that chair had heard can ever help these cars .	this car who only that chair had heard can ever help these cars .
only the school that can run could ever run .	the school that can only run could ever run .
only this fork who can hear that chair will ever hear this plane .	this fork who can only hear that chair will ever hear this plane .
only the ring who must scream will ever wave .	the ring who must only scream will ever wave .
only that candle who should hold these teachers had ever heard the dish .	that candle who should only hold these teachers had ever heard the dish .
only that hat who the button could know can ever work with those schools .	that hat who only the button could know can ever work with those schools .
only that book who might sing should ever win .	that book who might only sing should ever win .
only that plate who may sing will ever take this child .	that plate who may only sing will ever take this child .
only the chair who could find the lady has ever thrown the people .	the chair who could only find the lady has ever thrown the people .
only this picture that must grow had ever eaten .	this picture that must only grow had ever eaten .
only these chairs who had heard this box had ever found that car .	these chairs who had only heard this box had ever found that car .
only that museum who could drop the women could ever yell .	that museum who could only drop the women could ever yell .
only these cups who may know these glasses had ever bothered that button .	these cups who may only know these glasses had ever bothered that button .
only these cups who must exercise had ever lost this restaurant .	these cups who must only exercise had ever lost this restaurant .
only that school who can wave had ever confused the bowl .	that school who can only wave had ever confused the bowl .
only those bottles who these shirts must know should ever laugh .	those bottles who only these shirts must know should ever laugh .
only the mall who can paint has ever painted .	the mall who can only paint has ever painted .
only the truck who would cry can ever sneeze .	the truck who would only cry can ever sneeze .
only these cups who can talk have ever confused this window .	these cups who can only talk have ever confused this window .
only that ship who may paint could ever have the women .	that ship who may only paint could ever have the women .
only the cups who had heard the car would ever paint .	the cups who had only heard the car would ever paint .
only those bottles who have heard that bowl could ever hear these candles .	those bottles who have only heard that bowl could ever hear these candles .
only those bags who may steal the queen will ever read .	those bags who may only steal the queen will ever read .
only this mirror who has read will ever sell these doctors .	this mirror who has only read will ever sell these doctors .
only those buttons who have heard this door could ever work with the hats .	those buttons who have only heard this door could ever work with the hats .
only the glass who the picture would hear will ever exercise .	the glass who only the picture would hear will ever exercise .
only that school who that cup must hear could ever clean the patient .	that school who only that cup must hear could ever clean the patient .
only the boats who could scream should ever smile .	the boats who could only scream should ever smile .
only the spoon who can talk has ever heard these schools .	the spoon who can only talk has ever heard these schools .
only these books who those schools could know will ever appreciate the dishes .	these books who only those schools could know will ever appreciate the dishes .
only that glass who may cough has ever worked with the school .	that glass who may only cough has ever worked with the school .
only this candle who the bowl could know had ever lost these ladies .	this candle who only the bowl could know had ever lost these ladies .
only these shoes who can have these ladies could ever yell .	these shoes who can only have these ladies could ever yell .
only this plate who will take those men will ever help that boat .	this plate who will only take those men will ever help that boat .
only these buttons who have yelled should ever sell these girls .	these buttons who have only yelled should ever sell these girls .
only those dolls who the boats have heard have ever worked with these buttons .	those dolls who only the boats have heard have ever worked with these buttons .
only these dolls who have heard the spoon had ever read .	these dolls who have only heard the spoon had ever read .
only those boxes who the cars might know have ever cried .	those boxes who only the cars might know have ever cried .
only this hospital who this door can hear had ever talked to the candle .	this hospital who only this door can hear had ever talked to the candle .
only these bottles who could read will ever cry .	these bottles who could only read will ever cry .
only that bank who should know this school will ever talk to that kitchen .	that bank who should only know this school will ever talk to that kitchen .
only this restaurant who that car may know has ever taught this plate .	this restaurant who only that car may know has ever taught this plate .
only the bowl who has dropped these ladies had ever waved .	the bowl who has only dropped these ladies had ever waved .
only that school who must steal this person has ever waved .	that school who must only steal this person has ever waved .
only these beds who may exercise could ever lie .	these beds who may only exercise could ever lie .
only the truck who might cry would ever talk to those candles .	the truck who might only cry would ever talk to those candles .
only the fork who had lost could ever shake the adult .	the fork who had only lost could ever shake the adult .
only these buttons who may laugh would ever cry .	these buttons who may only laugh would ever cry .
only the hat who this shoe should hear can ever visit these forks .	the hat who only this shoe should hear can ever visit these forks .
only the room who must steal the king has ever lost those books .	the room who must only steal the king has ever lost those books .
only those schools who have found the man have ever painted .	those schools who have only found the man have ever painted .
only the chairs who should drop this teacher should ever shake that person .	the chairs who should only drop this teacher should ever shake that person .
only this mirror who will steal the teacher had ever yelled .	this mirror who will only steal the teacher had ever yelled .
only that bottle who has won can ever bring this girl .	that bottle who has only won can ever bring this girl .
only the shirt who must know that park has ever scared those cars .	the shirt who must only know that park has ever scared those cars .
only this bowl who may hear the mall will ever understand that library .	this bowl who may only hear the mall will ever understand that library .
only these glasses who should wave could ever scream .	these glasses who should only wave could ever scream .
only that museum who could wave could ever help the shirts .	that museum who could only wave could ever help the shirts .
only the library who has heard that couch will ever steal these doctors .	the library who has only heard that couch will ever steal these doctors .
only those dishes who have heard those crayons could ever lie .	those dishes who have only heard those crayons could ever lie .
only those bags who would keep that adult could ever teach this park .	those bags who would only keep that adult could ever teach this park .
only the boat who may know this plate can ever smile .	the boat who may only know this plate can ever smile .
only the cars that can run had ever run .	the cars that can only run had ever run .
only those chairs who should paint had ever cried .	those chairs who should only paint had ever cried .
only that bag who had cleaned those men should ever bring these girls .	that bag who had only cleaned those men should ever bring these girls .
only this doll who may read had ever heard this rocket .	this doll who may only read had ever heard this rocket .
only that bag who would move the doctor would ever exercise .	that bag who would only move the doctor would ever exercise .
only this window who could know the chairs can ever yell .	this window who could only know the chairs can ever yell .
only this room that this book might hear would ever run .	this room that only this book might hear would ever run .
only the doll who could talk had ever cried .	the doll who could only talk had ever cried .
only these rings who can know those glasses have ever painted .	these rings who can only know those glasses have ever painted .
only that bottle who will laugh has ever cleaned the boy .	that bottle who will only laugh has ever cleaned the boy .
only these pictures who might lose will ever scare this door .	these pictures who might only lose will ever scare this door .
only the cars who must sneeze would ever win .	the cars who must only sneeze would ever win .
only this truck who this museum has heard has ever talked .	this truck who only this museum has heard has ever talked .
only those hats who should practice will ever lie .	those hats who should only practice will ever lie .
only that glass who has won would ever worry the bowl .	that glass who has only won would ever worry the bowl .
only those rings who would lift the girls can ever answer the toy .	those rings who would only lift the girls can ever answer the toy .
only this hat who may hear these candles had ever taught this box .	this hat who may only hear these candles had ever taught this box .
only the picture who would hold this teacher had ever found these children .	the picture who would only hold this teacher had ever found these children .
only this hat who has heard that candle will ever cough .	this hat who has only heard that candle will ever cough .
only the school who had laughed can ever scare the cars .	the school who had only laughed can ever scare the cars .
only that bank who this fork has heard had ever heard this book .	that bank who only this fork has heard had ever heard this book .
only the window who that rocket can hear should ever scream .	the window who only that rocket can hear should ever scream .
only these beds who have won would ever know those buttons .	these beds who have only won would ever know those buttons .
only this bicycle that could hear these toys has ever grown .	this bicycle that could only hear these toys has ever grown .
only these windows who might read have ever confused this bottle .	these windows who might only read have ever confused this bottle .
only that bicycle who could wave could ever hold that person .	that bicycle who could only wave could ever hold that person .
only that ship who might lift this lady had ever cried .	that ship who might only lift this lady had ever cried .
only this bank who the book will hear had ever worked with this candle .	this bank who only the book will hear had ever worked with this candle .
only that bank who this park will know should ever help the couch .	that bank who only this park will know should ever help the couch .
only the spoons who may talk would ever buy the dancer .	the spoons who may only talk would ever buy the dancer .
only the bottle that the school had heard should ever grow .	the bottle that only the school had heard should ever grow .
only this bed who had talked has ever found this woman .	this bed who had only talked has ever found this woman .
only those books who will practice will ever hear the hospital .	those books who will only practice will ever hear the hospital .
only the bag who may clean this guy has ever taught the glass .	the bag who may only clean this guy has ever taught the glass .
only this truck who has painted would ever understand that fork .	this truck who has only painted would ever understand that fork .
only this room that the shoe might hear would ever eat .	this room that only the shoe might hear would ever eat .
only this chair who may win should ever know the bottles .	this chair who may only win should ever know the bottles .
only the school who that bank may know should ever stretch .	the school who only that bank may know should ever stretch .
only these rooms who may bring this dancer have ever found that crayon .	these rooms who may only bring this dancer have ever found that crayon .
only these shirts who might scream had ever moved those men .	these shirts who might only scream had ever moved those men .
only that chair that has learned could ever eat .	that chair that has only learned could ever eat .
only the ship who could sell that patient would ever understand this shirt .	the ship who could only sell that patient would ever understand this shirt .
only the shoe that could know that bank can ever grow .	the shoe that could only know that bank can ever grow .
only those beds who may practice should ever worry those schools .	those beds who may only practice should ever worry those schools .
only that bag that has grown has ever grown .	that bag that has only grown has ever grown .
only the shoes who can win could ever teach the hospital .	the shoes who can only win could ever teach the hospital .
only these crayons who may clean the doctor should ever care for the book .	these crayons who may only clean the doctor should ever care for the book .
only the rooms who could hear this bank would ever answer that plate .	the rooms who could only hear this bank would ever answer that plate .
only that ship who might wave would ever care for the mirror .	that ship who might only wave would ever care for the mirror .
only these shirts who have yelled can ever hear that door .	these shirts who have only yelled can ever hear that door .
only this ship who must shake this queen would ever lose .	this ship who must only shake this queen would ever lose .
only this shirt who had heard that bag had ever heard this bag .	this shirt who had only heard that bag had ever heard this bag .
only the spoons who would sell that patient should ever praise that shoe .	the spoons who would only sell that patient should ever praise that shoe .
only the shirt who must whisper will ever wave .	the shirt who must only whisper will ever wave .
only this ship that has eaten would ever learn .	this ship that has only eaten would ever learn .
only the schools who these books had heard had ever bothered that museum .	the schools who only these books had heard had ever bothered that museum .
only this truck who would wave should ever lose .	this truck who would only wave should ever lose .
only that bed who would practice could ever paint .	that bed who would only practice could ever paint .
only that door that should hear that library would ever run .	that door that should only hear that library would ever run .
only that park who has heard those shoes would ever help that ship .	that park who has only heard those shoes would ever help that ship .
only the schools who would know these windows could ever scream .	the schools who would only know these windows could ever scream .
only this cup who had heard these shirts has ever worked with the schools .	this cup who had only heard these shirts has ever worked with the schools .
only this restaurant who has heard these toys had ever won .	this restaurant who has only heard these toys had ever won .
only these windows who had talked should ever praise that bank .	these windows who had only talked should ever praise that bank .
only that bank that has heard those doors had ever run .	that bank that has only heard those doors had ever run .
only this car that may eat has ever run .	this car that may only eat has ever run .
only this truck who will smile will ever smile .	this truck who will only smile will ever smile .
only the shirts who will sing have ever worried these shirts .	the shirts who will only sing have ever worried these shirts .
only this shoe who should lift that boy could ever lose .	this shoe who should only lift that boy could ever lose .
only the ring who must hear that car will ever talk .	the ring who must only hear that car will ever talk .
only these glasses who had moved that child would ever hear that school .	these glasses who had only moved that child would ever hear that school .
only this hospital who has cried had ever taken the women .	this hospital who has only cried had ever taken the women .
only those trucks who must cry could ever praise that rocket .	those trucks who must only cry could ever praise that rocket .
only the chairs who these shoes had heard can ever practice .	the chairs who only these shoes had heard can ever practice .
only the dolls who could keep that driver should ever find this teacher .	the dolls who could only keep that driver should ever find this teacher .
only this car who had yelled has ever thrown that guy .	this car who had only yelled has ever thrown that guy .
only these glasses who have heard these shoes had ever read .	these glasses who have only heard these shoes had ever read .
only that book who had kept those guys should ever hear these boats .	that book who had only kept those guys should ever hear these boats .
only these chairs who must cry will ever shake the man .	these chairs who must only cry will ever shake the man .
only these cars who the beds have heard should ever sing .	these cars who only the beds have heard should ever sing .
only those cups who may lie can ever stretch .	those cups who may only lie can ever stretch .
only this room who has found that man can ever hold this dancer .	this room who has only found that man can ever hold this dancer .
only this dish who will clean the patient can ever stretch .	this dish who will only clean the patient can ever stretch .
only the candle who will sell the king had ever thrown the guy .	the candle who will only sell the king had ever thrown the guy .
only these chairs who have held the boy could ever talk to these bowls .	these chairs who have only held the boy could ever talk to these bowls .
only these schools who have yelled had ever cried .	these schools who have only yelled had ever cried .
only that school who would exercise has ever taken the doctors .	that school who would only exercise has ever taken the doctors .
only these cars who had won could ever cry .	these cars who had only won could ever cry .
only those cars who these schools have heard would ever read .	those cars who only these schools have heard would ever read .
only the pictures who might sneeze could ever yell .	the pictures who might only sneeze could ever yell .
only those crayons who have heard the cars would ever talk .	those crayons who have only heard the cars would ever talk .
only that dish who has talked had ever held this girl .	that dish who has only talked had ever held this girl .
only those pictures who the shoes will hear could ever paint .	those pictures who only the shoes will hear could ever paint .
only the cars who would laugh will ever talk to those boats .	the cars who would only laugh will ever talk to those boats .
only the mall who has yelled had ever yelled .	the mall who has only yelled had ever yelled .
only this school who could win should ever smile .	this school who could only win should ever smile .
only this bag who must cry could ever win .	this bag who must only cry could ever win .
only this book who must smile has ever yelled .	this book who must only smile has ever yelled .
only these beds who had heard these dishes had ever held the dancer .	these beds who had only heard these dishes had ever held the dancer .
only these buttons who will shake those men had ever bought those children .	these buttons who will only shake those men had ever bought those children .
only that doll who the park may know would ever help that shoe .	that doll who only the park may know would ever help that shoe .
only those buttons who must drop the boys would ever laugh .	those buttons who must only drop the boys would ever laugh .
only this bicycle who would know this library can ever stretch .	this bicycle who would only know this library can ever stretch .
only those pictures who those pictures might hear have ever painted .	those pictures who only those pictures might hear have ever painted .
only these schools who had read will ever sing .	these schools who had only read will ever sing .
only these shirts who would lie would ever clean these doctors .	these shirts who would only lie would ever clean these doctors .
only that ship who will sneeze will ever hear this room .	that ship who will only sneeze will ever hear this room .
only this school who would whisper should ever keep the customer .	this school who would only whisper should ever keep the customer .
only that rug who the library may know would ever keep that guy .	that rug who only the library may know would ever keep that guy .
only that car who had lost these boys had ever heard the rings .	that car who had only lost these boys had ever heard the rings .
only the boats who have fixed the child would ever bring these ladies .	the boats who have only fixed the child would ever bring these ladies .
only that fork who would have the doctors would ever worry the shoes .	that fork who would only have the doctors would ever worry the shoes .
only the cars who would stretch should ever lie .	the cars who would only stretch should ever lie .
only this picture who the car can know should ever yell .	this picture who only the car can know should ever yell .
only these buttons who these forks must hear would ever sell those girls .	these buttons who only these forks must hear would ever sell those girls .
only this button who that cup must know has ever worried the cup .	this button who only that cup must know has ever worried the cup .
only the rooms who can know that car have ever laughed .	the rooms who can only know that car have ever laughed .
only this ring that that couch can know will ever learn .	this ring that only that couch can know will ever learn .
only the boats who those schools will know would ever know the museum .	the boats who only those schools will know would ever know the museum .
only those boats that must know these windows had ever eaten .	those boats that must only know these windows had ever eaten .
only those boxes who had heard these bowls can ever laugh .	those boxes who had only heard these bowls can ever laugh .
only that museum who has heard the glasses will ever buy this driver .	that museum who has only heard the glasses will ever buy this driver .
only those hats who should drop this child could ever wave .	those hats who should only drop this child could ever wave .
only these schools who could know the bottles would ever buy those guys .	these schools who could only know the bottles would ever buy those guys .
only that fork who could hear the ship can ever yell .	that fork who could only hear the ship can ever yell .
only the bottles who have kept that doctor could ever scare those cars .	the bottles who have only kept that doctor could ever scare those cars .
only those windows that the rings must know have ever grown .	those windows that only the rings must know have ever grown .
only the rug that had eaten had ever run .	the rug that had only eaten had ever run .
only the shirt who should scream could ever talk .	the shirt who should only scream could ever talk .
only these boats who the cups would hear should ever visit that bowl .	these boats who only the cups would hear should ever visit that bowl .
only those buttons who will hear that car can ever lift the doctors .	those buttons who will only hear that car can ever lift the doctors .
only the glass who had kept that child will ever paint .	the glass who had only kept that child will ever paint .
only those chairs who have laughed had ever talked .	those chairs who have only laughed had ever talked .
only that school who this bed would know could ever stretch .	that school who only this bed would know could ever stretch .
only that box who might hear the cups will ever help those cars .	that box who might only hear the cups will ever help those cars .
only that rug who should find these ladies should ever praise these cups .	that rug who should only find these ladies should ever praise these cups .
only that ship who could hear these dishes has ever heard that bed .	that ship who could only hear these dishes has ever heard that bed .
only that room who can lift these people should ever help the button .	that room who can only lift these people should ever help the button .
only this window who has yelled had ever worked with those forks .	this window who has only yelled had ever worked with those forks .
only that toy who has heard this bicycle would ever help the bed .	that toy who has only heard this bicycle would ever help the bed .
only the books who had waved would ever scare that toy .	the books who had only waved would ever scare that toy .
only this couch who can find the child had ever visited the hospital .	this couch who can only find the child had ever visited the hospital .
only this button who may exercise could ever win .	this button who may only exercise could ever win .
only these trucks who these rings had heard should ever clean these guys .	these trucks who only these rings had heard should ever clean these guys .
only this bed who would keep the lady should ever visit the chairs .	this bed who would only keep the lady should ever visit the chairs .
only that room that must learn should ever grow .	that room that must only learn should ever grow .
only these windows that must eat had ever learned .	these windows that must only eat had ever learned .
only the cups who may hear the toys can ever wave .	the cups who may only hear the toys can ever wave .
only these hats who had moved this guy could ever talk .	these hats who had only moved this guy could ever talk .
only that mall who can hear those books should ever hear those books .	that mall who can only hear those books should ever hear those books .
only these cups who have taken that queen would ever care for the cars .	these cups who have only taken that queen would ever care for the cars .
only those schools who had cleaned these teachers had ever answered this room .	those schools who had only cleaned these teachers had ever answered this room .
only the bicycle who should hear the bottle will ever visit that spoon .	the bicycle who should only hear the bottle will ever visit that spoon .
only this school that had learned had ever learned .	this school that had only learned had ever learned .
only those candles who should sell this person had ever waved .	those candles who should only sell this person had ever waved .
only this couch who the hospital will hear can ever wave .	this couch who only the hospital will hear can ever wave .
only those glasses who must make these girls could ever fix this driver .	those glasses who must only make these girls could ever fix this driver .
only these dishes who had won could ever drop that man .	these dishes who had only won could ever drop that man .
only that restaurant who will know that toy should ever throw that man .	that restaurant who will only know that toy should ever throw that man .
only the park who has brought the woman could ever smile .	the park who has only brought the woman could ever smile .
only this bicycle who that door can know will ever bother those plates .	this bicycle who only that door can know will ever bother those plates .
only the schools who have dropped the girls could ever understand that shirt .	the schools who have only dropped the girls could ever understand that shirt .
only that window who has talked has ever taken this patient .	that window who has only talked has ever taken this patient .
only those forks who may sneeze have ever lost .	those forks who may only sneeze have ever lost .
only these dolls that may learn had ever eaten .	these dolls that may only learn had ever eaten .
only the hat who has yelled had ever won .	the hat who has only yelled had ever won .
only the bank who this ship will hear has ever dropped those guys .	the bank who only this ship will hear has ever dropped those guys .
only this school who had read can ever know this couch .	this school who had only read can ever know this couch .
only this rug who that fork should know should ever know these cups .	this rug who only that fork should know should ever know these cups .
only that room who had waved would ever worry this plane .	that room who had only waved would ever worry this plane .
only the chair who that crayon could know had ever worked with that bed .	the chair who only that crayon could know had ever worked with that bed .
only the restaurant who had made the ladies will ever teach the window .	the restaurant who had only made the ladies will ever teach the window .
only that mirror who the dish had heard has ever worried this mall .	that mirror who only the dish had heard has ever worried this mall .
only the bowl who can buy that man could ever have that man .	the bowl who can only buy that man could ever have that man .
only these bottles who these bottles must hear have ever heard the spoon .	these bottles who only these bottles must hear have ever heard the spoon .
only the bag that this restaurant has heard will ever eat .	the bag that only this restaurant has heard will ever eat .
only that car who may smile can ever know those forks .	that car who may only smile can ever know those forks .
only this truck who that rocket will hear should ever smile .	this truck who only that rocket will hear should ever smile .
only that school who has yelled can ever sneeze .	that school who has only yelled can ever sneeze .
only this box who must lose had ever found this teacher .	this box who must only lose had ever found this teacher .
only the rings who had heard that crayon have ever confused this couch .	the rings who had only heard that crayon have ever confused this couch .
only the hospital who that plane would know has ever taken the guys .	the hospital who only that plane would know has ever taken the guys .
only that library who should make these doctors could ever throw that driver .	that library who should only make these doctors could ever throw that driver .
only the toy who would take the driver will ever wave .	the toy who would only take the driver will ever wave .
only the door that this window has heard has ever grown .	the door that only this window has heard has ever grown .
only those shirts who these rings had heard have ever won .	those shirts who only these rings had heard have ever won .
only those boats who those bowls would know can ever lie .	those boats who only those bowls would know can ever lie .
only this toy who has lost will ever smile .	this toy who has only lost will ever smile .
only the pictures who should lie could ever care for this bicycle .	the pictures who should only lie could ever care for this bicycle .
only these schools who have painted had ever heard this button .	these schools who have only painted had ever heard this button .
only that truck who that window has heard can ever sing .	that truck who only that window has heard can ever sing .
only that glass that has run had ever run .	that glass that has only run had ever run .
only that button who the fork had heard has ever confused these candles .	that button who only the fork had heard has ever confused these candles .
only the school who has taken the guys would ever worry this school .	the school who has only taken the guys would ever worry this school .
only the ring who had lost the patient has ever answered this bag .	the ring who had only lost the patient has ever answered this bag .
only that rocket who has lost that woman had ever bought the ladies .	that rocket who has only lost that woman had ever bought the ladies .
only the rug who could whisper can ever scream .	the rug who could only whisper can ever scream .
only the schools who would move this person should ever cry .	the schools who would only move this person should ever cry .
only those shirts who have lost the driver have ever held these guys .	those shirts who have only lost the driver have ever held these guys .
only these rooms who must sell the doctors will ever exercise .	these rooms who must only sell the doctors will ever exercise .
only that glass who had lost can ever talk .	that glass who had only lost can ever talk .
only this fork who has heard that candle has ever painted .	this fork who has only heard that candle has ever painted .
only these hats who would find these boys could ever care for that couch .	these hats who would only find these boys could ever care for that couch .
only the hat who can lie would ever lie .	the hat who can only lie would ever lie .
only this boat who must cough should ever worry that mall .	this boat who must only cough should ever worry that mall .
only this shirt who the hospital had heard can ever stretch .	this shirt who only the hospital had heard can ever stretch .
only the boat who had bought the people had ever talked .	the boat who had only bought the people had ever talked .
only that candle who will cough will ever hold this guy .	that candle who will only cough will ever hold this guy .
only this ring who might sing has ever found the chair .	this ring who might only sing has ever found the chair .
only these boats who have laughed can ever lie .	these boats who have only laughed can ever lie .
only these doors who those dishes may hear will ever hear the rings .	these doors who only those dishes may hear will ever hear the rings .
only this park who had cleaned the adult has ever thrown those boys .	this park who had only cleaned the adult has ever thrown those boys .
only the buttons who would fix this driver should ever care for the couch .	the buttons who would only fix this driver should ever care for the couch .
only that school who will find these teachers can ever win .	that school who will only find these teachers can ever win .
only these boats who those bags may know can ever understand that ring .	these boats who only those bags may know can ever understand that ring .
only these spoons who will yell could ever smile .	these spoons who will only yell could ever smile .
only the rug who could exercise has ever made these doctors .	the rug who could only exercise has ever made these doctors .
only those toys who would win had ever worried the boats .	those toys who would only win had ever worried the boats .
only that school who should scream has ever talked to the glass .	that school who should only scream has ever talked to the glass .
only the crayon who must buy that man would ever answer this museum .	the crayon who must only buy that man would ever answer this museum .
only the schools who may move the teachers have ever confused that ship .	the schools who may only move the teachers have ever confused that ship .
only the ship who this rocket had heard can ever move those boys .	the ship who only this rocket had heard can ever move those boys .
only this button who will hear these buttons would ever cry .	this button who will only hear these buttons would ever cry .
only those trucks who these glasses might know could ever bother that glass .	those trucks who only these glasses might know could ever bother that glass .
only the car who the bag should know should ever answer these bags .	the car who only the bag should know should ever answer these bags .
only that cup who would know those bottles should ever worry the bicycle .	that cup who would only know those bottles should ever worry the bicycle .
only the rings who could practice will ever exercise .	the rings who could only practice will ever exercise .
only this ring who will take the boys will ever find the women .	this ring who will only take the boys will ever find the women .
only this rug who that plate will know had ever moved this doctor .	this rug who only that plate will know had ever moved this doctor .
only the chairs who can hold that customer have ever waved .	the chairs who can only hold that customer have ever waved .
only the boats who had lost those people have ever held this lady .	the boats who had only lost those people have ever held this lady .
only those cups who may wave would ever lie .	those cups who may only wave would ever lie .
only those rings who had found that man should ever know this bag .	those rings who had only found that man should ever know this bag .
only the glasses who might smile could ever know the candles .	the glasses who might only smile could ever know the candles .
only that dish who can smile should ever listen to those boxes .	that dish who can only smile should ever listen to those boxes .
only this restaurant who that school had heard has ever helped the button .	this restaurant who only that school had heard has ever helped the button .
only that book that has heard the shoe has ever run .	that book that has only heard the shoe has ever run .
only the restaurant who must lie has ever held the patient .	the restaurant who must only lie has ever held the patient .
only the plates who had cried had ever cleaned the person .	the plates who had only cried had ever cleaned the person .
only these shoes who had won had ever waved .	these shoes who had only won had ever waved .
only that crayon who has yelled has ever lost those cars .	that crayon who has only yelled has ever lost those cars .
only the buttons who had won should ever worry that toy .	the buttons who had only won should ever worry that toy .
only the bags who those shoes can know should ever know this kitchen .	the bags who only those shoes can know should ever know this kitchen .
only this doll who would paint will ever work with those glasses .	this doll who would only paint will ever work with those glasses .
only these books who should exercise should ever praise that hat .	these books who should only exercise should ever praise that hat .
only these rooms that have grown have ever eaten .	these rooms that have only grown have ever eaten .
only these rings who will cry will ever cough .	these rings who will only cry will ever cough .
only the cars who had read will ever sing .	the cars who had only read will ever sing .
only these plates who could shake the women had ever lost .	these plates who could only shake the women had ever lost .
only the park who that picture may hear should ever scream .	the park who only that picture may hear should ever scream .
only these shoes who might read had ever kept these women .	these shoes who might only read had ever kept these women .
only the mall who might cry has ever talked to these glasses .	the mall who might only cry has ever talked to these glasses .
only these bottles who may lie will ever exercise .	these bottles who may only lie will ever exercise .
only this rug who the kitchen had heard can ever have those doctors .	this rug who only the kitchen had heard can ever have those doctors .
only that boat who would lose this woman has ever confused this car .	that boat who would only lose this woman has ever confused this car .
only this door who that library had heard would ever listen to those doors .	this door who only that library had heard would ever listen to those doors .
only the cars who should smile have ever bought these women .	the cars who should only smile have ever bought these women .
only this glass who will whisper would ever hear those schools .	this glass who will only whisper would ever hear those schools .
only this book who had heard this park had ever kept the man .	this book who had only heard this park had ever kept the man .
only the beds who have lost could ever lose .	the beds who have only lost could ever lose .
only that bottle who had lost this adult had ever talked .	that bottle who had only lost this adult had ever talked .
only that park that the window could hear will ever eat .	that park that only the window could hear will ever eat .
only these shirts that would know that dish have ever learned .	these shirts that would only know that dish have ever learned .
only that mall who had thrown those teachers had ever bought the ladies .	that mall who had only thrown those teachers had ever bought the ladies .
only these glasses who should move the patient have ever bought these girls .	these glasses who should only move the patient have ever bought these girls .
only that car who has painted will ever praise the buttons .	that car who has only painted will ever praise the buttons .
only this book who will take those children has ever visited that mirror .	this book who will only take those children has ever visited that mirror .
only that plane who must know that mall could ever whisper .	that plane who must only know that mall could ever whisper .
only this bowl who might whisper should ever help those cars .	this bowl who might only whisper should ever help those cars .
only the rocket who may hear this fork should ever answer that bowl .	the rocket who may only hear this fork should ever answer that bowl .
only the boat who will fix this person would ever take that queen .	the boat who will only fix this person would ever take that queen .
only the doll who could take the teacher would ever lift the person .	the doll who could only take the teacher would ever lift the person .
only the buttons who must sing will ever scream .	the buttons who must only sing will ever scream .
only the buttons who can have the girls have ever dropped the girls .	the buttons who can only have the girls have ever dropped the girls .
only that shoe who the book could know can ever answer that bed .	that shoe who only the book could know can ever answer that bed .
only this truck who that car may hear would ever win .	this truck who only that car may hear would ever win .
only those bottles who could steal that woman can ever scare the book .	those bottles who could only steal that woman can ever scare the book .
only the hat who may find that customer had ever yelled .	the hat who may only find that customer had ever yelled .
only that book who had painted had ever found this book .	that book who had only painted had ever found this book .
only that bottle who must yell will ever answer the boxes .	that bottle who must only yell will ever answer the boxes .
only that car who had made that queen can ever stretch .	that car who had only made that queen can ever stretch .
only the book that could eat has ever run .	the book that could only eat has ever run .
only these cars who had held those people can ever have the woman .	these cars who had only held those people can ever have the woman .
only the doll who will know that mall could ever practice .	the doll who will only know that mall could ever practice .
only the cup who must smile has ever kept that person .	the cup who must only smile has ever kept that person .
only these bottles who must drop this king can ever lose .	these bottles who must only drop this king can ever lose .
only the park who had read had ever taken those children .	the park who had only read had ever taken those children .
only the hat who that chair would know has ever heard that ship .	the hat who only that chair would know has ever heard that ship .
only the toys who had heard this mirror had ever won .	the toys who had only heard this mirror had ever won .
only that dish who had made those women should ever make these guys .	that dish who had only made those women should ever make these guys .
only these schools who the shirts had heard should ever practice .	these schools who only the shirts had heard should ever practice .
only these dishes that have run will ever learn .	these dishes that have only run will ever learn .
only the car that should know this shirt has ever grown .	the car that should only know this shirt has ever grown .
only that mirror who would lose can ever work with those trucks .	that mirror who would only lose can ever work with those trucks .
only those shirts who had brought that king will ever visit that chair .	those shirts who had only brought that king will ever visit that chair .
only these buttons who have won had ever yelled .	these buttons who have only won had ever yelled .
only this button who has thrown this adult could ever whisper .	this button who has only thrown this adult could ever whisper .
only these bottles who can know that car have ever talked to those forks .	these bottles who can only know that car have ever talked to those forks .
only the fork who had kept the teachers will ever fix those girls .	the fork who had only kept the teachers will ever fix those girls .
only this bank who had fixed that person will ever take this person .	this bank who had only fixed that person will ever take this person .
only that mirror who that button had heard would ever help this kitchen .	that mirror who only that button had heard would ever help this kitchen .
only those beds who the forks must know have ever kept that adult .	those beds who only the forks must know have ever kept that adult .
only that school who this rug had heard can ever paint .	that school who only this rug had heard can ever paint .
only this truck who would laugh would ever bring the queen .	this truck who would only laugh would ever bring the queen .
only this rocket who has heard that spoon will ever paint .	this rocket who has only heard that spoon will ever paint .
only this bag who must know those crayons had ever heard this doll .	this bag who must only know those crayons had ever heard this doll .
only these hats who will have this dentist can ever take this girl .	these hats who will only have this dentist can ever take this girl .
only those cups who these forks might hear can ever yell .	those cups who only these forks might hear can ever yell .
only this couch who has talked would ever lose .	this couch who has only talked would ever lose .
only these cups who will know these trucks had ever dropped those boys .	these cups who will only know these trucks had ever dropped those boys .
only that shirt who has lost should ever practice .	that shirt who has only lost should ever practice .
only the plane who the library could know had ever taken that dentist .	the plane who only the library could know had ever taken that dentist .
only these schools who had heard the windows will ever hear that glass .	these schools who had only heard the windows will ever hear that glass .
only that cup who must win would ever wave .	that cup who must only win would ever wave .
only this plane who had taken that adult has ever found the button .	this plane who had only taken that adult has ever found the button .
only this crayon who had heard these buttons had ever cried .	this crayon who had only heard these buttons had ever cried .
only that bowl who may sneeze could ever visit this room .	that bowl who may only sneeze could ever visit this room .
only those boxes who have fixed this teacher can ever talk to this hat .	those boxes who have only fixed this teacher can ever talk to this hat .
only those spoons who these crayons have heard could ever worry that ship .	those spoons who only these crayons have heard could ever worry that ship .
only the toys who have held that woman will ever answer that hat .	the toys who have only held that woman will ever answer that hat .
only this car who should whisper can ever know the crayons .	this car who should only whisper can ever know the crayons .
only that book that could eat had ever run .	that book that could only eat had ever run .
only this car who might cry has ever bothered these trucks .	this car who might only cry has ever bothered these trucks .
only those cars who those bowls had heard had ever taken that person .	those cars who only those bowls had heard had ever taken that person .
only those doors who had won would ever shake those boys .	those doors who had only won would ever shake those boys .
only that couch who has laughed will ever buy these ladies .	that couch who has only laughed will ever buy these ladies .
only this car who might hear those glasses has ever visited these shoes .	this car who might only hear those glasses has ever visited these shoes .
only these windows who may keep the adult could ever exercise .	these windows who may only keep the adult could ever exercise .
only this bicycle who had fixed the guy had ever cleaned the guys .	this bicycle who had only fixed the guy had ever cleaned the guys .
only those shirts who have fixed the lady could ever care for this ring .	those shirts who have only fixed the lady could ever care for this ring .
only these beds who should stretch would ever win .	these beds who should only stretch would ever win .
only these bottles who have yelled should ever scream .	these bottles who have only yelled should ever scream .
only that car who had heard the museum could ever fix these children .	that car who had only heard the museum could ever fix these children .
only those plates who had heard the windows have ever painted .	those plates who had only heard the windows have ever painted .
only that crayon who the fork had heard had ever bothered this rug .	that crayon who only the fork had heard had ever bothered this rug .
only the shoes who could hear this mall have ever cried .	the shoes who could only hear this mall have ever cried .
only those beds who had lost these girls had ever talked to these shoes .	those beds who had only lost these girls had ever talked to these shoes .
only this picture who would paint will ever help those forks .	this picture who would only paint will ever help those forks .
only the boat who might cough has ever held the girls .	the boat who might only cough has ever held the girls .
only that chair who will shake the doctors can ever practice .	that chair who will only shake the doctors can ever practice .
only this shirt who will steal that girl had ever moved the king .	this shirt who will only steal that girl had ever moved the king .
only the window who had heard that bottle has ever waved .	the window who had only heard that bottle has ever waved .
only this shirt who could talk could ever visit the schools .	this shirt who could only talk could ever visit the schools .
only the dolls who have cried can ever exercise .	the dolls who have only cried can ever exercise .
only those glasses who the windows could know had ever lost the bank .	those glasses who only the windows could know had ever lost the bank .
only that museum who would lie will ever cry .	that museum who would only lie will ever cry .
only the spoons who had cried can ever work with that rug .	the spoons who had only cried can ever work with that rug .
only that shoe who would know these rooms can ever cough .	that shoe who would only know these rooms can ever cough .
only that bank who may lose could ever listen to these boats .	that bank who may only lose could ever listen to these boats .
only the fork who may know these glasses will ever whisper .	the fork who may only know these glasses will ever whisper .
only these cups who had taken the guys can ever paint .	these cups who had only taken the guys can ever paint .
only those cars who those beds had heard should ever care for the ship .	those cars who only those beds had heard should ever care for the ship .
only those books who have made this dentist should ever understand this picture .	those books who have only made this dentist should ever understand this picture .
only that door who must win has ever taught that button .	that door who must only win has ever taught that button .
only these cups who will take this driver had ever kept those girls .	these cups who will only take this driver had ever kept those girls .
only the bags who will scream had ever fixed this patient .	the bags who will only scream had ever fixed this patient .
only these bags who had laughed should ever cry .	these bags who had only laughed should ever cry .
only the library who has heard that glass has ever bought this doctor .	the library who has only heard that glass has ever bought this doctor .
only the forks who have held that boy can ever cry .	the forks who have only held that boy can ever cry .
only this restaurant who would know the doll will ever keep the women .	this restaurant who would only know the doll will ever keep the women .
only that ring who can hear those crayons had ever kept the child .	that ring who can only hear those crayons had ever kept the child .
only these books who had lost the customer would ever lose .	these books who had only lost the customer would ever lose .
only the book who that ship had heard can ever appreciate this shoe .	the book who only that ship had heard can ever appreciate this shoe .
only that hospital who should stretch would ever praise these hats .	that hospital who should only stretch would ever praise these hats .
only this couch who may take that guy has ever worried those bottles .	this couch who may only take that guy has ever worried those bottles .
only this plate who the bank should hear had ever confused the buttons .	this plate who only the bank should hear had ever confused the buttons .
only the candles who the forks have heard would ever scream .	the candles who only the forks have heard would ever scream .
only this park who might hear this mall can ever care for that bicycle .	this park who might only hear this mall can ever care for that bicycle .
only this crayon who this ring has heard had ever taught the rug .	this crayon who only this ring has heard had ever taught the rug .
only the dish who that mirror had heard would ever listen to that shoe .	the dish who only that mirror had heard would ever listen to that shoe .
only this shoe who must shake the dentist can ever practice .	this shoe who must only shake the dentist can ever practice .
only these cars who those pictures have heard would ever paint .	these cars who only those pictures have heard would ever paint .
only this bed who had found this dancer would ever lose .	this bed who had only found this dancer would ever lose .
only the boxes who can scream will ever lose .	the boxes who can only scream will ever lose .
only the glass who the school might hear could ever win .	the glass who only the school might hear could ever win .
only the book who had kept these boys had ever worked with these beds .	the book who had only kept these boys had ever worked with these beds .
only the bowls who will stretch can ever steal that child .	the bowls who will only stretch can ever steal that child .
only this doll who had heard the dishes will ever hear this doll .	this doll who had only heard the dishes will ever hear this doll .
only the books who should take that man could ever help that candle .	the books who should only take that man could ever help that candle .
only this glass who has brought these girls had ever worked with this school .	this glass who has only brought these girls had ever worked with this school .
only that park who that mirror might know has ever talked .	that park who only that mirror might know has ever talked .
only that chair that has eaten had ever grown .	that chair that has only eaten had ever grown .
only that mall who must scream has ever laughed .	that mall who must only scream has ever laughed .
only that chair who would have the girls could ever teach the room .	that chair who would only have the girls could ever teach the room .
only those bottles who may hear the restaurant have ever heard this bag .	those bottles who may only hear the restaurant have ever heard this bag .
only those rings who these boats had heard would ever know the button .	those rings who only these boats had heard would ever know the button .
only the picture who has won has ever made that dancer .	the picture who has only won has ever made that dancer .
only those buttons who have heard the candles should ever praise this couch .	those buttons who have only heard the candles should ever praise this couch .
only the bag that had run had ever learned .	the bag that had only run had ever learned .
only this dish who must sing had ever scared the crayon .	this dish who must only sing had ever scared the crayon .
only that button who that button had heard has ever bought this girl .	that button who only that button had heard has ever bought this girl .
only this hospital who the shirt must hear had ever worried these books .	this hospital who only the shirt must hear had ever worried these books .
only these doors who will cry should ever laugh .	these doors who will only cry should ever laugh .
only this bowl who had heard these cups has ever taken that man .	this bowl who had only heard these cups has ever taken that man .
only the door who this crayon had heard would ever read .	the door who only this crayon had heard would ever read .
only these trucks who might sell that child could ever buy this dentist .	these trucks who might only sell that child could ever buy this dentist .
only that bowl who should hear that hat has ever cleaned the teachers .	that bowl who should only hear that hat has ever cleaned the teachers .
only this window who that rocket should know could ever cough .	this window who only that rocket should know could ever cough .
only this mirror who should bring this customer had ever bothered the shoes .	this mirror who should only bring this customer had ever bothered the shoes .
only this school who that glass had heard could ever win .	this school who only that glass had heard could ever win .
only the boxes who should know these spoons should ever bother the car .	the boxes who should only know these spoons should ever bother the car .
only the bottle who could buy the guy would ever smile .	the bottle who could only buy the guy would ever smile .
only the toy who has cried would ever fix this dentist .	the toy who has only cried would ever fix this dentist .
only the schools that could run had ever grown .	the schools that could only run had ever grown .
only that rocket that that fork could hear should ever eat .	that rocket that only that fork could hear should ever eat .
only those books who had talked could ever help this book .	those books who had only talked could ever help this book .
only the boxes who can hear this school had ever fixed the girl .	the boxes who can only hear this school had ever fixed the girl .
only these dolls who could hear those crayons could ever sell the guy .	these dolls who could only hear those crayons could ever sell the guy .
only this doll who the candle has heard had ever heard that crayon .	this doll who only the candle has heard had ever heard that crayon .
only this window that can hear that school would ever learn .	this window that can only hear that school would ever learn .
only that mall who that bicycle will know had ever worked with these books .	that mall who only that bicycle will know had ever worked with these books .
only those spoons who might know this plane can ever practice .	those spoons who might only know this plane can ever practice .
only that school who has heard that spoon has ever worried the car .	that school who has only heard that spoon has ever worried the car .
only this plane who might wave can ever talk to that museum .	this plane who might only wave can ever talk to that museum .
only the cups who will practice would ever bother these doors .	the cups who will only practice would ever bother these doors .
only the dish who could steal that customer will ever laugh .	the dish who could only steal that customer will ever laugh .
only these cars who must yell can ever throw these women .	these cars who must only yell can ever throw these women .
only the toy who can hear this bank would ever cry .	the toy who can only hear this bank would ever cry .
only that car who will hear these schools will ever bother this ring .	that car who will only hear these schools will ever bother this ring .
only this school that this cup may hear had ever run .	this school that only this cup may hear had ever run .
only this bowl that has eaten would ever learn .	this bowl that has only eaten would ever learn .
only that hospital who would read had ever visited the kitchen .	that hospital who would only read had ever visited the kitchen .
only these doors who should paint can ever whisper .	these doors who should only paint can ever whisper .
only the toy who should smile had ever moved this driver .	the toy who should only smile had ever moved this driver .
only that restaurant who this restaurant had heard will ever move that king .	that restaurant who only this restaurant had heard will ever move that king .
only these buttons who must whisper would ever lie .	these buttons who must only whisper would ever lie .
only that glass who will wave can ever whisper .	that glass who will only wave can ever whisper .
only the bank who has heard this school had ever held that king .	the bank who has only heard this school had ever held that king .
only this park who that room may hear could ever listen to this glass .	this park who only that room may hear could ever listen to this glass .
only the bicycle who must wave could ever appreciate the ring .	the bicycle who must only wave could ever appreciate the ring .
only this mall who could find the teachers could ever whisper .	this mall who could only find the teachers could ever whisper .
only this car who would paint had ever made this king .	this car who would only paint had ever made this king .
only that glass that the mall had heard has ever run .	that glass that only the mall had heard has ever run .
only the spoons who could cry can ever answer this rocket .	the spoons who could only cry can ever answer this rocket .
only these schools who might practice had ever worried those toys .	these schools who might only practice had ever worried those toys .
only that ship who should bring that customer had ever taught the boat .	that ship who should only bring that customer had ever taught the boat .
only that door who must hear that fork will ever teach the plates .	that door who must only hear that fork will ever teach the plates .
only these boats who might keep these girls should ever talk to the window .	these boats who might only keep these girls should ever talk to the window .
only the books who the bowls can hear should ever buy those people .	the books who only the bowls can hear should ever buy those people .
only those plates who may move this person would ever practice .	those plates who may only move this person would ever practice .
only the boats who have read should ever read .	the boats who have only read should ever read .
only this cup who should throw those guys will ever talk to those shoes .	this cup who should only throw those guys will ever talk to those shoes .
only this crayon who this bag will know would ever smile .	this crayon who only this bag will know would ever smile .
only the dish who may cry can ever hold the queen .	the dish who may only cry can ever hold the queen .
only that school who will read had ever talked to the plane .	that school who will only read had ever talked to the plane .
only that ship who can know that boat should ever cough .	that ship who can only know that boat should ever cough .
only the library who may sing can ever bring those ladies .	the library who may only sing can ever bring those ladies .
only the door who can lift this teacher has ever read .	the door who can only lift this teacher has ever read .
only this plate who can stretch has ever yelled .	this plate who can only stretch has ever yelled .
only that truck who the museum had heard has ever fixed this queen .	that truck who only the museum had heard has ever fixed this queen .
only this kitchen who had made that man would ever yell .	this kitchen who had only made that man would ever yell .
only the cup who should find the man can ever praise those buttons .	the cup who should only find the man can ever praise those buttons .
only the buttons who have cleaned the customer can ever throw the guys .	the buttons who have only cleaned the customer can ever throw the guys .
only those chairs who might stretch have ever talked to that ship .	those chairs who might only stretch have ever talked to that ship .
only that chair who had held this king had ever waved .	that chair who had only held this king had ever waved .
only this crayon who would take the boy has ever kept those boys .	this crayon who would only take the boy has ever kept those boys .
only the dishes who had won had ever won .	the dishes who had only won had ever won .
only the crayon who had lost will ever help this box .	the crayon who had only lost will ever help this box .
only the school who has fixed this woman will ever read .	the school who has only fixed this woman will ever read .
only the crayon that would know that box will ever learn .	the crayon that would only know that box will ever learn .
only these chairs who had heard those bowls should ever read .	these chairs who had only heard those bowls should ever read .
only this book who has thrown this person can ever scare the hat .	this book who has only thrown this person can ever scare the hat .
only the rocket who has made the patient can ever wave .	the rocket who has only made the patient can ever wave .
only these cars who these rooms had heard could ever scream .	these cars who only these rooms had heard could ever scream .
only that library who has heard the book will ever sneeze .	that library who has only heard the book will ever sneeze .
only the dishes that had eaten should ever run .	the dishes that had only eaten should ever run .
only those books who might laugh could ever smile .	those books who might only laugh could ever smile .
only that plate that must eat can ever eat .	that plate that must only eat can ever eat .
only the school who has moved these guys will ever lift these guys .	the school who has only moved these guys will ever lift these guys .
only that candle who could sing could ever read .	that candle who could only sing could ever read .
only the boxes who could hear this picture had ever heard those buttons .	the boxes who could only hear this picture had ever heard those buttons .
only those shoes who had heard these toys have ever confused this hat .	those shoes who had only heard these toys have ever confused this hat .
only this toy who has bought these people had ever dropped the queen .	this toy who has only bought these people had ever dropped the queen .
only the box who the cup must know would ever find this driver .	the box who only the cup must know would ever find this driver .
only the beds who will hear the spoon had ever brought the guy .	the beds who will only hear the spoon had ever brought the guy .
only this ring who had laughed should ever take that person .	this ring who had only laughed should ever take that person .
only the boxes who might read could ever hear that chair .	the boxes who might only read could ever hear that chair .
only these glasses who have held this doctor had ever heard these toys .	these glasses who have only held this doctor had ever heard these toys .
only these cars that the cups should hear would ever grow .	these cars that only the cups should hear would ever grow .
only those beds who should hear this glass have ever heard this mall .	those beds who should only hear this glass have ever heard this mall .
only that rug who this book would hear should ever know these hats .	that rug who only this book would hear should ever know these hats .
only those books who may lift the doctors could ever listen to this window .	those books who may only lift the doctors could ever listen to this window .
only those shirts who have talked would ever take this adult .	those shirts who have only talked would ever take this adult .
only the box who must lose had ever brought the lady .	the box who must only lose had ever brought the lady .
only these shoes who might know the crayon will ever lift the guys .	these shoes who might only know the crayon will ever lift the guys .
only those candles who may hear those rooms will ever practice .	those candles who may only hear those rooms will ever practice .
only this bowl who would smile will ever lose .	this bowl who would only smile will ever lose .
only the chairs who would lie had ever confused those spoons .	the chairs who would only lie had ever confused those spoons .
only this kitchen who had bought this doctor had ever fixed this doctor .	this kitchen who had only bought this doctor had ever fixed this doctor .
only that room who could know the restaurant had ever lost those beds .	that room who could only know the restaurant had ever lost those beds .
only those spoons that the books might know had ever eaten .	those spoons that only the books might know had ever eaten .
only the door who might exercise had ever cleaned that person .	the door who might only exercise had ever cleaned that person .
only the kitchen who this ship has heard should ever sneeze .	the kitchen who only this ship has heard should ever sneeze .
only these chairs who these trucks will hear should ever visit the candles .	these chairs who only these trucks will hear should ever visit the candles .
only that crayon who can know this hospital will ever appreciate this dish .	that crayon who can only know this hospital will ever appreciate this dish .
only the school who had heard this car should ever sing .	the school who had only heard this car should ever sing .
only these dishes who should read will ever buy this queen .	these dishes who should only read will ever buy this queen .
only that glass who would lose should ever cough .	that glass who would only lose should ever cough .
only those pictures who can lose had ever found the driver .	those pictures who can only lose had ever found the driver .
only that bottle who must sing will ever work with that rug .	that bottle who must only sing will ever work with that rug .
only the library who this glass could know has ever taken those women .	the library who only this glass could know has ever taken those women .
only this window that has learned would ever run .	this window that has only learned would ever run .
only the candle who would hold that boy would ever talk to that bowl .	the candle who would only hold that boy would ever talk to that bowl .
only the shoes who these glasses might hear had ever waved .	the shoes who only these glasses might hear had ever waved .
only those trucks who may stretch will ever lose this dancer .	those trucks who may only stretch will ever lose this dancer .
only the toys who those books have heard had ever laughed .	the toys who only those books have heard had ever laughed .
only this school who may sneeze could ever lose the boy .	this school who may only sneeze could ever lose the boy .
only this car who had lost the men can ever laugh .	this car who had only lost the men can ever laugh .
only that truck who the ring can know has ever moved this driver .	that truck who only the ring can know has ever moved this driver .
only these beds who may win would ever whisper .	these beds who may only win would ever whisper .
only these bottles that these chairs would know could ever eat .	these bottles that only these chairs would know could ever eat .
only this dish who has won had ever found this dentist .	this dish who has only won had ever found this dentist .
only the boats who will exercise could ever drop the customer .	the boats who will only exercise could ever drop the customer .
only the toys who had held this patient should ever know those cars .	the toys who had only held this patient should ever know those cars .
only the button who may know the mall would ever practice .	the button who may only know the mall would ever practice .
only this room who should lift these guys has ever heard this car .	this room who should only lift these guys has ever heard this car .
only that rocket who had lost that doctor had ever yelled .	that rocket who had only lost that doctor had ever yelled .
only the bicycle who should hear this school has ever taught this restaurant .	the bicycle who should only hear this school has ever taught this restaurant .
only the doll who must stretch will ever paint .	the doll who must only stretch will ever paint .
only these dolls who those glasses have heard should ever help the plane .	these dolls who only those glasses have heard should ever help the plane .
only the buttons who would hear this bag could ever move the guy .	the buttons who would only hear this bag could ever move the guy .
only that book who that car had heard could ever lie .	that book who only that car had heard could ever lie .
only the door who could hear these spoons had ever answered these glasses .	the door who could only hear these spoons had ever answered these glasses .
only those schools that should grow have ever eaten .	those schools that should only grow have ever eaten .
only that truck who has won has ever cleaned these people .	that truck who has only won has ever cleaned these people .
only the cars who have heard this candle can ever smile .	the cars who have only heard this candle can ever smile .
only that candle who has heard the candle could ever sneeze .	that candle who has only heard the candle could ever sneeze .
only this mall who has bought that queen should ever scare that bottle .	this mall who has only bought that queen should ever scare that bottle .
only that rug who that spoon had heard had ever answered that shoe .	that rug who only that spoon had heard had ever answered that shoe .
only that hat who this box had heard had ever brought those men .	that hat who only this box had heard had ever brought those men .
only this bicycle who will throw those men should ever cry .	this bicycle who will only throw those men should ever cry .
only this mirror who has heard the ship could ever visit that rug .	this mirror who has only heard the ship could ever visit that rug .
only those bags who the rooms might know will ever read .	those bags who only the rooms might know will ever read .
only the rug who had read would ever read .	the rug who had only read would ever read .
only those chairs that have eaten had ever grown .	those chairs that have only eaten had ever grown .
only the toy who will know that park will ever care for these hats .	the toy who will only know that park will ever care for these hats .
only the pictures who should cough had ever heard the rings .	the pictures who should only cough had ever heard the rings .
only that couch who could hear these spoons can ever clean those children .	that couch who could only hear these spoons can ever clean those children .
only those cars who had thrown this woman could ever make the children .	those cars who had only thrown this woman could ever make the children .
only the restaurant who had bought that boy will ever hear those beds .	the restaurant who had only bought that boy will ever hear those beds .
only those dishes who may talk had ever painted .	those dishes who may only talk had ever painted .
only these cups who must drop this teacher will ever answer the truck .	these cups who must only drop this teacher will ever answer the truck .
only those rooms who have brought the guy have ever helped this bicycle .	those rooms who have only brought the guy have ever helped this bicycle .
only this library who had made those people had ever answered the dishes .	this library who had only made those people had ever answered the dishes .
only those books who have kept the dentist will ever hear that bottle .	those books who have only kept the dentist will ever hear that bottle .
only these bottles who will wave can ever visit that door .	these bottles who will only wave can ever visit that door .
only this car who the picture would know would ever understand the cars .	this car who only the picture would know would ever understand the cars .
only that car who will sing would ever teach the toy .	that car who will only sing would ever teach the toy .
only those bowls who might fix this dancer could ever appreciate the box .	those bowls who might only fix this dancer could ever appreciate the box .
only these rings who had made that adult should ever move the driver .	these rings who had only made that adult should ever move the driver .
only those plates who the toys had heard should ever find this dentist .	those plates who only the toys had heard should ever find this dentist .
only these glasses who could steal that guy will ever laugh .	these glasses who could only steal that guy will ever laugh .
only the ship who can cough should ever exercise .	the ship who can only cough should ever exercise .
only the picture who should laugh can ever scare the spoon .	the picture who should only laugh can ever scare the spoon .
only this shirt who has thrown these ladies will ever make this woman .	this shirt who has only thrown these ladies will ever make this woman .
only the glasses who should keep those boys could ever scream .	the glasses who should only keep those boys could ever scream .
only this library who this shirt should hear has ever heard that mirror .	this library who only this shirt should hear has ever heard that mirror .
only the chairs who will hear those crayons can ever whisper .	the chairs who will only hear those crayons can ever whisper .
only that restaurant who had lost has ever scared these bottles .	that restaurant who had only lost has ever scared these bottles .
only the bowls who may scream can ever sneeze .	the bowls who may only scream can ever sneeze .
only the forks who might lift that woman could ever cough .	the forks who might only lift that woman could ever cough .
only the couch who had painted can ever worry that window .	the couch who had only painted can ever worry that window .
only those dishes who those cars can hear had ever worked with this car .	those dishes who only those cars can hear had ever worked with this car .
only this toy who has won had ever talked .	this toy who has only won had ever talked .
only the plates who would stretch will ever work with these rings .	the plates who would only stretch will ever work with these rings .
only the bottle who has moved these children will ever sell these guys .	the bottle who has only moved these children will ever sell these guys .
only these boxes who those crayons should know can ever steal that dancer .	these boxes who only those crayons should know can ever steal that dancer .
only the button who that fork might know will ever laugh .	the button who only that fork might know will ever laugh .
only those dolls who had heard the bottles have ever taken those doctors .	those dolls who had only heard the bottles have ever taken those doctors .
only that shoe who has heard these books should ever teach that truck .	that shoe who has only heard these books should ever teach that truck .
only this library who should stretch has ever lost .	this library who should only stretch has ever lost .
only the dolls who have yelled should ever laugh .	the dolls who have only yelled should ever laugh .
only this candle who that school must hear will ever steal the doctor .	this candle who only that school must hear will ever steal the doctor .
only that bed who may steal those women had ever heard this ring .	that bed who may only steal those women had ever heard this ring .
only that car who must bring that teacher will ever hear that truck .	that car who must only bring that teacher will ever hear that truck .
only those spoons who had heard these candles should ever teach the books .	those spoons who had only heard these candles should ever teach the books .
only this park who that couch has heard had ever cried .	this park who only that couch has heard had ever cried .
only this rug that has learned should ever grow .	this rug that has only learned should ever grow .
only that crayon who had heard this ring can ever hear this book .	that crayon who had only heard this ring can ever hear this book .
only the boxes who those rings will hear could ever yell .	the boxes who only those rings will hear could ever yell .
only those chairs who have lost had ever won .	those chairs who have only lost had ever won .
only the plate who has found this guy should ever take those ladies .	the plate who has only found this guy should ever take those ladies .
only these schools who the cars had heard would ever praise that bed .	these schools who only the cars had heard would ever praise that bed .
only the hats who would sell these ladies had ever painted .	the hats who would only sell these ladies had ever painted .
only the toys who might lift these teachers could ever visit the book .	the toys who might only lift these teachers could ever visit the book .
only this cup who would hear the trucks had ever found this teacher .	this cup who would only hear the trucks had ever found this teacher .
only the rug that can hear those bowls has ever learned .	the rug that can only hear those bowls has ever learned .
only the rooms who had laughed will ever praise those plates .	the rooms who had only laughed will ever praise those plates .
only the boat who might hear this bottle had ever answered those crayons .	the boat who might only hear this bottle had ever answered those crayons .
only the fork who had heard this bowl would ever throw this king .	the fork who had only heard this bowl would ever throw this king .
only the button who had kept the teacher could ever work with those spoons .	the button who had only kept the teacher could ever work with those spoons .
only this box who the book must know had ever waved .	this box who only the book must know had ever waved .
only the park who had painted has ever cried .	the park who had only painted has ever cried .
only that bag who this kitchen must hear will ever answer these bags .	that bag who only this kitchen must hear will ever answer these bags .
only the doll who would win can ever drop the boy .	the doll who would only win can ever drop the boy .
only this ring who must hear that museum had ever helped these rings .	this ring who must only hear that museum had ever helped these rings .
only the crayons who the trucks may hear could ever teach that truck .	the crayons who only the trucks may hear could ever teach that truck .
only these cars that those shoes must hear should ever run .	these cars that only those shoes must hear should ever run .
only the glass who had taken that customer has ever read .	the glass who had only taken that customer has ever read .
only this park who may scream has ever worried this cup .	this park who may only scream has ever worried this cup .
only those bowls who will hear these cars have ever painted .	those bowls who will only hear these cars have ever painted .
only the cars who would win had ever waved .	the cars who would only win had ever waved .
only that rug who may sell the child had ever lost this museum .	that rug who may only sell the child had ever lost this museum .
only the car who could sneeze could ever know the school .	the car who could only sneeze could ever know the school .
only this dish who may whisper can ever cry .	this dish who may only whisper can ever cry .
only these shoes who the glasses could know would ever throw the doctor .	these shoes who only the glasses could know would ever throw the doctor .
only that car who could hear the trucks has ever heard the rocket .	that car who could only hear the trucks has ever heard the rocket .
only that book who had heard that bowl had ever kept those doctors .	that book who had only heard that bowl had ever kept those doctors .
only the toy who can scream had ever waved .	the toy who can only scream had ever waved .
only these rings who will sing will ever whisper .	these rings who will only sing will ever whisper .
only that box who had heard the window has ever held the queen .	that box who had only heard the window has ever held the queen .
only this window who had found this man will ever sneeze .	this window who had only found this man will ever sneeze .
only the hospital who would know the windows will ever listen to the windows .	the hospital who would only know the windows will ever listen to the windows .
only the buttons who had bought the people have ever confused that room .	the buttons who had only bought the people have ever confused that room .
only that couch who should keep this king would ever listen to these boats .	that couch who should only keep this king would ever listen to these boats .
only the school who the restaurant had heard has ever worked with that shoe .	the school who only the restaurant had heard has ever worked with that shoe .
only this plate who might move those women should ever understand these cups .	this plate who might only move those women should ever understand these cups .
only these plates who could laugh can ever steal the adult .	these plates who could only laugh can ever steal the adult .
only those candles who had heard the spoons had ever yelled .	those candles who had only heard the spoons had ever yelled .
only this room who this spoon must know will ever scare the school .	this room who only this spoon must know will ever scare the school .
only this couch who has found the women could ever paint .	this couch who has only found the women could ever paint .
only the boxes who must know those shirts could ever answer this shoe .	the boxes who must only know those shirts could ever answer this shoe .
only that bed who has taken these children should ever shake those guys .	that bed who has only taken these children should ever shake those guys .
only those spoons who will drop these men can ever throw this adult .	those spoons who will only drop these men can ever throw this adult .
only this door who has read could ever worry this room .	this door who has only read could ever worry this room .
only that door who could sneeze would ever exercise .	that door who could only sneeze would ever exercise .
only those rings who these books will know had ever visited that ship .	those rings who only these books will know had ever visited that ship .
only this shirt that might know the bank could ever learn .	this shirt that might only know the bank could ever learn .
only the plane who can practice had ever heard that window .	the plane who can only practice had ever heard that window .
only those bottles who must hear that bottle would ever sell that woman .	those bottles who must only hear that bottle would ever sell that woman .
only those windows who these windows can know will ever scare the chair .	those windows who only these windows can know will ever scare the chair .
only the room who the car could hear has ever held those boys .	the room who only the car could hear has ever held those boys .
only the bowl who that toy will hear has ever worried that car .	the bowl who only that toy will hear has ever worried that car .
only this kitchen who has brought that woman has ever painted .	this kitchen who has only brought that woman has ever painted .
only that bottle who the hospital can hear would ever scream .	that bottle who only the hospital can hear would ever scream .
only this plane who might take this woman has ever cried .	this plane who might only take this woman has ever cried .
only that school who may know those candles will ever keep the queen .	that school who may only know those candles will ever keep the queen .
only those cars who these hats had heard had ever yelled .	those cars who only these hats had heard had ever yelled .
only the mirror who could find the driver has ever scared that bicycle .	the mirror who could only find the driver has ever scared that bicycle .
only those bottles who the schools have heard will ever talk to the ring .	those bottles who only the schools have heard will ever talk to the ring .
only this ship who would clean these men can ever hear the buttons .	this ship who would only clean these men can ever hear the buttons .
only the plates who could laugh have ever helped this mirror .	the plates who could only laugh have ever helped this mirror .
only that rug who would stretch could ever sell that driver .	that rug who would only stretch could ever sell that driver .
only the door who should cough would ever read .	the door who should only cough would ever read .
only these pictures who should take this woman have ever worried those schools .	these pictures who should only take this woman have ever worried those schools .
only those chairs who might whisper would ever help these buttons .	those chairs who might only whisper would ever help these buttons .
only the crayon who can take this woman can ever lie .	the crayon who can only take this woman can ever lie .
only that school who might lose the guys has ever dropped the women .	that school who might only lose the guys has ever dropped the women .
only those cups that those schools could know could ever run .	those cups that only those schools could know could ever run .
only that bicycle who might steal those ladies should ever scream .	that bicycle who might only steal those ladies should ever scream .
only the candle who may hear this bottle had ever confused that doll .	the candle who may only hear this bottle had ever confused that doll .
only the rings who should smile can ever sing .	the rings who should only smile can ever sing .
only the toys who have lost have ever lost this rug .	the toys who have only lost have ever lost this rug .
only the crayon who could yell had ever found the boy .	the crayon who could only yell had ever found the boy .
only the dishes who might bring the child have ever waved .	the dishes who might only bring the child have ever waved .
only these rooms who may know that museum would ever work with that shirt .	these rooms who may only know that museum would ever work with that shirt .
only this book who might hear those rings had ever lost these books .	this book who might only hear those rings had ever lost these books .
only that truck who can find this guy can ever listen to the plane .	that truck who can only find this guy can ever listen to the plane .
only the school who the bowl will know would ever hear those cars .	the school who only the bowl will know would ever hear those cars .
only that door who might sing could ever praise the books .	that door who might only sing could ever praise the books .
only the truck that would grow can ever eat .	the truck that would only grow can ever eat .
only this hospital who may know these books would ever sing .	this hospital who may only know these books would ever sing .
only that shirt who had found those ladies can ever scream .	that shirt who had only found those ladies can ever scream .
only those pictures who had made that queen have ever thrown that girl .	those pictures who had only made that queen have ever thrown that girl .
only these books who might know the bicycle could ever read .	these books who might only know the bicycle could ever read .
only that toy who must lie would ever understand these glasses .	that toy who must only lie would ever understand these glasses .
only the shirts who would smile will ever worry these doors .	the shirts who would only smile will ever worry these doors .
only this rug who that glass has heard would ever bring that lady .	this rug who only that glass has heard would ever bring that lady .
only this spoon who may find this queen can ever bother these glasses .	this spoon who may only find this queen can ever bother these glasses .
only the mirror who would stretch can ever work with the museum .	the mirror who would only stretch can ever work with the museum .
only that bag who had won should ever cry .	that bag who had only won should ever cry .
only that room who will cry should ever steal the patient .	that room who will only cry should ever steal the patient .
only those crayons who would throw the girl will ever buy the girls .	those crayons who would only throw the girl will ever buy the girls .
only that chair that would grow should ever grow .	that chair that would only grow should ever grow .
only this door who might talk will ever work with the shoe .	this door who might only talk will ever work with the shoe .
only this hat who had heard those buttons should ever scare the cups .	this hat who had only heard those buttons should ever scare the cups .
only that car who could buy the teacher could ever keep this doctor .	that car who could only buy the teacher could ever keep this doctor .
only the bowls who must sing should ever exercise .	the bowls who must only sing should ever exercise .
only the dishes who have held those girls will ever teach the books .	the dishes who have only held those girls will ever teach the books .
only those shoes who have yelled can ever lie .	those shoes who have only yelled can ever lie .
only the books who should sneeze could ever make these doctors .	the books who should only sneeze could ever make these doctors .
only the car who would hear this couch had ever cleaned these men .	the car who would only hear this couch had ever cleaned these men .
only the bowls who could hear this glass can ever know this toy .	the bowls who could only hear this glass can ever know this toy .
only these books who will paint should ever hold that boy .	these books who will only paint should ever hold that boy .
only those crayons who had dropped the doctor could ever bring the ladies .	those crayons who had only dropped the doctor could ever bring the ladies .
only those candles who must exercise have ever talked .	those candles who must only exercise have ever talked .
only the restaurant who may lose those women can ever hear the couch .	the restaurant who may only lose those women can ever hear the couch .
only the boat who might clean that king can ever cough .	the boat who might only clean that king can ever cough .
only the dishes who these beds should know had ever cried .	the dishes who only these beds should know had ever cried .
only that hospital who must cry had ever read .	that hospital who must only cry had ever read .
only these buttons who can shake the woman can ever whisper .	these buttons who can only shake the woman can ever whisper .
only this crayon who must clean that dancer will ever care for those bags .	this crayon who must only clean that dancer will ever care for those bags .
only this crayon who has heard the bowls should ever move the children .	this crayon who has only heard the bowls should ever move the children .
only the shirts who can hear this spoon can ever make the lady .	the shirts who can only hear this spoon can ever make the lady .
only the window who must hold that guy could ever help these dishes .	the window who must only hold that guy could ever help these dishes .
only the ring who this rug might hear will ever listen to this library .	the ring who only this rug might hear will ever listen to this library .
only these bags who have waved have ever found the crayons .	these bags who have only waved have ever found the crayons .
only that mall who has bought these doctors can ever talk to the book .	that mall who has only bought these doctors can ever talk to the book .
only the bed who that book had heard would ever whisper .	the bed who only that book had heard would ever whisper .
only the rug who would steal the man would ever talk to this bottle .	the rug who would only steal the man would ever talk to this bottle .
only that school who this doll has heard would ever listen to those buttons .	that school who only this doll has heard would ever listen to those buttons .
only that rocket who would shake the ladies would ever work with this window .	that rocket who would only shake the ladies would ever work with this window .
only this room who will read would ever buy these boys .	this room who will only read would ever buy these boys .
only the plates who had heard that bottle will ever know the room .	the plates who had only heard that bottle will ever know the room .
only that shoe who this shoe may know should ever sell these boys .	that shoe who only this shoe may know should ever sell these boys .
