this rocket visited that crayon on the floor .	this rocket visited on the floor that crayon .
that boat in the kitchen taught the car .	that boat taught in the kitchen the car .
this picture bothered that truck in the school .	this picture bothered in the school that truck .
this rug lost this rug on the table .	this rug lost on the table this rug .
that spoon scared the candle by the bed .	that spoon scared by the bed the candle .
that couch worked with the spoon on the bed .	that couch worked with on the bed the spoon .
that shirt on the table helped the glass .	that shirt helped on the table the glass .
the bicycle in the park found that button .	the bicycle found in the park that button .
that plane found that couch by the car .	that plane found by the car that couch .
that picture worried this bicycle on the table .	that picture worried on the table this bicycle .
this bowl bothered that toy by the plane .	this bowl bothered by the plane that toy .
the toy on the chair confused that bottle .	the toy confused on the chair that bottle .
this car found the candle by the door .	this car found by the door the candle .
the dish found that ring by the shirt .	the dish found by the shirt that ring .
that doll on the table helped this hat .	that doll helped on the table this hat .
that book by the fork confused this car .	that book confused by the fork this car .
that shoe by the mirror visited that rocket .	that shoe visited by the mirror that rocket .
the plate in the mall worked with the shirt .	the plate worked with in the mall the shirt .
this rocket helped the car by the hat .	this rocket helped by the hat the car .
this plate in the mall answered the chair .	this plate answered in the mall the chair .
that bag in the room found this crayon .	that bag found in the room this crayon .
the rocket by the shoe found that button .	the rocket found by the shoe that button .
this glass on the street worried this rocket .	this glass worried on the street this rocket .
that doll found this ring on the couch .	that doll found on the couch this ring .
this couch answered that ring in the restaurant .	this couch answered in the restaurant that ring .
the rug lost the car in the mall .	the rug lost in the mall the car .
the book bothered this mirror on the table .	the book bothered on the table this mirror .
the plate on the floor found this plate .	the plate found on the floor this plate .
the spoon in the school talked to this chair .	the spoon talked to in the school this chair .
this box answered the window on the bed .	this box answered on the bed the window .
this ring in the hospital helped this book .	this ring helped in the hospital this book .
the book visited that toy by the shoe .	the book visited by the shoe that toy .
that plate found the ring in the school .	that plate found in the school the ring .
that bed helped that rug by the car .	that bed helped by the car that rug .
the book in the room confused this plate .	the book confused in the room this plate .
the picture on the ground lost this doll .	the picture lost on the ground this doll .
this picture by the picture visited this mirror .	this picture visited by the picture this mirror .
the truck worked with the toy in the restaurant .	the truck worked with in the restaurant the toy .
the book confused this fork by the car .	the book confused by the car this fork .
that bicycle bothered the box on the bed .	that bicycle bothered on the bed the box .
that box helped that bag on the bed .	that box helped on the bed that bag .
the book talked to the rocket in the museum .	the book talked to in the museum the rocket .
this plate on the floor talked to the doll .	this plate talked to on the floor the doll .
the mirror answered that ship on the ground .	the mirror answered on the ground that ship .
this boat by the rug confused the window .	this boat confused by the rug the window .
that rug worried the box by the hat .	that rug worried by the hat the box .
that toy by the rug worked with the ship .	that toy worked with by the rug the ship .
that dish bothered that button in the kitchen .	that dish bothered in the kitchen that button .
the plate found that box by the box .	the plate found by the box that box .
the bed on the couch lost the ship .	the bed lost on the couch the ship .
that rug in the library taught this couch .	that rug taught in the library this couch .
that bottle answered this hat in the park .	that bottle answered in the park this hat .
this dish in the library talked to the crayon .	this dish talked to in the library the crayon .
the ship by the shirt talked to this glass .	the ship talked to by the shirt this glass .
this hat taught this plate in the mall .	this hat taught in the mall this plate .
the spoon worked with that shoe in the bank .	the spoon worked with in the bank that shoe .
this plane on the floor answered that plate .	this plane answered on the floor that plate .
the plane by the plate helped that couch .	the plane helped by the plate that couch .
the door in the library taught the boat .	the door taught in the library the boat .
this dish talked to this shoe in the school .	this dish talked to in the school this shoe .
that bed worried that truck in the kitchen .	that bed worried in the kitchen that truck .
this car by the rocket visited this shoe .	this car visited by the rocket this shoe .
that car worked with the cup in the kitchen .	that car worked with in the kitchen the cup .
that toy found this window on the floor .	that toy found on the floor this window .
this shoe answered this fork on the chair .	this shoe answered on the chair this fork .
the book lost that picture in the mall .	the book lost in the mall that picture .
this bed scared the spoon on the ground .	this bed scared on the ground the spoon .
this car in the restaurant worried that door .	this car worried in the restaurant that door .
the book in the restaurant bothered the cup .	the book bothered in the restaurant the cup .
that bottle lost that dish by the bag .	that bottle lost by the bag that dish .
this picture on the stool worked with this book .	this picture worked with on the stool this book .
the ring in the school taught that crayon .	the ring taught in the school that crayon .
the plate on the floor found that doll .	the plate found on the floor that doll .
the ship talked to this shoe in the restaurant .	the ship talked to in the restaurant this shoe .
the spoon on the couch confused that cup .	the spoon confused on the couch that cup .
the dish worked with this ship by the dish .	the dish worked with by the dish this ship .
this bicycle bothered this window in the room .	this bicycle bothered in the room this window .
the fork in the kitchen worried this truck .	the fork worried in the kitchen this truck .
that box on the floor visited that plane .	that box visited on the floor that plane .
that window worked with this chair by the ship .	that window worked with by the ship this chair .
the rug by the window bothered the rug .	the rug bothered by the window the rug .
the mirror scared the shoe by the fork .	the mirror scared by the fork the shoe .
the book on the street talked to the window .	the book talked to on the street the window .
that crayon on the chair found this glass .	that crayon found on the chair this glass .
that rocket on the bed bothered this candle .	that rocket bothered on the bed this candle .
this chair answered that candle by the fork .	this chair answered by the fork that candle .
that rug by the shirt helped that crayon .	that rug helped by the shirt that crayon .
this book confused the shirt on the stool .	this book confused on the stool the shirt .
this book worked with this chair in the park .	this book worked with in the park this chair .
this door found the bottle in the museum .	this door found in the museum the bottle .
this door on the stool worked with this truck .	this door worked with on the stool this truck .
the ship by the window talked to this truck .	the ship talked to by the window this truck .
this plane taught this door by the couch .	this plane taught by the couch this door .
the car on the couch taught this dish .	the car taught on the couch this dish .
this bag found the doll by the crayon .	this bag found by the crayon the doll .
the bed answered the shirt on the street .	the bed answered on the street the shirt .
that bottle on the couch taught the crayon .	that bottle taught on the couch the crayon .
that cup taught the dish by the picture .	that cup taught by the picture the dish .
the rug by the plate confused the ring .	the rug confused by the plate the ring .
the candle taught the door in the museum .	the candle taught in the museum the door .
this box lost the crayon on the stool .	this box lost on the stool the crayon .
this book scared this cup on the table .	this book scared on the table this cup .
this candle by the ring confused that dish .	this candle confused by the ring that dish .
this cup worried this truck in the restaurant .	this cup worried in the restaurant this truck .
that ship on the street bothered that picture .	that ship bothered on the street that picture .
this plate scared this candle in the bank .	this plate scared in the bank this candle .
that plate on the floor worked with that fork .	that plate worked with on the floor that fork .
that spoon visited that bicycle on the chair .	that spoon visited on the chair that bicycle .
the box on the couch scared that crayon .	the box scared on the couch that crayon .
the plate worked with that book in the kitchen .	the plate worked with in the kitchen that book .
the plane by the fork confused the rocket .	the plane confused by the fork the rocket .
this car in the restaurant bothered that shirt .	this car bothered in the restaurant that shirt .
that dish in the bank bothered that picture .	that dish bothered in the bank that picture .
this box on the couch worried the rocket .	this box worried on the couch the rocket .
that chair helped the fork on the chair .	that chair helped on the chair the fork .
the fork helped that glass on the bed .	the fork helped on the bed that glass .
this candle answered the bag on the street .	this candle answered on the street the bag .
this toy helped the candle by the candle .	this toy helped by the candle the candle .
the chair answered this fork in the library .	the chair answered in the library this fork .
that plane talked to the plane by the ring .	that plane talked to by the ring the plane .
the cup by the doll answered this picture .	the cup answered by the doll this picture .
this spoon helped the hat by the ring .	this spoon helped by the ring the hat .
this doll by the candle taught this fork .	this doll taught by the candle this fork .
that bowl in the room answered this spoon .	that bowl answered in the room this spoon .
this button lost the cup on the ground .	this button lost on the ground the cup .
that shoe talked to this dish on the ground .	that shoe talked to on the ground this dish .
the ship helped this picture in the mall .	the ship helped in the mall this picture .
the toy in the hospital visited the cup .	the toy visited in the hospital the cup .
this bicycle by the door worried this bed .	this bicycle worried by the door this bed .
the bowl worked with this toy by the car .	the bowl worked with by the car this toy .
that candle by the book confused this rocket .	that candle confused by the book this rocket .
the rug in the museum talked to the fork .	the rug talked to in the museum the fork .
the box in the room lost the toy .	the box lost in the room the toy .
that plate by the couch answered the candle .	that plate answered by the couch the candle .
that plate on the street talked to the doll .	that plate talked to on the street the doll .
this rocket by the doll taught that glass .	this rocket taught by the doll that glass .
that door by the cup confused that crayon .	that door confused by the cup that crayon .
the book bothered the plate in the school .	the book bothered in the school the plate .
the crayon found that picture by the rug .	the crayon found by the rug that picture .
the doll helped the doll on the couch .	the doll helped on the couch the doll .
that dish worried the candle on the bed .	that dish worried on the bed the candle .
that car bothered this plate in the room .	that car bothered in the room this plate .
the shoe found this toy by the candle .	the shoe found by the candle this toy .
that fork helped this book by the ship .	that fork helped by the ship this book .
this picture in the room confused the car .	this picture confused in the room the car .
that doll in the library bothered this dish .	that doll bothered in the library this dish .
this truck on the bed bothered this couch .	this truck bothered on the bed this couch .
that toy in the mall found that shoe .	that toy found in the mall that shoe .
that plate by the crayon helped the door .	that plate helped by the crayon the door .
the door worried that boat by the cup .	the door worried by the cup that boat .
the ring on the table worried this chair .	the ring worried on the table this chair .
that door scared the book by the plate .	that door scared by the plate the book .
this shoe by the shirt bothered that chair .	this shoe bothered by the shirt that chair .
that car on the table lost this dish .	that car lost on the table this dish .
the rug by the bottle answered the boat .	the rug answered by the bottle the boat .
that crayon by the shoe visited the shirt .	that crayon visited by the shoe the shirt .
that spoon by the bowl lost that book .	that spoon lost by the bowl that book .
the plane bothered the candle in the school .	the plane bothered in the school the candle .
the toy on the bed visited this rug .	the toy visited on the bed this rug .
the chair worried the box on the stool .	the chair worried on the stool the box .
the hat on the street found the candle .	the hat found on the street the candle .
this ring on the floor answered this shoe .	this ring answered on the floor this shoe .
the plate answered that shirt on the ground .	the plate answered on the ground that shirt .
that book visited this box by the book .	that book visited by the book this box .
the bag by the ring worried that couch .	the bag worried by the ring that couch .
the couch by the plate scared that ship .	the couch scared by the plate that ship .
that book in the restaurant visited the book .	that book visited in the restaurant the book .
that book in the bank confused the rocket .	that book confused in the bank the rocket .
this bicycle taught the bottle on the bed .	this bicycle taught on the bed the bottle .
the book in the hospital helped the rocket .	the book helped in the hospital the rocket .
that fork answered that door by the fork .	that fork answered by the fork that door .
that bottle by the cup scared that couch .	that bottle scared by the cup that couch .
that plate worried the book by the glass .	that plate worried by the glass the book .
that cup answered the glass by the bed .	that cup answered by the bed the glass .
this chair on the ground helped that bicycle .	this chair helped on the ground that bicycle .
that fork taught that couch on the stool .	that fork taught on the stool that couch .
this doll worried that hat by the book .	this doll worried by the book that hat .
that box by the ring worked with this car .	that box worked with by the ring this car .
the rug in the school lost this ship .	the rug lost in the school this ship .
the car visited that shirt by the bicycle .	the car visited by the bicycle that shirt .
the hat by the rocket bothered the glass .	the hat bothered by the rocket the glass .
that plate on the table answered the bed .	that plate answered on the table the bed .
this toy by the couch visited the ring .	this toy visited by the couch the ring .
that picture in the school worried the fork .	that picture worried in the school the fork .
that toy on the couch lost that window .	that toy lost on the couch that window .
this spoon by the truck lost the bicycle .	this spoon lost by the truck the bicycle .
this toy found the rocket by the rocket .	this toy found by the rocket the rocket .
the spoon in the school worked with this ship .	the spoon worked with in the school this ship .
this doll in the museum found that shoe .	this doll found in the museum that shoe .
the bicycle on the ground answered that ring .	the bicycle answered on the ground that ring .
the bag bothered this car on the couch .	the bag bothered on the couch this car .
this hat worried that window by the bag .	this hat worried by the bag that window .
that dish helped that bottle in the kitchen .	that dish helped in the kitchen that bottle .
that couch worked with this shoe on the table .	that couch worked with on the table this shoe .
the shirt worked with the rocket on the chair .	the shirt worked with on the chair the rocket .
this picture lost that spoon on the table .	this picture lost on the table that spoon .
the boat confused the boat in the school .	the boat confused in the school the boat .
that window on the stool helped that truck .	that window helped on the stool that truck .
that candle scared the rocket by the plane .	that candle scared by the plane the rocket .
that plane in the library confused this spoon .	that plane confused in the library this spoon .
that toy by the bicycle talked to this plate .	that toy talked to by the bicycle this plate .
this hat on the stool visited this fork .	this hat visited on the stool this fork .
this spoon visited this button by the crayon .	this spoon visited by the crayon this button .
this shoe in the bank found this dish .	this shoe found in the bank this dish .
this car by the bicycle answered this door .	this car answered by the bicycle this door .
this plate on the bed visited the ship .	this plate visited on the bed the ship .
the plane bothered that ship on the table .	the plane bothered on the table that ship .
that button by the hat worried that bag .	that button worried by the hat that bag .
this rocket scared this button by the chair .	this rocket scared by the chair this button .
this fork on the chair found that truck .	this fork found on the chair that truck .
that chair on the ground confused the shoe .	that chair confused on the ground the shoe .
this car lost this car in the library .	this car lost in the library this car .
that book confused that dish on the floor .	that book confused on the floor that dish .
the cup in the mall helped the toy .	the cup helped in the mall the toy .
that door on the floor scared this button .	that door scared on the floor this button .
the boat in the mall found the crayon .	the boat found in the mall the crayon .
this box in the kitchen bothered that dish .	this box bothered in the kitchen that dish .
this plane scared this candle on the bed .	this plane scared on the bed this candle .
this window in the mall helped this plane .	this window helped in the mall this plane .
this picture on the couch found the couch .	this picture found on the couch the couch .
that ship found that plane on the couch .	that ship found on the couch that plane .
that plate on the bed found this ring .	that plate found on the bed this ring .
the bed found the mirror by the box .	the bed found by the box the mirror .
that rug in the restaurant talked to the truck .	that rug talked to in the restaurant the truck .
this ship visited this crayon on the ground .	this ship visited on the ground this crayon .
the car in the room confused this rocket .	the car confused in the room this rocket .
that truck bothered this boat on the stool .	that truck bothered on the stool this boat .
the button worried that shoe by the cup .	the button worried by the cup that shoe .
this rocket in the room talked to this bag .	this rocket talked to in the room this bag .
the rocket lost the rocket by the ship .	the rocket lost by the ship the rocket .
the ship scared that bed on the couch .	the ship scared on the couch that bed .
that boat talked to this spoon on the stool .	that boat talked to on the stool this spoon .
that car on the chair lost the plane .	that car lost on the chair the plane .
this ship worked with the truck in the bank .	this ship worked with in the bank the truck .
this bag by the hat scared this cup .	this bag scared by the hat this cup .
this crayon confused the ship by the bottle .	this crayon confused by the bottle the ship .
this truck on the chair found that rug .	this truck found on the chair that rug .
the spoon worked with the hat in the room .	the spoon worked with in the room the hat .
that glass confused this rug on the table .	that glass confused on the table this rug .
this hat lost that ring in the hospital .	this hat lost in the hospital that ring .
the box by the shoe scared this bowl .	the box scared by the shoe this bowl .
this hat by the boat helped that cup .	this hat helped by the boat that cup .
this shoe lost that doll by the bowl .	this shoe lost by the bowl that doll .
the mirror worried the truck on the couch .	the mirror worried on the couch the truck .
that fork scared this car on the ground .	that fork scared on the ground this car .
that bowl worried the bowl by the door .	that bowl worried by the door the bowl .
this hat by the couch found that shirt .	this hat found by the couch that shirt .
this bicycle visited that boat by the spoon .	this bicycle visited by the spoon that boat .
this shoe helped this picture in the room .	this shoe helped in the room this picture .
that spoon talked to the fork on the table .	that spoon talked to on the table the fork .
that spoon on the stool worried that bicycle .	that spoon worried on the stool that bicycle .
that hat by the bag answered the spoon .	that hat answered by the bag the spoon .
the plane by the book taught the plate .	the plane taught by the book the plate .
that picture by the truck taught the crayon .	that picture taught by the truck the crayon .
this bag by the glass confused that plate .	this bag confused by the glass that plate .
the couch by the car talked to that ring .	the couch talked to by the car that ring .
this cup on the stool confused that bag .	this cup confused on the stool that bag .
that bag confused the chair on the table .	that bag confused on the table the chair .
that bottle on the couch answered the ship .	that bottle answered on the couch the ship .
this truck on the chair worried this crayon .	this truck worried on the chair this crayon .
this rug on the bed helped this rocket .	this rug helped on the bed this rocket .
the door by the picture talked to that book .	the door talked to by the picture that book .
that bed in the mall bothered this rug .	that bed bothered in the mall this rug .
the couch on the floor talked to the door .	the couch talked to on the floor the door .
this ship confused this boat on the stool .	this ship confused on the stool this boat .
this box on the couch bothered the window .	this box bothered on the couch the window .
the doll scared the bottle by the book .	the doll scared by the book the bottle .
that book by the plate lost this bowl .	that book lost by the plate this bowl .
that bicycle by the bottle lost this doll .	that bicycle lost by the bottle this doll .
that hat on the bed confused this book .	that hat confused on the bed this book .
the toy by the boat lost this cup .	the toy lost by the boat this cup .
that picture worried that shirt by the bed .	that picture worried by the bed that shirt .
the picture taught that picture by the book .	the picture taught by the book that picture .
this car in the bank visited the box .	this car visited in the bank the box .
this bed on the bed taught the book .	this bed taught on the bed the book .
that spoon confused the ship in the room .	that spoon confused in the room the ship .
this fork on the stool visited this candle .	this fork visited on the stool this candle .
that doll by the shirt scared the cup .	that doll scared by the shirt the cup .
the book in the room worried this button .	the book worried in the room this button .
the bottle on the couch talked to that plane .	the bottle talked to on the couch that plane .
this rocket by the toy bothered that book .	this rocket bothered by the toy that book .
this bag by the plane confused the crayon .	this bag confused by the plane the crayon .
that boat on the floor answered this button .	that boat answered on the floor this button .
that bicycle by the bowl scared that ring .	that bicycle scared by the bowl that ring .
the button taught the button by the book .	the button taught by the book the button .
this candle by the rug taught that cup .	this candle taught by the rug that cup .
the car taught that crayon on the ground .	the car taught on the ground that crayon .
that doll by the shirt talked to this bottle .	that doll talked to by the shirt this bottle .
this candle confused that plane by the cup .	this candle confused by the cup that plane .
that crayon lost that book by the bicycle .	that crayon lost by the bicycle that book .
this spoon on the table confused that cup .	this spoon confused on the table that cup .
that box confused this couch by the doll .	that box confused by the doll this couch .
that picture in the bank answered that dish .	that picture answered in the bank that dish .
the bicycle helped that mirror by the rocket .	the bicycle helped by the rocket that mirror .
this book on the ground confused that plate .	this book confused on the ground that plate .
this bowl answered this book by the bed .	this bowl answered by the bed this book .
this ship scared the spoon by the car .	this ship scared by the car the spoon .
that rug talked to this bowl in the school .	that rug talked to in the school this bowl .
this bag talked to the bed on the floor .	this bag talked to on the floor the bed .
that rug bothered this shirt in the school .	that rug bothered in the school this shirt .
that door by the rocket found the plane .	that door found by the rocket the plane .
that rocket visited that picture by the candle .	that rocket visited by the candle that picture .
the picture scared that book on the table .	the picture scared on the table that book .
that shoe worried the cup in the school .	that shoe worried in the school the cup .
the shoe on the bed answered that ring .	the shoe answered on the bed that ring .
that ship taught this hat in the mall .	that ship taught in the mall this hat .
that chair in the restaurant talked to this doll .	that chair talked to in the restaurant this doll .
the book lost this crayon in the park .	the book lost in the park this crayon .
the car by the picture confused that plane .	the car confused by the picture that plane .
that bed on the street worried this spoon .	that bed worried on the street this spoon .
that door by the glass bothered that toy .	that door bothered by the glass that toy .
that bed worked with that toy by the window .	that bed worked with by the window that toy .
the bed lost this bicycle in the kitchen .	the bed lost in the kitchen this bicycle .
that button talked to the spoon in the kitchen .	that button talked to in the kitchen the spoon .
this car talked to the hat on the stool .	this car talked to on the stool the hat .
that book in the bank bothered that ring .	that book bothered in the bank that ring .
that crayon worked with that picture by the plane .	that crayon worked with by the plane that picture .
that fork answered the truck on the ground .	that fork answered on the ground the truck .
the plane in the museum bothered that plane .	the plane bothered in the museum that plane .
that rocket worried the book on the bed .	that rocket worried on the bed the book .
this rug by the bag confused this truck .	this rug confused by the bag this truck .
that shirt by the glass helped the cup .	that shirt helped by the glass the cup .
the book on the table talked to that chair .	the book talked to on the table that chair .
the ship bothered this plane on the street .	the ship bothered on the street this plane .
that spoon worked with this door on the floor .	that spoon worked with on the floor this door .
this spoon in the restaurant confused this book .	this spoon confused in the restaurant this book .
that book on the stool worked with this window .	that book worked with on the stool this window .
this button by the plane answered that toy .	this button answered by the plane that toy .
the bottle answered the window by the bowl .	the bottle answered by the bowl the window .
that boat on the chair taught this bicycle .	that boat taught on the chair this bicycle .
that glass worried the bowl on the chair .	that glass worried on the chair the bowl .
this car on the stool worked with this bag .	this car worked with on the stool this bag .
the picture on the bed worked with that crayon .	the picture worked with on the bed that crayon .
this toy helped that doll on the chair .	this toy helped on the chair that doll .
the book answered that hat in the restaurant .	the book answered in the restaurant that hat .
this hat visited that window by the plane .	this hat visited by the plane that window .
the ship on the floor confused this spoon .	the ship confused on the floor this spoon .
this boat lost this bowl on the stool .	this boat lost on the stool this bowl .
this chair in the library helped this shirt .	this chair helped in the library this shirt .
this bed by the button found that ship .	this bed found by the button that ship .
the truck by the bed confused the truck .	the truck confused by the bed the truck .
that book in the park answered this box .	that book answered in the park this box .
the cup answered the plate by the button .	the cup answered by the button the plate .
that crayon found that ship on the chair .	that crayon found on the chair that ship .
this shoe by the box found that candle .	this shoe found by the box that candle .
this rug worried the ring by the ring .	this rug worried by the ring the ring .
that boat lost that door by the book .	that boat lost by the book that door .
this book by the doll worked with this rug .	this book worked with by the doll this rug .
this cup by the bag worked with the window .	this cup worked with by the bag the window .
that car in the bank confused that picture .	that car confused in the bank that picture .
that bag found this candle by the box .	that bag found by the box this candle .
that hat on the floor worried this book .	that hat worried on the floor this book .
this car found that box in the hospital .	this car found in the hospital that box .
this cup found the shirt by the ring .	this cup found by the ring the shirt .
this boat by the mirror taught this bowl .	this boat taught by the mirror this bowl .
the bicycle talked to this toy in the room .	the bicycle talked to in the room this toy .
the car worried the car in the school .	the car worried in the school the car .
that plane in the room talked to this bowl .	that plane talked to in the room this bowl .
the bed by the toy visited this doll .	the bed visited by the toy this doll .
the bicycle on the street scared this boat .	the bicycle scared on the street this boat .
the book on the table worried that hat .	the book worried on the table that hat .
that hat found this hat on the couch .	that hat found on the couch this hat .
that couch helped this picture on the ground .	that couch helped on the ground this picture .
the plate on the chair talked to the bowl .	the plate talked to on the chair the bowl .
that bicycle talked to that plate on the bed .	that bicycle talked to on the bed that plate .
this picture on the table confused the crayon .	this picture confused on the table the crayon .
the plate confused this truck in the park .	the plate confused in the park this truck .
that spoon in the hospital bothered this dish .	that spoon bothered in the hospital this dish .
that bag in the bank found that hat .	that bag found in the bank that hat .
the bed worked with the bed on the floor .	the bed worked with on the floor the bed .
this doll worked with the toy by the rug .	this doll worked with by the rug the toy .
that bed on the chair talked to this boat .	that bed talked to on the chair this boat .
this bicycle bothered that window in the kitchen .	this bicycle bothered in the kitchen that window .
the ring in the bank scared this car .	the ring scared in the bank this car .
this bed by the plate answered this rug .	this bed answered by the plate this rug .
the truck bothered that glass by the picture .	the truck bothered by the picture that glass .
the shoe confused that plane in the kitchen .	the shoe confused in the kitchen that plane .
that rug in the school visited this spoon .	that rug visited in the school this spoon .
this toy worried this dish by the button .	this toy worried by the button this dish .
that bowl in the museum lost the mirror .	that bowl lost in the museum the mirror .
this shirt on the floor worked with the hat .	this shirt worked with on the floor the hat .
this candle in the room answered that ring .	this candle answered in the room that ring .
this glass worked with that bed on the bed .	this glass worked with on the bed that bed .
the rug talked to this boat on the street .	the rug talked to on the street this boat .
that bag found the car by the truck .	that bag found by the truck the car .
that bed worked with this truck on the stool .	that bed worked with on the stool this truck .
the hat worked with the bowl by the crayon .	the hat worked with by the crayon the bowl .
this bowl on the street lost the hat .	this bowl lost on the street the hat .
that mirror talked to that doll by the book .	that mirror talked to by the book that doll .
this door by the bed bothered that window .	this door bothered by the bed that window .
this doll by the bicycle talked to this doll .	this doll talked to by the bicycle this doll .
that bowl by the plate confused that boat .	that bowl confused by the plate that boat .
the crayon helped this cup on the street .	the crayon helped on the street this cup .
the window in the park visited the box .	the window visited in the park the box .
the ship on the couch answered the picture .	the ship answered on the couch the picture .
the doll worried the window in the library .	the doll worried in the library the window .
the car by the window taught the rocket .	the car taught by the window the rocket .
that bottle by the chair talked to this boat .	that bottle talked to by the chair this boat .
the book taught this fork in the school .	the book taught in the school this fork .
that box lost that bed on the stool .	that box lost on the stool that bed .
this candle by the bed confused this shirt .	this candle confused by the bed this shirt .
that bed in the bank worked with this mirror .	that bed worked with in the bank this mirror .
that doll bothered the ship in the kitchen .	that doll bothered in the kitchen the ship .
the rug in the restaurant scared the window .	the rug scared in the restaurant the window .
this couch talked to this cup by the door .	this couch talked to by the door this cup .
this cup confused this book on the table .	this cup confused on the table this book .
this book on the ground scared this door .	this book scared on the ground this door .
that car confused this car by the doll .	that car confused by the doll this car .
that button by the mirror bothered that truck .	that button bothered by the mirror that truck .
that bag helped that rocket by the fork .	that bag helped by the fork that rocket .
that crayon on the ground bothered the book .	that crayon bothered on the ground the book .
that bed helped the box on the ground .	that bed helped on the ground the box .
this hat lost the window by the shoe .	this hat lost by the shoe the window .
the bed by the box found the couch .	the bed found by the box the couch .
this plane on the ground bothered this doll .	this plane bothered on the ground this doll .
that plane by the crayon lost this ship .	that plane lost by the crayon this ship .
this dish scared the boat by the car .	this dish scared by the car the boat .
the door bothered the door by the window .	the door bothered by the window the door .
this plate visited that mirror by the truck .	this plate visited by the truck that mirror .
that couch by the spoon visited the ring .	that couch visited by the spoon the ring .
that picture by the picture lost that door .	that picture lost by the picture that door .
that fork by the bottle answered this couch .	that fork answered by the bottle this couch .
the book on the chair scared the glass .	the book scared on the chair the glass .
the glass visited the hat in the mall .	the glass visited in the mall the hat .
this ship worried the rug on the floor .	this ship worried on the floor the rug .
the shirt answered the car in the bank .	the shirt answered in the bank the car .
this book on the table scared that bag .	this book scared on the table that bag .
that car by the ship taught the book .	that car taught by the ship the book .
this bottle in the museum worked with that plate .	this bottle worked with in the museum that plate .
this box on the street worked with the bowl .	this box worked with on the street the bowl .
this window by the toy answered that bed .	this window answered by the toy that bed .
the shirt visited the fork on the floor .	the shirt visited on the floor the fork .
this glass found the crayon by the rug .	this glass found by the rug the crayon .
the bed answered that bowl on the ground .	the bed answered on the ground that bowl .
the bowl in the school confused this picture .	the bowl confused in the school this picture .
that picture worked with that candle in the kitchen .	that picture worked with in the kitchen that candle .
that ring talked to that door on the ground .	that ring talked to on the ground that door .
this shoe found that bicycle in the park .	this shoe found in the park that bicycle .
this chair bothered the picture on the stool .	this chair bothered on the stool the picture .
the shirt visited this cup in the bank .	the shirt visited in the bank this cup .
that rug taught that door by the picture .	that rug taught by the picture that door .
that door taught this toy on the stool .	that door taught on the stool this toy .
that toy on the floor talked to the hat .	that toy talked to on the floor the hat .
this dish on the table answered the fork .	this dish answered on the table the fork .
that toy lost that box on the ground .	that toy lost on the ground that box .
that bottle in the library helped the fork .	that bottle helped in the library the fork .
the book on the stool visited the bicycle .	the book visited on the stool the bicycle .
the door visited the mirror on the floor .	the door visited on the floor the mirror .
that picture scared that book by the truck .	that picture scared by the truck that book .
the dish in the school bothered this shoe .	the dish bothered in the school this shoe .
the picture in the room confused that chair .	the picture confused in the room that chair .
this fork worked with this mirror on the chair .	this fork worked with on the chair this mirror .
this crayon in the mall scared that bottle .	this crayon scared in the mall that bottle .
the window in the room bothered the ring .	the window bothered in the room the ring .
that bed taught that dish by the bag .	that bed taught by the bag that dish .
the hat on the bed bothered this bottle .	the hat bothered on the bed this bottle .
that book worked with the chair by the spoon .	that book worked with by the spoon the chair .
the bag scared that candle on the table .	the bag scared on the table that candle .
this box in the school bothered that ship .	this box bothered in the school that ship .
that bed on the stool visited this chair .	that bed visited on the stool this chair .
this bag by the bed scared that shirt .	this bag scared by the bed that shirt .
the dish worked with that spoon by the glass .	the dish worked with by the glass that spoon .
that window talked to the fork by the glass .	that window talked to by the glass the fork .
the picture on the couch bothered that bed .	the picture bothered on the couch that bed .
this book confused this toy by the chair .	this book confused by the chair this toy .
this doll worked with the bottle on the couch .	this doll worked with on the couch the bottle .
the crayon on the bed worked with the button .	the crayon worked with on the bed the button .
the toy by the book confused that rug .	the toy confused by the book that rug .
that book in the kitchen found this boat .	that book found in the kitchen this boat .
that bed taught the spoon by the toy .	that bed taught by the toy the spoon .
the door worried this door in the mall .	the door worried in the mall this door .
that book by the crayon lost this spoon .	that book lost by the crayon this spoon .
this toy by the book worked with the ring .	this toy worked with by the book the ring .
this couch confused that bowl on the chair .	this couch confused on the chair that bowl .
this plate by the bag taught that glass .	this plate taught by the bag that glass .
this spoon bothered the picture by the bicycle .	this spoon bothered by the bicycle the picture .
that candle answered that glass by the rocket .	that candle answered by the rocket that glass .
the picture in the room answered that bed .	the picture answered in the room that bed .
that ship in the hospital scared the ship .	that ship scared in the hospital the ship .
the mirror talked to this box on the chair .	the mirror talked to on the chair this box .
the box by the fork answered the fork .	the box answered by the fork the fork .
the rocket scared this boat on the couch .	the rocket scared on the couch this boat .
this couch talked to that spoon by the button .	this couch talked to by the button that spoon .
that cup worried the plane by the toy .	that cup worried by the toy the plane .
that glass taught the book by the box .	that glass taught by the box the book .
this crayon on the floor found this bowl .	this crayon found on the floor this bowl .
this book helped this shoe in the hospital .	this book helped in the hospital this shoe .
the cup found this car by the fork .	the cup found by the fork this car .
the ship answered the bottle in the hospital .	the ship answered in the hospital the bottle .
the chair by the ring scared that toy .	the chair scared by the ring that toy .
the cup worried this shirt by the glass .	the cup worried by the glass this shirt .
this bed bothered the rug by the chair .	this bed bothered by the chair the rug .
that cup on the bed worked with the rocket .	that cup worked with on the bed the rocket .
this window talked to the crayon by the glass .	this window talked to by the glass the crayon .
that book in the park answered this bowl .	that book answered in the park this bowl .
this fork worried the bottle on the chair .	this fork worried on the chair the bottle .
the mirror in the mall visited that bottle .	the mirror visited in the mall that bottle .
the plane answered that shoe on the table .	the plane answered on the table that shoe .
the bottle on the chair scared the couch .	the bottle scared on the chair the couch .
that button found that ship in the room .	that button found in the room that ship .
that crayon on the bed found that chair .	that crayon found on the bed that chair .
this rocket in the room worked with that bed .	this rocket worked with in the room that bed .
that ship on the street bothered this boat .	that ship bothered on the street this boat .
the truck talked to that bed on the bed .	the truck talked to on the bed that bed .
that couch by the picture scared this ship .	that couch scared by the picture this ship .
that window visited the truck in the school .	that window visited in the school the truck .
the glass on the ground found the window .	the glass found on the ground the window .
that plate on the chair talked to this car .	that plate talked to on the chair this car .
that picture talked to the crayon by the button .	that picture talked to by the button the crayon .
this rug by the book talked to that book .	this rug talked to by the book that book .
the truck bothered the picture in the restaurant .	the truck bothered in the restaurant the picture .
the plate visited the box in the mall .	the plate visited in the mall the box .
this bag on the couch bothered this hat .	this bag bothered on the couch this hat .
that shirt in the museum lost the hat .	that shirt lost in the museum the hat .
this ship in the hospital bothered the dish .	this ship bothered in the hospital the dish .
that rug helped this button on the chair .	that rug helped on the chair this button .
the shoe by the plane helped that truck .	the shoe helped by the plane that truck .
that boat helped the shoe in the bank .	that boat helped in the bank the shoe .
the shoe on the ground answered that button .	the shoe answered on the ground that button .
this shirt by the boat answered that window .	this shirt answered by the boat that window .
this car confused this bowl by the candle .	this car confused by the candle this bowl .
the dish bothered the fork in the bank .	the dish bothered in the bank the fork .
this dish on the bed confused this couch .	this dish confused on the bed this couch .
that button in the hospital taught that ring .	that button taught in the hospital that ring .
this picture in the mall scared this rug .	this picture scared in the mall this rug .
the button by the car worked with that window .	the button worked with by the car that window .
that bottle taught this car by the button .	that bottle taught by the button this car .
this window by the couch visited the window .	this window visited by the couch the window .
this plane by the toy answered that bed .	this plane answered by the toy that bed .
that candle answered that shirt in the library .	that candle answered in the library that shirt .
this ring in the room talked to this boat .	this ring talked to in the room this boat .
that spoon in the kitchen answered that window .	that spoon answered in the kitchen that window .
the box in the school helped this button .	the box helped in the school this button .
this door by the spoon visited the candle .	this door visited by the spoon the candle .
this doll worked with that mirror by the book .	this doll worked with by the book that mirror .
this chair in the hospital found that spoon .	this chair found in the hospital that spoon .
that shirt on the ground worked with this doll .	that shirt worked with on the ground this doll .
the window answered that shoe on the floor .	the window answered on the floor that shoe .
this doll taught the bed by the spoon .	this doll taught by the spoon the bed .
that boat confused this doll in the kitchen .	that boat confused in the kitchen this doll .
that bottle on the couch worked with this ship .	that bottle worked with on the couch this ship .
the cup helped this car on the floor .	the cup helped on the floor this car .
the chair worried this chair in the library .	the chair worried in the library this chair .
that cup bothered that ship in the park .	that cup bothered in the park that ship .
the glass on the stool talked to this toy .	the glass talked to on the stool this toy .
the glass on the stool found this rocket .	the glass found on the stool this rocket .
that car scared the toy by the dish .	that car scared by the dish the toy .
the ring answered this window by the window .	the ring answered by the window this window .
this picture on the floor visited that crayon .	this picture visited on the floor that crayon .
that cup helped the chair in the school .	that cup helped in the school the chair .
that bed on the ground worried the dish .	that bed worried on the ground the dish .
that crayon found that rug in the restaurant .	that crayon found in the restaurant that rug .
the doll on the bed lost that button .	the doll lost on the bed that button .
the rocket on the street lost this book .	the rocket lost on the street this book .
this bicycle helped the candle by the candle .	this bicycle helped by the candle the candle .
the couch confused that spoon in the bank .	the couch confused in the bank that spoon .
this dish on the table worked with this boat .	this dish worked with on the table this boat .
the window in the hospital lost that hat .	the window lost in the hospital that hat .
the bowl by the bicycle lost that doll .	the bowl lost by the bicycle that doll .
that bag visited this toy in the hospital .	that bag visited in the hospital this toy .
this door by the glass lost that bed .	this door lost by the glass that bed .
that picture talked to that bed in the restaurant .	that picture talked to in the restaurant that bed .
that chair talked to the doll by the ring .	that chair talked to by the ring the doll .
this doll by the bed answered that rocket .	this doll answered by the bed that rocket .
the candle in the bank visited the cup .	the candle visited in the bank the cup .
that ship visited the bicycle by the plate .	that ship visited by the plate the bicycle .
the crayon answered the crayon on the floor .	the crayon answered on the floor the crayon .
that car bothered the fork on the stool .	that car bothered on the stool the fork .
that window by the rug bothered this toy .	that window bothered by the rug this toy .
this crayon by the spoon found this truck .	this crayon found by the spoon this truck .
the shoe on the ground scared this toy .	the shoe scared on the ground this toy .
that window lost this plane by the ring .	that window lost by the ring this plane .
that plate bothered that dish by the bag .	that plate bothered by the bag that dish .
that boat on the stool visited this crayon .	that boat visited on the stool this crayon .
that car visited this ship by the box .	that car visited by the box this ship .
that toy scared this box in the museum .	that toy scared in the museum this box .
that rug in the school talked to that couch .	that rug talked to in the school that couch .
the bed worried the book in the park .	the bed worried in the park the book .
the rocket on the chair confused this rug .	the rocket confused on the chair this rug .
this hat talked to this bed on the stool .	this hat talked to on the stool this bed .
that boat by the button answered the candle .	that boat answered by the button the candle .
this fork by the shoe scared this dish .	this fork scared by the shoe this dish .
this bed on the stool helped the truck .	this bed helped on the stool the truck .
this book worked with that truck in the museum .	this book worked with in the museum that truck .
this plate in the mall worried this cup .	this plate worried in the mall this cup .
that fork on the bed confused the boat .	that fork confused on the bed the boat .
this toy visited that boat in the hospital .	this toy visited in the hospital that boat .
the boat answered that doll by the bag .	the boat answered by the bag that doll .
this mirror on the ground visited the book .	this mirror visited on the ground the book .
this bed on the stool worried that boat .	this bed worried on the stool that boat .
that glass in the restaurant taught this bag .	that glass taught in the restaurant this bag .
that toy helped the ship on the chair .	that toy helped on the chair the ship .
that car worked with that car on the couch .	that car worked with on the couch that car .
this ring in the museum visited the door .	this ring visited in the museum the door .
that box in the park answered this rocket .	that box answered in the park this rocket .
that button by the window lost the window .	that button lost by the window the window .
that plate on the floor helped the ship .	that plate helped on the floor the ship .
this bed in the school taught this rocket .	this bed taught in the school this rocket .
the crayon confused this boat by the hat .	the crayon confused by the hat this boat .
the book talked to this crayon on the chair .	the book talked to on the chair this crayon .
this boat by the plate found that bed .	this boat found by the plate that bed .
the door on the table answered that bag .	the door answered on the table that bag .
that dish answered that bottle by the doll .	that dish answered by the doll that bottle .
this plane found this shoe by the book .	this plane found by the book this shoe .
this shoe bothered that toy in the library .	this shoe bothered in the library that toy .
that truck worried that mirror by the doll .	that truck worried by the doll that mirror .
that dish on the chair visited that truck .	that dish visited on the chair that truck .
this bed by the shoe taught this rocket .	this bed taught by the shoe this rocket .
that ring worried this rocket on the table .	that ring worried on the table this rocket .
this bowl by the toy visited the picture .	this bowl visited by the toy the picture .
this fork by the bag talked to the chair .	this fork talked to by the bag the chair .
the bag on the chair found this spoon .	the bag found on the chair this spoon .
the chair confused this hat in the restaurant .	the chair confused in the restaurant this hat .
that shirt on the table scared this couch .	that shirt scared on the table this couch .
the cup worried that glass on the floor .	the cup worried on the floor that glass .
this book visited that toy on the stool .	this book visited on the stool that toy .
the rocket in the museum helped this rug .	the rocket helped in the museum this rug .
this dish answered this glass on the bed .	this dish answered on the bed this glass .
that box taught the mirror on the bed .	that box taught on the bed the mirror .
the spoon scared this ship on the ground .	the spoon scared on the ground this ship .
this bottle scared the rug in the kitchen .	this bottle scared in the kitchen the rug .
this ring scared this crayon by the dish .	this ring scared by the dish this crayon .
the chair on the chair worried the car .	the chair worried on the chair the car .
that book in the bank talked to that chair .	that book talked to in the bank that chair .
this box taught the mirror in the mall .	this box taught in the mall the mirror .
the rocket bothered this dish in the mall .	the rocket bothered in the mall this dish .
this couch in the restaurant bothered that window .	this couch bothered in the restaurant that window .
this truck on the table worried the candle .	this truck worried on the table the candle .
this car confused that book by the shirt .	this car confused by the shirt that book .
this button by the chair taught that bottle .	this button taught by the chair that bottle .
that bag by the bottle answered this shirt .	that bag answered by the bottle this shirt .
the ring taught that bag on the ground .	the ring taught on the ground that bag .
this glass bothered this hat in the bank .	this glass bothered in the bank this hat .
that door on the chair found the ship .	that door found on the chair the ship .
that boat found that candle in the hospital .	that boat found in the hospital that candle .
the mirror by the car lost this truck .	the mirror lost by the car this truck .
this ship by the window scared this window .	this ship scared by the window this window .
the toy on the stool taught the ring .	the toy taught on the stool the ring .
the door confused that cup in the museum .	the door confused in the museum that cup .
that picture by the car found this window .	that picture found by the car this window .
this car confused that hat on the chair .	this car confused on the chair that hat .
that crayon worried the shirt in the hospital .	that crayon worried in the hospital the shirt .
that hat on the floor found that shirt .	that hat found on the floor that shirt .
the book by the car worked with the cup .	the book worked with by the car the cup .
the hat lost the couch by the door .	the hat lost by the door the couch .
this candle on the floor helped that fork .	this candle helped on the floor that fork .
that plane by the truck bothered the hat .	that plane bothered by the truck the hat .
the plate on the table visited the book .	the plate visited on the table the book .
the car on the table taught that picture .	the car taught on the table that picture .
the bottle confused the shoe on the street .	the bottle confused on the street the shoe .
this doll visited this window on the stool .	this doll visited on the stool this window .
the hat visited that dish in the kitchen .	the hat visited in the kitchen that dish .
that ship confused that dish in the museum .	that ship confused in the museum that dish .
the door lost this truck in the hospital .	the door lost in the hospital this truck .
that door taught the book in the room .	that door taught in the room the book .
this hat found the bag on the floor .	this hat found on the floor the bag .
that window in the hospital talked to the shoe .	that window talked to in the hospital the shoe .
that crayon bothered this couch by the bicycle .	that crayon bothered by the bicycle this couch .
that car confused this dish on the chair .	that car confused on the chair this dish .
the book bothered that hat on the ground .	the book bothered on the ground that hat .
this bowl by the candle bothered the glass .	this bowl bothered by the candle the glass .
this couch answered the book by the couch .	this couch answered by the couch the book .
that bowl on the street lost the truck .	that bowl lost on the street the truck .
that window in the room worried that boat .	that window worried in the room that boat .
that mirror found that bag on the ground .	that mirror found on the ground that bag .
that bed in the kitchen bothered that bag .	that bed bothered in the kitchen that bag .
this spoon found that plate in the school .	this spoon found in the school that plate .
that ship by the bag visited the bag .	that ship visited by the bag the bag .
the dish taught that window on the ground .	the dish taught on the ground that window .
the car worried the button on the street .	the car worried on the street the button .
the ring on the couch confused this book .	the ring confused on the couch this book .
this plate bothered this shirt on the table .	this plate bothered on the table this shirt .
the crayon in the library taught the car .	the crayon taught in the library the car .
this mirror in the bank scared that bottle .	this mirror scared in the bank that bottle .
this boat visited that glass by the cup .	this boat visited by the cup that glass .
this spoon in the library confused the rug .	this spoon confused in the library the rug .
the glass visited this book by the bag .	the glass visited by the bag this book .
this plane helped the door on the stool .	this plane helped on the stool the door .
this rocket in the museum worried the fork .	this rocket worried in the museum the fork .
this bicycle by the box visited this window .	this bicycle visited by the box this window .
that book worked with this crayon on the bed .	that book worked with on the bed this crayon .
this bag on the bed confused this book .	this bag confused on the bed this book .
the glass worked with this chair on the stool .	the glass worked with on the stool this chair .
this bottle by the truck scared that bed .	this bottle scared by the truck that bed .
the glass scared the car on the stool .	the glass scared on the stool the car .
that button worked with that bottle in the school .	that button worked with in the school that bottle .
the toy in the library taught the rocket .	the toy taught in the library the rocket .
the car on the ground lost the boat .	the car lost on the ground the boat .
this car by the rocket found the mirror .	this car found by the rocket the mirror .
this window in the bank worked with the crayon .	this window worked with in the bank the crayon .
that crayon talked to the bowl in the school .	that crayon talked to in the school the bowl .
that plate in the library scared the car .	that plate scared in the library the car .
that cup confused this mirror by the candle .	that cup confused by the candle this mirror .
this ship on the chair lost the candle .	this ship lost on the chair the candle .
this doll confused that ring on the chair .	this doll confused on the chair that ring .
this cup by the shirt lost that car .	this cup lost by the shirt that car .
the bed in the bank taught that box .	the bed taught in the bank that box .
the rocket visited this shirt on the stool .	the rocket visited on the stool this shirt .
that dish helped this door by the bed .	that dish helped by the bed this door .
that box on the bed answered the book .	that box answered on the bed the book .
the bicycle bothered this mirror by the button .	the bicycle bothered by the button this mirror .
the book on the bed bothered that boat .	the book bothered on the bed that boat .
the bag on the floor worried this window .	the bag worried on the floor this window .
this dish by the ship taught that plate .	this dish taught by the ship that plate .
that ship by the rocket helped that book .	that ship helped by the rocket that book .
that rocket bothered this boat on the street .	that rocket bothered on the street this boat .
that book by the ship talked to the bed .	that book talked to by the ship the bed .
this crayon by the box taught that car .	this crayon taught by the box that car .
the dish worried the car on the ground .	the dish worried on the ground the car .
the plate confused that fork by the doll .	the plate confused by the doll that fork .
the button on the chair taught this fork .	the button taught on the chair this fork .
that ship confused this bowl by the box .	that ship confused by the box this bowl .
the ring by the truck found that book .	the ring found by the truck that book .
this truck by the fork answered this mirror .	this truck answered by the fork this mirror .
the candle on the bed confused this bottle .	the candle confused on the bed this bottle .
that mirror by the ship bothered that picture .	that mirror bothered by the ship that picture .
that ring taught the truck on the ground .	that ring taught on the ground the truck .
the cup talked to that mirror in the library .	the cup talked to in the library that mirror .
this bowl found the bicycle in the museum .	this bowl found in the museum the bicycle .
this bag in the mall lost this glass .	this bag lost in the mall this glass .
this rug by the candle worked with that book .	this rug worked with by the candle that book .
the glass by the picture worked with the chair .	the glass worked with by the picture the chair .
that shirt found that spoon by the car .	that shirt found by the car that spoon .
that crayon visited that glass by the button .	that crayon visited by the button that glass .
this spoon in the museum scared this car .	this spoon scared in the museum this car .
the bag confused the doll on the bed .	the bag confused on the bed the doll .
this plate in the bank worried the car .	this plate worried in the bank the car .
that plane worried this plane by the bag .	that plane worried by the bag this plane .
the book confused that car by the spoon .	the book confused by the spoon that car .
the box helped the button by the window .	the box helped by the window the button .
the rug on the floor worked with the doll .	the rug worked with on the floor the doll .
that button found this window in the mall .	that button found in the mall this window .
this cup bothered that chair in the park .	this cup bothered in the park that chair .
that bowl found the rocket in the room .	that bowl found in the room the rocket .
this car confused this window by the book .	this car confused by the book this window .
that box scared this boat in the room .	that box scared in the room this boat .
that dish in the restaurant scared the couch .	that dish scared in the restaurant the couch .
the bag in the restaurant lost this book .	the bag lost in the restaurant this book .
this window on the floor taught this window .	this window taught on the floor this window .
that boat on the floor worried that book .	that boat worried on the floor that book .
this crayon lost the bowl in the restaurant .	this crayon lost in the restaurant the bowl .
this bed answered the book on the table .	this bed answered on the table the book .
this hat by the bowl helped this picture .	this hat helped by the bowl this picture .
this chair in the library worked with this spoon .	this chair worked with in the library this spoon .
this bottle taught the bed on the ground .	this bottle taught on the ground the bed .
that truck by the glass visited the plane .	that truck visited by the glass the plane .
the picture scared this cup by the couch .	the picture scared by the couch this cup .
this chair visited that shoe in the room .	this chair visited in the room that shoe .
this shirt lost the mirror by the boat .	this shirt lost by the boat the mirror .
that book in the hospital taught that window .	that book taught in the hospital that window .
this chair found this hat on the table .	this chair found on the table this hat .
the box on the bed helped this candle .	the box helped on the bed this candle .
that rug by the car worried the button .	that rug worried by the car the button .
that mirror worked with that dish in the mall .	that mirror worked with in the mall that dish .
that bottle scared that chair on the street .	that bottle scared on the street that chair .
this book talked to that couch by the bag .	this book talked to by the bag that couch .
that bag talked to that chair by the book .	that bag talked to by the book that chair .
that bowl taught this fork on the couch .	that bowl taught on the couch this fork .
that dish on the ground lost the bottle .	that dish lost on the ground the bottle .
the glass talked to this box by the box .	the glass talked to by the box this box .
that hat on the stool visited the boat .	that hat visited on the stool the boat .
this bed on the floor talked to this shoe .	this bed talked to on the floor this shoe .
this shirt visited that boat in the hospital .	this shirt visited in the hospital that boat .
the truck in the school taught the bag .	the truck taught in the school the bag .
the plate worried this button by the rocket .	the plate worried by the rocket this button .
the bowl worried that chair by the dish .	the bowl worried by the dish that chair .
that crayon answered the cup on the bed .	that crayon answered on the bed the cup .
this couch bothered this mirror in the school .	this couch bothered in the school this mirror .
this bowl visited the chair by the bag .	this bowl visited by the bag the chair .
the chair answered the shirt on the floor .	the chair answered on the floor the shirt .
this picture by the toy found the hat .	this picture found by the toy the hat .
the car by the shoe bothered the spoon .	the car bothered by the shoe the spoon .
this bottle in the kitchen taught that picture .	this bottle taught in the kitchen that picture .
this dish confused that book on the table .	this dish confused on the table that book .
that bowl visited the glass by the rug .	that bowl visited by the rug the glass .
the bed worried that glass by the shirt .	the bed worried by the shirt that glass .
the picture found this crayon on the stool .	the picture found on the stool this crayon .
this hat by the boat worried the truck .	this hat worried by the boat the truck .
the ring confused this shoe in the hospital .	the ring confused in the hospital this shoe .
this rocket worked with the book by the doll .	this rocket worked with by the doll the book .
the bag talked to this book by the bicycle .	the bag talked to by the bicycle this book .
that candle by the fork worked with that plate .	that candle worked with by the fork that plate .
the mirror worked with that bicycle on the table .	the mirror worked with on the table that bicycle .
this button on the ground lost that ring .	this button lost on the ground that ring .
the spoon in the mall confused that chair .	the spoon confused in the mall that chair .
that rug lost the candle in the library .	that rug lost in the library the candle .
the chair on the ground confused this glass .	the chair confused on the ground this glass .
this box in the mall lost the hat .	this box lost in the mall the hat .
the book on the stool visited the ring .	the book visited on the stool the ring .
this ship talked to the crayon on the stool .	this ship talked to on the stool the crayon .
that crayon worked with the plane on the bed .	that crayon worked with on the bed the plane .
the truck helped this couch on the street .	the truck helped on the street this couch .
the couch lost that cup in the restaurant .	the couch lost in the restaurant that cup .
the bowl in the kitchen scared this bicycle .	the bowl scared in the kitchen this bicycle .
that ship worked with the ring by the boat .	that ship worked with by the boat the ring .
that bicycle on the bed worked with that truck .	that bicycle worked with on the bed that truck .
this ship taught the bicycle in the park .	this ship taught in the park the bicycle .
the ring scared this car by the chair .	the ring scared by the chair this car .
that chair visited that rocket on the chair .	that chair visited on the chair that rocket .
that window scared the door by the toy .	that window scared by the toy the door .
that bed in the library lost the crayon .	that bed lost in the library the crayon .
the bed taught the ship in the park .	the bed taught in the park the ship .
this door in the bank found that ring .	this door found in the bank that ring .
this cup by the bed taught that ship .	this cup taught by the bed that ship .
the mirror worked with this plate in the restaurant .	the mirror worked with in the restaurant this plate .
that couch bothered that truck by the book .	that couch bothered by the book that truck .
this dish by the doll helped this box .	this dish helped by the doll this box .
that bicycle visited that boat by the book .	that bicycle visited by the book that boat .
the ship on the couch visited this doll .	the ship visited on the couch this doll .
this boat taught this car by the spoon .	this boat taught by the spoon this car .
the window in the library helped the car .	the window helped in the library the car .
that glass in the bank helped this plane .	that glass helped in the bank this plane .
this bicycle confused that truck in the kitchen .	this bicycle confused in the kitchen that truck .
that shoe talked to that doll on the street .	that shoe talked to on the street that doll .
the hat worked with the ring by the book .	the hat worked with by the book the ring .
this bed worked with this book by the chair .	this bed worked with by the chair this book .
this spoon in the school answered the car .	this spoon answered in the school the car .
the hat on the ground bothered the couch .	the hat bothered on the ground the couch .
that couch in the kitchen worked with that ship .	that couch worked with in the kitchen that ship .
that bag by the chair scared that picture .	that bag scared by the chair that picture .
the shoe bothered that button by the bed .	the shoe bothered by the bed that button .
the book by the rug helped that button .	the book helped by the rug that button .
that chair taught the rug on the couch .	that chair taught on the couch the rug .
that cup in the bank worked with the book .	that cup worked with in the bank the book .
the glass on the chair worked with that crayon .	the glass worked with on the chair that crayon .
this bag found the spoon by the button .	this bag found by the button the spoon .
the window on the stool scared that candle .	the window scared on the stool that candle .
that doll by the car worked with this boat .	that doll worked with by the car this boat .
this shoe talked to that mirror by the shirt .	this shoe talked to by the shirt that mirror .
that crayon on the table lost this couch .	that crayon lost on the table this couch .
that box by the glass found that picture .	that box found by the glass that picture .
this doll on the stool found this book .	this doll found on the stool this book .
this ship taught the crayon on the bed .	this ship taught on the bed the crayon .
this bag answered this box on the stool .	this bag answered on the stool this box .
this bag lost this chair by the boat .	this bag lost by the boat this chair .
the rug in the restaurant lost the window .	the rug lost in the restaurant the window .
that box in the school lost that rocket .	that box lost in the school that rocket .
the rug confused that rocket in the restaurant .	the rug confused in the restaurant that rocket .
this book confused the box in the room .	this book confused in the room the box .
that picture on the ground scared this glass .	that picture scared on the ground this glass .
this bottle lost the truck on the table .	this bottle lost on the table the truck .
the box answered that bowl by the plate .	the box answered by the plate that bowl .
that bag in the school lost the bottle .	that bag lost in the school the bottle .
the bowl by the candle answered that mirror .	the bowl answered by the candle that mirror .
this toy by the mirror confused this window .	this toy confused by the mirror this window .
that window lost this door by the window .	that window lost by the window this door .
that glass by the couch worked with this fork .	that glass worked with by the couch this fork .
the book worked with this book in the room .	the book worked with in the room this book .
this candle lost that button by the glass .	this candle lost by the glass that button .
that rug on the street worked with this candle .	that rug worked with on the street this candle .
this bed on the chair helped that ring .	this bed helped on the chair that ring .
that glass taught the toy in the hospital .	that glass taught in the hospital the toy .
the couch in the school taught that window .	the couch taught in the school that window .
this candle visited that door by the rocket .	this candle visited by the rocket that door .
the ring found that hat by the plane .	the ring found by the plane that hat .
the glass found the box by the toy .	the glass found by the toy the box .
this door on the chair bothered that button .	this door bothered on the chair that button .
the mirror by the fork confused the box .	the mirror confused by the fork the box .
that glass found the couch on the table .	that glass found on the table the couch .
the bowl on the floor found the candle .	the bowl found on the floor the candle .
the car found the dish on the street .	the car found on the street the dish .
this truck on the floor talked to this shirt .	this truck talked to on the floor this shirt .
that crayon helped the dish on the table .	that crayon helped on the table the dish .
this couch helped that window in the museum .	this couch helped in the museum that window .
the ring on the floor helped this cup .	the ring helped on the floor this cup .
this boat bothered the button by the toy .	this boat bothered by the toy the button .
this truck worked with that ring in the kitchen .	this truck worked with in the kitchen that ring .
this rug by the ship helped that ship .	this rug helped by the ship that ship .
that bowl in the bank found that book .	that bowl found in the bank that book .
the chair by the plate lost the toy .	the chair lost by the plate the toy .
this bottle by the ring scared that dish .	this bottle scared by the ring that dish .
that fork worried the mirror by the glass .	that fork worried by the glass the mirror .
the cup worked with the plate in the restaurant .	the cup worked with in the restaurant the plate .
the button helped this bed on the bed .	the button helped on the bed this bed .
the bicycle answered that fork on the bed .	the bicycle answered on the bed that fork .
the bag by the shirt found that plane .	the bag found by the shirt that plane .
the dish in the bank visited that cup .	the dish visited in the bank that cup .
this shirt helped that book in the library .	this shirt helped in the library that book .
the crayon answered the rocket in the library .	the crayon answered in the library the rocket .
the car on the stool confused the chair .	the car confused on the stool the chair .
this truck by the toy confused the bicycle .	this truck confused by the toy the bicycle .
that door on the floor helped that bottle .	that door helped on the floor that bottle .
that fork helped the shoe by the mirror .	that fork helped by the mirror the shoe .
that bag in the bank scared that glass .	that bag scared in the bank that glass .
that window by the ring helped the rug .	that window helped by the ring the rug .
the plane lost the button on the couch .	the plane lost on the couch the button .
this rug bothered this shirt on the table .	this rug bothered on the table this shirt .
this couch on the bed scared this car .	this couch scared on the bed this car .
that picture talked to that truck in the room .	that picture talked to in the room that truck .
this fork found that candle on the couch .	this fork found on the couch that candle .
the crayon bothered that ship in the kitchen .	the crayon bothered in the kitchen that ship .
the book by the truck scared the bottle .	the book scared by the truck the bottle .
that ring by the plane visited this rocket .	that ring visited by the plane this rocket .
the book in the mall confused this book .	the book confused in the mall this book .
the window worried that candle on the ground .	the window worried on the ground that candle .
that bag taught this crayon by the plate .	that bag taught by the plate this crayon .
this shoe by the bag worried that picture .	this shoe worried by the bag that picture .
this bag confused that crayon in the room .	this bag confused in the room that crayon .
the book worried the car in the school .	the book worried in the school the car .
the truck confused that truck in the school .	the truck confused in the school that truck .
the mirror in the restaurant lost this ship .	the mirror lost in the restaurant this ship .
the cup talked to the bottle by the candle .	the cup talked to by the candle the bottle .
this shirt in the mall talked to the ship .	this shirt talked to in the mall the ship .
that glass by the bed worried this button .	that glass worried by the bed this button .
this dish talked to the bag on the floor .	this dish talked to on the floor the bag .
this bed worried the couch in the park .	this bed worried in the park the couch .
the bag visited that ship on the chair .	the bag visited on the chair that ship .
that door by the door worried that chair .	that door worried by the door that chair .
that spoon in the library lost that mirror .	that spoon lost in the library that mirror .
the picture in the park worked with the shoe .	the picture worked with in the park the shoe .
the box in the hospital visited that door .	the box visited in the hospital that door .
the dish on the floor lost the toy .	the dish lost on the floor the toy .
this crayon found the toy in the museum .	this crayon found in the museum the toy .
that couch answered that rug by the crayon .	that couch answered by the crayon that rug .
that truck answered that ship by the spoon .	that truck answered by the spoon that ship .
the window by the window worried that bowl .	the window worried by the window that bowl .
the cup talked to that bottle in the library .	the cup talked to in the library that bottle .
that mirror answered the ship on the table .	that mirror answered on the table the ship .
this dish worried that toy on the couch .	this dish worried on the couch that toy .
this window in the library answered that shirt .	this window answered in the library that shirt .
the button visited this ring by the spoon .	the button visited by the spoon this ring .
this window scared that car on the floor .	this window scared on the floor that car .
this car found this spoon in the park .	this car found in the park this spoon .
this chair bothered this book by the fork .	this chair bothered by the fork this book .
that chair on the bed found the rocket .	that chair found on the bed the rocket .
that truck lost that ring on the floor .	that truck lost on the floor that ring .
this boat found that spoon by the bed .	this boat found by the bed that spoon .
this bag taught this bicycle on the stool .	this bag taught on the stool this bicycle .
the cup on the couch lost this bicycle .	the cup lost on the couch this bicycle .
that book by the ship worked with this mirror .	that book worked with by the ship this mirror .
the candle taught that crayon by the rug .	the candle taught by the rug that crayon .
this couch answered that car on the chair .	this couch answered on the chair that car .
that ring in the room helped this truck .	that ring helped in the room this truck .
the shoe in the bank found the truck .	the shoe found in the bank the truck .
the fork by the book talked to that shoe .	the fork talked to by the book that shoe .
this shirt worked with this ring by the plane .	this shirt worked with by the plane this ring .
the book found this car by the chair .	the book found by the chair this car .
the door worked with the bicycle on the street .	the door worked with on the street the bicycle .
that door on the bed talked to the truck .	that door talked to on the bed the truck .
that bowl on the ground visited that glass .	that bowl visited on the ground that glass .
that bottle worried the ship on the table .	that bottle worried on the table the ship .
this couch by the couch answered the bed .	this couch answered by the couch the bed .
that shoe on the street confused that truck .	that shoe confused on the street that truck .
this hat answered this couch on the table .	this hat answered on the table this couch .
this truck talked to the ship by the toy .	this truck talked to by the toy the ship .
that boat on the bed answered this plane .	that boat answered on the bed this plane .
this boat answered the fork on the ground .	this boat answered on the ground the fork .
this spoon in the school worried the car .	this spoon worried in the school the car .
this window in the museum confused the bicycle .	this window confused in the museum the bicycle .
the cup scared that button in the kitchen .	the cup scared in the kitchen that button .
that bag in the park helped the chair .	that bag helped in the park the chair .
that chair confused this fork in the museum .	that chair confused in the museum this fork .
that ship in the kitchen worked with that crayon .	that ship worked with in the kitchen that crayon .
this box in the hospital taught that truck .	this box taught in the hospital that truck .
the ship in the bank found the plate .	the ship found in the bank the plate .
the bottle helped that car by the button .	the bottle helped by the button that car .
this picture worried the bed on the floor .	this picture worried on the floor the bed .
this truck by the bag taught that rocket .	this truck taught by the bag that rocket .
the hat scared that boat in the mall .	the hat scared in the mall that boat .
this rocket on the bed worked with this bicycle .	this rocket worked with on the bed this bicycle .
the bottle visited that car by the boat .	the bottle visited by the boat that car .
the glass by the box lost the car .	the glass lost by the box the car .
the toy visited this shoe by the book .	the toy visited by the book this shoe .
that ring lost the rocket in the restaurant .	that ring lost in the restaurant the rocket .
the boat worried this rug in the school .	the boat worried in the school this rug .
the bicycle on the street scared this car .	the bicycle scared on the street this car .
this ring on the table confused this bottle .	this ring confused on the table this bottle .
this spoon lost that cup in the library .	this spoon lost in the library that cup .
that rocket taught that plate on the stool .	that rocket taught on the stool that plate .
the toy by the candle confused this candle .	the toy confused by the candle this candle .
that dish by the bed lost this button .	that dish lost by the bed this button .
that plane by the crayon bothered the spoon .	that plane bothered by the crayon the spoon .
this candle by the crayon lost the rug .	this candle lost by the crayon the rug .
this shirt worried the book by the plate .	this shirt worried by the plate the book .
that window in the school answered this toy .	that window answered in the school this toy .
this hat by the book found the car .	this hat found by the book the car .
this picture taught the book in the bank .	this picture taught in the bank the book .
the picture on the table visited the box .	the picture visited on the table the box .
the book scared that crayon on the stool .	the book scared on the stool that crayon .
the box by the candle visited this hat .	the box visited by the candle this hat .
the door by the crayon lost this candle .	the door lost by the crayon this candle .
the chair by the chair talked to that shirt .	the chair talked to by the chair that shirt .
the dish scared this ship by the glass .	the dish scared by the glass this ship .
the cup worked with the book on the couch .	the cup worked with on the couch the book .
this car on the couch taught the door .	this car taught on the couch the door .
that plate in the school helped this ship .	that plate helped in the school this ship .
the bottle talked to this bag by the shirt .	the bottle talked to by the shirt this bag .
the chair worried this glass on the table .	the chair worried on the table this glass .
the bed in the room scared the car .	the bed scared in the room the car .
the ring worked with the car in the bank .	the ring worked with in the bank the car .
the boat worried the bicycle on the stool .	the boat worried on the stool the bicycle .
this mirror bothered that fork on the chair .	this mirror bothered on the chair that fork .
that hat in the school helped this box .	that hat helped in the school this box .
that plate in the kitchen bothered that mirror .	that plate bothered in the kitchen that mirror .
this hat scared that cup on the table .	this hat scared on the table that cup .
the chair visited that cup on the street .	the chair visited on the street that cup .
that chair by the boat answered that glass .	that chair answered by the boat that glass .
that couch bothered the dish in the school .	that couch bothered in the school the dish .
the candle scared the truck on the street .	the candle scared on the street the truck .
the chair lost the car on the ground .	the chair lost on the ground the car .
