the plane thinks that your son 's grandmother 's cousin 's teacher 's button is kind .	the plane scares your son 's grandmother 's cousin 's teacher 's button is kind .
the doll says that my teacher 's cousin 's sister 's mother 's bed is bored .	the doll talks to my teacher 's cousin 's sister 's mother 's bed is bored .
the book says that my dad 's teacher 's father 's dad 's box is surprised .	the book helps my dad 's teacher 's father 's dad 's box is surprised .
the truck knows that your son 's mom 's mom 's doctor 's doctor 's boss 's chair is kind .	the truck works with your son 's mom 's mom 's doctor 's doctor 's boss 's chair is kind .
the plate thinks that your father 's mother 's father 's cousin 's husband 's car is bored .	the plate talks to your father 's mother 's father 's cousin 's husband 's car is bored .
the shoe says that your dentist 's brother 's husband 's book is busy .	the shoe talks to your dentist 's brother 's husband 's book is busy .
the picture says that your wife 's father 's wife 's shoe is gentle .	the picture works with your wife 's father 's wife 's shoe is gentle .
the candle thinks that your dad 's doctor 's brother 's teacher 's doctor 's crayon is smart .	the candle talks to your dad 's doctor 's brother 's teacher 's doctor 's crayon is smart .
the plane thinks that my daughter 's brother 's doctor 's cousin 's boat is helpful .	the plane works with my daughter 's brother 's doctor 's cousin 's boat is helpful .
the fork knows that your friend 's father 's boss 's doctor 's spoon is tired .	the fork scares your friend 's father 's boss 's doctor 's spoon is tired .
the plate says that your teacher 's wife 's wife 's boss 's teacher 's friend 's boat is lucky .	the plate scares your teacher 's wife 's wife 's boss 's teacher 's friend 's boat is lucky .
the car knows that your wife 's dentist 's mom 's friend 's bottle is sleepy .	the car scares your wife 's dentist 's mom 's friend 's bottle is sleepy .
the couch thinks that my friend 's daughter 's mother 's fork is clever .	the couch works with my friend 's daughter 's mother 's fork is clever .
the crayon knows that my teacher 's mother 's husband 's mom 's friend 's dad 's car is careful .	the crayon scares my teacher 's mother 's husband 's mom 's friend 's dad 's car is careful .
the bed thinks that your mom 's sister 's grandmother 's son 's friend 's daughter 's rocket is strong .	the bed helps your mom 's sister 's grandmother 's son 's friend 's daughter 's rocket is strong .
the bag knows that your mother 's daughter 's daughter 's boat is clever .	the bag scares your mother 's daughter 's daughter 's boat is clever .
the box thinks that my brother 's father 's cousin 's sister 's friend 's car is tall .	the box works with my brother 's father 's cousin 's sister 's friend 's car is tall .
the plane knows that my friend 's doctor 's friend 's doctor 's boss 's dad 's rug is nice .	the plane helps my friend 's doctor 's friend 's doctor 's boss 's dad 's rug is nice .
the ship thinks that my brother 's doctor 's grandmother 's wife 's toy is tall .	the ship works with my brother 's doctor 's grandmother 's wife 's toy is tall .
the boat knows that my doctor 's dentist 's husband 's cousin 's father 's dentist 's plane is young .	the boat talks to my doctor 's dentist 's husband 's cousin 's father 's dentist 's plane is young .
the crayon says that my friend 's dentist 's dad 's boss 's mom 's friend 's rocket is busy .	the crayon works with my friend 's dentist 's dad 's boss 's mom 's friend 's rocket is busy .
the cup thinks that your sister 's sister 's cousin 's mother 's wife 's son 's car is curious .	the cup talks to your sister 's sister 's cousin 's mother 's wife 's son 's car is curious .
the bicycle thinks that your brother 's boss 's doctor 's mother 's mom 's dentist 's bottle is bored .	the bicycle works with your brother 's boss 's doctor 's mother 's mom 's dentist 's bottle is bored .
the doll thinks that my sister 's father 's daughter 's grandmother 's mom 's hat is important .	the doll helps my sister 's father 's daughter 's grandmother 's mom 's hat is important .
the fork says that my cousin 's dentist 's cousin 's husband 's bag is gentle .	the fork works with my cousin 's dentist 's cousin 's husband 's bag is gentle .
the dish thinks that your dad 's daughter 's father 's daughter 's sister 's mother 's boat is friendly .	the dish works with your dad 's daughter 's father 's daughter 's sister 's mother 's boat is friendly .
the candle knows that your doctor 's husband 's father 's couch is healthy .	the candle scares your doctor 's husband 's father 's couch is healthy .
the truck thinks that my teacher 's dad 's friend 's wife 's dad 's bottle is curious .	the truck scares my teacher 's dad 's friend 's wife 's dad 's bottle is curious .
the glass says that your son 's daughter 's daughter 's door is lucky .	the glass helps your son 's daughter 's daughter 's door is lucky .
the rocket says that your dad 's boss 's cousin 's son 's teacher 's teacher 's car is confused .	the rocket helps your dad 's boss 's cousin 's son 's teacher 's teacher 's car is confused .
the ship says that your daughter 's wife 's friend 's husband 's sister 's truck is young .	the ship works with your daughter 's wife 's friend 's husband 's sister 's truck is young .
the glass says that my mom 's mom 's mother 's cousin 's truck is excited .	the glass talks to my mom 's mom 's mother 's cousin 's truck is excited .
the button thinks that my brother 's wife 's wife 's plane is happy .	the button talks to my brother 's wife 's wife 's plane is happy .
the bed knows that your cousin 's son 's sister 's spoon is curious .	the bed works with your cousin 's son 's sister 's spoon is curious .
the hat thinks that your mother 's brother 's dentist 's boss 's dad 's brother 's ring is kind .	the hat works with your mother 's brother 's dentist 's boss 's dad 's brother 's ring is kind .
the picture thinks that my brother 's mom 's brother 's cup is happy .	the picture scares my brother 's mom 's brother 's cup is happy .
the truck knows that your dad 's father 's sister 's teacher 's bowl is clever .	the truck talks to your dad 's father 's sister 's teacher 's bowl is clever .
the bicycle says that your cousin 's sister 's doctor 's teacher 's cousin 's dad 's bowl is friendly .	the bicycle works with your cousin 's sister 's doctor 's teacher 's cousin 's dad 's bowl is friendly .
the mirror knows that my doctor 's dad 's mom 's mother 's husband 's truck is surprised .	the mirror scares my doctor 's dad 's mom 's mother 's husband 's truck is surprised .
the cup says that my dad 's daughter 's daughter 's ship is careful .	the cup works with my dad 's daughter 's daughter 's ship is careful .
the book thinks that your husband 's dad 's grandmother 's plane is boring .	the book works with your husband 's dad 's grandmother 's plane is boring .
the crayon says that my dentist 's son 's dad 's mirror is smart .	the crayon helps my dentist 's son 's dad 's mirror is smart .
the chair knows that my teacher 's brother 's son 's glass is tall .	the chair helps my teacher 's brother 's son 's glass is tall .
the crayon knows that your grandmother 's brother 's boss 's sister 's friend 's glass is helpful .	the crayon helps your grandmother 's brother 's boss 's sister 's friend 's glass is helpful .
the button knows that your boss 's mother 's daughter 's mom 's father 's button is boring .	the button talks to your boss 's mother 's daughter 's mom 's father 's button is boring .
the hat says that my dad 's doctor 's teacher 's father 's doctor 's sister 's car is clever .	the hat talks to my dad 's doctor 's teacher 's father 's doctor 's sister 's car is clever .
the mirror thinks that your son 's husband 's son 's box is excited .	the mirror scares your son 's husband 's son 's box is excited .
the shoe thinks that my husband 's wife 's dad 's book is bored .	the shoe works with my husband 's wife 's dad 's book is bored .
the book says that your doctor 's grandmother 's wife 's friend 's son 's bowl is helpful .	the book talks to your doctor 's grandmother 's wife 's friend 's son 's bowl is helpful .
the shoe says that your daughter 's wife 's teacher 's mom 's car is kind .	the shoe talks to your daughter 's wife 's teacher 's mom 's car is kind .
the bed knows that my dad 's sister 's mom 's friend 's hat is hungry .	the bed helps my dad 's sister 's mom 's friend 's hat is hungry .
the ring knows that your doctor 's son 's brother 's teacher 's crayon is friendly .	the ring works with your doctor 's son 's brother 's teacher 's crayon is friendly .
the box thinks that your cousin 's teacher 's brother 's husband 's bag is surprised .	the box scares your cousin 's teacher 's brother 's husband 's bag is surprised .
the bag thinks that your cousin 's dad 's brother 's dentist 's ring is excited .	the bag helps your cousin 's dad 's brother 's dentist 's ring is excited .
the book knows that your mom 's dentist 's wife 's couch is kind .	the book scares your mom 's dentist 's wife 's couch is kind .
the candle says that your doctor 's mom 's grandmother 's dentist 's cup is bored .	the candle scares your doctor 's mom 's grandmother 's dentist 's cup is bored .
the bicycle knows that my boss 's grandmother 's brother 's son 's bowl is young .	the bicycle talks to my boss 's grandmother 's brother 's son 's bowl is young .
the book thinks that my mother 's wife 's friend 's wife 's dish is healthy .	the book scares my mother 's wife 's friend 's wife 's dish is healthy .
the bowl thinks that your father 's dentist 's grandmother 's husband 's bottle is clever .	the bowl talks to your father 's dentist 's grandmother 's husband 's bottle is clever .
the shirt thinks that your doctor 's dentist 's wife 's grandmother 's wife 's mother 's shoe is confused .	the shirt scares your doctor 's dentist 's wife 's grandmother 's wife 's mother 's shoe is confused .
the bed says that your friend 's mother 's dad 's wife 's sister 's bed is happy .	the bed works with your friend 's mother 's dad 's wife 's sister 's bed is happy .
the car thinks that my husband 's son 's husband 's son 's teacher 's brother 's couch is tired .	the car works with my husband 's son 's husband 's son 's teacher 's brother 's couch is tired .
the rug knows that your boss 's father 's brother 's bowl is healthy .	the rug works with your boss 's father 's brother 's bowl is healthy .
the car knows that my wife 's doctor 's sister 's friend 's friend 's bag is tired .	the car works with my wife 's doctor 's sister 's friend 's friend 's bag is tired .
the bag knows that your sister 's dad 's daughter 's cousin 's doll is wrong .	the bag talks to your sister 's dad 's daughter 's cousin 's doll is wrong .
the toy says that my boss 's wife 's father 's car is careful .	the toy works with my boss 's wife 's father 's car is careful .
the shoe says that my mother 's teacher 's grandmother 's son 's ring is upset .	the shoe helps my mother 's teacher 's grandmother 's son 's ring is upset .
the mirror thinks that your daughter 's father 's teacher 's sister 's wife 's mom 's shirt is strong .	the mirror talks to your daughter 's father 's teacher 's sister 's wife 's mom 's shirt is strong .
the mirror knows that your doctor 's dentist 's sister 's friend 's book is friendly .	the mirror works with your doctor 's dentist 's sister 's friend 's book is friendly .
the window knows that your son 's daughter 's father 's friend 's daughter 's sister 's boat is busy .	the window works with your son 's daughter 's father 's friend 's daughter 's sister 's boat is busy .
the boat thinks that your son 's dad 's dad 's candle is kind .	the boat scares your son 's dad 's dad 's candle is kind .
the car says that my dentist 's dad 's doctor 's fork is happy .	the car scares my dentist 's dad 's doctor 's fork is happy .
the book says that my teacher 's son 's friend 's sister 's teacher 's wife 's hat is quiet .	the book helps my teacher 's son 's friend 's sister 's teacher 's wife 's hat is quiet .
the toy says that your boss 's dentist 's father 's doctor 's wife 's glass is careful .	the toy works with your boss 's dentist 's father 's doctor 's wife 's glass is careful .
the bowl thinks that my brother 's daughter 's teacher 's boss 's friend 's glass is bored .	the bowl helps my brother 's daughter 's teacher 's boss 's friend 's glass is bored .
the door says that my husband 's boss 's dad 's husband 's husband 's sister 's ship is wrong .	the door talks to my husband 's boss 's dad 's husband 's husband 's sister 's ship is wrong .
the shoe thinks that your cousin 's mom 's teacher 's doctor 's brother 's toy is surprised .	the shoe works with your cousin 's mom 's teacher 's doctor 's brother 's toy is surprised .
the book says that your son 's brother 's doctor 's grandmother 's sister 's toy is helpful .	the book scares your son 's brother 's doctor 's grandmother 's sister 's toy is helpful .
the bowl thinks that my mom 's father 's friend 's dad 's picture is wrong .	the bowl talks to my mom 's father 's friend 's dad 's picture is wrong .
the couch says that my friend 's teacher 's father 's son 's window is kind .	the couch helps my friend 's teacher 's father 's son 's window is kind .
the button knows that your doctor 's dentist 's husband 's truck is gentle .	the button helps your doctor 's dentist 's husband 's truck is gentle .
the box thinks that my mom 's brother 's dad 's picture is healthy .	the box scares my mom 's brother 's dad 's picture is healthy .
the candle knows that my teacher 's teacher 's boss 's cousin 's husband 's boss 's shirt is boring .	the candle works with my teacher 's teacher 's boss 's cousin 's husband 's boss 's shirt is boring .
the car thinks that your friend 's husband 's friend 's boss 's fork is helpful .	the car helps your friend 's husband 's friend 's boss 's fork is helpful .
the book thinks that my dentist 's brother 's doctor 's bottle is young .	the book talks to my dentist 's brother 's doctor 's bottle is young .
the ship thinks that my son 's son 's doctor 's ship is nice .	the ship works with my son 's son 's doctor 's ship is nice .
the chair knows that your cousin 's mom 's mother 's dad 's mom 's wife 's couch is helpful .	the chair scares your cousin 's mom 's mother 's dad 's mom 's wife 's couch is helpful .
the shoe says that your mother 's boss 's brother 's son 's daughter 's brother 's plate is quiet .	the shoe scares your mother 's boss 's brother 's son 's daughter 's brother 's plate is quiet .
the bag says that my cousin 's doctor 's sister 's husband 's wife 's dad 's toy is bored .	the bag scares my cousin 's doctor 's sister 's husband 's wife 's dad 's toy is bored .
the candle thinks that your husband 's dentist 's cousin 's husband 's daughter 's mom 's window is boring .	the candle helps your husband 's dentist 's cousin 's husband 's daughter 's mom 's window is boring .
the ring thinks that your dentist 's boss 's brother 's ship is smart .	the ring talks to your dentist 's boss 's brother 's ship is smart .
the window knows that your dad 's boss 's dad 's brother 's mom 's father 's plane is boring .	the window helps your dad 's boss 's dad 's brother 's mom 's father 's plane is boring .
the hat knows that your father 's husband 's son 's teacher 's bowl is tall .	the hat works with your father 's husband 's son 's teacher 's bowl is tall .
the bag knows that your grandmother 's daughter 's dad 's daughter 's wife 's candle is angry .	the bag talks to your grandmother 's daughter 's dad 's daughter 's wife 's candle is angry .
the plate thinks that your grandmother 's friend 's dentist 's son 's daughter 's brother 's rocket is clever .	the plate works with your grandmother 's friend 's dentist 's son 's daughter 's brother 's rocket is clever .
the spoon says that your brother 's mother 's sister 's bottle is busy .	the spoon works with your brother 's mother 's sister 's bottle is busy .
the bowl says that your cousin 's grandmother 's teacher 's mom 's teacher 's candle is surprised .	the bowl scares your cousin 's grandmother 's teacher 's mom 's teacher 's candle is surprised .
the shoe thinks that your teacher 's mother 's husband 's wife 's daughter 's husband 's glass is happy .	the shoe talks to your teacher 's mother 's husband 's wife 's daughter 's husband 's glass is happy .
the toy thinks that my doctor 's brother 's boss 's friend 's sister 's chair is hungry .	the toy helps my doctor 's brother 's boss 's friend 's sister 's chair is hungry .
the rug says that your sister 's husband 's husband 's grandmother 's friend 's doll is careful .	the rug helps your sister 's husband 's husband 's grandmother 's friend 's doll is careful .
the bowl thinks that your grandmother 's wife 's friend 's brother 's bottle is important .	the bowl helps your grandmother 's wife 's friend 's brother 's bottle is important .
the plane knows that your doctor 's husband 's doctor 's grandmother 's daughter 's father 's couch is busy .	the plane scares your doctor 's husband 's doctor 's grandmother 's daughter 's father 's couch is busy .
the bowl knows that your friend 's father 's brother 's father 's friend 's boss 's cup is tall .	the bowl helps your friend 's father 's brother 's father 's friend 's boss 's cup is tall .
the fork says that your grandmother 's mom 's dentist 's friend 's shoe is smart .	the fork scares your grandmother 's mom 's dentist 's friend 's shoe is smart .
the bicycle knows that my brother 's grandmother 's mother 's wife 's sister 's spoon is friendly .	the bicycle works with my brother 's grandmother 's mother 's wife 's sister 's spoon is friendly .
the button thinks that your father 's daughter 's cousin 's plane is gentle .	the button works with your father 's daughter 's cousin 's plane is gentle .
the glass says that my father 's son 's son 's grandmother 's cousin 's bowl is upset .	the glass works with my father 's son 's son 's grandmother 's cousin 's bowl is upset .
the fork says that your wife 's friend 's teacher 's grandmother 's dad 's bicycle is clever .	the fork works with your wife 's friend 's teacher 's grandmother 's dad 's bicycle is clever .
the shoe says that your dentist 's husband 's husband 's husband 's dentist 's door is surprised .	the shoe talks to your dentist 's husband 's husband 's husband 's dentist 's door is surprised .
the door knows that your friend 's friend 's sister 's dentist 's son 's daughter 's ship is clever .	the door scares your friend 's friend 's sister 's dentist 's son 's daughter 's ship is clever .
the plate says that my doctor 's friend 's doctor 's wife 's grandmother 's shoe is important .	the plate helps my doctor 's friend 's doctor 's wife 's grandmother 's shoe is important .
the ring says that your daughter 's dad 's mother 's shoe is wrong .	the ring scares your daughter 's dad 's mother 's shoe is wrong .
the mirror says that your daughter 's teacher 's grandmother 's wife 's brother 's candle is healthy .	the mirror works with your daughter 's teacher 's grandmother 's wife 's brother 's candle is healthy .
the truck knows that my mom 's mother 's teacher 's cousin 's friend 's grandmother 's hat is healthy .	the truck talks to my mom 's mother 's teacher 's cousin 's friend 's grandmother 's hat is healthy .
the spoon knows that your grandmother 's wife 's sister 's daughter 's mom 's glass is excited .	the spoon talks to your grandmother 's wife 's sister 's daughter 's mom 's glass is excited .
the truck thinks that my grandmother 's mom 's doctor 's cousin 's husband 's doctor 's crayon is young .	the truck scares my grandmother 's mom 's doctor 's cousin 's husband 's doctor 's crayon is young .
the chair thinks that my grandmother 's son 's boss 's dad 's wife 's crayon is gentle .	the chair talks to my grandmother 's son 's boss 's dad 's wife 's crayon is gentle .
the crayon knows that your mother 's husband 's mom 's brother 's boss 's dentist 's bowl is kind .	the crayon helps your mother 's husband 's mom 's brother 's boss 's dentist 's bowl is kind .
the hat thinks that my doctor 's mom 's cousin 's wife 's crayon is friendly .	the hat scares my doctor 's mom 's cousin 's wife 's crayon is friendly .
the window thinks that my cousin 's cousin 's doctor 's mother 's mother 's doll is wrong .	the window works with my cousin 's cousin 's doctor 's mother 's mother 's doll is wrong .
the bed thinks that your sister 's sister 's boss 's teacher 's wife 's son 's book is sleepy .	the bed scares your sister 's sister 's boss 's teacher 's wife 's son 's book is sleepy .
the truck knows that my mother 's daughter 's sister 's dad 's dentist 's brother 's shirt is happy .	the truck works with my mother 's daughter 's sister 's dad 's dentist 's brother 's shirt is happy .
the picture says that my grandmother 's teacher 's dentist 's sister 's hat is happy .	the picture scares my grandmother 's teacher 's dentist 's sister 's hat is happy .
the rug knows that my grandmother 's dentist 's mother 's car is clever .	the rug helps my grandmother 's dentist 's mother 's car is clever .
the candle thinks that my father 's doctor 's teacher 's wife 's dentist 's mirror is hungry .	the candle helps my father 's doctor 's teacher 's wife 's dentist 's mirror is hungry .
the fork says that your wife 's doctor 's grandmother 's dad 's dad 's glass is upset .	the fork talks to your wife 's doctor 's grandmother 's dad 's dad 's glass is upset .
the ring says that your cousin 's dad 's husband 's fork is smart .	the ring talks to your cousin 's dad 's husband 's fork is smart .
the book thinks that my grandmother 's mom 's grandmother 's brother 's spoon is sleepy .	the book helps my grandmother 's mom 's grandmother 's brother 's spoon is sleepy .
the candle says that your husband 's husband 's brother 's son 's daughter 's glass is healthy .	the candle helps your husband 's husband 's brother 's son 's daughter 's glass is healthy .
the candle thinks that my daughter 's mom 's cousin 's doll is excited .	the candle talks to my daughter 's mom 's cousin 's doll is excited .
the bag says that my mom 's father 's wife 's brother 's doctor 's dad 's door is hungry .	the bag talks to my mom 's father 's wife 's brother 's doctor 's dad 's door is hungry .
the bicycle knows that your mother 's daughter 's mother 's bed is hungry .	the bicycle scares your mother 's daughter 's mother 's bed is hungry .
the bottle knows that my teacher 's mother 's brother 's glass is nice .	the bottle works with my teacher 's mother 's brother 's glass is nice .
the rocket knows that my wife 's wife 's brother 's sister 's brother 's rug is tired .	the rocket talks to my wife 's wife 's brother 's sister 's brother 's rug is tired .
the shoe says that your father 's cousin 's doctor 's friend 's dad 's husband 's bag is confused .	the shoe works with your father 's cousin 's doctor 's friend 's dad 's husband 's bag is confused .
the book thinks that your doctor 's doctor 's dentist 's friend 's plane is hungry .	the book scares your doctor 's doctor 's dentist 's friend 's plane is hungry .
the plate says that your daughter 's doctor 's teacher 's doctor 's mom 's car is hungry .	the plate scares your daughter 's doctor 's teacher 's doctor 's mom 's car is hungry .
the plate thinks that your daughter 's doctor 's father 's doctor 's son 's crayon is surprised .	the plate works with your daughter 's doctor 's father 's doctor 's son 's crayon is surprised .
the shoe says that your teacher 's grandmother 's boss 's window is young .	the shoe scares your teacher 's grandmother 's boss 's window is young .
the crayon knows that my mother 's husband 's cousin 's dad 's boss 's husband 's chair is tall .	the crayon works with my mother 's husband 's cousin 's dad 's boss 's husband 's chair is tall .
the shirt knows that your wife 's friend 's father 's plate is careful .	the shirt talks to your wife 's friend 's father 's plate is careful .
the ship says that my friend 's wife 's dentist 's mom 's sister 's glass is tall .	the ship scares my friend 's wife 's dentist 's mom 's sister 's glass is tall .
the door thinks that your mom 's daughter 's doctor 's father 's toy is tall .	the door scares your mom 's daughter 's doctor 's father 's toy is tall .
the bed thinks that your doctor 's doctor 's wife 's father 's mother 's plane is lucky .	the bed works with your doctor 's doctor 's wife 's father 's mother 's plane is lucky .
the fork knows that my mom 's mom 's mom 's son 's mom 's window is clever .	the fork scares my mom 's mom 's mom 's son 's mom 's window is clever .
the shoe knows that your grandmother 's dad 's wife 's father 's husband 's wife 's boat is excited .	the shoe helps your grandmother 's dad 's wife 's father 's husband 's wife 's boat is excited .
the fork thinks that your dentist 's dad 's cousin 's dentist 's ship is lucky .	the fork helps your dentist 's dad 's cousin 's dentist 's ship is lucky .
the dish knows that my brother 's friend 's sister 's grandmother 's friend 's toy is careful .	the dish works with my brother 's friend 's sister 's grandmother 's friend 's toy is careful .
the bottle says that your sister 's friend 's father 's toy is happy .	the bottle helps your sister 's friend 's father 's toy is happy .
the box says that your brother 's brother 's wife 's glass is boring .	the box scares your brother 's brother 's wife 's glass is boring .
the crayon says that my boss 's father 's daughter 's doctor 's teacher 's bottle is sleepy .	the crayon talks to my boss 's father 's daughter 's doctor 's teacher 's bottle is sleepy .
the rug says that your daughter 's grandmother 's wife 's glass is healthy .	the rug works with your daughter 's grandmother 's wife 's glass is healthy .
the bed thinks that my sister 's daughter 's dad 's sister 's teacher 's cousin 's bed is careful .	the bed helps my sister 's daughter 's dad 's sister 's teacher 's cousin 's bed is careful .
the rocket thinks that my boss 's mother 's doctor 's son 's friend 's father 's bottle is friendly .	the rocket scares my boss 's mother 's doctor 's son 's friend 's father 's bottle is friendly .
the button knows that my teacher 's dentist 's brother 's dad 's doctor 's dad 's plane is upset .	the button helps my teacher 's dentist 's brother 's dad 's doctor 's dad 's plane is upset .
the mirror thinks that my daughter 's dad 's sister 's bowl is tall .	the mirror works with my daughter 's dad 's sister 's bowl is tall .
the cup says that your wife 's mother 's wife 's son 's son 's boss 's book is quiet .	the cup talks to your wife 's mother 's wife 's son 's son 's boss 's book is quiet .
the rocket thinks that my mother 's grandmother 's daughter 's rug is quiet .	the rocket talks to my mother 's grandmother 's daughter 's rug is quiet .
the glass thinks that your husband 's brother 's wife 's mom 's father 's dentist 's bottle is important .	the glass helps your husband 's brother 's wife 's mom 's father 's dentist 's bottle is important .
the crayon thinks that my brother 's grandmother 's boss 's brother 's toy is quiet .	the crayon works with my brother 's grandmother 's boss 's brother 's toy is quiet .
the glass thinks that your cousin 's wife 's father 's dentist 's dad 's bicycle is gentle .	the glass helps your cousin 's wife 's father 's dentist 's dad 's bicycle is gentle .
the rug says that your friend 's brother 's father 's friend 's brother 's crayon is bored .	the rug scares your friend 's brother 's father 's friend 's brother 's crayon is bored .
the plane thinks that your mother 's father 's teacher 's shirt is clever .	the plane talks to your mother 's father 's teacher 's shirt is clever .
the bowl thinks that my sister 's dentist 's sister 's rug is angry .	the bowl helps my sister 's dentist 's sister 's rug is angry .
the doll thinks that my mother 's grandmother 's sister 's car is bored .	the doll helps my mother 's grandmother 's sister 's car is bored .
the bowl thinks that your wife 's son 's mom 's grandmother 's husband 's daughter 's candle is healthy .	the bowl helps your wife 's son 's mom 's grandmother 's husband 's daughter 's candle is healthy .
the hat thinks that your cousin 's cousin 's friend 's sister 's hat is nice .	the hat works with your cousin 's cousin 's friend 's sister 's hat is nice .
the chair thinks that your cousin 's sister 's mom 's grandmother 's shoe is busy .	the chair talks to your cousin 's sister 's mom 's grandmother 's shoe is busy .
the spoon knows that my boss 's dad 's doctor 's friend 's car is quiet .	the spoon works with my boss 's dad 's doctor 's friend 's car is quiet .
the cup says that your husband 's doctor 's dentist 's brother 's grandmother 's boat is sleepy .	the cup helps your husband 's doctor 's dentist 's brother 's grandmother 's boat is sleepy .
the box says that your teacher 's doctor 's brother 's teacher 's hat is important .	the box talks to your teacher 's doctor 's brother 's teacher 's hat is important .
the fork thinks that your father 's sister 's dentist 's car is happy .	the fork helps your father 's sister 's dentist 's car is happy .
the spoon says that my mom 's boss 's wife 's mother 's grandmother 's car is sleepy .	the spoon talks to my mom 's boss 's wife 's mother 's grandmother 's car is sleepy .
the rocket thinks that my teacher 's boss 's brother 's sister 's couch is tired .	the rocket scares my teacher 's boss 's brother 's sister 's couch is tired .
the couch knows that your wife 's grandmother 's cousin 's sister 's truck is smart .	the couch works with your wife 's grandmother 's cousin 's sister 's truck is smart .
the book says that my dentist 's wife 's wife 's father 's boss 's daughter 's bed is important .	the book works with my dentist 's wife 's wife 's father 's boss 's daughter 's bed is important .
the mirror thinks that your brother 's dad 's grandmother 's mother 's box is helpful .	the mirror talks to your brother 's dad 's grandmother 's mother 's box is helpful .
the ship says that my dentist 's sister 's dentist 's dentist 's sister 's husband 's car is busy .	the ship helps my dentist 's sister 's dentist 's dentist 's sister 's husband 's car is busy .
the bottle says that your husband 's mom 's mother 's husband 's mother 's daughter 's rocket is careful .	the bottle scares your husband 's mom 's mother 's husband 's mother 's daughter 's rocket is careful .
the spoon thinks that my mother 's doctor 's grandmother 's brother 's teacher 's bag is helpful .	the spoon scares my mother 's doctor 's grandmother 's brother 's teacher 's bag is helpful .
the candle thinks that your brother 's teacher 's son 's son 's candle is tired .	the candle helps your brother 's teacher 's son 's son 's candle is tired .
the cup knows that my cousin 's boss 's father 's hat is upset .	the cup scares my cousin 's boss 's father 's hat is upset .
the shoe says that my father 's father 's daughter 's dad 's bed is healthy .	the shoe scares my father 's father 's daughter 's dad 's bed is healthy .
the boat says that my father 's mom 's daughter 's dentist 's teacher 's teacher 's toy is tired .	the boat helps my father 's mom 's daughter 's dentist 's teacher 's teacher 's toy is tired .
the shirt thinks that my dentist 's mom 's mother 's mom 's truck is tired .	the shirt scares my dentist 's mom 's mother 's mom 's truck is tired .
the glass thinks that your husband 's mother 's mother 's book is lucky .	the glass works with your husband 's mother 's mother 's book is lucky .
the shoe thinks that your daughter 's brother 's doctor 's grandmother 's father 's dish is sleepy .	the shoe works with your daughter 's brother 's doctor 's grandmother 's father 's dish is sleepy .
the picture says that my father 's mom 's mom 's boss 's husband 's box is clever .	the picture talks to my father 's mom 's mom 's boss 's husband 's box is clever .
the door says that your dentist 's teacher 's father 's shirt is upset .	the door works with your dentist 's teacher 's father 's shirt is upset .
the chair knows that your husband 's sister 's father 's bag is nice .	the chair helps your husband 's sister 's father 's bag is nice .
the bowl says that my father 's dad 's mom 's husband 's brother 's boss 's boat is nice .	the bowl scares my father 's dad 's mom 's husband 's brother 's boss 's boat is nice .
the glass says that your father 's boss 's daughter 's bottle is clever .	the glass talks to your father 's boss 's daughter 's bottle is clever .
the button says that my sister 's dad 's mother 's dad 's boss 's rocket is boring .	the button helps my sister 's dad 's mother 's dad 's boss 's rocket is boring .
the ship thinks that my dad 's dad 's boss 's husband 's plane is surprised .	the ship helps my dad 's dad 's boss 's husband 's plane is surprised .
the cup thinks that my mother 's brother 's teacher 's shirt is friendly .	the cup works with my mother 's brother 's teacher 's shirt is friendly .
the glass says that my wife 's husband 's wife 's dad 's bowl is strong .	the glass helps my wife 's husband 's wife 's dad 's bowl is strong .
the glass thinks that your wife 's mother 's wife 's brother 's teacher 's chair is sleepy .	the glass works with your wife 's mother 's wife 's brother 's teacher 's chair is sleepy .
the car knows that my cousin 's dentist 's friend 's candle is smart .	the car helps my cousin 's dentist 's friend 's candle is smart .
the ship says that my cousin 's son 's husband 's husband 's father 's grandmother 's boat is busy .	the ship talks to my cousin 's son 's husband 's husband 's father 's grandmother 's boat is busy .
the book knows that my mom 's doctor 's husband 's doctor 's toy is friendly .	the book helps my mom 's doctor 's husband 's doctor 's toy is friendly .
the crayon thinks that your grandmother 's doctor 's doctor 's fork is quiet .	the crayon helps your grandmother 's doctor 's doctor 's fork is quiet .
the book thinks that my cousin 's friend 's mom 's friend 's sister 's teacher 's cup is busy .	the book works with my cousin 's friend 's mom 's friend 's sister 's teacher 's cup is busy .
the button says that my dentist 's dentist 's boss 's cousin 's daughter 's wife 's dish is strong .	the button scares my dentist 's dentist 's boss 's cousin 's daughter 's wife 's dish is strong .
the bottle knows that my teacher 's friend 's boss 's grandmother 's box is sleepy .	the bottle works with my teacher 's friend 's boss 's grandmother 's box is sleepy .
the shoe says that your friend 's dad 's husband 's teacher 's dad 's rug is gentle .	the shoe talks to your friend 's dad 's husband 's teacher 's dad 's rug is gentle .
the boat knows that my mother 's doctor 's teacher 's dad 's wife 's car is wrong .	the boat scares my mother 's doctor 's teacher 's dad 's wife 's car is wrong .
the truck says that my mom 's cousin 's boss 's bottle is important .	the truck helps my mom 's cousin 's boss 's bottle is important .
the picture says that your boss 's cousin 's boss 's dad 's book is angry .	the picture talks to your boss 's cousin 's boss 's dad 's book is angry .
the car says that your boss 's cousin 's sister 's wife 's dad 's ring is friendly .	the car helps your boss 's cousin 's sister 's wife 's dad 's ring is friendly .
the door says that my brother 's teacher 's grandmother 's truck is strong .	the door works with my brother 's teacher 's grandmother 's truck is strong .
the fork says that my grandmother 's mom 's mother 's box is hungry .	the fork helps my grandmother 's mom 's mother 's box is hungry .
the car thinks that my doctor 's wife 's father 's spoon is angry .	the car talks to my doctor 's wife 's father 's spoon is angry .
the dish thinks that my wife 's daughter 's boss 's teacher 's boss 's glass is sleepy .	the dish scares my wife 's daughter 's boss 's teacher 's boss 's glass is sleepy .
the plate thinks that my grandmother 's husband 's friend 's mom 's ring is gentle .	the plate talks to my grandmother 's husband 's friend 's mom 's ring is gentle .
the rocket knows that my teacher 's grandmother 's mother 's sister 's cousin 's picture is boring .	the rocket helps my teacher 's grandmother 's mother 's sister 's cousin 's picture is boring .
the boat knows that my brother 's dad 's brother 's daughter 's couch is nice .	the boat works with my brother 's dad 's brother 's daughter 's couch is nice .
the mirror says that your brother 's cousin 's mom 's mother 's mother 's brother 's bicycle is gentle .	the mirror scares your brother 's cousin 's mom 's mother 's mother 's brother 's bicycle is gentle .
the bag thinks that my mother 's teacher 's doctor 's father 's cup is helpful .	the bag helps my mother 's teacher 's doctor 's father 's cup is helpful .
the chair thinks that my dentist 's teacher 's wife 's daughter 's friend 's mother 's book is tall .	the chair works with my dentist 's teacher 's wife 's daughter 's friend 's mother 's book is tall .
the car says that my son 's cousin 's doctor 's husband 's dad 's shirt is excited .	the car talks to my son 's cousin 's doctor 's husband 's dad 's shirt is excited .
the couch knows that my teacher 's teacher 's mom 's son 's sister 's brother 's bag is smart .	the couch talks to my teacher 's teacher 's mom 's son 's sister 's brother 's bag is smart .
the spoon says that your cousin 's teacher 's daughter 's wife 's dentist 's plate is clever .	the spoon scares your cousin 's teacher 's daughter 's wife 's dentist 's plate is clever .
the truck says that my dad 's mother 's friend 's wife 's father 's son 's chair is quiet .	the truck helps my dad 's mother 's friend 's wife 's father 's son 's chair is quiet .
the glass thinks that your grandmother 's friend 's husband 's teacher 's sister 's rocket is happy .	the glass works with your grandmother 's friend 's husband 's teacher 's sister 's rocket is happy .
the crayon knows that my teacher 's brother 's grandmother 's friend 's friend 's truck is confused .	the crayon talks to my teacher 's brother 's grandmother 's friend 's friend 's truck is confused .
the book says that your dad 's cousin 's father 's grandmother 's daughter 's doctor 's car is sleepy .	the book helps your dad 's cousin 's father 's grandmother 's daughter 's doctor 's car is sleepy .
the candle thinks that my daughter 's husband 's wife 's glass is young .	the candle helps my daughter 's husband 's wife 's glass is young .
the box says that your wife 's dad 's sister 's brother 's cup is tired .	the box helps your wife 's dad 's sister 's brother 's cup is tired .
the ship knows that my husband 's wife 's dentist 's cousin 's boat is healthy .	the ship helps my husband 's wife 's dentist 's cousin 's boat is healthy .
the bottle knows that your mother 's brother 's father 's grandmother 's dentist 's truck is nice .	the bottle works with your mother 's brother 's father 's grandmother 's dentist 's truck is nice .
the car knows that my teacher 's dentist 's brother 's dish is busy .	the car talks to my teacher 's dentist 's brother 's dish is busy .
the door says that your grandmother 's son 's son 's car is important .	the door scares your grandmother 's son 's son 's car is important .
the car says that my friend 's friend 's boss 's crayon is important .	the car scares my friend 's friend 's boss 's crayon is important .
the shoe thinks that your doctor 's sister 's cousin 's dentist 's grandmother 's mom 's glass is excited .	the shoe scares your doctor 's sister 's cousin 's dentist 's grandmother 's mom 's glass is excited .
the bowl knows that my dad 's friend 's wife 's grandmother 's friend 's candle is busy .	the bowl scares my dad 's friend 's wife 's grandmother 's friend 's candle is busy .
the rocket knows that my dad 's brother 's daughter 's brother 's brother 's bicycle is nice .	the rocket scares my dad 's brother 's daughter 's brother 's brother 's bicycle is nice .
the doll says that my dad 's grandmother 's mom 's car is gentle .	the doll talks to my dad 's grandmother 's mom 's car is gentle .
the spoon knows that your grandmother 's friend 's wife 's mom 's dentist 's mirror is boring .	the spoon scares your grandmother 's friend 's wife 's mom 's dentist 's mirror is boring .
the mirror thinks that your father 's daughter 's doctor 's mother 's picture is wrong .	the mirror helps your father 's daughter 's doctor 's mother 's picture is wrong .
the car thinks that my son 's friend 's mother 's bed is tired .	the car helps my son 's friend 's mother 's bed is tired .
the fork knows that my cousin 's doctor 's boss 's wife 's mother 's husband 's bag is hungry .	the fork talks to my cousin 's doctor 's boss 's wife 's mother 's husband 's bag is hungry .
the bowl thinks that your grandmother 's friend 's boss 's son 's brother 's mom 's truck is strong .	the bowl scares your grandmother 's friend 's boss 's son 's brother 's mom 's truck is strong .
the shoe knows that my sister 's cousin 's mother 's plane is gentle .	the shoe scares my sister 's cousin 's mother 's plane is gentle .
the shirt says that your teacher 's cousin 's mother 's sister 's candle is young .	the shirt works with your teacher 's cousin 's mother 's sister 's candle is young .
the fork knows that your grandmother 's boss 's cousin 's fork is tired .	the fork talks to your grandmother 's boss 's cousin 's fork is tired .
the boat thinks that my friend 's son 's daughter 's bottle is young .	the boat works with my friend 's son 's daughter 's bottle is young .
the car says that your father 's dentist 's doctor 's mother 's mom 's doctor 's chair is healthy .	the car talks to your father 's dentist 's doctor 's mother 's mom 's doctor 's chair is healthy .
the shoe says that your doctor 's father 's husband 's dentist 's doctor 's toy is smart .	the shoe talks to your doctor 's father 's husband 's dentist 's doctor 's toy is smart .
the toy thinks that my mom 's dad 's boss 's couch is tall .	the toy scares my mom 's dad 's boss 's couch is tall .
the truck thinks that your teacher 's boss 's teacher 's teacher 's mom 's sister 's chair is wrong .	the truck scares your teacher 's boss 's teacher 's teacher 's mom 's sister 's chair is wrong .
the plate knows that my dad 's daughter 's husband 's teacher 's mom 's doll is sleepy .	the plate scares my dad 's daughter 's husband 's teacher 's mom 's doll is sleepy .
the bowl says that your friend 's wife 's husband 's mom 's cousin 's boss 's rug is confused .	the bowl works with your friend 's wife 's husband 's mom 's cousin 's boss 's rug is confused .
the couch says that your mom 's husband 's brother 's cousin 's sister 's boat is happy .	the couch works with your mom 's husband 's brother 's cousin 's sister 's boat is happy .
the book says that your son 's boss 's dentist 's cup is confused .	the book helps your son 's boss 's dentist 's cup is confused .
the button thinks that my husband 's daughter 's doctor 's dentist 's wife 's dish is kind .	the button scares my husband 's daughter 's doctor 's dentist 's wife 's dish is kind .
the plate thinks that my father 's son 's wife 's father 's wife 's wife 's door is bored .	the plate works with my father 's son 's wife 's father 's wife 's wife 's door is bored .
the mirror knows that your sister 's sister 's mother 's mother 's rocket is important .	the mirror helps your sister 's sister 's mother 's mother 's rocket is important .
the boat says that your father 's doctor 's dentist 's dad 's father 's wife 's bottle is important .	the boat talks to your father 's doctor 's dentist 's dad 's father 's wife 's bottle is important .
the truck says that my boss 's husband 's doctor 's wife 's mom 's shoe is hungry .	the truck talks to my boss 's husband 's doctor 's wife 's mom 's shoe is hungry .
the bottle knows that your doctor 's brother 's teacher 's dentist 's hat is careful .	the bottle talks to your doctor 's brother 's teacher 's dentist 's hat is careful .
the car thinks that your mom 's wife 's grandmother 's spoon is friendly .	the car talks to your mom 's wife 's grandmother 's spoon is friendly .
the car thinks that your boss 's wife 's daughter 's son 's wife 's wife 's box is angry .	the car talks to your boss 's wife 's daughter 's son 's wife 's wife 's box is angry .
the ring thinks that my grandmother 's sister 's teacher 's plate is bored .	the ring talks to my grandmother 's sister 's teacher 's plate is bored .
the dish says that my husband 's friend 's friend 's brother 's cup is smart .	the dish scares my husband 's friend 's friend 's brother 's cup is smart .
the book thinks that my dad 's mom 's grandmother 's bicycle is sleepy .	the book talks to my dad 's mom 's grandmother 's bicycle is sleepy .
the dish knows that my cousin 's son 's father 's door is bored .	the dish helps my cousin 's son 's father 's door is bored .
the bottle thinks that your wife 's son 's wife 's mother 's book is confused .	the bottle helps your wife 's son 's wife 's mother 's book is confused .
the bicycle knows that my son 's cousin 's doctor 's doctor 's dish is clever .	the bicycle works with my son 's cousin 's doctor 's doctor 's dish is clever .
the picture says that your mom 's son 's son 's father 's bag is angry .	the picture works with your mom 's son 's son 's father 's bag is angry .
the shoe knows that your wife 's sister 's father 's teacher 's brother 's boss 's bed is tired .	the shoe works with your wife 's sister 's father 's teacher 's brother 's boss 's bed is tired .
the bowl knows that your wife 's teacher 's friend 's boss 's dad 's fork is wrong .	the bowl scares your wife 's teacher 's friend 's boss 's dad 's fork is wrong .
the picture knows that your grandmother 's brother 's teacher 's grandmother 's husband 's car is lucky .	the picture talks to your grandmother 's brother 's teacher 's grandmother 's husband 's car is lucky .
the crayon thinks that my daughter 's cousin 's dentist 's toy is quiet .	the crayon talks to my daughter 's cousin 's dentist 's toy is quiet .
the window says that your daughter 's sister 's dentist 's doctor 's cousin 's teacher 's book is healthy .	the window talks to your daughter 's sister 's dentist 's doctor 's cousin 's teacher 's book is healthy .
the book thinks that your doctor 's teacher 's wife 's picture is lucky .	the book helps your doctor 's teacher 's wife 's picture is lucky .
the window says that my brother 's mother 's brother 's teacher 's wife 's grandmother 's book is angry .	the window scares my brother 's mother 's brother 's teacher 's wife 's grandmother 's book is angry .
the book thinks that my mother 's father 's mother 's teacher 's teacher 's wife 's plate is happy .	the book helps my mother 's father 's mother 's teacher 's teacher 's wife 's plate is happy .
the button says that my husband 's sister 's cousin 's friend 's wife 's window is friendly .	the button works with my husband 's sister 's cousin 's friend 's wife 's window is friendly .
the hat thinks that my cousin 's doctor 's dentist 's daughter 's wife 's grandmother 's shoe is sleepy .	the hat works with my cousin 's doctor 's dentist 's daughter 's wife 's grandmother 's shoe is sleepy .
the cup thinks that my doctor 's husband 's wife 's husband 's plate is quiet .	the cup helps my doctor 's husband 's wife 's husband 's plate is quiet .
the crayon knows that my sister 's brother 's grandmother 's cousin 's husband 's bowl is angry .	the crayon talks to my sister 's brother 's grandmother 's cousin 's husband 's bowl is angry .
the picture says that your cousin 's husband 's doctor 's mom 's mother 's spoon is helpful .	the picture works with your cousin 's husband 's doctor 's mom 's mother 's spoon is helpful .
the rocket knows that my mother 's daughter 's daughter 's teacher 's dentist 's mother 's hat is wrong .	the rocket scares my mother 's daughter 's daughter 's teacher 's dentist 's mother 's hat is wrong .
the rocket thinks that your sister 's dentist 's doctor 's wife 's ship is friendly .	the rocket helps your sister 's dentist 's doctor 's wife 's ship is friendly .
the hat knows that my daughter 's mom 's daughter 's friend 's dentist 's cousin 's toy is excited .	the hat scares my daughter 's mom 's daughter 's friend 's dentist 's cousin 's toy is excited .
the book thinks that my mother 's boss 's dad 's car is lucky .	the book talks to my mother 's boss 's dad 's car is lucky .
the ring knows that your husband 's son 's father 's grandmother 's window is nice .	the ring works with your husband 's son 's father 's grandmother 's window is nice .
the chair says that your dad 's husband 's cousin 's daughter 's friend 's wife 's picture is tall .	the chair works with your dad 's husband 's cousin 's daughter 's friend 's wife 's picture is tall .
the ring thinks that my grandmother 's wife 's wife 's dentist 's cousin 's father 's ring is bored .	the ring works with my grandmother 's wife 's wife 's dentist 's cousin 's father 's ring is bored .
the picture says that your daughter 's wife 's dad 's cup is tired .	the picture scares your daughter 's wife 's dad 's cup is tired .
the dish knows that your dentist 's brother 's doctor 's picture is hungry .	the dish works with your dentist 's brother 's doctor 's picture is hungry .
the shirt thinks that my grandmother 's cousin 's sister 's teacher 's wife 's sister 's doll is busy .	the shirt helps my grandmother 's cousin 's sister 's teacher 's wife 's sister 's doll is busy .
the car thinks that your grandmother 's doctor 's boss 's mom 's brother 's mother 's spoon is nice .	the car scares your grandmother 's doctor 's boss 's mom 's brother 's mother 's spoon is nice .
the plate thinks that my cousin 's sister 's brother 's dad 's father 's couch is important .	the plate works with my cousin 's sister 's brother 's dad 's father 's couch is important .
the rug thinks that your husband 's dad 's friend 's mirror is happy .	the rug works with your husband 's dad 's friend 's mirror is happy .
the bicycle says that your father 's friend 's husband 's friend 's cousin 's brother 's box is angry .	the bicycle talks to your father 's friend 's husband 's friend 's cousin 's brother 's box is angry .
the book knows that your father 's friend 's husband 's cousin 's car is gentle .	the book works with your father 's friend 's husband 's cousin 's car is gentle .
the cup thinks that your daughter 's dentist 's friend 's boss 's fork is healthy .	the cup scares your daughter 's dentist 's friend 's boss 's fork is healthy .
the car knows that your mom 's doctor 's sister 's teacher 's brother 's grandmother 's window is kind .	the car scares your mom 's doctor 's sister 's teacher 's brother 's grandmother 's window is kind .
the shirt knows that my daughter 's cousin 's wife 's dad 's boss 's dentist 's bicycle is nice .	the shirt talks to my daughter 's cousin 's wife 's dad 's boss 's dentist 's bicycle is nice .
the bottle thinks that my sister 's friend 's brother 's doctor 's dentist 's grandmother 's toy is tall .	the bottle helps my sister 's friend 's brother 's doctor 's dentist 's grandmother 's toy is tall .
the picture knows that my teacher 's husband 's grandmother 's car is clever .	the picture scares my teacher 's husband 's grandmother 's car is clever .
the bottle knows that my teacher 's mother 's doctor 's mom 's mom 's wife 's candle is upset .	the bottle helps my teacher 's mother 's doctor 's mom 's mom 's wife 's candle is upset .
the plate knows that my cousin 's mom 's brother 's wife 's doctor 's husband 's fork is surprised .	the plate helps my cousin 's mom 's brother 's wife 's doctor 's husband 's fork is surprised .
the shoe says that my grandmother 's dad 's teacher 's fork is happy .	the shoe works with my grandmother 's dad 's teacher 's fork is happy .
the car says that your doctor 's daughter 's wife 's father 's car is busy .	the car scares your doctor 's daughter 's wife 's father 's car is busy .
the car thinks that your son 's husband 's mother 's shoe is boring .	the car works with your son 's husband 's mother 's shoe is boring .
the bed knows that your teacher 's mother 's daughter 's boss 's book is important .	the bed scares your teacher 's mother 's daughter 's boss 's book is important .
the toy knows that my brother 's father 's mom 's doctor 's sister 's mother 's shirt is angry .	the toy talks to my brother 's father 's mom 's doctor 's sister 's mother 's shirt is angry .
the window knows that your dentist 's father 's teacher 's sister 's rocket is confused .	the window scares your dentist 's father 's teacher 's sister 's rocket is confused .
the chair knows that your grandmother 's cousin 's dentist 's sister 's bed is upset .	the chair scares your grandmother 's cousin 's dentist 's sister 's bed is upset .
the truck knows that your dad 's grandmother 's dad 's car is tired .	the truck helps your dad 's grandmother 's dad 's car is tired .
the bag knows that my mom 's teacher 's sister 's mother 's cousin 's car is angry .	the bag helps my mom 's teacher 's sister 's mother 's cousin 's car is angry .
the fork says that your brother 's brother 's dad 's friend 's bag is tired .	the fork works with your brother 's brother 's dad 's friend 's bag is tired .
the window knows that your cousin 's wife 's daughter 's doctor 's book is important .	the window talks to your cousin 's wife 's daughter 's doctor 's book is important .
the plane says that your brother 's dad 's doctor 's grandmother 's spoon is helpful .	the plane helps your brother 's dad 's doctor 's grandmother 's spoon is helpful .
the cup knows that your dentist 's sister 's sister 's father 's bowl is young .	the cup works with your dentist 's sister 's sister 's father 's bowl is young .
the ring says that your cousin 's mother 's grandmother 's button is gentle .	the ring talks to your cousin 's mother 's grandmother 's button is gentle .
the car thinks that your husband 's brother 's father 's husband 's dad 's rug is smart .	the car helps your husband 's brother 's father 's husband 's dad 's rug is smart .
the glass knows that my son 's dentist 's brother 's wife 's bicycle is important .	the glass scares my son 's dentist 's brother 's wife 's bicycle is important .
the window thinks that my husband 's brother 's father 's brother 's daughter 's picture is lucky .	the window scares my husband 's brother 's father 's brother 's daughter 's picture is lucky .
the couch says that my friend 's dentist 's friend 's grandmother 's mom 's boat is quiet .	the couch talks to my friend 's dentist 's friend 's grandmother 's mom 's boat is quiet .
the mirror says that my brother 's father 's brother 's cousin 's brother 's mother 's fork is busy .	the mirror works with my brother 's father 's brother 's cousin 's brother 's mother 's fork is busy .
the doll thinks that my mom 's son 's daughter 's dentist 's car is healthy .	the doll scares my mom 's son 's daughter 's dentist 's car is healthy .
the bowl knows that my husband 's teacher 's boss 's dad 's father 's fork is curious .	the bowl scares my husband 's teacher 's boss 's dad 's father 's fork is curious .
the window thinks that my daughter 's friend 's boss 's teacher 's dad 's cousin 's chair is angry .	the window helps my daughter 's friend 's boss 's teacher 's dad 's cousin 's chair is angry .
the window thinks that your father 's sister 's brother 's teacher 's dad 's husband 's spoon is tall .	the window scares your father 's sister 's brother 's teacher 's dad 's husband 's spoon is tall .
the spoon says that your cousin 's brother 's doctor 's toy is happy .	the spoon talks to your cousin 's brother 's doctor 's toy is happy .
the glass knows that your husband 's sister 's sister 's dad 's brother 's hat is young .	the glass scares your husband 's sister 's sister 's dad 's brother 's hat is young .
the book thinks that your son 's husband 's mom 's brother 's cousin 's dish is helpful .	the book works with your son 's husband 's mom 's brother 's cousin 's dish is helpful .
the boat thinks that my doctor 's wife 's daughter 's son 's brother 's fork is boring .	the boat works with my doctor 's wife 's daughter 's son 's brother 's fork is boring .
the spoon says that your grandmother 's grandmother 's sister 's toy is clever .	the spoon talks to your grandmother 's grandmother 's sister 's toy is clever .
the book says that my grandmother 's son 's doctor 's boss 's wife 's rug is confused .	the book helps my grandmother 's son 's doctor 's boss 's wife 's rug is confused .
the car knows that your teacher 's sister 's boss 's bag is excited .	the car works with your teacher 's sister 's boss 's bag is excited .
the car thinks that your teacher 's grandmother 's wife 's teacher 's sister 's couch is upset .	the car helps your teacher 's grandmother 's wife 's teacher 's sister 's couch is upset .
the cup thinks that my daughter 's grandmother 's doctor 's bowl is smart .	the cup works with my daughter 's grandmother 's doctor 's bowl is smart .
the car thinks that your grandmother 's father 's husband 's brother 's bowl is strong .	the car helps your grandmother 's father 's husband 's brother 's bowl is strong .
the plate thinks that your husband 's boss 's sister 's grandmother 's car is young .	the plate helps your husband 's boss 's sister 's grandmother 's car is young .
the rug says that your husband 's wife 's cousin 's father 's wife 's spoon is angry .	the rug helps your husband 's wife 's cousin 's father 's wife 's spoon is angry .
the chair knows that your dad 's husband 's brother 's wife 's daughter 's sister 's car is quiet .	the chair scares your dad 's husband 's brother 's wife 's daughter 's sister 's car is quiet .
the bicycle thinks that my husband 's son 's brother 's daughter 's son 's chair is confused .	the bicycle works with my husband 's son 's brother 's daughter 's son 's chair is confused .
the plate thinks that your sister 's sister 's husband 's father 's boat is kind .	the plate scares your sister 's sister 's husband 's father 's boat is kind .
the cup thinks that my boss 's grandmother 's husband 's button is helpful .	the cup works with my boss 's grandmother 's husband 's button is helpful .
the hat thinks that your husband 's friend 's sister 's grandmother 's bag is hungry .	the hat scares your husband 's friend 's sister 's grandmother 's bag is hungry .
the ship knows that my husband 's dad 's wife 's teacher 's brother 's plate is kind .	the ship works with my husband 's dad 's wife 's teacher 's brother 's plate is kind .
the hat knows that your teacher 's daughter 's dentist 's son 's teacher 's grandmother 's fork is sleepy .	the hat scares your teacher 's daughter 's dentist 's son 's teacher 's grandmother 's fork is sleepy .
the bed says that my brother 's doctor 's friend 's father 's doctor 's plane is smart .	the bed works with my brother 's doctor 's friend 's father 's doctor 's plane is smart .
the book says that my husband 's mom 's boss 's plate is young .	the book works with my husband 's mom 's boss 's plate is young .
the hat knows that my boss 's son 's boss 's candle is excited .	the hat scares my boss 's son 's boss 's candle is excited .
the glass knows that my boss 's wife 's boss 's doctor 's candle is tired .	the glass scares my boss 's wife 's boss 's doctor 's candle is tired .
the toy knows that my cousin 's cousin 's friend 's rocket is smart .	the toy talks to my cousin 's cousin 's friend 's rocket is smart .
the shoe knows that your teacher 's dentist 's friend 's cousin 's brother 's grandmother 's picture is tall .	the shoe works with your teacher 's dentist 's friend 's cousin 's brother 's grandmother 's picture is tall .
the toy says that your brother 's grandmother 's dentist 's cousin 's friend 's picture is young .	the toy talks to your brother 's grandmother 's dentist 's cousin 's friend 's picture is young .
the cup knows that your boss 's doctor 's wife 's book is sleepy .	the cup helps your boss 's doctor 's wife 's book is sleepy .
the hat knows that my mom 's grandmother 's dad 's sister 's wife 's teacher 's boat is tall .	the hat talks to my mom 's grandmother 's dad 's sister 's wife 's teacher 's boat is tall .
the fork thinks that your brother 's friend 's mom 's sister 's hat is friendly .	the fork talks to your brother 's friend 's mom 's sister 's hat is friendly .
the door knows that my husband 's dentist 's mom 's father 's mother 's brother 's shoe is important .	the door scares my husband 's dentist 's mom 's father 's mother 's brother 's shoe is important .
the boat knows that my son 's sister 's mom 's boss 's friend 's candle is careful .	the boat scares my son 's sister 's mom 's boss 's friend 's candle is careful .
the spoon knows that my friend 's cousin 's daughter 's boss 's mom 's truck is gentle .	the spoon helps my friend 's cousin 's daughter 's boss 's mom 's truck is gentle .
the bag thinks that my doctor 's mother 's boss 's cousin 's bag is kind .	the bag talks to my doctor 's mother 's boss 's cousin 's bag is kind .
the door thinks that my husband 's daughter 's teacher 's doctor 's doctor 's crayon is surprised .	the door talks to my husband 's daughter 's teacher 's doctor 's doctor 's crayon is surprised .
the plane knows that your doctor 's son 's brother 's grandmother 's car is upset .	the plane helps your doctor 's son 's brother 's grandmother 's car is upset .
the shoe thinks that your boss 's cousin 's doctor 's teacher 's brother 's doctor 's book is lucky .	the shoe helps your boss 's cousin 's doctor 's teacher 's brother 's doctor 's book is lucky .
the book knows that your mother 's daughter 's brother 's mom 's ship is upset .	the book works with your mother 's daughter 's brother 's mom 's ship is upset .
the rocket thinks that your father 's son 's dad 's cousin 's teacher 's teacher 's hat is strong .	the rocket helps your father 's son 's dad 's cousin 's teacher 's teacher 's hat is strong .
the ring says that your cousin 's sister 's boss 's teacher 's dad 's crayon is sleepy .	the ring scares your cousin 's sister 's boss 's teacher 's dad 's crayon is sleepy .
the bed knows that your teacher 's brother 's son 's grandmother 's bicycle is clever .	the bed scares your teacher 's brother 's son 's grandmother 's bicycle is clever .
the bowl thinks that your cousin 's grandmother 's friend 's doll is tall .	the bowl helps your cousin 's grandmother 's friend 's doll is tall .
the shoe thinks that your father 's dentist 's husband 's brother 's father 's plate is upset .	the shoe scares your father 's dentist 's husband 's brother 's father 's plate is upset .
the shirt knows that your grandmother 's daughter 's dad 's grandmother 's brother 's friend 's picture is careful .	the shirt helps your grandmother 's daughter 's dad 's grandmother 's brother 's friend 's picture is careful .
the book thinks that your daughter 's son 's friend 's grandmother 's mother 's husband 's dish is bored .	the book helps your daughter 's son 's friend 's grandmother 's mother 's husband 's dish is bored .
the ring thinks that your doctor 's doctor 's doctor 's hat is tired .	the ring talks to your doctor 's doctor 's doctor 's hat is tired .
the shoe thinks that my boss 's son 's cousin 's sister 's father 's boat is young .	the shoe works with my boss 's son 's cousin 's sister 's father 's boat is young .
the mirror knows that your friend 's dentist 's cousin 's mother 's teacher 's boat is wrong .	the mirror works with your friend 's dentist 's cousin 's mother 's teacher 's boat is wrong .
the bicycle knows that my dentist 's dad 's cousin 's dentist 's sister 's shoe is boring .	the bicycle helps my dentist 's dad 's cousin 's dentist 's sister 's shoe is boring .
the rocket says that my teacher 's boss 's sister 's mom 's brother 's glass is bored .	the rocket talks to my teacher 's boss 's sister 's mom 's brother 's glass is bored .
the picture knows that my mom 's father 's mother 's father 's mother 's picture is confused .	the picture scares my mom 's father 's mother 's father 's mother 's picture is confused .
the bicycle knows that my teacher 's teacher 's teacher 's teacher 's wife 's dentist 's candle is boring .	the bicycle scares my teacher 's teacher 's teacher 's teacher 's wife 's dentist 's candle is boring .
the fork knows that my husband 's mother 's teacher 's husband 's fork is kind .	the fork talks to my husband 's mother 's teacher 's husband 's fork is kind .
the candle thinks that my friend 's father 's grandmother 's doll is excited .	the candle scares my friend 's father 's grandmother 's doll is excited .
the book says that your dentist 's sister 's mother 's sister 's father 's cousin 's cup is young .	the book scares your dentist 's sister 's mother 's sister 's father 's cousin 's cup is young .
the candle knows that your husband 's mom 's grandmother 's grandmother 's mother 's window is busy .	the candle helps your husband 's mom 's grandmother 's grandmother 's mother 's window is busy .
the glass thinks that my boss 's boss 's cousin 's son 's toy is bored .	the glass helps my boss 's boss 's cousin 's son 's toy is bored .
the chair thinks that your boss 's grandmother 's dad 's grandmother 's truck is gentle .	the chair scares your boss 's grandmother 's dad 's grandmother 's truck is gentle .
the button knows that your dentist 's friend 's mom 's mother 's book is upset .	the button scares your dentist 's friend 's mom 's mother 's book is upset .
the cup knows that your son 's friend 's son 's boss 's husband 's bag is young .	the cup helps your son 's friend 's son 's boss 's husband 's bag is young .
the bag thinks that your wife 's teacher 's son 's boss 's son 's book is tired .	the bag talks to your wife 's teacher 's son 's boss 's son 's book is tired .
the candle knows that your wife 's friend 's mom 's doctor 's bed is tall .	the candle talks to your wife 's friend 's mom 's doctor 's bed is tall .
the truck knows that your boss 's mom 's daughter 's wife 's boss 's doctor 's bowl is confused .	the truck works with your boss 's mom 's daughter 's wife 's boss 's doctor 's bowl is confused .
the rocket thinks that your dad 's boss 's mother 's brother 's friend 's bag is lucky .	the rocket helps your dad 's boss 's mother 's brother 's friend 's bag is lucky .
the candle knows that your cousin 's doctor 's grandmother 's dentist 's rocket is young .	the candle talks to your cousin 's doctor 's grandmother 's dentist 's rocket is young .
the chair thinks that my husband 's teacher 's friend 's son 's wife 's father 's hat is strong .	the chair helps my husband 's teacher 's friend 's son 's wife 's father 's hat is strong .
the mirror thinks that my dentist 's sister 's friend 's dad 's doctor 's fork is excited .	the mirror works with my dentist 's sister 's friend 's dad 's doctor 's fork is excited .
the ship thinks that your mom 's grandmother 's cousin 's boss 's doctor 's dad 's book is friendly .	the ship helps your mom 's grandmother 's cousin 's boss 's doctor 's dad 's book is friendly .
the couch thinks that my mother 's mom 's father 's daughter 's son 's daughter 's ship is young .	the couch helps my mother 's mom 's father 's daughter 's son 's daughter 's ship is young .
the toy thinks that my brother 's father 's boss 's toy is sleepy .	the toy scares my brother 's father 's boss 's toy is sleepy .
the shirt says that your cousin 's dad 's grandmother 's sister 's chair is healthy .	the shirt talks to your cousin 's dad 's grandmother 's sister 's chair is healthy .
the button knows that my grandmother 's friend 's boss 's sister 's shoe is bored .	the button talks to my grandmother 's friend 's boss 's sister 's shoe is bored .
the doll knows that my sister 's friend 's sister 's book is important .	the doll talks to my sister 's friend 's sister 's book is important .
the bicycle knows that my dentist 's dentist 's doctor 's boss 's rug is curious .	the bicycle helps my dentist 's dentist 's doctor 's boss 's rug is curious .
the door knows that your brother 's father 's mom 's doctor 's doll is strong .	the door works with your brother 's father 's mom 's doctor 's doll is strong .
the bottle knows that your teacher 's doctor 's teacher 's mom 's son 's mother 's doll is tall .	the bottle scares your teacher 's doctor 's teacher 's mom 's son 's mother 's doll is tall .
the mirror knows that your husband 's boss 's dad 's bottle is tired .	the mirror talks to your husband 's boss 's dad 's bottle is tired .
the box thinks that your doctor 's friend 's father 's couch is sleepy .	the box works with your doctor 's friend 's father 's couch is sleepy .
the dish thinks that your brother 's friend 's daughter 's son 's shirt is wrong .	the dish works with your brother 's friend 's daughter 's son 's shirt is wrong .
the car knows that your daughter 's father 's daughter 's husband 's book is upset .	the car scares your daughter 's father 's daughter 's husband 's book is upset .
the toy says that my husband 's grandmother 's husband 's glass is confused .	the toy talks to my husband 's grandmother 's husband 's glass is confused .
the bottle knows that my wife 's daughter 's friend 's cousin 's boat is important .	the bottle helps my wife 's daughter 's friend 's cousin 's boat is important .
the boat knows that my daughter 's husband 's doctor 's grandmother 's dentist 's truck is young .	the boat works with my daughter 's husband 's doctor 's grandmother 's dentist 's truck is young .
the button says that my teacher 's daughter 's daughter 's sister 's dad 's brother 's cup is busy .	the button scares my teacher 's daughter 's daughter 's sister 's dad 's brother 's cup is busy .
the crayon says that my cousin 's teacher 's wife 's grandmother 's bottle is gentle .	the crayon talks to my cousin 's teacher 's wife 's grandmother 's bottle is gentle .
the ring thinks that your dad 's boss 's son 's ship is quiet .	the ring scares your dad 's boss 's son 's ship is quiet .
the book knows that my mother 's mother 's doctor 's son 's boss 's boss 's shoe is confused .	the book scares my mother 's mother 's doctor 's son 's boss 's boss 's shoe is confused .
the dish knows that my dentist 's friend 's dad 's mom 's bag is kind .	the dish talks to my dentist 's friend 's dad 's mom 's bag is kind .
the box says that your sister 's sister 's doctor 's window is curious .	the box talks to your sister 's sister 's doctor 's window is curious .
the car says that my friend 's dad 's cousin 's teacher 's cousin 's cousin 's car is helpful .	the car works with my friend 's dad 's cousin 's teacher 's cousin 's cousin 's car is helpful .
the box says that my sister 's son 's cousin 's father 's candle is sleepy .	the box works with my sister 's son 's cousin 's father 's candle is sleepy .
the mirror thinks that my father 's father 's dentist 's dentist 's father 's doctor 's ring is hungry .	the mirror scares my father 's father 's dentist 's dentist 's father 's doctor 's ring is hungry .
the bicycle knows that your mom 's daughter 's mother 's mirror is boring .	the bicycle scares your mom 's daughter 's mother 's mirror is boring .
the plane knows that your dentist 's father 's dentist 's son 's crayon is healthy .	the plane works with your dentist 's father 's dentist 's son 's crayon is healthy .
the car says that my teacher 's son 's daughter 's boss 's grandmother 's crayon is kind .	the car helps my teacher 's son 's daughter 's boss 's grandmother 's crayon is kind .
the box thinks that your teacher 's husband 's teacher 's brother 's mother 's friend 's bottle is sleepy .	the box scares your teacher 's husband 's teacher 's brother 's mother 's friend 's bottle is sleepy .
the crayon thinks that your mom 's wife 's teacher 's sister 's candle is nice .	the crayon scares your mom 's wife 's teacher 's sister 's candle is nice .
the shoe thinks that my grandmother 's sister 's mom 's wife 's cup is wrong .	the shoe scares my grandmother 's sister 's mom 's wife 's cup is wrong .
the doll knows that my mother 's husband 's dad 's wife 's sister 's bed is busy .	the doll works with my mother 's husband 's dad 's wife 's sister 's bed is busy .
the bowl knows that your boss 's daughter 's boss 's truck is bored .	the bowl works with your boss 's daughter 's boss 's truck is bored .
the ring knows that my teacher 's daughter 's son 's husband 's car is quiet .	the ring works with my teacher 's daughter 's son 's husband 's car is quiet .
the bottle knows that your husband 's dentist 's teacher 's teacher 's window is lucky .	the bottle talks to your husband 's dentist 's teacher 's teacher 's window is lucky .
the book knows that your sister 's wife 's doctor 's mom 's boss 's son 's fork is strong .	the book works with your sister 's wife 's doctor 's mom 's boss 's son 's fork is strong .
the boat thinks that my dad 's daughter 's boss 's sister 's cousin 's shoe is helpful .	the boat scares my dad 's daughter 's boss 's sister 's cousin 's shoe is helpful .
the boat says that your teacher 's dentist 's son 's wife 's doctor 's crayon is helpful .	the boat scares your teacher 's dentist 's son 's wife 's doctor 's crayon is helpful .
the truck says that your doctor 's mom 's dentist 's grandmother 's rocket is sleepy .	the truck works with your doctor 's mom 's dentist 's grandmother 's rocket is sleepy .
the truck knows that my mom 's friend 's cousin 's mother 's sister 's sister 's mirror is smart .	the truck scares my mom 's friend 's cousin 's mother 's sister 's sister 's mirror is smart .
the window knows that your dad 's husband 's doctor 's son 's teacher 's bottle is lucky .	the window helps your dad 's husband 's doctor 's son 's teacher 's bottle is lucky .
the plane says that your friend 's wife 's father 's grandmother 's teacher 's brother 's shirt is young .	the plane helps your friend 's wife 's father 's grandmother 's teacher 's brother 's shirt is young .
the plate says that your boss 's friend 's teacher 's plane is hungry .	the plate works with your boss 's friend 's teacher 's plane is hungry .
the fork thinks that your dentist 's mother 's wife 's plane is sleepy .	the fork works with your dentist 's mother 's wife 's plane is sleepy .
the book thinks that my dad 's dad 's dentist 's dentist 's mother 's son 's fork is confused .	the book scares my dad 's dad 's dentist 's dentist 's mother 's son 's fork is confused .
the window thinks that your grandmother 's father 's husband 's mom 's mirror is young .	the window helps your grandmother 's father 's husband 's mom 's mirror is young .
the book thinks that my mom 's doctor 's boss 's doctor 's sister 's rug is happy .	the book talks to my mom 's doctor 's boss 's doctor 's sister 's rug is happy .
the glass thinks that my father 's daughter 's friend 's boss 's box is boring .	the glass talks to my father 's daughter 's friend 's boss 's box is boring .
the button thinks that your dentist 's father 's sister 's glass is smart .	the button helps your dentist 's father 's sister 's glass is smart .
the plane thinks that my dentist 's friend 's dentist 's sister 's mom 's boss 's bowl is hungry .	the plane scares my dentist 's friend 's dentist 's sister 's mom 's boss 's bowl is hungry .
the chair says that my teacher 's dad 's mom 's dad 's teacher 's mother 's car is healthy .	the chair works with my teacher 's dad 's mom 's dad 's teacher 's mother 's car is healthy .
the plane thinks that my grandmother 's son 's friend 's daughter 's candle is important .	the plane works with my grandmother 's son 's friend 's daughter 's candle is important .
the book says that your doctor 's wife 's sister 's teacher 's boss 's window is sleepy .	the book scares your doctor 's wife 's sister 's teacher 's boss 's window is sleepy .
the chair thinks that my friend 's grandmother 's teacher 's friend 's son 's bag is clever .	the chair scares my friend 's grandmother 's teacher 's friend 's son 's bag is clever .
the mirror knows that my friend 's dentist 's cousin 's dish is tired .	the mirror works with my friend 's dentist 's cousin 's dish is tired .
the car knows that my son 's brother 's doctor 's son 's box is strong .	the car works with my son 's brother 's doctor 's son 's box is strong .
the bowl knows that my cousin 's father 's mom 's bag is happy .	the bowl scares my cousin 's father 's mom 's bag is happy .
the window thinks that your boss 's son 's husband 's husband 's mother 's cousin 's glass is nice .	the window helps your boss 's son 's husband 's husband 's mother 's cousin 's glass is nice .
the box says that your daughter 's doctor 's teacher 's son 's dentist 's door is confused .	the box helps your daughter 's doctor 's teacher 's son 's dentist 's door is confused .
the book says that my husband 's cousin 's friend 's cousin 's ring is helpful .	the book scares my husband 's cousin 's friend 's cousin 's ring is helpful .
the book says that your father 's grandmother 's cousin 's dish is quiet .	the book scares your father 's grandmother 's cousin 's dish is quiet .
the box says that my teacher 's wife 's mom 's picture is boring .	the box scares my teacher 's wife 's mom 's picture is boring .
the truck says that your dentist 's wife 's friend 's boss 's teacher 's crayon is angry .	the truck works with your dentist 's wife 's friend 's boss 's teacher 's crayon is angry .
the doll says that my dentist 's dad 's wife 's boss 's rocket is tired .	the doll helps my dentist 's dad 's wife 's boss 's rocket is tired .
the bottle says that your father 's son 's cousin 's father 's dentist 's car is strong .	the bottle scares your father 's son 's cousin 's father 's dentist 's car is strong .
the box says that my son 's teacher 's dad 's sister 's book is kind .	the box works with my son 's teacher 's dad 's sister 's book is kind .
the bowl knows that my cousin 's grandmother 's son 's son 's doll is excited .	the bowl scares my cousin 's grandmother 's son 's son 's doll is excited .
the spoon knows that my mother 's mom 's teacher 's doctor 's ring is careful .	the spoon scares my mother 's mom 's teacher 's doctor 's ring is careful .
the ship says that my boss 's father 's teacher 's bicycle is hungry .	the ship talks to my boss 's father 's teacher 's bicycle is hungry .
the window knows that your friend 's doctor 's dentist 's dad 's mom 's box is lucky .	the window works with your friend 's doctor 's dentist 's dad 's mom 's box is lucky .
the candle says that your daughter 's mom 's doctor 's mom 's doctor 's dish is curious .	the candle talks to your daughter 's mom 's doctor 's mom 's doctor 's dish is curious .
the ship says that your dad 's father 's father 's couch is bored .	the ship works with your dad 's father 's father 's couch is bored .
the rug knows that your daughter 's son 's dad 's hat is strong .	the rug works with your daughter 's son 's dad 's hat is strong .
the glass knows that my cousin 's grandmother 's husband 's father 's truck is curious .	the glass scares my cousin 's grandmother 's husband 's father 's truck is curious .
the book knows that my doctor 's friend 's dentist 's husband 's mom 's dentist 's book is upset .	the book works with my doctor 's friend 's dentist 's husband 's mom 's dentist 's book is upset .
the toy thinks that my son 's grandmother 's father 's grandmother 's book is smart .	the toy scares my son 's grandmother 's father 's grandmother 's book is smart .
the bicycle says that my brother 's son 's mom 's shirt is quiet .	the bicycle works with my brother 's son 's mom 's shirt is quiet .
the chair knows that my sister 's daughter 's teacher 's dad 's dad 's mother 's mirror is quiet .	the chair works with my sister 's daughter 's teacher 's dad 's dad 's mother 's mirror is quiet .
the cup says that your boss 's grandmother 's husband 's shoe is tired .	the cup scares your boss 's grandmother 's husband 's shoe is tired .
the mirror knows that my brother 's father 's brother 's brother 's rocket is angry .	the mirror helps my brother 's father 's brother 's brother 's rocket is angry .
the dish thinks that your cousin 's wife 's dad 's book is sleepy .	the dish talks to your cousin 's wife 's dad 's book is sleepy .
the fork thinks that your sister 's cousin 's son 's dish is kind .	the fork works with your sister 's cousin 's son 's dish is kind .
the bowl knows that my grandmother 's mom 's son 's ship is hungry .	the bowl scares my grandmother 's mom 's son 's ship is hungry .
the bag says that your wife 's wife 's doctor 's daughter 's boss 's car is surprised .	the bag works with your wife 's wife 's doctor 's daughter 's boss 's car is surprised .
the doll thinks that my son 's mother 's father 's teacher 's grandmother 's grandmother 's spoon is confused .	the doll helps my son 's mother 's father 's teacher 's grandmother 's grandmother 's spoon is confused .
the boat says that my mom 's sister 's brother 's doctor 's teacher 's box is nice .	the boat works with my mom 's sister 's brother 's doctor 's teacher 's box is nice .
the window thinks that my son 's brother 's brother 's sister 's shoe is bored .	the window helps my son 's brother 's brother 's sister 's shoe is bored .
the book says that my wife 's son 's wife 's doctor 's son 's father 's button is careful .	the book scares my wife 's son 's wife 's doctor 's son 's father 's button is careful .
the picture says that my brother 's father 's dad 's father 's button is lucky .	the picture works with my brother 's father 's dad 's father 's button is lucky .
the plate knows that your father 's son 's teacher 's father 's dad 's boss 's book is angry .	the plate talks to your father 's son 's teacher 's father 's dad 's boss 's book is angry .
the rocket knows that your sister 's father 's daughter 's dentist 's father 's son 's hat is tired .	the rocket talks to your sister 's father 's daughter 's dentist 's father 's son 's hat is tired .
the couch thinks that your husband 's teacher 's boss 's brother 's mom 's couch is happy .	the couch talks to your husband 's teacher 's boss 's brother 's mom 's couch is happy .
the mirror says that my mother 's friend 's dad 's brother 's teacher 's picture is lucky .	the mirror works with my mother 's friend 's dad 's brother 's teacher 's picture is lucky .
the book knows that my sister 's brother 's sister 's cousin 's ring is important .	the book helps my sister 's brother 's sister 's cousin 's ring is important .
the rocket knows that your teacher 's dad 's father 's book is gentle .	the rocket talks to your teacher 's dad 's father 's book is gentle .
the plate knows that your mom 's cousin 's sister 's teacher 's sister 's grandmother 's shoe is quiet .	the plate scares your mom 's cousin 's sister 's teacher 's sister 's grandmother 's shoe is quiet .
the car knows that my daughter 's doctor 's mother 's doctor 's grandmother 's chair is kind .	the car talks to my daughter 's doctor 's mother 's doctor 's grandmother 's chair is kind .
the doll says that your cousin 's dentist 's grandmother 's husband 's ring is bored .	the doll scares your cousin 's dentist 's grandmother 's husband 's ring is bored .
the car thinks that my son 's teacher 's boss 's mother 's brother 's mom 's dish is quiet .	the car scares my son 's teacher 's boss 's mother 's brother 's mom 's dish is quiet .
the bed thinks that my boss 's grandmother 's mother 's mother 's son 's daughter 's button is hungry .	the bed scares my boss 's grandmother 's mother 's mother 's son 's daughter 's button is hungry .
the plate thinks that my mom 's father 's mother 's door is upset .	the plate talks to my mom 's father 's mother 's door is upset .
the toy says that your mom 's mom 's doctor 's doctor 's wife 's doctor 's window is wrong .	the toy helps your mom 's mom 's doctor 's doctor 's wife 's doctor 's window is wrong .
the candle knows that my cousin 's teacher 's father 's daughter 's dad 's father 's bowl is busy .	the candle works with my cousin 's teacher 's father 's daughter 's dad 's father 's bowl is busy .
the bag thinks that my mom 's mother 's husband 's sister 's teacher 's ship is happy .	the bag works with my mom 's mother 's husband 's sister 's teacher 's ship is happy .
the fork knows that my wife 's boss 's husband 's cousin 's mother 's rocket is lucky .	the fork helps my wife 's boss 's husband 's cousin 's mother 's rocket is lucky .
the picture says that my father 's mom 's wife 's father 's book is boring .	the picture talks to my father 's mom 's wife 's father 's book is boring .
the car thinks that my daughter 's boss 's grandmother 's brother 's daughter 's dentist 's book is helpful .	the car helps my daughter 's boss 's grandmother 's brother 's daughter 's dentist 's book is helpful .
the spoon says that my father 's cousin 's mom 's friend 's husband 's mom 's bicycle is confused .	the spoon works with my father 's cousin 's mom 's friend 's husband 's mom 's bicycle is confused .
the plate thinks that your dad 's dad 's dad 's mirror is careful .	the plate helps your dad 's dad 's dad 's mirror is careful .
the book thinks that your cousin 's dad 's mom 's plate is tall .	the book helps your cousin 's dad 's mom 's plate is tall .
the shirt says that my dad 's brother 's teacher 's grandmother 's daughter 's rug is hungry .	the shirt works with my dad 's brother 's teacher 's grandmother 's daughter 's rug is hungry .
the fork says that my sister 's dentist 's mom 's grandmother 's crayon is tall .	the fork helps my sister 's dentist 's mom 's grandmother 's crayon is tall .
the box thinks that your boss 's wife 's daughter 's doctor 's mirror is tall .	the box scares your boss 's wife 's daughter 's doctor 's mirror is tall .
the box thinks that my dad 's mother 's sister 's mom 's mother 's plate is hungry .	the box scares my dad 's mother 's sister 's mom 's mother 's plate is hungry .
the bed says that your dad 's mother 's cousin 's wife 's dentist 's mom 's car is smart .	the bed talks to your dad 's mother 's cousin 's wife 's dentist 's mom 's car is smart .
the book knows that your mom 's doctor 's boss 's dad 's husband 's father 's plate is sleepy .	the book scares your mom 's doctor 's boss 's dad 's husband 's father 's plate is sleepy .
the truck says that my father 's boss 's father 's son 's teacher 's daughter 's bag is helpful .	the truck talks to my father 's boss 's father 's son 's teacher 's daughter 's bag is helpful .
the shirt knows that my daughter 's wife 's wife 's ship is bored .	the shirt works with my daughter 's wife 's wife 's ship is bored .
the door knows that my cousin 's brother 's mother 's husband 's ring is sleepy .	the door helps my cousin 's brother 's mother 's husband 's ring is sleepy .
the car knows that my daughter 's teacher 's boss 's button is kind .	the car scares my daughter 's teacher 's boss 's button is kind .
the boat says that my mom 's teacher 's dentist 's wife 's toy is important .	the boat talks to my mom 's teacher 's dentist 's wife 's toy is important .
the picture thinks that your cousin 's dentist 's doctor 's doctor 's ring is healthy .	the picture talks to your cousin 's dentist 's doctor 's doctor 's ring is healthy .
the window thinks that your mom 's dad 's mom 's picture is important .	the window scares your mom 's dad 's mom 's picture is important .
the box says that your teacher 's husband 's boss 's grandmother 's plate is clever .	the box helps your teacher 's husband 's boss 's grandmother 's plate is clever .
the rocket knows that your wife 's grandmother 's son 's dad 's doctor 's dad 's plane is happy .	the rocket talks to your wife 's grandmother 's son 's dad 's doctor 's dad 's plane is happy .
the crayon says that your friend 's wife 's wife 's boss 's wife 's mother 's couch is helpful .	the crayon helps your friend 's wife 's wife 's boss 's wife 's mother 's couch is helpful .
the cup says that my friend 's brother 's friend 's father 's chair is clever .	the cup helps my friend 's brother 's friend 's father 's chair is clever .
the bicycle thinks that my grandmother 's doctor 's friend 's mom 's daughter 's bicycle is surprised .	the bicycle works with my grandmother 's doctor 's friend 's mom 's daughter 's bicycle is surprised .
the bag knows that my sister 's husband 's son 's mother 's rocket is young .	the bag scares my sister 's husband 's son 's mother 's rocket is young .
the book says that your dad 's mom 's daughter 's mother 's door is boring .	the book helps your dad 's mom 's daughter 's mother 's door is boring .
the shirt says that your grandmother 's sister 's mother 's bag is tired .	the shirt works with your grandmother 's sister 's mother 's bag is tired .
the box says that my boss 's dentist 's wife 's door is lucky .	the box talks to my boss 's dentist 's wife 's door is lucky .
the shoe knows that my boss 's dad 's cousin 's friend 's teacher 's toy is upset .	the shoe scares my boss 's dad 's cousin 's friend 's teacher 's toy is upset .
the window says that my teacher 's sister 's teacher 's brother 's hat is confused .	the window scares my teacher 's sister 's teacher 's brother 's hat is confused .
the shirt thinks that my boss 's dad 's teacher 's crayon is wrong .	the shirt works with my boss 's dad 's teacher 's crayon is wrong .
the plate thinks that your son 's daughter 's grandmother 's wife 's glass is wrong .	the plate works with your son 's daughter 's grandmother 's wife 's glass is wrong .
the fork thinks that my wife 's husband 's dad 's daughter 's dad 's truck is lucky .	the fork works with my wife 's husband 's dad 's daughter 's dad 's truck is lucky .
the ring knows that my wife 's husband 's husband 's grandmother 's rug is tired .	the ring works with my wife 's husband 's husband 's grandmother 's rug is tired .
the fork knows that my doctor 's cousin 's dad 's couch is angry .	the fork works with my doctor 's cousin 's dad 's couch is angry .
the ship says that my sister 's boss 's teacher 's daughter 's mirror is wrong .	the ship scares my sister 's boss 's teacher 's daughter 's mirror is wrong .
the cup thinks that your grandmother 's daughter 's wife 's cousin 's sister 's wife 's picture is lucky .	the cup talks to your grandmother 's daughter 's wife 's cousin 's sister 's wife 's picture is lucky .
the glass knows that your boss 's mother 's friend 's father 's plane is lucky .	the glass works with your boss 's mother 's friend 's father 's plane is lucky .
the chair thinks that your teacher 's husband 's friend 's wife 's book is quiet .	the chair talks to your teacher 's husband 's friend 's wife 's book is quiet .
the window thinks that my son 's father 's cousin 's sister 's husband 's father 's bowl is angry .	the window helps my son 's father 's cousin 's sister 's husband 's father 's bowl is angry .
the rocket says that my father 's mom 's teacher 's son 's book is important .	the rocket helps my father 's mom 's teacher 's son 's book is important .
the bowl says that your mom 's wife 's wife 's mother 's mirror is important .	the bowl talks to your mom 's wife 's wife 's mother 's mirror is important .
the couch knows that your daughter 's dad 's brother 's doctor 's daughter 's ship is kind .	the couch works with your daughter 's dad 's brother 's doctor 's daughter 's ship is kind .
the doll says that your mom 's grandmother 's wife 's daughter 's doctor 's glass is confused .	the doll helps your mom 's grandmother 's wife 's daughter 's doctor 's glass is confused .
the car knows that my boss 's mother 's mother 's daughter 's mom 's boss 's candle is helpful .	the car works with my boss 's mother 's mother 's daughter 's mom 's boss 's candle is helpful .
the rocket knows that your dentist 's mom 's grandmother 's brother 's teacher 's boss 's truck is helpful .	the rocket works with your dentist 's mom 's grandmother 's brother 's teacher 's boss 's truck is helpful .
the window thinks that my brother 's daughter 's sister 's boat is friendly .	the window works with my brother 's daughter 's sister 's boat is friendly .
the hat says that your cousin 's teacher 's teacher 's sister 's brother 's bed is lucky .	the hat talks to your cousin 's teacher 's teacher 's sister 's brother 's bed is lucky .
the bag knows that my dad 's teacher 's sister 's daughter 's car is wrong .	the bag talks to my dad 's teacher 's sister 's daughter 's car is wrong .
the truck knows that your dentist 's daughter 's father 's teacher 's teacher 's grandmother 's picture is helpful .	the truck helps your dentist 's daughter 's father 's teacher 's teacher 's grandmother 's picture is helpful .
the ring says that my sister 's doctor 's husband 's doctor 's window is excited .	the ring works with my sister 's doctor 's husband 's doctor 's window is excited .
the hat says that your sister 's mother 's doctor 's bed is excited .	the hat helps your sister 's mother 's doctor 's bed is excited .
the boat says that your father 's son 's father 's crayon is busy .	the boat scares your father 's son 's father 's crayon is busy .
the rug thinks that your teacher 's friend 's daughter 's friend 's grandmother 's car is nice .	the rug works with your teacher 's friend 's daughter 's friend 's grandmother 's car is nice .
the bowl thinks that your sister 's teacher 's dad 's doll is bored .	the bowl helps your sister 's teacher 's dad 's doll is bored .
the shoe knows that my boss 's teacher 's mother 's boss 's mother 's picture is surprised .	the shoe helps my boss 's teacher 's mother 's boss 's mother 's picture is surprised .
the bicycle knows that your wife 's teacher 's dad 's grandmother 's chair is confused .	the bicycle works with your wife 's teacher 's dad 's grandmother 's chair is confused .
the bicycle knows that my sister 's wife 's cousin 's daughter 's car is tall .	the bicycle scares my sister 's wife 's cousin 's daughter 's car is tall .
the spoon thinks that my son 's son 's dad 's doctor 's doll is lucky .	the spoon works with my son 's son 's dad 's doctor 's doll is lucky .
the shirt thinks that my dentist 's grandmother 's teacher 's grandmother 's mother 's grandmother 's plane is angry .	the shirt talks to my dentist 's grandmother 's teacher 's grandmother 's mother 's grandmother 's plane is angry .
the door knows that your father 's mother 's daughter 's boss 's mom 's boss 's bottle is busy .	the door helps your father 's mother 's daughter 's boss 's mom 's boss 's bottle is busy .
the picture says that your mom 's cousin 's mother 's dentist 's bed is confused .	the picture scares your mom 's cousin 's mother 's dentist 's bed is confused .
the plate says that my cousin 's boss 's father 's son 's daughter 's husband 's fork is sleepy .	the plate scares my cousin 's boss 's father 's son 's daughter 's husband 's fork is sleepy .
the door says that your friend 's grandmother 's sister 's car is confused .	the door helps your friend 's grandmother 's sister 's car is confused .
the bowl knows that my dentist 's brother 's friend 's teacher 's mom 's truck is young .	the bowl helps my dentist 's brother 's friend 's teacher 's mom 's truck is young .
the bed says that my friend 's brother 's mother 's mother 's cousin 's fork is nice .	the bed works with my friend 's brother 's mother 's mother 's cousin 's fork is nice .
the chair says that your doctor 's doctor 's dad 's son 's brother 's father 's plane is important .	the chair talks to your doctor 's doctor 's dad 's son 's brother 's father 's plane is important .
the rocket thinks that your wife 's teacher 's daughter 's doctor 's doctor 's dad 's bottle is healthy .	the rocket scares your wife 's teacher 's daughter 's doctor 's doctor 's dad 's bottle is healthy .
the picture thinks that my mom 's dentist 's dad 's ship is smart .	the picture works with my mom 's dentist 's dad 's ship is smart .
the cup thinks that my teacher 's mom 's grandmother 's daughter 's daughter 's dentist 's toy is tall .	the cup scares my teacher 's mom 's grandmother 's daughter 's daughter 's dentist 's toy is tall .
the picture knows that your teacher 's doctor 's son 's wife 's bottle is helpful .	the picture works with your teacher 's doctor 's son 's wife 's bottle is helpful .
the boat thinks that your mom 's dentist 's dad 's dad 's father 's mom 's book is wrong .	the boat talks to your mom 's dentist 's dad 's dad 's father 's mom 's book is wrong .
the crayon says that my brother 's daughter 's husband 's daughter 's grandmother 's husband 's button is angry .	the crayon works with my brother 's daughter 's husband 's daughter 's grandmother 's husband 's button is angry .
the picture says that your friend 's doctor 's dad 's wife 's box is confused .	the picture works with your friend 's doctor 's dad 's wife 's box is confused .
the ship says that your mom 's dad 's daughter 's grandmother 's mom 's boss 's rug is nice .	the ship helps your mom 's dad 's daughter 's grandmother 's mom 's boss 's rug is nice .
the bag says that your dentist 's mom 's daughter 's mother 's plane is happy .	the bag talks to your dentist 's mom 's daughter 's mother 's plane is happy .
the bowl says that your father 's boss 's daughter 's boss 's teacher 's boat is wrong .	the bowl talks to your father 's boss 's daughter 's boss 's teacher 's boat is wrong .
the chair says that your mom 's grandmother 's brother 's cousin 's daughter 's rocket is nice .	the chair talks to your mom 's grandmother 's brother 's cousin 's daughter 's rocket is nice .
the bicycle says that your sister 's doctor 's boss 's mom 's crayon is excited .	the bicycle scares your sister 's doctor 's boss 's mom 's crayon is excited .
the rug says that your boss 's son 's daughter 's cup is careful .	the rug scares your boss 's son 's daughter 's cup is careful .
the shoe says that my brother 's daughter 's teacher 's boss 's rug is upset .	the shoe works with my brother 's daughter 's teacher 's boss 's rug is upset .
the plane thinks that your father 's son 's mother 's chair is confused .	the plane works with your father 's son 's mother 's chair is confused .
the window thinks that your father 's husband 's teacher 's bowl is wrong .	the window scares your father 's husband 's teacher 's bowl is wrong .
the dish thinks that your mom 's teacher 's dad 's boss 's ring is upset .	the dish scares your mom 's teacher 's dad 's boss 's ring is upset .
the car says that your brother 's boss 's daughter 's bed is wrong .	the car works with your brother 's boss 's daughter 's bed is wrong .
the fork knows that my boss 's father 's son 's mom 's husband 's bowl is kind .	the fork talks to my boss 's father 's son 's mom 's husband 's bowl is kind .
the box knows that my brother 's brother 's sister 's sister 's boss 's bag is smart .	the box talks to my brother 's brother 's sister 's sister 's boss 's bag is smart .
the car knows that my doctor 's sister 's wife 's doctor 's mom 's brother 's boat is confused .	the car talks to my doctor 's sister 's wife 's doctor 's mom 's brother 's boat is confused .
the car knows that your son 's dad 's grandmother 's wife 's son 's window is important .	the car talks to your son 's dad 's grandmother 's wife 's son 's window is important .
the fork says that your cousin 's teacher 's son 's dentist 's dad 's couch is boring .	the fork helps your cousin 's teacher 's son 's dentist 's dad 's couch is boring .
the truck knows that your son 's daughter 's cousin 's rocket is strong .	the truck talks to your son 's daughter 's cousin 's rocket is strong .
the bottle says that your mother 's boss 's mom 's father 's mirror is strong .	the bottle talks to your mother 's boss 's mom 's father 's mirror is strong .
the rug says that your grandmother 's mom 's brother 's dad 's crayon is tall .	the rug works with your grandmother 's mom 's brother 's dad 's crayon is tall .
the doll says that my daughter 's mother 's doctor 's mirror is surprised .	the doll scares my daughter 's mother 's doctor 's mirror is surprised .
the plane thinks that your doctor 's friend 's cousin 's car is helpful .	the plane talks to your doctor 's friend 's cousin 's car is helpful .
the couch thinks that my brother 's husband 's doctor 's boss 's son 's glass is kind .	the couch talks to my brother 's husband 's doctor 's boss 's son 's glass is kind .
the cup knows that my sister 's boss 's friend 's bag is young .	the cup scares my sister 's boss 's friend 's bag is young .
the rocket knows that my son 's cousin 's mom 's friend 's toy is healthy .	the rocket talks to my son 's cousin 's mom 's friend 's toy is healthy .
the spoon knows that your husband 's cousin 's son 's daughter 's doctor 's candle is clever .	the spoon helps your husband 's cousin 's son 's daughter 's doctor 's candle is clever .
the mirror thinks that your son 's teacher 's grandmother 's wife 's bed is curious .	the mirror works with your son 's teacher 's grandmother 's wife 's bed is curious .
the picture says that your son 's dad 's daughter 's plate is important .	the picture scares your son 's dad 's daughter 's plate is important .
the couch thinks that your cousin 's husband 's boss 's glass is young .	the couch talks to your cousin 's husband 's boss 's glass is young .
the ship knows that my husband 's husband 's daughter 's box is surprised .	the ship works with my husband 's husband 's daughter 's box is surprised .
the doll says that your mother 's son 's mom 's sister 's mom 's chair is upset .	the doll scares your mother 's son 's mom 's sister 's mom 's chair is upset .
the bicycle thinks that your brother 's cousin 's wife 's brother 's brother 's bicycle is helpful .	the bicycle talks to your brother 's cousin 's wife 's brother 's brother 's bicycle is helpful .
the fork says that my wife 's mother 's mother 's grandmother 's ship is smart .	the fork helps my wife 's mother 's mother 's grandmother 's ship is smart .
the bowl says that your mom 's father 's daughter 's grandmother 's dish is smart .	the bowl helps your mom 's father 's daughter 's grandmother 's dish is smart .
the bag knows that your dad 's mom 's brother 's teacher 's cousin 's brother 's candle is helpful .	the bag scares your dad 's mom 's brother 's teacher 's cousin 's brother 's candle is helpful .
the spoon says that my dentist 's boss 's grandmother 's mom 's bag is gentle .	the spoon talks to my dentist 's boss 's grandmother 's mom 's bag is gentle .
the bag thinks that my mother 's wife 's wife 's window is busy .	the bag works with my mother 's wife 's wife 's window is busy .
the bowl thinks that my dentist 's dad 's mother 's picture is nice .	the bowl helps my dentist 's dad 's mother 's picture is nice .
the box knows that my husband 's dad 's daughter 's button is bored .	the box scares my husband 's dad 's daughter 's button is bored .
the ring says that my mom 's father 's doctor 's window is confused .	the ring scares my mom 's father 's doctor 's window is confused .
the glass thinks that your teacher 's doctor 's son 's wife 's bed is healthy .	the glass helps your teacher 's doctor 's son 's wife 's bed is healthy .
the chair says that my brother 's daughter 's husband 's boss 's doll is careful .	the chair works with my brother 's daughter 's husband 's boss 's doll is careful .
the ring knows that my dad 's mom 's dad 's plate is wrong .	the ring talks to my dad 's mom 's dad 's plate is wrong .
the crayon says that your husband 's dad 's husband 's daughter 's dad 's daughter 's plate is busy .	the crayon helps your husband 's dad 's husband 's daughter 's dad 's daughter 's plate is busy .
the car thinks that my son 's dad 's boss 's friend 's mother 's rocket is important .	the car scares my son 's dad 's boss 's friend 's mother 's rocket is important .
the ring says that your dad 's father 's cousin 's wife 's husband 's shirt is surprised .	the ring works with your dad 's father 's cousin 's wife 's husband 's shirt is surprised .
the spoon thinks that my dad 's doctor 's cousin 's husband 's button is careful .	the spoon talks to my dad 's doctor 's cousin 's husband 's button is careful .
the hat thinks that my father 's doctor 's husband 's doctor 's cousin 's crayon is lucky .	the hat helps my father 's doctor 's husband 's doctor 's cousin 's crayon is lucky .
the plate says that your dentist 's father 's sister 's picture is friendly .	the plate scares your dentist 's father 's sister 's picture is friendly .
the bicycle thinks that my mom 's teacher 's husband 's sister 's son 's mom 's hat is helpful .	the bicycle helps my mom 's teacher 's husband 's sister 's son 's mom 's hat is helpful .
the rocket knows that your boss 's mother 's brother 's dentist 's son 's father 's plane is gentle .	the rocket helps your boss 's mother 's brother 's dentist 's son 's father 's plane is gentle .
the car knows that your mother 's doctor 's dentist 's brother 's dentist 's son 's boat is bored .	the car scares your mother 's doctor 's dentist 's brother 's dentist 's son 's boat is bored .
the bed knows that my wife 's grandmother 's son 's father 's daughter 's dentist 's shirt is gentle .	the bed scares my wife 's grandmother 's son 's father 's daughter 's dentist 's shirt is gentle .
the picture says that your grandmother 's grandmother 's father 's ship is young .	the picture helps your grandmother 's grandmother 's father 's ship is young .
the window knows that your sister 's mother 's sister 's father 's crayon is boring .	the window works with your sister 's mother 's sister 's father 's crayon is boring .
the shoe thinks that my dentist 's daughter 's husband 's sister 's teacher 's mother 's truck is boring .	the shoe scares my dentist 's daughter 's husband 's sister 's teacher 's mother 's truck is boring .
the bottle thinks that my teacher 's boss 's mom 's friend 's bag is gentle .	the bottle works with my teacher 's boss 's mom 's friend 's bag is gentle .
the bowl knows that my mother 's sister 's son 's teacher 's dad 's candle is happy .	the bowl works with my mother 's sister 's son 's teacher 's dad 's candle is happy .
the bed thinks that your grandmother 's dad 's boss 's wife 's spoon is busy .	the bed works with your grandmother 's dad 's boss 's wife 's spoon is busy .
the car says that your daughter 's dad 's doctor 's doctor 's father 's dad 's cup is young .	the car works with your daughter 's dad 's doctor 's doctor 's father 's dad 's cup is young .
the window says that your cousin 's boss 's daughter 's teacher 's doctor 's ship is confused .	the window scares your cousin 's boss 's daughter 's teacher 's doctor 's ship is confused .
the fork thinks that your wife 's brother 's cousin 's friend 's doctor 's husband 's bag is excited .	the fork talks to your wife 's brother 's cousin 's friend 's doctor 's husband 's bag is excited .
the plane says that your doctor 's mother 's teacher 's fork is nice .	the plane helps your doctor 's mother 's teacher 's fork is nice .
the cup knows that my grandmother 's husband 's husband 's dentist 's dad 's grandmother 's shoe is quiet .	the cup talks to my grandmother 's husband 's husband 's dentist 's dad 's grandmother 's shoe is quiet .
the candle knows that my boss 's mother 's son 's car is young .	the candle scares my boss 's mother 's son 's car is young .
the shirt thinks that my father 's friend 's cousin 's friend 's wife 's father 's car is surprised .	the shirt helps my father 's friend 's cousin 's friend 's wife 's father 's car is surprised .
the book thinks that my brother 's friend 's dentist 's mother 's mother 's window is wrong .	the book works with my brother 's friend 's dentist 's mother 's mother 's window is wrong .
the hat says that my dentist 's son 's sister 's truck is hungry .	the hat helps my dentist 's son 's sister 's truck is hungry .
the truck thinks that your sister 's wife 's dad 's truck is happy .	the truck scares your sister 's wife 's dad 's truck is happy .
the bowl thinks that my mother 's sister 's grandmother 's grandmother 's cousin 's doctor 's spoon is gentle .	the bowl scares my mother 's sister 's grandmother 's grandmother 's cousin 's doctor 's spoon is gentle .
the candle says that your boss 's wife 's father 's mother 's husband 's daughter 's picture is bored .	the candle works with your boss 's wife 's father 's mother 's husband 's daughter 's picture is bored .
the cup knows that your mother 's doctor 's father 's friend 's ring is tall .	the cup works with your mother 's doctor 's father 's friend 's ring is tall .
the plate thinks that my son 's father 's grandmother 's teacher 's teacher 's boss 's boat is helpful .	the plate scares my son 's father 's grandmother 's teacher 's teacher 's boss 's boat is helpful .
the rug thinks that my grandmother 's cousin 's brother 's husband 's doctor 's dad 's mirror is happy .	the rug works with my grandmother 's cousin 's brother 's husband 's doctor 's dad 's mirror is happy .
the ring thinks that your father 's friend 's daughter 's doll is angry .	the ring scares your father 's friend 's daughter 's doll is angry .
the doll thinks that your dentist 's father 's dad 's friend 's mom 's wife 's rocket is young .	the doll works with your dentist 's father 's dad 's friend 's mom 's wife 's rocket is young .
the hat knows that my dad 's dad 's daughter 's grandmother 's bottle is sleepy .	the hat helps my dad 's dad 's daughter 's grandmother 's bottle is sleepy .
the plate knows that my wife 's sister 's sister 's rug is clever .	the plate talks to my wife 's sister 's sister 's rug is clever .
the bag knows that your mother 's brother 's dad 's bottle is smart .	the bag scares your mother 's brother 's dad 's bottle is smart .
the ship says that my brother 's daughter 's friend 's bottle is healthy .	the ship works with my brother 's daughter 's friend 's bottle is healthy .
the shoe thinks that your dad 's cousin 's wife 's husband 's brother 's friend 's bowl is clever .	the shoe talks to your dad 's cousin 's wife 's husband 's brother 's friend 's bowl is clever .
the couch says that my dentist 's mother 's dad 's dentist 's husband 's brother 's toy is busy .	the couch scares my dentist 's mother 's dad 's dentist 's husband 's brother 's toy is busy .
the car says that my dentist 's boss 's friend 's friend 's doctor 's friend 's door is quiet .	the car works with my dentist 's boss 's friend 's friend 's doctor 's friend 's door is quiet .
the shirt knows that your brother 's dentist 's teacher 's dad 's son 's sister 's bed is helpful .	the shirt talks to your brother 's dentist 's teacher 's dad 's son 's sister 's bed is helpful .
the bag says that your grandmother 's dentist 's grandmother 's son 's bottle is helpful .	the bag scares your grandmother 's dentist 's grandmother 's son 's bottle is helpful .
the crayon thinks that my grandmother 's sister 's boss 's dentist 's mom 's boss 's picture is tall .	the crayon scares my grandmother 's sister 's boss 's dentist 's mom 's boss 's picture is tall .
the button knows that your husband 's doctor 's teacher 's daughter 's mom 's candle is happy .	the button scares your husband 's doctor 's teacher 's daughter 's mom 's candle is happy .
the rug knows that my father 's sister 's dad 's dentist 's wife 's truck is careful .	the rug works with my father 's sister 's dad 's dentist 's wife 's truck is careful .
the window thinks that your teacher 's mother 's doctor 's doll is helpful .	the window helps your teacher 's mother 's doctor 's doll is helpful .
the candle thinks that my mother 's dentist 's wife 's dad 's cousin 's boat is strong .	the candle talks to my mother 's dentist 's wife 's dad 's cousin 's boat is strong .
the shoe says that your father 's son 's mom 's son 's cousin 's dish is confused .	the shoe scares your father 's son 's mom 's son 's cousin 's dish is confused .
the hat says that your boss 's grandmother 's doctor 's doll is quiet .	the hat scares your boss 's grandmother 's doctor 's doll is quiet .
the bottle thinks that my cousin 's son 's son 's door is smart .	the bottle helps my cousin 's son 's son 's door is smart .
the bag thinks that my husband 's son 's brother 's cousin 's dentist 's ring is hungry .	the bag helps my husband 's son 's brother 's cousin 's dentist 's ring is hungry .
the picture thinks that your boss 's sister 's mother 's grandmother 's dad 's bicycle is bored .	the picture scares your boss 's sister 's mother 's grandmother 's dad 's bicycle is bored .
the couch knows that your grandmother 's mother 's father 's mother 's husband 's grandmother 's picture is tired .	the couch works with your grandmother 's mother 's father 's mother 's husband 's grandmother 's picture is tired .
the door thinks that your dentist 's brother 's brother 's hat is upset .	the door scares your dentist 's brother 's brother 's hat is upset .
the candle knows that my father 's cousin 's cousin 's cup is young .	the candle scares my father 's cousin 's cousin 's cup is young .
the rug says that my brother 's mother 's husband 's mom 's teacher 's book is nice .	the rug scares my brother 's mother 's husband 's mom 's teacher 's book is nice .
the fork knows that my grandmother 's mom 's dentist 's teacher 's doctor 's brother 's doll is friendly .	the fork talks to my grandmother 's mom 's dentist 's teacher 's doctor 's brother 's doll is friendly .
the rug thinks that my grandmother 's father 's teacher 's plane is careful .	the rug scares my grandmother 's father 's teacher 's plane is careful .
the shoe thinks that my husband 's dentist 's teacher 's sister 's cousin 's bag is gentle .	the shoe works with my husband 's dentist 's teacher 's sister 's cousin 's bag is gentle .
the shoe knows that your friend 's cousin 's dad 's dad 's wife 's doll is smart .	the shoe talks to your friend 's cousin 's dad 's dad 's wife 's doll is smart .
the bottle thinks that my teacher 's sister 's friend 's wife 's son 's daughter 's ship is happy .	the bottle talks to my teacher 's sister 's friend 's wife 's son 's daughter 's ship is happy .
the box knows that my friend 's daughter 's sister 's mirror is quiet .	the box helps my friend 's daughter 's sister 's mirror is quiet .
the window says that your cousin 's husband 's friend 's cousin 's book is careful .	the window works with your cousin 's husband 's friend 's cousin 's book is careful .
the bowl knows that my sister 's dentist 's cousin 's dentist 's grandmother 's cousin 's glass is young .	the bowl works with my sister 's dentist 's cousin 's dentist 's grandmother 's cousin 's glass is young .
the shoe says that your brother 's grandmother 's father 's sister 's candle is clever .	the shoe helps your brother 's grandmother 's father 's sister 's candle is clever .
the mirror thinks that your mom 's sister 's father 's dad 's brother 's dentist 's bag is smart .	the mirror works with your mom 's sister 's father 's dad 's brother 's dentist 's bag is smart .
the car says that my mother 's grandmother 's brother 's shoe is excited .	the car helps my mother 's grandmother 's brother 's shoe is excited .
the window thinks that my teacher 's cousin 's cousin 's window is gentle .	the window works with my teacher 's cousin 's cousin 's window is gentle .
the bicycle thinks that your father 's brother 's boss 's sister 's bowl is quiet .	the bicycle talks to your father 's brother 's boss 's sister 's bowl is quiet .
the crayon knows that my friend 's teacher 's husband 's ship is quiet .	the crayon talks to my friend 's teacher 's husband 's ship is quiet .
the spoon knows that your daughter 's husband 's cousin 's sister 's daughter 's wife 's ship is sleepy .	the spoon works with your daughter 's husband 's cousin 's sister 's daughter 's wife 's ship is sleepy .
the bag knows that my teacher 's cousin 's brother 's daughter 's ship is lucky .	the bag works with my teacher 's cousin 's brother 's daughter 's ship is lucky .
the shoe says that my cousin 's husband 's husband 's brother 's door is bored .	the shoe scares my cousin 's husband 's husband 's brother 's door is bored .
the rug thinks that your mom 's mom 's dad 's bowl is important .	the rug helps your mom 's mom 's dad 's bowl is important .
the plane knows that my father 's husband 's mom 's sister 's friend 's car is excited .	the plane works with my father 's husband 's mom 's sister 's friend 's car is excited .
the ring thinks that your sister 's doctor 's son 's crayon is bored .	the ring scares your sister 's doctor 's son 's crayon is bored .
the plane says that my cousin 's friend 's father 's cousin 's candle is quiet .	the plane helps my cousin 's friend 's father 's cousin 's candle is quiet .
the plane thinks that my brother 's sister 's brother 's daughter 's wife 's candle is curious .	the plane works with my brother 's sister 's brother 's daughter 's wife 's candle is curious .
the bag thinks that your brother 's grandmother 's husband 's doctor 's cousin 's car is important .	the bag helps your brother 's grandmother 's husband 's doctor 's cousin 's car is important .
the button says that my boss 's doctor 's wife 's friend 's doll is healthy .	the button scares my boss 's doctor 's wife 's friend 's doll is healthy .
the book thinks that your grandmother 's wife 's dentist 's mother 's grandmother 's daughter 's book is nice .	the book helps your grandmother 's wife 's dentist 's mother 's grandmother 's daughter 's book is nice .
the boat thinks that my sister 's doctor 's dentist 's sister 's dish is hungry .	the boat helps my sister 's doctor 's dentist 's sister 's dish is hungry .
the doll says that my sister 's mother 's son 's doll is angry .	the doll helps my sister 's mother 's son 's doll is angry .
the bag knows that your dentist 's teacher 's wife 's sister 's grandmother 's friend 's shirt is upset .	the bag scares your dentist 's teacher 's wife 's sister 's grandmother 's friend 's shirt is upset .
the fork knows that my grandmother 's cousin 's cousin 's bicycle is friendly .	the fork talks to my grandmother 's cousin 's cousin 's bicycle is friendly .
the bed says that my teacher 's brother 's son 's dad 's father 's book is smart .	the bed helps my teacher 's brother 's son 's dad 's father 's book is smart .
the cup knows that my father 's brother 's brother 's cousin 's brother 's mirror is careful .	the cup works with my father 's brother 's brother 's cousin 's brother 's mirror is careful .
the bag knows that my dad 's daughter 's cousin 's friend 's dad 's sister 's fork is happy .	the bag works with my dad 's daughter 's cousin 's friend 's dad 's sister 's fork is happy .
the glass knows that your son 's father 's doctor 's mirror is healthy .	the glass helps your son 's father 's doctor 's mirror is healthy .
the box says that my mother 's sister 's mom 's dad 's rug is hungry .	the box talks to my mother 's sister 's mom 's dad 's rug is hungry .
the bag says that your wife 's cousin 's son 's book is nice .	the bag works with your wife 's cousin 's son 's book is nice .
the window thinks that my teacher 's grandmother 's wife 's daughter 's dentist 's grandmother 's plate is hungry .	the window talks to my teacher 's grandmother 's wife 's daughter 's dentist 's grandmother 's plate is hungry .
the hat says that my cousin 's cousin 's mother 's boss 's grandmother 's mirror is angry .	the hat helps my cousin 's cousin 's mother 's boss 's grandmother 's mirror is angry .
the chair knows that your grandmother 's daughter 's dad 's bicycle is important .	the chair scares your grandmother 's daughter 's dad 's bicycle is important .
the spoon says that my daughter 's mom 's sister 's plane is tall .	the spoon scares my daughter 's mom 's sister 's plane is tall .
the picture knows that my friend 's father 's mom 's dad 's brother 's mom 's crayon is quiet .	the picture helps my friend 's father 's mom 's dad 's brother 's mom 's crayon is quiet .
the glass thinks that my sister 's boss 's dentist 's daughter 's friend 's rocket is young .	the glass scares my sister 's boss 's dentist 's daughter 's friend 's rocket is young .
the hat says that your sister 's brother 's father 's door is curious .	the hat works with your sister 's brother 's father 's door is curious .
the glass thinks that my dad 's boss 's doctor 's window is careful .	the glass works with my dad 's boss 's doctor 's window is careful .
the candle says that my son 's mom 's dad 's ship is excited .	the candle works with my son 's mom 's dad 's ship is excited .
the shirt says that your dad 's cousin 's wife 's spoon is sleepy .	the shirt helps your dad 's cousin 's wife 's spoon is sleepy .
the rug says that your boss 's brother 's teacher 's mother 's doctor 's picture is helpful .	the rug works with your boss 's brother 's teacher 's mother 's doctor 's picture is helpful .
the glass says that my dad 's dad 's sister 's grandmother 's bicycle is tired .	the glass scares my dad 's dad 's sister 's grandmother 's bicycle is tired .
the crayon says that your father 's son 's grandmother 's book is happy .	the crayon works with your father 's son 's grandmother 's book is happy .
the toy knows that your dentist 's dentist 's father 's rug is happy .	the toy scares your dentist 's dentist 's father 's rug is happy .
the boat knows that your cousin 's husband 's grandmother 's daughter 's ring is tired .	the boat scares your cousin 's husband 's grandmother 's daughter 's ring is tired .
the ring says that my friend 's mother 's mother 's mom 's doctor 's dad 's ship is smart .	the ring scares my friend 's mother 's mother 's mom 's doctor 's dad 's ship is smart .
the box knows that your father 's boss 's friend 's doctor 's cousin 's shirt is curious .	the box works with your father 's boss 's friend 's doctor 's cousin 's shirt is curious .
the book says that my mom 's friend 's boss 's ship is sleepy .	the book scares my mom 's friend 's boss 's ship is sleepy .
the car says that your cousin 's sister 's son 's son 's mom 's sister 's glass is friendly .	the car helps your cousin 's sister 's son 's son 's mom 's sister 's glass is friendly .
the spoon says that your teacher 's daughter 's friend 's dad 's shirt is healthy .	the spoon works with your teacher 's daughter 's friend 's dad 's shirt is healthy .
the plate thinks that your dentist 's dentist 's father 's father 's mom 's teacher 's car is important .	the plate works with your dentist 's dentist 's father 's father 's mom 's teacher 's car is important .
the picture thinks that my teacher 's mother 's teacher 's daughter 's doctor 's grandmother 's bag is strong .	the picture works with my teacher 's mother 's teacher 's daughter 's doctor 's grandmother 's bag is strong .
the door knows that my mom 's doctor 's grandmother 's wife 's spoon is gentle .	the door helps my mom 's doctor 's grandmother 's wife 's spoon is gentle .
the button knows that your cousin 's doctor 's son 's daughter 's grandmother 's bottle is tired .	the button talks to your cousin 's doctor 's son 's daughter 's grandmother 's bottle is tired .
the couch knows that your boss 's doctor 's sister 's mother 's daughter 's grandmother 's couch is kind .	the couch works with your boss 's doctor 's sister 's mother 's daughter 's grandmother 's couch is kind .
the plate knows that my mom 's wife 's dentist 's cousin 's dad 's teacher 's rug is surprised .	the plate scares my mom 's wife 's dentist 's cousin 's dad 's teacher 's rug is surprised .
the book thinks that your son 's dentist 's grandmother 's boss 's sister 's picture is helpful .	the book works with your son 's dentist 's grandmother 's boss 's sister 's picture is helpful .
the button knows that my dentist 's son 's dad 's wife 's doctor 's teacher 's plate is smart .	the button helps my dentist 's son 's dad 's wife 's doctor 's teacher 's plate is smart .
the hat says that your father 's daughter 's grandmother 's boss 's cup is curious .	the hat talks to your father 's daughter 's grandmother 's boss 's cup is curious .
the hat thinks that your daughter 's friend 's brother 's picture is healthy .	the hat works with your daughter 's friend 's brother 's picture is healthy .
the ring knows that my brother 's teacher 's mother 's bag is busy .	the ring works with my brother 's teacher 's mother 's bag is busy .
the rocket thinks that your doctor 's father 's cousin 's wife 's father 's grandmother 's shoe is sleepy .	the rocket scares your doctor 's father 's cousin 's wife 's father 's grandmother 's shoe is sleepy .
the boat says that my boss 's sister 's doctor 's husband 's boss 's doctor 's crayon is happy .	the boat helps my boss 's sister 's doctor 's husband 's boss 's doctor 's crayon is happy .
the box says that your mom 's grandmother 's teacher 's husband 's dentist 's rug is confused .	the box talks to your mom 's grandmother 's teacher 's husband 's dentist 's rug is confused .
the bicycle knows that my friend 's dad 's mom 's father 's grandmother 's daughter 's glass is excited .	the bicycle scares my friend 's dad 's mom 's father 's grandmother 's daughter 's glass is excited .
the bottle says that my brother 's mom 's teacher 's fork is tired .	the bottle scares my brother 's mom 's teacher 's fork is tired .
the shirt thinks that your mother 's sister 's father 's friend 's mother 's bag is bored .	the shirt helps your mother 's sister 's father 's friend 's mother 's bag is bored .
the couch thinks that your son 's grandmother 's sister 's husband 's couch is strong .	the couch helps your son 's grandmother 's sister 's husband 's couch is strong .
the box thinks that my mom 's mother 's mother 's boss 's couch is clever .	the box scares my mom 's mother 's mother 's boss 's couch is clever .
the rug thinks that your brother 's dad 's daughter 's dentist 's boss 's husband 's window is angry .	the rug scares your brother 's dad 's daughter 's dentist 's boss 's husband 's window is angry .
the bottle thinks that my father 's brother 's grandmother 's book is busy .	the bottle helps my father 's brother 's grandmother 's book is busy .
the box knows that my brother 's husband 's mom 's father 's shirt is surprised .	the box helps my brother 's husband 's mom 's father 's shirt is surprised .
the car knows that my cousin 's daughter 's boss 's father 's doctor 's shirt is quiet .	the car works with my cousin 's daughter 's boss 's father 's doctor 's shirt is quiet .
the car says that your mom 's mother 's brother 's wife 's brother 's grandmother 's rug is helpful .	the car talks to your mom 's mother 's brother 's wife 's brother 's grandmother 's rug is helpful .
the box thinks that my sister 's mom 's friend 's friend 's dentist 's grandmother 's button is sleepy .	the box helps my sister 's mom 's friend 's friend 's dentist 's grandmother 's button is sleepy .
the bed knows that my teacher 's mother 's husband 's teacher 's mom 's car is boring .	the bed scares my teacher 's mother 's husband 's teacher 's mom 's car is boring .
the ship knows that your sister 's mother 's son 's dad 's friend 's dentist 's shoe is clever .	the ship talks to your sister 's mother 's son 's dad 's friend 's dentist 's shoe is clever .
the bicycle says that your husband 's cousin 's dentist 's son 's book is important .	the bicycle scares your husband 's cousin 's dentist 's son 's book is important .
the crayon says that my daughter 's friend 's teacher 's husband 's plate is clever .	the crayon helps my daughter 's friend 's teacher 's husband 's plate is clever .
the book says that my mother 's brother 's dentist 's hat is angry .	the book works with my mother 's brother 's dentist 's hat is angry .
the fork says that your husband 's dentist 's friend 's glass is nice .	the fork talks to your husband 's dentist 's friend 's glass is nice .
the hat thinks that my mom 's brother 's dad 's dentist 's doctor 's brother 's glass is strong .	the hat works with my mom 's brother 's dad 's dentist 's doctor 's brother 's glass is strong .
the plate knows that my husband 's mother 's teacher 's cousin 's father 's friend 's couch is important .	the plate scares my husband 's mother 's teacher 's cousin 's father 's friend 's couch is important .
the fork says that your sister 's grandmother 's brother 's friend 's teacher 's brother 's doll is lucky .	the fork talks to your sister 's grandmother 's brother 's friend 's teacher 's brother 's doll is lucky .
the bicycle knows that your grandmother 's mother 's doctor 's grandmother 's mother 's candle is sleepy .	the bicycle works with your grandmother 's mother 's doctor 's grandmother 's mother 's candle is sleepy .
the plate says that your sister 's dad 's son 's couch is smart .	the plate works with your sister 's dad 's son 's couch is smart .
the window knows that my boss 's doctor 's father 's friend 's truck is sleepy .	the window talks to my boss 's doctor 's father 's friend 's truck is sleepy .
the ship knows that your mom 's cousin 's daughter 's son 's dish is boring .	the ship helps your mom 's cousin 's daughter 's son 's dish is boring .
the cup knows that your doctor 's dad 's teacher 's picture is upset .	the cup helps your doctor 's dad 's teacher 's picture is upset .
the dish thinks that your friend 's cousin 's cousin 's sister 's dad 's teacher 's rocket is important .	the dish talks to your friend 's cousin 's cousin 's sister 's dad 's teacher 's rocket is important .
the rug knows that your dad 's sister 's friend 's daughter 's dentist 's picture is sleepy .	the rug works with your dad 's sister 's friend 's daughter 's dentist 's picture is sleepy .
the button thinks that your teacher 's mom 's wife 's dentist 's rug is confused .	the button works with your teacher 's mom 's wife 's dentist 's rug is confused .
the dish knows that my sister 's friend 's father 's father 's rocket is confused .	the dish works with my sister 's friend 's father 's father 's rocket is confused .
the boat knows that your boss 's cousin 's mother 's mother 's daughter 's friend 's ring is quiet .	the boat works with your boss 's cousin 's mother 's mother 's daughter 's friend 's ring is quiet .
the bag knows that your doctor 's mom 's boss 's dad 's teacher 's teacher 's box is kind .	the bag scares your doctor 's mom 's boss 's dad 's teacher 's teacher 's box is kind .
the shirt knows that my husband 's brother 's mom 's grandmother 's mother 's father 's toy is happy .	the shirt works with my husband 's brother 's mom 's grandmother 's mother 's father 's toy is happy .
the crayon thinks that your boss 's son 's son 's couch is friendly .	the crayon works with your boss 's son 's son 's couch is friendly .
the book thinks that my father 's sister 's mother 's brother 's window is confused .	the book works with my father 's sister 's mother 's brother 's window is confused .
the bottle says that my mom 's mother 's mom 's door is lucky .	the bottle works with my mom 's mother 's mom 's door is lucky .
the box knows that my grandmother 's husband 's daughter 's mother 's teacher 's button is important .	the box works with my grandmother 's husband 's daughter 's mother 's teacher 's button is important .
the shirt thinks that my daughter 's friend 's mom 's daughter 's son 's picture is bored .	the shirt helps my daughter 's friend 's mom 's daughter 's son 's picture is bored .
the hat thinks that my wife 's dad 's boss 's sister 's box is upset .	the hat talks to my wife 's dad 's boss 's sister 's box is upset .
the mirror knows that my teacher 's brother 's sister 's crayon is hungry .	the mirror scares my teacher 's brother 's sister 's crayon is hungry .
the candle says that my son 's husband 's wife 's cup is lucky .	the candle works with my son 's husband 's wife 's cup is lucky .
the chair knows that my grandmother 's dad 's father 's mother 's cup is healthy .	the chair helps my grandmother 's dad 's father 's mother 's cup is healthy .
the couch thinks that my friend 's father 's father 's doctor 's cousin 's door is strong .	the couch works with my friend 's father 's father 's doctor 's cousin 's door is strong .
the bowl thinks that your doctor 's dad 's daughter 's window is upset .	the bowl works with your doctor 's dad 's daughter 's window is upset .
the glass knows that your brother 's doctor 's son 's doctor 's wife 's glass is boring .	the glass helps your brother 's doctor 's son 's doctor 's wife 's glass is boring .
the bicycle thinks that my wife 's brother 's friend 's sister 's grandmother 's shoe is lucky .	the bicycle helps my wife 's brother 's friend 's sister 's grandmother 's shoe is lucky .
the rug knows that my teacher 's boss 's brother 's friend 's dentist 's box is confused .	the rug helps my teacher 's boss 's brother 's friend 's dentist 's box is confused .
the button says that my grandmother 's dentist 's teacher 's wife 's bicycle is careful .	the button helps my grandmother 's dentist 's teacher 's wife 's bicycle is careful .
the box thinks that my sister 's husband 's dentist 's teacher 's doctor 's grandmother 's bag is tired .	the box talks to my sister 's husband 's dentist 's teacher 's doctor 's grandmother 's bag is tired .
the boat knows that my boss 's son 's son 's bottle is important .	the boat talks to my boss 's son 's son 's bottle is important .
the picture thinks that your teacher 's doctor 's brother 's window is happy .	the picture works with your teacher 's doctor 's brother 's window is happy .
the shirt thinks that my mom 's son 's brother 's bottle is clever .	the shirt scares my mom 's son 's brother 's bottle is clever .
the book knows that your teacher 's mother 's daughter 's sister 's son 's mom 's shoe is curious .	the book helps your teacher 's mother 's daughter 's sister 's son 's mom 's shoe is curious .
the spoon thinks that my teacher 's cousin 's grandmother 's cousin 's friend 's dentist 's crayon is excited .	the spoon helps my teacher 's cousin 's grandmother 's cousin 's friend 's dentist 's crayon is excited .
the hat thinks that my wife 's brother 's dentist 's bicycle is helpful .	the hat talks to my wife 's brother 's dentist 's bicycle is helpful .
the hat says that my mom 's dentist 's grandmother 's wife 's doll is healthy .	the hat talks to my mom 's dentist 's grandmother 's wife 's doll is healthy .
the bag says that your husband 's dad 's wife 's grandmother 's son 's bottle is happy .	the bag scares your husband 's dad 's wife 's grandmother 's son 's bottle is happy .
the car knows that my mother 's daughter 's dad 's button is angry .	the car scares my mother 's daughter 's dad 's button is angry .
the cup knows that your doctor 's dentist 's doctor 's dad 's mother 's box is smart .	the cup scares your doctor 's dentist 's doctor 's dad 's mother 's box is smart .
the spoon thinks that your wife 's wife 's doctor 's teacher 's doctor 's bag is boring .	the spoon helps your wife 's wife 's doctor 's teacher 's doctor 's bag is boring .
the bottle thinks that your boss 's cousin 's dentist 's father 's shoe is tall .	the bottle scares your boss 's cousin 's dentist 's father 's shoe is tall .
the book says that my doctor 's grandmother 's cousin 's car is happy .	the book talks to my doctor 's grandmother 's cousin 's car is happy .
the button says that your cousin 's wife 's son 's husband 's brother 's daughter 's cup is wrong .	the button talks to your cousin 's wife 's son 's husband 's brother 's daughter 's cup is wrong .
the plane thinks that my son 's daughter 's mother 's wife 's cousin 's grandmother 's plane is smart .	the plane helps my son 's daughter 's mother 's wife 's cousin 's grandmother 's plane is smart .
the button thinks that your son 's daughter 's dad 's teacher 's teacher 's glass is healthy .	the button scares your son 's daughter 's dad 's teacher 's teacher 's glass is healthy .
the rocket thinks that your friend 's friend 's teacher 's dad 's wife 's car is careful .	the rocket talks to your friend 's friend 's teacher 's dad 's wife 's car is careful .
the mirror says that your husband 's dentist 's dentist 's mom 's crayon is confused .	the mirror works with your husband 's dentist 's dentist 's mom 's crayon is confused .
the glass says that your father 's cousin 's dad 's doll is excited .	the glass works with your father 's cousin 's dad 's doll is excited .
the window thinks that my wife 's sister 's sister 's rug is angry .	the window talks to my wife 's sister 's sister 's rug is angry .
the truck says that my mother 's wife 's cousin 's husband 's husband 's truck is careful .	the truck helps my mother 's wife 's cousin 's husband 's husband 's truck is careful .
the car says that my grandmother 's mother 's teacher 's son 's bed is quiet .	the car scares my grandmother 's mother 's teacher 's son 's bed is quiet .
the boat knows that my dad 's friend 's dentist 's husband 's bed is lucky .	the boat works with my dad 's friend 's dentist 's husband 's bed is lucky .
the doll knows that your teacher 's cousin 's wife 's doctor 's cousin 's father 's candle is bored .	the doll scares your teacher 's cousin 's wife 's doctor 's cousin 's father 's candle is bored .
the shirt thinks that your mom 's friend 's daughter 's son 's bowl is gentle .	the shirt scares your mom 's friend 's daughter 's son 's bowl is gentle .
the glass thinks that my father 's dad 's mother 's teacher 's boat is tall .	the glass talks to my father 's dad 's mother 's teacher 's boat is tall .
the crayon says that your mother 's sister 's brother 's cousin 's doctor 's dish is hungry .	the crayon helps your mother 's sister 's brother 's cousin 's doctor 's dish is hungry .
the bowl knows that my doctor 's sister 's brother 's shoe is strong .	the bowl talks to my doctor 's sister 's brother 's shoe is strong .
the bed knows that my daughter 's sister 's boss 's dentist 's doctor 's bed is excited .	the bed talks to my daughter 's sister 's boss 's dentist 's doctor 's bed is excited .
the door thinks that my friend 's father 's wife 's father 's grandmother 's daughter 's chair is tall .	the door helps my friend 's father 's wife 's father 's grandmother 's daughter 's chair is tall .
the ring knows that your husband 's wife 's mom 's doctor 's friend 's mom 's book is hungry .	the ring talks to your husband 's wife 's mom 's doctor 's friend 's mom 's book is hungry .
the bag says that my mom 's husband 's sister 's brother 's dad 's daughter 's plane is clever .	the bag helps my mom 's husband 's sister 's brother 's dad 's daughter 's plane is clever .
the truck knows that your son 's dentist 's grandmother 's son 's bag is smart .	the truck works with your son 's dentist 's grandmother 's son 's bag is smart .
the fork knows that my dad 's brother 's wife 's cousin 's sister 's bottle is smart .	the fork scares my dad 's brother 's wife 's cousin 's sister 's bottle is smart .
the ring thinks that your cousin 's cousin 's wife 's mom 's father 's mom 's button is bored .	the ring works with your cousin 's cousin 's wife 's mom 's father 's mom 's button is bored .
the glass thinks that your brother 's daughter 's brother 's candle is strong .	the glass talks to your brother 's daughter 's brother 's candle is strong .
the shirt says that your brother 's brother 's grandmother 's mom 's ring is gentle .	the shirt helps your brother 's brother 's grandmother 's mom 's ring is gentle .
the bottle knows that my mother 's friend 's daughter 's daughter 's shoe is wrong .	the bottle talks to my mother 's friend 's daughter 's daughter 's shoe is wrong .
the couch knows that your daughter 's husband 's doctor 's dad 's plane is tall .	the couch scares your daughter 's husband 's doctor 's dad 's plane is tall .
the crayon says that my wife 's dad 's mom 's shirt is friendly .	the crayon talks to my wife 's dad 's mom 's shirt is friendly .
the window says that your husband 's doctor 's father 's doll is happy .	the window helps your husband 's doctor 's father 's doll is happy .
the plane thinks that my son 's sister 's wife 's son 's brother 's father 's couch is careful .	the plane scares my son 's sister 's wife 's son 's brother 's father 's couch is careful .
the shoe thinks that your wife 's wife 's son 's bed is busy .	the shoe works with your wife 's wife 's son 's bed is busy .
the truck knows that your doctor 's daughter 's father 's mom 's plate is boring .	the truck works with your doctor 's daughter 's father 's mom 's plate is boring .
the cup says that my teacher 's boss 's brother 's grandmother 's father 's mother 's chair is helpful .	the cup scares my teacher 's boss 's brother 's grandmother 's father 's mother 's chair is helpful .
the toy knows that my boss 's mother 's daughter 's father 's husband 's picture is excited .	the toy talks to my boss 's mother 's daughter 's father 's husband 's picture is excited .
the window thinks that my cousin 's mom 's mom 's ring is wrong .	the window talks to my cousin 's mom 's mom 's ring is wrong .
the car thinks that my doctor 's husband 's dad 's friend 's friend 's friend 's dish is wrong .	the car scares my doctor 's husband 's dad 's friend 's friend 's friend 's dish is wrong .
the candle thinks that your daughter 's husband 's grandmother 's grandmother 's glass is important .	the candle talks to your daughter 's husband 's grandmother 's grandmother 's glass is important .
the glass says that my dentist 's teacher 's sister 's brother 's spoon is angry .	the glass helps my dentist 's teacher 's sister 's brother 's spoon is angry .
the car says that your grandmother 's mom 's daughter 's shoe is busy .	the car talks to your grandmother 's mom 's daughter 's shoe is busy .
the rug thinks that my mother 's brother 's daughter 's cup is clever .	the rug scares my mother 's brother 's daughter 's cup is clever .
the shoe thinks that my dentist 's teacher 's daughter 's friend 's dish is smart .	the shoe helps my dentist 's teacher 's daughter 's friend 's dish is smart .
the window thinks that your sister 's daughter 's wife 's bicycle is nice .	the window helps your sister 's daughter 's wife 's bicycle is nice .
the plate says that my boss 's daughter 's teacher 's mother 's bed is smart .	the plate scares my boss 's daughter 's teacher 's mother 's bed is smart .
the car knows that your daughter 's husband 's doctor 's book is confused .	the car works with your daughter 's husband 's doctor 's book is confused .
the window thinks that my wife 's boss 's sister 's boss 's cousin 's wife 's shirt is young .	the window works with my wife 's boss 's sister 's boss 's cousin 's wife 's shirt is young .
the crayon thinks that my dentist 's doctor 's husband 's brother 's daughter 's teacher 's button is nice .	the crayon helps my dentist 's doctor 's husband 's brother 's daughter 's teacher 's button is nice .
the crayon thinks that my cousin 's grandmother 's sister 's glass is kind .	the crayon helps my cousin 's grandmother 's sister 's glass is kind .
the doll knows that your sister 's brother 's mother 's son 's husband 's doll is quiet .	the doll scares your sister 's brother 's mother 's son 's husband 's doll is quiet .
the toy thinks that my mom 's boss 's friend 's mom 's grandmother 's wife 's rocket is tall .	the toy talks to my mom 's boss 's friend 's mom 's grandmother 's wife 's rocket is tall .
the shoe knows that your father 's mother 's husband 's teacher 's mother 's dentist 's couch is healthy .	the shoe scares your father 's mother 's husband 's teacher 's mother 's dentist 's couch is healthy .
the bicycle thinks that your dentist 's husband 's friend 's mom 's doctor 's cousin 's rug is friendly .	the bicycle talks to your dentist 's husband 's friend 's mom 's doctor 's cousin 's rug is friendly .
the shirt thinks that my mom 's dad 's daughter 's shirt is tall .	the shirt helps my mom 's dad 's daughter 's shirt is tall .
the book says that my mom 's brother 's teacher 's couch is upset .	the book works with my mom 's brother 's teacher 's couch is upset .
the dish knows that your friend 's mother 's cousin 's husband 's candle is curious .	the dish talks to your friend 's mother 's cousin 's husband 's candle is curious .
the couch knows that my dad 's dad 's grandmother 's couch is clever .	the couch helps my dad 's dad 's grandmother 's couch is clever .
the couch thinks that my daughter 's grandmother 's mother 's mom 's daughter 's ring is clever .	the couch works with my daughter 's grandmother 's mother 's mom 's daughter 's ring is clever .
the candle knows that your dad 's doctor 's teacher 's mom 's husband 's dad 's crayon is angry .	the candle talks to your dad 's doctor 's teacher 's mom 's husband 's dad 's crayon is angry .
the hat says that my wife 's daughter 's husband 's mirror is boring .	the hat talks to my wife 's daughter 's husband 's mirror is boring .
the shirt knows that my brother 's friend 's dad 's bag is gentle .	the shirt scares my brother 's friend 's dad 's bag is gentle .
the ship knows that your father 's wife 's husband 's wife 's glass is lucky .	the ship scares your father 's wife 's husband 's wife 's glass is lucky .
the cup thinks that your son 's husband 's dentist 's dad 's daughter 's mom 's bowl is sleepy .	the cup works with your son 's husband 's dentist 's dad 's daughter 's mom 's bowl is sleepy .
the ring says that your husband 's daughter 's dentist 's teacher 's cousin 's mirror is helpful .	the ring works with your husband 's daughter 's dentist 's teacher 's cousin 's mirror is helpful .
the hat knows that my boss 's son 's grandmother 's button is healthy .	the hat talks to my boss 's son 's grandmother 's button is healthy .
the bowl knows that my cousin 's mother 's friend 's mother 's mother 's bottle is kind .	the bowl works with my cousin 's mother 's friend 's mother 's mother 's bottle is kind .
the glass says that your sister 's sister 's grandmother 's doctor 's friend 's dentist 's window is surprised .	the glass talks to your sister 's sister 's grandmother 's doctor 's friend 's dentist 's window is surprised .
the plane thinks that my friend 's sister 's cousin 's father 's dad 's sister 's fork is friendly .	the plane scares my friend 's sister 's cousin 's father 's dad 's sister 's fork is friendly .
the dish says that your husband 's daughter 's son 's mom 's mirror is busy .	the dish talks to your husband 's daughter 's son 's mom 's mirror is busy .
the bowl knows that my doctor 's daughter 's boss 's hat is important .	the bowl scares my doctor 's daughter 's boss 's hat is important .
the couch thinks that my son 's dad 's son 's grandmother 's doctor 's rug is tired .	the couch helps my son 's dad 's son 's grandmother 's doctor 's rug is tired .
the bottle thinks that your husband 's brother 's brother 's cousin 's spoon is bored .	the bottle talks to your husband 's brother 's brother 's cousin 's spoon is bored .
the spoon knows that my husband 's cousin 's daughter 's dentist 's friend 's wife 's button is tired .	the spoon works with my husband 's cousin 's daughter 's dentist 's friend 's wife 's button is tired .
the ship thinks that your daughter 's mom 's doctor 's dad 's grandmother 's dentist 's picture is important .	the ship talks to your daughter 's mom 's doctor 's dad 's grandmother 's dentist 's picture is important .
the bag thinks that your doctor 's boss 's sister 's son 's bottle is tired .	the bag talks to your doctor 's boss 's sister 's son 's bottle is tired .
the spoon says that my husband 's boss 's dad 's mom 's door is tall .	the spoon helps my husband 's boss 's dad 's mom 's door is tall .
the boat knows that your doctor 's husband 's daughter 's friend 's dentist 's boss 's couch is gentle .	the boat works with your doctor 's husband 's daughter 's friend 's dentist 's boss 's couch is gentle .
the hat thinks that my daughter 's father 's grandmother 's truck is boring .	the hat talks to my daughter 's father 's grandmother 's truck is boring .
the rocket thinks that my boss 's boss 's mother 's grandmother 's ring is strong .	the rocket works with my boss 's boss 's mother 's grandmother 's ring is strong .
the mirror says that your mom 's brother 's son 's dad 's plate is strong .	the mirror scares your mom 's brother 's son 's dad 's plate is strong .
the rug knows that your brother 's dentist 's mother 's father 's boss 's sister 's car is smart .	the rug works with your brother 's dentist 's mother 's father 's boss 's sister 's car is smart .
the mirror thinks that your brother 's dad 's brother 's doctor 's friend 's dentist 's cup is helpful .	the mirror talks to your brother 's dad 's brother 's doctor 's friend 's dentist 's cup is helpful .
the book thinks that your son 's mom 's dentist 's mom 's mom 's spoon is tired .	the book scares your son 's mom 's dentist 's mom 's mom 's spoon is tired .
the rocket thinks that my doctor 's friend 's brother 's grandmother 's doctor 's shirt is tall .	the rocket scares my doctor 's friend 's brother 's grandmother 's doctor 's shirt is tall .
the couch says that your boss 's brother 's sister 's teacher 's mother 's doctor 's boat is sleepy .	the couch works with your boss 's brother 's sister 's teacher 's mother 's doctor 's boat is sleepy .
the glass says that my boss 's son 's friend 's brother 's mom 's ring is clever .	the glass works with my boss 's son 's friend 's brother 's mom 's ring is clever .
the bowl knows that your brother 's dentist 's teacher 's wife 's mirror is young .	the bowl works with your brother 's dentist 's teacher 's wife 's mirror is young .
the doll says that your doctor 's sister 's son 's dentist 's bicycle is nice .	the doll scares your doctor 's sister 's son 's dentist 's bicycle is nice .
the mirror says that your husband 's mom 's doctor 's mom 's father 's friend 's car is confused .	the mirror scares your husband 's mom 's doctor 's mom 's father 's friend 's car is confused .
the dish knows that your dad 's brother 's friend 's button is helpful .	the dish talks to your dad 's brother 's friend 's button is helpful .
the cup knows that my mom 's grandmother 's son 's box is quiet .	the cup talks to my mom 's grandmother 's son 's box is quiet .
the dish thinks that your mother 's mother 's husband 's dad 's doctor 's grandmother 's ship is curious .	the dish talks to your mother 's mother 's husband 's dad 's doctor 's grandmother 's ship is curious .
the plate thinks that your husband 's boss 's boss 's boss 's grandmother 's mirror is helpful .	the plate works with your husband 's boss 's boss 's boss 's grandmother 's mirror is helpful .
the crayon thinks that my dad 's dentist 's grandmother 's daughter 's son 's car is smart .	the crayon works with my dad 's dentist 's grandmother 's daughter 's son 's car is smart .
the rocket says that your doctor 's teacher 's father 's dentist 's ship is gentle .	the rocket talks to your doctor 's teacher 's father 's dentist 's ship is gentle .
the car thinks that your mother 's teacher 's friend 's wife 's teacher 's mother 's rocket is surprised .	the car helps your mother 's teacher 's friend 's wife 's teacher 's mother 's rocket is surprised .
the candle thinks that your daughter 's brother 's mom 's dentist 's son 's glass is confused .	the candle talks to your daughter 's brother 's mom 's dentist 's son 's glass is confused .
the bed knows that my cousin 's cousin 's husband 's daughter 's son 's son 's glass is surprised .	the bed helps my cousin 's cousin 's husband 's daughter 's son 's son 's glass is surprised .
the doll knows that my cousin 's doctor 's wife 's brother 's grandmother 's husband 's ring is careful .	the doll scares my cousin 's doctor 's wife 's brother 's grandmother 's husband 's ring is careful .
the rocket thinks that my wife 's mom 's teacher 's mom 's wife 's couch is sleepy .	the rocket scares my wife 's mom 's teacher 's mom 's wife 's couch is sleepy .
the hat says that my teacher 's father 's daughter 's bed is nice .	the hat works with my teacher 's father 's daughter 's bed is nice .
the picture says that my grandmother 's husband 's boss 's picture is gentle .	the picture scares my grandmother 's husband 's boss 's picture is gentle .
the plane knows that my sister 's dentist 's friend 's window is nice .	the plane scares my sister 's dentist 's friend 's window is nice .
the glass thinks that your boss 's daughter 's dad 's son 's brother 's bed is confused .	the glass works with your boss 's daughter 's dad 's son 's brother 's bed is confused .
the bed thinks that my wife 's dad 's boss 's father 's son 's door is hungry .	the bed talks to my wife 's dad 's boss 's father 's son 's door is hungry .
the bowl knows that my husband 's dad 's friend 's box is hungry .	the bowl talks to my husband 's dad 's friend 's box is hungry .
the box knows that my father 's teacher 's son 's wife 's doctor 's cousin 's plane is important .	the box helps my father 's teacher 's son 's wife 's doctor 's cousin 's plane is important .
the car says that my husband 's boss 's father 's grandmother 's teacher 's bowl is wrong .	the car talks to my husband 's boss 's father 's grandmother 's teacher 's bowl is wrong .
the rug says that your sister 's brother 's dad 's dentist 's picture is gentle .	the rug talks to your sister 's brother 's dad 's dentist 's picture is gentle .
the hat thinks that your husband 's husband 's wife 's bottle is bored .	the hat scares your husband 's husband 's wife 's bottle is bored .
the bed knows that your son 's brother 's mother 's wife 's rocket is tired .	the bed helps your son 's brother 's mother 's wife 's rocket is tired .
the hat knows that your teacher 's brother 's mom 's dentist 's son 's brother 's car is busy .	the hat scares your teacher 's brother 's mom 's dentist 's son 's brother 's car is busy .
the bowl says that my mom 's son 's mother 's husband 's bag is lucky .	the bowl scares my mom 's son 's mother 's husband 's bag is lucky .
the plate thinks that your father 's daughter 's father 's friend 's daughter 's dad 's truck is surprised .	the plate helps your father 's daughter 's father 's friend 's daughter 's dad 's truck is surprised .
the crayon says that my sister 's mother 's dad 's wife 's cousin 's shirt is lucky .	the crayon talks to my sister 's mother 's dad 's wife 's cousin 's shirt is lucky .
the bowl says that your husband 's mother 's doctor 's chair is strong .	the bowl talks to your husband 's mother 's doctor 's chair is strong .
the truck thinks that your dentist 's sister 's husband 's picture is helpful .	the truck talks to your dentist 's sister 's husband 's picture is helpful .
the door knows that my cousin 's father 's dad 's chair is confused .	the door helps my cousin 's father 's dad 's chair is confused .
the glass thinks that my father 's cousin 's sister 's grandmother 's son 's plate is tired .	the glass talks to my father 's cousin 's sister 's grandmother 's son 's plate is tired .
the rocket thinks that my dad 's daughter 's husband 's bottle is smart .	the rocket talks to my dad 's daughter 's husband 's bottle is smart .
the couch says that my dentist 's son 's sister 's book is wrong .	the couch works with my dentist 's son 's sister 's book is wrong .
the rug knows that your cousin 's father 's mother 's doctor 's wife 's husband 's rug is young .	the rug helps your cousin 's father 's mother 's doctor 's wife 's husband 's rug is young .
the fork knows that my mother 's mother 's brother 's spoon is confused .	the fork scares my mother 's mother 's brother 's spoon is confused .
the shoe knows that your daughter 's dad 's grandmother 's sister 's cousin 's bicycle is lucky .	the shoe helps your daughter 's dad 's grandmother 's sister 's cousin 's bicycle is lucky .
the bottle thinks that my dad 's wife 's sister 's sister 's shirt is boring .	the bottle helps my dad 's wife 's sister 's sister 's shirt is boring .
the bottle thinks that my cousin 's sister 's son 's dentist 's cousin 's candle is surprised .	the bottle works with my cousin 's sister 's son 's dentist 's cousin 's candle is surprised .
the shoe knows that your father 's sister 's mom 's mom 's daughter 's bottle is friendly .	the shoe works with your father 's sister 's mom 's mom 's daughter 's bottle is friendly .
the book says that your teacher 's doctor 's sister 's grandmother 's dad 's father 's book is bored .	the book scares your teacher 's doctor 's sister 's grandmother 's dad 's father 's book is bored .
the picture says that your teacher 's boss 's brother 's husband 's boss 's husband 's truck is quiet .	the picture helps your teacher 's boss 's brother 's husband 's boss 's husband 's truck is quiet .
the toy knows that your dentist 's dentist 's cousin 's book is smart .	the toy works with your dentist 's dentist 's cousin 's book is smart .
the toy thinks that your sister 's doctor 's teacher 's husband 's dad 's brother 's shirt is kind .	the toy talks to your sister 's doctor 's teacher 's husband 's dad 's brother 's shirt is kind .
the bag thinks that your dentist 's father 's son 's boss 's mirror is helpful .	the bag works with your dentist 's father 's son 's boss 's mirror is helpful .
the bowl knows that my cousin 's husband 's sister 's mom 's boss 's doll is surprised .	the bowl scares my cousin 's husband 's sister 's mom 's boss 's doll is surprised .
the toy knows that my friend 's daughter 's mom 's spoon is upset .	the toy works with my friend 's daughter 's mom 's spoon is upset .
the toy knows that your mother 's daughter 's teacher 's father 's sister 's picture is clever .	the toy scares your mother 's daughter 's teacher 's father 's sister 's picture is clever .
the toy knows that my boss 's cousin 's sister 's bag is clever .	the toy talks to my boss 's cousin 's sister 's bag is clever .
the bag says that my son 's friend 's son 's doctor 's son 's doll is upset .	the bag helps my son 's friend 's son 's doctor 's son 's doll is upset .
the plate says that my brother 's sister 's teacher 's daughter 's ring is strong .	the plate helps my brother 's sister 's teacher 's daughter 's ring is strong .
the picture knows that my wife 's daughter 's father 's car is confused .	the picture works with my wife 's daughter 's father 's car is confused .
the dish says that your mother 's daughter 's dentist 's daughter 's dad 's brother 's shirt is healthy .	the dish helps your mother 's daughter 's dentist 's daughter 's dad 's brother 's shirt is healthy .
the shoe thinks that your sister 's son 's dad 's teacher 's grandmother 's dentist 's ship is nice .	the shoe helps your sister 's son 's dad 's teacher 's grandmother 's dentist 's ship is nice .
the dish knows that your daughter 's doctor 's friend 's cousin 's daughter 's dish is upset .	the dish works with your daughter 's doctor 's friend 's cousin 's daughter 's dish is upset .
the boat knows that your mother 's mom 's friend 's glass is quiet .	the boat helps your mother 's mom 's friend 's glass is quiet .
the window says that my teacher 's mom 's boss 's picture is gentle .	the window talks to my teacher 's mom 's boss 's picture is gentle .
the car knows that my wife 's father 's son 's grandmother 's shoe is hungry .	the car works with my wife 's father 's son 's grandmother 's shoe is hungry .
the plate thinks that my grandmother 's doctor 's son 's husband 's grandmother 's dish is gentle .	the plate scares my grandmother 's doctor 's son 's husband 's grandmother 's dish is gentle .
the bottle knows that my friend 's mother 's teacher 's husband 's ship is friendly .	the bottle works with my friend 's mother 's teacher 's husband 's ship is friendly .
the crayon knows that your doctor 's cousin 's doctor 's toy is surprised .	the crayon works with your doctor 's cousin 's doctor 's toy is surprised .
the ship knows that my father 's mother 's brother 's shoe is gentle .	the ship scares my father 's mother 's brother 's shoe is gentle .
the crayon says that your son 's friend 's cousin 's friend 's friend 's husband 's plate is happy .	the crayon scares your son 's friend 's cousin 's friend 's friend 's husband 's plate is happy .
the shirt knows that your cousin 's dad 's son 's teacher 's boat is young .	the shirt works with your cousin 's dad 's son 's teacher 's boat is young .
the car knows that your daughter 's dad 's teacher 's grandmother 's mother 's car is young .	the car works with your daughter 's dad 's teacher 's grandmother 's mother 's car is young .
the candle thinks that your boss 's dad 's mom 's bicycle is angry .	the candle works with your boss 's dad 's mom 's bicycle is angry .
the car knows that your grandmother 's dentist 's mother 's husband 's toy is busy .	the car works with your grandmother 's dentist 's mother 's husband 's toy is busy .
the rocket says that your husband 's father 's boss 's doctor 's spoon is busy .	the rocket talks to your husband 's father 's boss 's doctor 's spoon is busy .
the picture thinks that my boss 's brother 's brother 's cousin 's box is excited .	the picture helps my boss 's brother 's brother 's cousin 's box is excited .
the glass says that your grandmother 's dentist 's father 's son 's book is boring .	the glass scares your grandmother 's dentist 's father 's son 's book is boring .
the car thinks that your son 's cousin 's husband 's bottle is bored .	the car scares your son 's cousin 's husband 's bottle is bored .
the car knows that my doctor 's brother 's brother 's grandmother 's mom 's ring is healthy .	the car helps my doctor 's brother 's brother 's grandmother 's mom 's ring is healthy .
the doll knows that your cousin 's teacher 's daughter 's son 's book is important .	the doll works with your cousin 's teacher 's daughter 's son 's book is important .
the dish thinks that my friend 's son 's father 's doctor 's dentist 's brother 's box is helpful .	the dish talks to my friend 's son 's father 's doctor 's dentist 's brother 's box is helpful .
the boat thinks that your wife 's husband 's grandmother 's boss 's wife 's sister 's door is upset .	the boat works with your wife 's husband 's grandmother 's boss 's wife 's sister 's door is upset .
the ring knows that my mother 's husband 's mom 's cousin 's dish is kind .	the ring helps my mother 's husband 's mom 's cousin 's dish is kind .
the truck says that your sister 's father 's grandmother 's friend 's cousin 's son 's book is important .	the truck talks to your sister 's father 's grandmother 's friend 's cousin 's son 's book is important .
the car knows that my grandmother 's daughter 's boss 's dentist 's door is important .	the car works with my grandmother 's daughter 's boss 's dentist 's door is important .
the candle thinks that my mother 's friend 's husband 's teacher 's boss 's plate is nice .	the candle works with my mother 's friend 's husband 's teacher 's boss 's plate is nice .
the bowl thinks that your dentist 's mother 's daughter 's son 's dentist 's grandmother 's fork is surprised .	the bowl works with your dentist 's mother 's daughter 's son 's dentist 's grandmother 's fork is surprised .
the boat says that my teacher 's grandmother 's boss 's mother 's husband 's spoon is kind .	the boat works with my teacher 's grandmother 's boss 's mother 's husband 's spoon is kind .
the picture knows that your dentist 's son 's daughter 's father 's couch is sleepy .	the picture helps your dentist 's son 's daughter 's father 's couch is sleepy .
the chair says that my sister 's dentist 's father 's dad 's husband 's grandmother 's spoon is careful .	the chair talks to my sister 's dentist 's father 's dad 's husband 's grandmother 's spoon is careful .
the hat says that your friend 's doctor 's teacher 's cousin 's toy is lucky .	the hat talks to your friend 's doctor 's teacher 's cousin 's toy is lucky .
the chair says that your boss 's father 's grandmother 's dad 's rocket is boring .	the chair works with your boss 's father 's grandmother 's dad 's rocket is boring .
the bowl thinks that your son 's boss 's cousin 's shoe is strong .	the bowl helps your son 's boss 's cousin 's shoe is strong .
the shirt knows that your doctor 's brother 's son 's ship is surprised .	the shirt works with your doctor 's brother 's son 's ship is surprised .
the button knows that my friend 's grandmother 's sister 's brother 's picture is helpful .	the button helps my friend 's grandmother 's sister 's brother 's picture is helpful .
the doll thinks that your cousin 's daughter 's doctor 's dentist 's bag is bored .	the doll works with your cousin 's daughter 's doctor 's dentist 's bag is bored .
the window knows that your teacher 's son 's friend 's grandmother 's wife 's couch is kind .	the window works with your teacher 's son 's friend 's grandmother 's wife 's couch is kind .
the truck says that my husband 's grandmother 's wife 's button is smart .	the truck talks to my husband 's grandmother 's wife 's button is smart .
the dish knows that your mom 's father 's sister 's dentist 's bowl is angry .	the dish scares your mom 's father 's sister 's dentist 's bowl is angry .
the bowl knows that my cousin 's mother 's mother 's mom 's brother 's son 's hat is upset .	the bowl works with my cousin 's mother 's mother 's mom 's brother 's son 's hat is upset .
the rocket knows that your friend 's teacher 's wife 's son 's grandmother 's boss 's shirt is confused .	the rocket helps your friend 's teacher 's wife 's son 's grandmother 's boss 's shirt is confused .
the car thinks that my wife 's husband 's doctor 's hat is bored .	the car works with my wife 's husband 's doctor 's hat is bored .
the spoon knows that your dad 's wife 's cousin 's daughter 's button is strong .	the spoon scares your dad 's wife 's cousin 's daughter 's button is strong .
the shoe thinks that your boss 's wife 's dad 's brother 's cousin 's husband 's window is clever .	the shoe helps your boss 's wife 's dad 's brother 's cousin 's husband 's window is clever .
the bowl knows that my daughter 's dad 's son 's doctor 's mother 's dish is friendly .	the bowl talks to my daughter 's dad 's son 's doctor 's mother 's dish is friendly .
the book knows that your wife 's dad 's teacher 's spoon is tall .	the book talks to your wife 's dad 's teacher 's spoon is tall .
the shoe thinks that your doctor 's son 's friend 's dad 's wife 's couch is helpful .	the shoe helps your doctor 's son 's friend 's dad 's wife 's couch is helpful .
the truck thinks that my mom 's mom 's grandmother 's husband 's dad 's brother 's plane is nice .	the truck talks to my mom 's mom 's grandmother 's husband 's dad 's brother 's plane is nice .
the ring thinks that your teacher 's brother 's son 's daughter 's spoon is curious .	the ring helps your teacher 's brother 's son 's daughter 's spoon is curious .
the mirror says that my dentist 's father 's dentist 's cousin 's dad 's glass is nice .	the mirror works with my dentist 's father 's dentist 's cousin 's dad 's glass is nice .
the car knows that my daughter 's brother 's mother 's wife 's mother 's truck is gentle .	the car scares my daughter 's brother 's mother 's wife 's mother 's truck is gentle .
the chair knows that your dad 's brother 's boss 's wife 's doctor 's doctor 's bicycle is hungry .	the chair helps your dad 's brother 's boss 's wife 's doctor 's doctor 's bicycle is hungry .
the glass says that my father 's son 's friend 's cousin 's husband 's button is confused .	the glass helps my father 's son 's friend 's cousin 's husband 's button is confused .
the bowl says that your mom 's friend 's dad 's wife 's husband 's shirt is curious .	the bowl helps your mom 's friend 's dad 's wife 's husband 's shirt is curious .
the boat thinks that my husband 's sister 's brother 's plate is quiet .	the boat helps my husband 's sister 's brother 's plate is quiet .
the bag knows that my dad 's wife 's doctor 's mom 's boat is happy .	the bag helps my dad 's wife 's doctor 's mom 's boat is happy .
the bowl thinks that my wife 's cousin 's brother 's mother 's window is quiet .	the bowl works with my wife 's cousin 's brother 's mother 's window is quiet .
the ship knows that your wife 's wife 's grandmother 's bed is surprised .	the ship helps your wife 's wife 's grandmother 's bed is surprised .
the bowl says that my father 's friend 's daughter 's friend 's mom 's boss 's bowl is sleepy .	the bowl works with my father 's friend 's daughter 's friend 's mom 's boss 's bowl is sleepy .
the rocket says that my grandmother 's son 's sister 's grandmother 's teacher 's teacher 's candle is angry .	the rocket scares my grandmother 's son 's sister 's grandmother 's teacher 's teacher 's candle is angry .
the glass thinks that your husband 's wife 's son 's boss 's mom 's car is strong .	the glass helps your husband 's wife 's son 's boss 's mom 's car is strong .
the toy thinks that my father 's boss 's father 's boss 's bicycle is helpful .	the toy helps my father 's boss 's father 's boss 's bicycle is helpful .
the hat thinks that your father 's husband 's father 's cousin 's car is healthy .	the hat works with your father 's husband 's father 's cousin 's car is healthy .
the truck says that your father 's mother 's sister 's grandmother 's doctor 's husband 's car is boring .	the truck scares your father 's mother 's sister 's grandmother 's doctor 's husband 's car is boring .
