these candles who work with that box do n't exercise .	these candles who work with that box does n't exercise .
the rocket who will visit these books does help the rooms .	the rocket who will visit these books do help the rooms .
those cars who visit that ring have n't moved this guy .	those cars who visit that ring has n't moved this guy .
the bottle who the spoons had n't bothered does n't care for this crayon .	the bottle who the spoons had n't bothered do n't care for this crayon .
that car who the schools worked with does laugh .	that car who the schools worked with do laugh .
the hospital who these boats visit does n't lie .	the hospital who these boats visit do n't lie .
these dishes who have n't made this guy are helping the cup .	these dishes who have n't made this guy is helping the cup .
these plates who the door must help are n't reading .	these plates who the door must help is n't reading .
that car who the shoes listen to does n't stretch .	that car who the shoes listen to do n't stretch .
the glass who fixed these children does n't keep those men .	the glass who fixed these children do n't keep those men .
this bank who can n't lift those people was painting .	this bank who can n't lift those people were painting .
the chair who had cleaned these girls is laughing .	the chair who had cleaned these girls are laughing .
the school who those doors should n't answer does cry .	the school who those doors should n't answer do cry .
the museum who the windows would bother has n't dropped that doctor .	the museum who the windows would bother have n't dropped that doctor .
this rocket who was n't working with the pictures does cry .	this rocket who was n't working with the pictures do cry .
this book who confused these dishes does n't buy that driver .	this book who confused these dishes do n't buy that driver .
the boat who has confused those windows does talk to the bottles .	the boat who has confused those windows do talk to the bottles .
these cars who may work with that bicycle have read .	these cars who may work with that bicycle has read .
these dolls who have scared this book do bring that teacher .	these dolls who have scared this book does bring that teacher .
that hospital who has n't talked to the chairs does n't scare the car .	that hospital who has n't talked to the chairs do n't scare the car .
the boxes who make the doctor do n't listen to these schools .	the boxes who make the doctor does n't listen to these schools .
the toys who had n't scared the school do hold the king .	the toys who had n't scared the school does hold the king .
these cars who drop that child do wave .	these cars who drop that child does wave .
those glasses who the door is n't talking to do n't exercise .	those glasses who the door is n't talking to does n't exercise .
this spoon who throws those teachers does n't shake this man .	this spoon who throws those teachers do n't shake this man .
this library who those buttons were listening to was n't teaching that cup .	this library who those buttons were listening to were n't teaching that cup .
this museum who those rings were n't helping has scared this restaurant .	this museum who those rings were n't helping have scared this restaurant .
the bottles who were n't throwing the adult are cleaning this king .	the bottles who were n't throwing the adult is cleaning this king .
this hat who those books were n't talking to does sing .	this hat who those books were n't talking to do sing .
this museum who these pictures did n't visit was making this woman .	this museum who these pictures did n't visit were making this woman .
that toy who would n't hold those guys has n't talked .	that toy who would n't hold those guys have n't talked .
that toy who the spoons visit does n't keep this adult .	that toy who the spoons visit do n't keep this adult .
the candles who have n't made this king have yelled .	the candles who have n't made this king has yelled .
the school who wo n't answer these candles does find that queen .	the school who wo n't answer these candles do find that queen .
the glass who these forks talk to was n't smiling .	the glass who these forks talk to were n't smiling .
those bowls who this picture bothered have n't talked to the rocket .	those bowls who this picture bothered has n't talked to the rocket .
that rug who dropped these girls has answered these crayons .	that rug who dropped these girls have answered these crayons .
the school who lost these shoes does n't shake the customer .	the school who lost these shoes do n't shake the customer .
this bicycle who answered those glasses is helping the shirt .	this bicycle who answered those glasses are helping the shirt .
these schools who are talking to this bicycle do n't talk to these plates .	these schools who are talking to this bicycle does n't talk to these plates .
this bag who the books help has n't lost .	this bag who the books help have n't lost .
the chair who keeps the ladies is n't waving .	the chair who keeps the ladies are n't waving .
the crayons who this couch lost have n't yelled .	the crayons who this couch lost has n't yelled .
the books who that bottle has scared do work with those trucks .	the books who that bottle has scared does work with those trucks .
the cars who can keep the boy have n't scared this hospital .	the cars who can keep the boy has n't scared this hospital .
the pictures who the rug is bothering do n't lift the doctors .	the pictures who the rug is bothering does n't lift the doctors .
that bottle who fixed those children has talked to these candles .	that bottle who fixed those children have talked to these candles .
this shoe who the bags would n't scare has n't talked .	this shoe who the bags would n't scare have n't talked .
these chairs who lost the shirt do n't smile .	these chairs who lost the shirt does n't smile .
those shoes who would talk to this toy were losing .	those shoes who would talk to this toy was losing .
those dolls who were n't talking to the school are whispering .	those dolls who were n't talking to the school is whispering .
that bed who is cleaning the doctors does n't worry this mirror .	that bed who is cleaning the doctors do n't worry this mirror .
the dishes who this plate bothered do n't know these pictures .	the dishes who this plate bothered does n't know these pictures .
these books who had this boy were n't visiting the glasses .	these books who had this boy was n't visiting the glasses .
this hospital who was n't helping the forks has n't fixed those men .	this hospital who was n't helping the forks have n't fixed those men .
those boats who have lost the hat do n't talk .	those boats who have lost the hat does n't talk .
the bottles who the restaurant answered have n't visited that bank .	the bottles who the restaurant answered has n't visited that bank .
this school who should n't make the girls is waving .	this school who should n't make the girls are waving .
the truck who the shirts help has n't answered the room .	the truck who the shirts help have n't answered the room .
the school who will bring the children was n't making that doctor .	the school who will bring the children were n't making that doctor .
those buttons who were n't listening to this plate were n't painting .	those buttons who were n't listening to this plate was n't painting .
this museum who these schools worked with is n't bothering this book .	this museum who these schools worked with are n't bothering this book .
the car who those books had n't scared is n't waving .	the car who those books had n't scared are n't waving .
that fork who those schools bother does n't practice .	that fork who those schools bother do n't practice .
this dish who answered these forks has heard the truck .	this dish who answered these forks have heard the truck .
these boats who are n't keeping that adult do help that school .	these boats who are n't keeping that adult does help that school .
that ship who works with these shoes has cleaned the girl .	that ship who works with these shoes have cleaned the girl .
the bottles who do n't work with the car do n't move that person .	the bottles who do n't work with the car does n't move that person .
the museum who the trucks were talking to does n't lift that guy .	the museum who the trucks were talking to do n't lift that guy .
these schools who this spoon can answer are visiting the spoon .	these schools who this spoon can answer is visiting the spoon .
the school who the books talked to has n't yelled .	the school who the books talked to have n't yelled .
these cups who were losing the person do answer the museum .	these cups who were losing the person does answer the museum .
this glass who those toys can n't talk to has n't found those toys .	this glass who those toys can n't talk to have n't found those toys .
those trucks who the dish bothered are making the men .	those trucks who the dish bothered is making the men .
this rug who these chairs care for has n't waved .	this rug who these chairs care for have n't waved .
that fork who bothered these pictures was bothering those beds .	that fork who bothered these pictures were bothering those beds .
that book who the dishes lost is n't singing .	that book who the dishes lost are n't singing .
that shirt who those cars do n't praise was n't practicing .	that shirt who those cars do n't praise were n't practicing .
those crayons who make that king have n't found the mirror .	those crayons who make that king has n't found the mirror .
this museum who the cars could n't praise has n't fixed this patient .	this museum who the cars could n't praise have n't fixed this patient .
these dishes who that box has n't answered have n't kept that doctor .	these dishes who that box has n't answered has n't kept that doctor .
the bed who those shoes work with does smile .	the bed who those shoes work with do smile .
the mirror who may care for those plates has n't lost this rocket .	the mirror who may care for those plates have n't lost this rocket .
that bank who these cars can n't praise does n't talk .	that bank who these cars can n't praise do n't talk .
the forks who have n't confused this crayon are helping the dolls .	the forks who have n't confused this crayon is helping the dolls .
the shoes who this bottle bothered have bought those people .	the shoes who this bottle bothered has bought those people .
the shirts who moved this man do n't hear those pictures .	the shirts who moved this man does n't hear those pictures .
those cars who may fix the woman do know these dolls .	those cars who may fix the woman does know these dolls .
the hospital who the shoes had answered does lift this doctor .	the hospital who the shoes had answered do lift this doctor .
the plates who are bothering this door have n't yelled .	the plates who are bothering this door has n't yelled .
that room who scares the forks has confused that bag .	that room who scares the forks have confused that bag .
this plane who these trucks confused is n't talking to those bags .	this plane who these trucks confused are n't talking to those bags .
the bottles who this plane could work with do n't hear the library .	the bottles who this plane could work with does n't hear the library .
the window who these books would n't answer was listening to this hospital .	the window who these books would n't answer were listening to this hospital .
those shirts who should n't lift the lady do scare this box .	those shirts who should n't lift the lady does scare this box .
that car who these spoons are n't bothering was losing .	that car who these spoons are n't bothering were losing .
the plate who those books would n't help does sell this woman .	the plate who those books would n't help do sell this woman .
the museum who will praise the books has n't heard that room .	the museum who will praise the books have n't heard that room .
those windows who will fix this guy have n't scared those books .	those windows who will fix this guy has n't scared those books .
this chair who the forks help does n't scare those books .	this chair who the forks help do n't scare those books .
that ring who could drop these doctors is n't buying the child .	that ring who could drop these doctors are n't buying the child .
those toys who the couch was working with have bought these men .	those toys who the couch was working with has bought these men .
those rooms who held the doctor have lost .	those rooms who held the doctor has lost .
this plane who these dishes were listening to has n't laughed .	this plane who these dishes were listening to have n't laughed .
the cup who these bowls bothered has lost .	the cup who these bowls bothered have lost .
the park who the pictures helped does bring that king .	the park who the pictures helped do bring that king .
this park who these crayons should n't bother has taught that ring .	this park who these crayons should n't bother have taught that ring .
this bank who is n't bothering the shirts does n't steal the women .	this bank who is n't bothering the shirts do n't steal the women .
the trucks who that candle would talk to do take the children .	the trucks who that candle would talk to does take the children .
the museum who the buttons are n't bothering does talk .	the museum who the buttons are n't bothering do talk .
that cup who the books had n't lost has cried .	that cup who the books had n't lost have cried .
those hats who take that queen do n't know this bowl .	those hats who take that queen does n't know this bowl .
the fork who the books are listening to has n't kept that patient .	the fork who the books are listening to have n't kept that patient .
this hospital who lost the children does n't lose .	this hospital who lost the children do n't lose .
the kitchen who should praise the bags was n't bringing that dancer .	the kitchen who should praise the bags were n't bringing that dancer .
this candle who these cars might answer does n't throw the girl .	this candle who these cars might answer do n't throw the girl .
this mirror who those bottles bothered is n't fixing these ladies .	this mirror who those bottles bothered are n't fixing these ladies .
those books who bothered the chair do shake this guy .	those books who bothered the chair does shake this guy .
those cars who this rug would n't listen to have n't held those children .	those cars who this rug would n't listen to has n't held those children .
the books who can n't bother the rocket are losing .	the books who can n't bother the rocket is losing .
this window who talked to these cups was whispering .	this window who talked to these cups were whispering .
those bowls who do n't clean the patient have fixed the doctor .	those bowls who do n't clean the patient has fixed the doctor .
that book who visited these bags does n't answer the cars .	that book who visited these bags do n't answer the cars .
that book who had bothered the pictures has confused those books .	that book who had bothered the pictures have confused those books .
these schools who have kept that lady do n't hear that plane .	these schools who have kept that lady does n't hear that plane .
that button who had thrown those women does n't drop that adult .	that button who had thrown those women do n't drop that adult .
the dishes who answered that box have n't talked .	the dishes who answered that box has n't talked .
the park who the cups bother does n't know the forks .	the park who the cups bother do n't know the forks .
the restaurant who the buttons had n't helped does n't worry these cars .	the restaurant who the buttons had n't helped do n't worry these cars .
the bowls who help this bicycle have scared the schools .	the bowls who help this bicycle has scared the schools .
the schools who this restaurant had bothered do n't care for this shoe .	the schools who this restaurant had bothered does n't care for this shoe .
the schools who could praise that toy do n't appreciate these windows .	the schools who could praise that toy does n't appreciate these windows .
those dishes who have n't fixed this dentist are shaking that adult .	those dishes who have n't fixed this dentist is shaking that adult .
those bags who this button wo n't care for do n't win .	those bags who this button wo n't care for does n't win .
that spoon who those shirts confused has cried .	that spoon who those shirts confused have cried .
those cars who helped the door are reading .	those cars who helped the door is reading .
the doll who those toys must talk to was n't singing .	the doll who those toys must talk to were n't singing .
these boats who do n't bring this woman do teach this car .	these boats who do n't bring this woman does teach this car .
those books who drop that adult were listening to the book .	those books who drop that adult was listening to the book .
the box who the boats answered does cry .	the box who the boats answered do cry .
that mirror who those shoes worked with is n't teaching those toys .	that mirror who those shoes worked with are n't teaching those toys .
that rocket who these dolls are n't talking to does n't steal that queen .	that rocket who these dolls are n't talking to do n't steal that queen .
the glasses who are n't taking this teacher have heard the shirts .	the glasses who are n't taking this teacher has heard the shirts .
those buttons who fixed the king have n't heard the cup .	those buttons who fixed the king has n't heard the cup .
the schools who that kitchen had bothered do win .	the schools who that kitchen had bothered does win .
this button who the hats answer is practicing .	this button who the hats answer are practicing .
these books who are n't helping that crayon do read .	these books who are n't helping that crayon does read .
the shoes who had confused that rug are n't singing .	the shoes who had confused that rug is n't singing .
the pictures who have moved the dentist have dropped this dentist .	the pictures who have moved the dentist has dropped this dentist .
the doors who confused that school have n't talked .	the doors who confused that school has n't talked .
that car who the books have confused does know that bowl .	that car who the books have confused do know that bowl .
this library who these doors have worked with has heard this doll .	this library who these doors have worked with have heard this doll .
the glass who these candles talk to was n't shaking those people .	the glass who these candles talk to were n't shaking those people .
this couch who these schools were n't visiting does n't lose that person .	this couch who these schools were n't visiting do n't lose that person .
these bottles who that crayon has n't bothered do know these books .	these bottles who that crayon has n't bothered does know these books .
this mall who was n't cleaning the girls does n't find that dentist .	this mall who was n't cleaning the girls do n't find that dentist .
those books who that truck is bothering have n't laughed .	those books who that truck is bothering has n't laughed .
that shirt who the crayons work with is moving this dancer .	that shirt who the crayons work with are moving this dancer .
that kitchen who the chairs were talking to does scare these chairs .	that kitchen who the chairs were talking to do scare these chairs .
that chair who could bring these teachers has lost the driver .	that chair who could bring these teachers have lost the driver .
this cup who the trucks talked to was n't making the boys .	this cup who the trucks talked to were n't making the boys .
these bowls who are making this doctor have taught that chair .	these bowls who are making this doctor has taught that chair .
this door who was talking to those candles is n't visiting the plane .	this door who was talking to those candles are n't visiting the plane .
the button who can n't fix these children does take the doctors .	the button who can n't fix these children do take the doctors .
that room who these forks should n't care for has n't won .	that room who these forks should n't care for have n't won .
this dish who has n't talked to the glasses has n't bothered the hats .	this dish who has n't talked to the glasses have n't bothered the hats .
this couch who these books care for does n't bring the ladies .	this couch who these books care for do n't bring the ladies .
those schools who could n't throw this customer are dropping the customer .	those schools who could n't throw this customer is dropping the customer .
the rocket who those rooms scare has moved the doctor .	the rocket who those rooms scare have moved the doctor .
these hats who this truck had n't scared do n't lose .	these hats who this truck had n't scared does n't lose .
the shirt who does n't praise the bags has n't lost this teacher .	the shirt who does n't praise the bags have n't lost this teacher .
those windows who this bowl could visit do talk .	those windows who this bowl could visit does talk .
these schools who the plate would n't bother do listen to the windows .	these schools who the plate would n't bother does listen to the windows .
those rings who throw this king were n't visiting these boats .	those rings who throw this king was n't visiting these boats .
these glasses who took that king were n't working with the rug .	these glasses who took that king was n't working with the rug .
the cars who bothered this plate do n't work with this mall .	the cars who bothered this plate does n't work with this mall .
the rings who have n't answered that kitchen have n't made the teacher .	the rings who have n't answered that kitchen has n't made the teacher .
that chair who had worked with the candles is n't holding that adult .	that chair who had worked with the candles are n't holding that adult .
that bicycle who these dishes talk to does n't sell that teacher .	that bicycle who these dishes talk to do n't sell that teacher .
the button who these pictures scared has lost .	the button who these pictures scared have lost .
this window who the rooms would n't talk to is yelling .	this window who the rooms would n't talk to are yelling .
those toys who will scare that plane do buy the lady .	those toys who will scare that plane does buy the lady .
those schools who were n't visiting the ring do n't keep that patient .	those schools who were n't visiting the ring does n't keep that patient .
this cup who the spoons are working with does n't answer the bottles .	this cup who the spoons are working with do n't answer the bottles .
these shirts who the candle was listening to are helping these books .	these shirts who the candle was listening to is helping these books .
these crayons who might visit the kitchen have found that hat .	these crayons who might visit the kitchen has found that hat .
the windows who bring the queen were working with this door .	the windows who bring the queen was working with this door .
this ring who was bothering the cups does n't keep the people .	this ring who was bothering the cups do n't keep the people .
that shoe who these hats have scared is listening to these schools .	that shoe who these hats have scared are listening to these schools .
the schools who the dish talked to are finding this driver .	the schools who the dish talked to is finding this driver .
that school who these pictures had n't worked with does n't yell .	that school who these pictures had n't worked with do n't yell .
that fork who makes the people does practice .	that fork who makes the people do practice .
the beds who might praise that museum do n't work with the chair .	the beds who might praise that museum does n't work with the chair .
the school who has n't bothered these boxes does know these trucks .	the school who has n't bothered these boxes do know these trucks .
these hats who this book is n't visiting have n't heard that plane .	these hats who this book is n't visiting has n't heard that plane .
the chairs who would n't have this doctor do stretch .	the chairs who would n't have this doctor does stretch .
the dishes who scared that candle were n't screaming .	the dishes who scared that candle was n't screaming .
that picture who should n't lose these men does scream .	that picture who should n't lose these men do scream .
the school who those dolls should praise was moving the customer .	the school who those dolls should praise were moving the customer .
these boxes who the bottle should listen to do lose .	these boxes who the bottle should listen to does lose .
this car who those schools can listen to has painted .	this car who those schools can listen to have painted .
this shirt who these buttons are n't working with has n't confused this bicycle .	this shirt who these buttons are n't working with have n't confused this bicycle .
that rocket who took those girls does n't listen to the plates .	that rocket who took those girls do n't listen to the plates .
these shoes who that crayon lost do move that teacher .	these shoes who that crayon lost does move that teacher .
the crayon who was talking to the cups was working with these books .	the crayon who was talking to the cups were working with these books .
this rug who the boats were n't listening to does n't win .	this rug who the boats were n't listening to do n't win .
this room who is fixing these guys does lose .	this room who is fixing these guys do lose .
these beds who shake that dentist have n't bothered the park .	these beds who shake that dentist has n't bothered the park .
these toys who could n't hold this woman do steal this child .	these toys who could n't hold this woman does steal this child .
that book who those dishes were n't visiting does n't hear these hats .	that book who those dishes were n't visiting do n't hear these hats .
this ring who the schools have confused does scream .	this ring who the schools have confused do scream .
those chairs who scared the book have read .	those chairs who scared the book has read .
those bottles who the plate was visiting do n't lift this driver .	those bottles who the plate was visiting does n't lift this driver .
that bank who might have the children does n't understand this crayon .	that bank who might have the children do n't understand this crayon .
those rooms who this door may work with do teach the dolls .	those rooms who this door may work with does teach the dolls .
these trucks who have talked to that hat are n't bringing those teachers .	these trucks who have talked to that hat is n't bringing those teachers .
these books who can n't work with that bag have n't taken the guy .	these books who can n't work with that bag has n't taken the guy .
that button who these beds have n't visited has n't taught that park .	that button who these beds have n't visited have n't taught that park .
that plate who wo n't visit the pictures was n't crying .	that plate who wo n't visit the pictures were n't crying .
these spoons who have n't scared that school do scare that book .	these spoons who have n't scared that school does scare that book .
the candles who that bed was bothering are bothering the truck .	the candles who that bed was bothering is bothering the truck .
these bags who that hospital has bothered do work with the shoes .	these bags who that hospital has bothered does work with the shoes .
these buttons who confused that bicycle were working with the park .	these buttons who confused that bicycle was working with the park .
that bicycle who should n't help the glasses does hear the cars .	that bicycle who should n't help the glasses do hear the cars .
this glass who those forks can help does n't help those shirts .	this glass who those forks can help do n't help those shirts .
these spoons who that bottle has n't visited have confused this window .	these spoons who that bottle has n't visited has confused this window .
these trucks who have n't held this boy have made those doctors .	these trucks who have n't held this boy has made those doctors .
these glasses who took this patient do n't shake this driver .	these glasses who took this patient does n't shake this driver .
the candles who the box talks to do n't clean this driver .	the candles who the box talks to does n't clean this driver .
that ring who these hats scared has confused the rocket .	that ring who these hats scared have confused the rocket .
the fork who those bottles were n't bothering has bothered that bed .	the fork who those bottles were n't bothering have bothered that bed .
the bags who should keep the child do n't help these glasses .	the bags who should keep the child does n't help these glasses .
these candles who praise the hat have moved this patient .	these candles who praise the hat has moved this patient .
those candles who were holding this lady do laugh .	those candles who were holding this lady does laugh .
those bottles who dropped that dancer were n't listening to that book .	those bottles who dropped that dancer was n't listening to that book .
that car who the rooms had n't visited has heard this shoe .	that car who the rooms had n't visited have heard this shoe .
the dish who the boats had n't helped does hear those bags .	the dish who the boats had n't helped do hear those bags .
this cup who the cups have n't talked to is n't visiting the rug .	this cup who the cups have n't talked to are n't visiting the rug .
these forks who the car did n't visit do work with that hospital .	these forks who the car did n't visit does work with that hospital .
the button who the bags work with does scream .	the button who the bags work with do scream .
the book who has n't lost these men was n't shaking the dentist .	the book who has n't lost these men were n't shaking the dentist .
the chairs who this school scared are n't practicing .	the chairs who this school scared is n't practicing .
those cars who work with that car do n't talk .	those cars who work with that car does n't talk .
this rug who these candles work with does worry this box .	this rug who these candles work with do worry this box .
the school who these schools would care for has n't waved .	the school who these schools would care for have n't waved .
these boxes who are n't bothering the door have waved .	these boxes who are n't bothering the door has waved .
that school who these cars bothered does worry the cars .	that school who these cars bothered do worry the cars .
those plates who this bicycle is n't visiting do n't practice .	those plates who this bicycle is n't visiting does n't practice .
the plate who was n't taking these boys was cleaning these women .	the plate who was n't taking these boys were cleaning these women .
this shirt who these rings might help does appreciate the beds .	this shirt who these rings might help do appreciate the beds .
that plane who those crayons bothered does fix the driver .	that plane who those crayons bothered do fix the driver .
the glasses who the crayon has n't helped do n't praise the shirt .	the glasses who the crayon has n't helped does n't praise the shirt .
those pictures who would steal the driver do know the windows .	those pictures who would steal the driver does know the windows .
those hats who that book answered do cough .	those hats who that book answered does cough .
the truck who the buttons worked with has n't heard that rocket .	the truck who the buttons worked with have n't heard that rocket .
that spoon who confused those boxes does n't throw these doctors .	that spoon who confused those boxes do n't throw these doctors .
the chair who held the doctors is n't talking to these toys .	the chair who held the doctors are n't talking to these toys .
the bottle who is listening to those plates does n't know this toy .	the bottle who is listening to those plates do n't know this toy .
those candles who that library may praise were teaching the bag .	those candles who that library may praise was teaching the bag .
the kitchen who these crayons had n't worked with is holding this customer .	the kitchen who these crayons had n't worked with are holding this customer .
the forks who have this driver have yelled .	the forks who have this driver has yelled .
the cars who the shoe is n't visiting do n't worry this shirt .	the cars who the shoe is n't visiting does n't worry this shirt .
those cups who that chair scares were n't helping this bicycle .	those cups who that chair scares was n't helping this bicycle .
these bowls who listen to this candle have yelled .	these bowls who listen to this candle has yelled .
these schools who had moved this king do n't read .	these schools who had moved this king does n't read .
this button who those dolls help does help that park .	this button who those dolls help do help that park .
the bed who these buttons did n't praise was n't throwing this patient .	the bed who these buttons did n't praise were n't throwing this patient .
those dishes who bother that mall do n't find that teacher .	those dishes who bother that mall does n't find that teacher .
those bags who this couch had talked to do smile .	those bags who this couch had talked to does smile .
those pictures who would work with the book have thrown this dentist .	those pictures who would work with the book has thrown this dentist .
that bed who had n't visited those bottles does cough .	that bed who had n't visited those bottles do cough .
that restaurant who was n't talking to these forks was n't laughing .	that restaurant who was n't talking to these forks were n't laughing .
the books who that hospital lost have lost those dishes .	the books who that hospital lost has lost those dishes .
those forks who could listen to the car are bothering this school .	those forks who could listen to the car is bothering this school .
the cars who keep this child have n't talked to the car .	the cars who keep this child has n't talked to the car .
these pictures who could n't steal this dancer do clean that lady .	these pictures who could n't steal this dancer does clean that lady .
that bag who those glasses have n't worked with does n't answer the dishes .	that bag who those glasses have n't worked with do n't answer the dishes .
the toys who had brought the queen do sing .	the toys who had brought the queen does sing .
this window who works with the dolls has n't worked with that truck .	this window who works with the dolls have n't worked with that truck .
the plane who those dishes had n't confused has lost that boy .	the plane who those dishes had n't confused have lost that boy .
the beds who wo n't work with this ring do cough .	the beds who wo n't work with this ring does cough .
the bottles who can praise that bed do n't find the guys .	the bottles who can praise that bed does n't find the guys .
this rocket who was n't helping these books has found the customer .	this rocket who was n't helping these books have found the customer .
this bottle who had n't made the people does n't answer the button .	this bottle who had n't made the people do n't answer the button .
these beds who that hospital was n't working with are n't visiting this fork .	these beds who that hospital was n't working with is n't visiting this fork .
the cars who that book confused do n't talk to those trucks .	the cars who that book confused does n't talk to those trucks .
that bottle who these spoons work with has bothered this bowl .	that bottle who these spoons work with have bothered this bowl .
this ring who had n't moved these guys has cleaned these people .	this ring who had n't moved these guys have cleaned these people .
the shoe who those rings visited has brought the dentist .	the shoe who those rings visited have brought the dentist .
those candles who talk to this car have n't read .	those candles who talk to this car has n't read .
the candle who was listening to those bags does know those books .	the candle who was listening to those bags do know those books .
those buttons who that box talked to do n't lose the girls .	those buttons who that box talked to does n't lose the girls .
the buttons who lose the patient do n't practice .	the buttons who lose the patient does n't practice .
that mirror who those dishes care for does laugh .	that mirror who those dishes care for do laugh .
the crayon who must drop those people does n't listen to those dishes .	the crayon who must drop those people do n't listen to those dishes .
the ship who did n't visit those candles has read .	the ship who did n't visit those candles have read .
that candle who confused the bottles does n't paint .	that candle who confused the bottles do n't paint .
the hats who have fixed that person have n't worried the boxes .	the hats who have fixed that person has n't worried the boxes .
that park who should take those boys is n't shaking this queen .	that park who should take those boys are n't shaking this queen .
those spoons who the ship lost do know those spoons .	those spoons who the ship lost does know those spoons .
that hospital who held the ladies does n't hear the ship .	that hospital who held the ladies do n't hear the ship .
that museum who these pictures worked with has made that man .	that museum who these pictures worked with have made that man .
the schools who that glass would answer do read .	the schools who that glass would answer does read .
these cups who this door was n't visiting have n't painted .	these cups who this door was n't visiting has n't painted .
those doors who had n't talked to that mirror do n't listen to this book .	those doors who had n't talked to that mirror does n't listen to this book .
those pictures who that shirt was n't listening to have yelled .	those pictures who that shirt was n't listening to has yelled .
those rings who had the driver do fix this lady .	those rings who had the driver does fix this lady .
this bowl who brings these teachers does n't praise that mirror .	this bowl who brings these teachers do n't praise that mirror .
these shoes who this ship could n't listen to are cleaning those doctors .	these shoes who this ship could n't listen to is cleaning those doctors .
that hospital who these boats work with has helped this bed .	that hospital who these boats work with have helped this bed .
these boxes who the hospital lost do buy the king .	these boxes who the hospital lost does buy the king .
the school who these crayons must talk to does cry .	the school who these crayons must talk to do cry .
the boats who the ring did n't care for do n't wave .	the boats who the ring did n't care for does n't wave .
these books who that doll could work with do sing .	these books who that doll could work with does sing .
the window who the shirts were helping does bother those hats .	the window who the shirts were helping do bother those hats .
the boat who these plates are helping does take this adult .	the boat who these plates are helping do take this adult .
those books who the bank would n't listen to do lose this queen .	those books who the bank would n't listen to does lose this queen .
these dishes who the cup works with do n't praise the glass .	these dishes who the cup works with does n't praise the glass .
those forks who that park was bothering were n't bothering that hospital .	those forks who that park was bothering was n't bothering that hospital .
that cup who talked to these toys has talked to this park .	that cup who talked to these toys have talked to this park .
this restaurant who dropped these girls has n't yelled .	this restaurant who dropped these girls have n't yelled .
that picture who throws the ladies was n't losing those doctors .	that picture who throws the ladies were n't losing those doctors .
those shoes who were n't losing this customer were helping these glasses .	those shoes who were n't losing this customer was helping these glasses .
that picture who cleaned those men does n't know those boats .	that picture who cleaned those men do n't know those boats .
this hat who these cups would n't listen to does n't help these schools .	this hat who these cups would n't listen to do n't help these schools .
this glass who should n't hold the men has kept those people .	this glass who should n't hold the men have kept those people .
the book who held those men does sing .	the book who held those men do sing .
the window who could n't scare the rings does practice .	the window who could n't scare the rings do practice .
that doll who scared these chairs does work with those shoes .	that doll who scared these chairs do work with those shoes .
the doll who did n't keep these children does n't read .	the doll who did n't keep these children do n't read .
those dishes who did n't bother the candle do n't answer those spoons .	those dishes who did n't bother the candle does n't answer those spoons .
those glasses who this bottle talked to do n't visit this book .	those glasses who this bottle talked to does n't visit this book .
this toy who the dishes should answer has n't bought those men .	this toy who the dishes should answer have n't bought those men .
this park who the crayons work with has found these chairs .	this park who the crayons work with have found these chairs .
those doors who may make this girl are helping these toys .	those doors who may make this girl is helping these toys .
those cars who work with this room do n't sell this customer .	those cars who work with this room does n't sell this customer .
those cars who are bringing that child have n't lost these bags .	those cars who are bringing that child has n't lost these bags .
the doll who shook these children has n't read .	the doll who shook these children have n't read .
the truck who had n't taken those ladies does yell .	the truck who had n't taken those ladies do yell .
the couch who was n't taking those people is fixing the queen .	the couch who was n't taking those people are fixing the queen .
the beds who that restaurant answered do throw the children .	the beds who that restaurant answered does throw the children .
those schools who this picture did n't scare are waving .	those schools who this picture did n't scare is waving .
the trucks who work with this bank do smile .	the trucks who work with this bank does smile .
this ship who is n't bothering the trucks has n't heard this bowl .	this ship who is n't bothering the trucks have n't heard this bowl .
the chair who talked to the plates has bought that lady .	the chair who talked to the plates have bought that lady .
those windows who lost the spoon do n't drop those girls .	those windows who lost the spoon does n't drop those girls .
the park who confused those shirts does n't smile .	the park who confused those shirts do n't smile .
the picture who the toys bother does fix these people .	the picture who the toys bother do fix these people .
the doors who have taken this driver do n't paint .	the doors who have taken this driver does n't paint .
that shoe who does n't throw the doctors does n't move this child .	that shoe who does n't throw the doctors do n't move this child .
these rooms who praise this boat do n't make that lady .	these rooms who praise this boat does n't make that lady .
the shoes who lost that toy have lost this person .	the shoes who lost that toy has lost this person .
those plates who this door wo n't answer do make that woman .	those plates who this door wo n't answer does make that woman .
these glasses who took that teacher do drop the adult .	these glasses who took that teacher does drop the adult .
these books who have lost this library were helping these doors .	these books who have lost this library was helping these doors .
the spoons who the car could visit have n't heard this school .	the spoons who the car could visit has n't heard this school .
the doors who this window works with do n't hear this shirt .	the doors who this window works with does n't hear this shirt .
those bowls who that truck is bothering have n't bothered the hat .	those bowls who that truck is bothering has n't bothered the hat .
that chair who was n't taking the women does n't visit this doll .	that chair who was n't taking the women do n't visit this doll .
this doll who visited those spoons has scared that crayon .	this doll who visited those spoons have scared that crayon .
the plates who that car should n't praise are laughing .	the plates who that car should n't praise is laughing .
these chairs who are n't talking to the bicycle do n't yell .	these chairs who are n't talking to the bicycle does n't yell .
those books who bothered the bag were n't taking that lady .	those books who bothered the bag was n't taking that lady .
this glass who would work with the glasses does fix this woman .	this glass who would work with the glasses do fix this woman .
the truck who is n't listening to these glasses is n't smiling .	the truck who is n't listening to these glasses are n't smiling .
the bottle who throws the people has n't visited these bottles .	the bottle who throws the people have n't visited these bottles .
the bottles who this bank was talking to are dropping that doctor .	the bottles who this bank was talking to is dropping that doctor .
this book who should n't visit these shoes was n't laughing .	this book who should n't visit these shoes were n't laughing .
these boats who this bicycle had n't bothered have n't found the lady .	these boats who this bicycle had n't bothered has n't found the lady .
those bottles who this ring should n't bother do n't hear that book .	those bottles who this ring should n't bother does n't hear that book .
those dolls who took this queen were listening to this rug .	those dolls who took this queen was listening to this rug .
the dishes who this museum must answer do n't praise the shirt .	the dishes who this museum must answer does n't praise the shirt .
that rug who moved those boys has n't confused the bank .	that rug who moved those boys have n't confused the bank .
those rings who that couch should visit have n't worried these schools .	those rings who that couch should visit has n't worried these schools .
the shoe who is talking to these shoes does n't find this dentist .	the shoe who is talking to these shoes do n't find this dentist .
these forks who are talking to this mall do sneeze .	these forks who are talking to this mall does sneeze .
that fork who confused those chairs has found those women .	that fork who confused those chairs have found those women .
the beds who the car has confused were practicing .	the beds who the car has confused was practicing .
these cups who this cup had visited have n't taken the woman .	these cups who this cup had visited has n't taken the woman .
this hospital who is n't working with the books is n't throwing the child .	this hospital who is n't working with the books are n't throwing the child .
the boats who the crayon will visit do n't teach the candle .	the boats who the crayon will visit does n't teach the candle .
those spoons who moved that girl do hear the glass .	those spoons who moved that girl does hear the glass .
those rooms who talked to that couch do n't shake the guy .	those rooms who talked to that couch does n't shake the guy .
those schools who this bottle visited do n't worry the windows .	those schools who this bottle visited does n't worry the windows .
the chairs who visited the chair are losing the doctor .	the chairs who visited the chair is losing the doctor .
the toys who the school has worked with do read .	the toys who the school has worked with does read .
these candles who praise that library are n't moving these guys .	these candles who praise that library is n't moving these guys .
the hats who have n't scared the car are n't working with those shoes .	the hats who have n't scared the car is n't working with those shoes .
those rooms who steal this adult do whisper .	those rooms who steal this adult does whisper .
that button who is making those children does n't bother the boats .	that button who is making those children do n't bother the boats .
that shoe who the beds confused has n't fixed the dentist .	that shoe who the beds confused have n't fixed the dentist .
those pictures who were losing the dancer have n't made that person .	those pictures who were losing the dancer has n't made that person .
this kitchen who the dishes lost is n't whispering .	this kitchen who the dishes lost are n't whispering .
the bowls who the car was working with have n't lost .	the bowls who the car was working with has n't lost .
the toy who talked to those windows is painting .	the toy who talked to those windows are painting .
these shirts who had talked to the mirror do n't buy this girl .	these shirts who had talked to the mirror does n't buy this girl .
that book who had n't answered those cars has n't made those people .	that book who had n't answered those cars have n't made those people .
those glasses who this cup talks to have n't cleaned the men .	those glasses who this cup talks to has n't cleaned the men .
the candles who bring this dancer do n't steal this doctor .	the candles who bring this dancer does n't steal this doctor .
these schools who will move the girl have scared these pictures .	these schools who will move the girl has scared these pictures .
the hats who sell that girl do drop the driver .	the hats who sell that girl does drop the driver .
those glasses who had n't lost the person were buying the children .	those glasses who had n't lost the person was buying the children .
that room who these plates talked to was n't fixing that man .	that room who these plates talked to were n't fixing that man .
these bottles who were helping the shoe were holding this king .	these bottles who were helping the shoe was holding this king .
these shirts who would n't have that person do listen to that picture .	these shirts who would n't have that person does listen to that picture .
the shirts who the picture should listen to do bother the doors .	the shirts who the picture should listen to does bother the doors .
that book who the boats are n't working with was n't bothering these spoons .	that book who the boats are n't working with were n't bothering these spoons .
that ship who was n't moving these people does n't hear the restaurant .	that ship who was n't moving these people do n't hear the restaurant .
that ship who makes these men has n't worried that bottle .	that ship who makes these men have n't worried that bottle .
this cup who those glasses care for does n't make these men .	this cup who those glasses care for do n't make these men .
those forks who move this king were practicing .	those forks who move this king was practicing .
this bank who can fix these women does n't visit those trucks .	this bank who can fix these women do n't visit those trucks .
the rings who are listening to the restaurant do n't cough .	the rings who are listening to the restaurant does n't cough .
this museum who held these teachers has thrown this man .	this museum who held these teachers have thrown this man .
the doll who was helping the hats is n't painting .	the doll who was helping the hats are n't painting .
those windows who this hat is n't talking to have n't dropped these girls .	those windows who this hat is n't talking to has n't dropped these girls .
the cars who praise the park are n't losing .	the cars who praise the park is n't losing .
this cup who scares the bags has visited the rings .	this cup who scares the bags have visited the rings .
the boats who can n't listen to this hospital do make the guys .	the boats who can n't listen to this hospital does make the guys .
those bowls who had thrown this boy do scare the hat .	those bowls who had thrown this boy does scare the hat .
the car who those plates were talking to was n't talking .	the car who those plates were talking to were n't talking .
these shoes who the ring was listening to do n't talk .	these shoes who the ring was listening to does n't talk .
this mirror who is throwing those ladies is n't working with these cars .	this mirror who is throwing those ladies are n't working with these cars .
these chairs who move that queen have made the doctors .	these chairs who move that queen has made the doctors .
those doors who this shoe was helping have n't talked to the rocket .	those doors who this shoe was helping has n't talked to the rocket .
those bottles who the school has lost were painting .	those bottles who the school has lost was painting .
this book who fixed these people was bothering these books .	this book who fixed these people were bothering these books .
these cars who steal the guy do laugh .	these cars who steal the guy does laugh .
the rooms who have kept that man were dropping these doctors .	the rooms who have kept that man was dropping these doctors .
the dish who keeps these men has worked with the kitchen .	the dish who keeps these men have worked with the kitchen .
those spoons who talk to the car are reading .	those spoons who talk to the car is reading .
this ring who those boxes help has scared the room .	this ring who those boxes help have scared the room .
those buttons who held the dancer are n't reading .	those buttons who held the dancer is n't reading .
those bags who were n't bothering this truck have n't heard those doors .	those bags who were n't bothering this truck has n't heard those doors .
the crayons who this shoe was bothering are buying this woman .	the crayons who this shoe was bothering is buying this woman .
this truck who the cars are n't bothering does n't lose .	this truck who the cars are n't bothering do n't lose .
the books who the window should n't help have n't cleaned that customer .	the books who the window should n't help has n't cleaned that customer .
those boxes who may praise that ring have visited the shirts .	those boxes who may praise that ring has visited the shirts .
that rug who those hats were n't helping was bothering the buttons .	that rug who those hats were n't helping were bothering the buttons .
the hats who could n't answer this dish are whispering .	the hats who could n't answer this dish is whispering .
the books who talked to the bag were finding that driver .	the books who talked to the bag was finding that driver .
these beds who should n't work with this bed have n't read .	these beds who should n't work with this bed has n't read .
these cups who had n't confused that boat have scared the shoes .	these cups who had n't confused that boat has scared the shoes .
these rings who that rocket wo n't scare do read .	these rings who that rocket wo n't scare does read .
this door who the bowls were working with has n't talked to these rings .	this door who the bowls were working with have n't talked to these rings .
that museum who those cars confused does n't paint .	that museum who those cars confused do n't paint .
the bottle who those bottles bother does sell this king .	the bottle who those bottles bother do sell this king .
that picture who fixed these teachers has taught these cars .	that picture who fixed these teachers have taught these cars .
that candle who those dishes answered has lost this doll .	that candle who those dishes answered have lost this doll .
the pictures who that car was n't talking to have n't lost .	the pictures who that car was n't talking to has n't lost .
these bowls who that bowl confused have n't kept the children .	these bowls who that bowl confused has n't kept the children .
this hat who those boats were working with does praise these forks .	this hat who those boats were working with do praise these forks .
those buttons who that bag was listening to do visit the boats .	those buttons who that bag was listening to does visit the boats .
the schools who this car does n't talk to have cried .	the schools who this car does n't talk to has cried .
this spoon who these shirts can n't listen to has heard the hat .	this spoon who these shirts can n't listen to have heard the hat .
that book who dropped those doctors has fixed this teacher .	that book who dropped those doctors have fixed this teacher .
the cars who that doll was working with do fix the patient .	the cars who that doll was working with does fix the patient .
the chairs who were n't working with that car do n't win .	the chairs who were n't working with that car does n't win .
the toy who had brought the children has n't worked with those boxes .	the toy who had brought the children have n't worked with those boxes .
that toy who could n't praise the cups is n't lying .	that toy who could n't praise the cups are n't lying .
the spoons who that bank has n't talked to have n't made the boys .	the spoons who that bank has n't talked to has n't made the boys .
the boats who that doll scares do n't buy this woman .	the boats who that doll scares does n't buy this woman .
these chairs who answer this school have answered this bank .	these chairs who answer this school has answered this bank .
the dish who scared these toys was buying the children .	the dish who scared these toys were buying the children .
that bag who did n't visit the forks does throw that lady .	that bag who did n't visit the forks do throw that lady .
the hospital who those schools talk to does practice .	the hospital who those schools talk to do practice .
these dolls who wo n't care for that school have n't read .	these dolls who wo n't care for that school has n't read .
the dolls who throw this patient do bother these cups .	the dolls who throw this patient does bother these cups .
these chairs who held that driver were n't talking to this school .	these chairs who held that driver was n't talking to this school .
the shirts who do n't listen to this bag were n't losing .	the shirts who do n't listen to this bag was n't losing .
the bowl who scares these shoes does n't bother this box .	the bowl who scares these shoes do n't bother this box .
that park who is listening to these hats has dropped this man .	that park who is listening to these hats have dropped this man .
that bed who works with the shoes does praise those candles .	that bed who works with the shoes do praise those candles .
the dishes who must throw this child do steal these men .	the dishes who must throw this child does steal these men .
those plates who were n't holding this patient were losing .	those plates who were n't holding this patient was losing .
that box who the cars are n't listening to was n't buying the driver .	that box who the cars are n't listening to were n't buying the driver .
that bowl who these bottles talk to does n't sneeze .	that bowl who these bottles talk to do n't sneeze .
that chair who the dishes answer was teaching these boxes .	that chair who the dishes answer were teaching these boxes .
this box who those plates scare does n't listen to those rings .	this box who those plates scare do n't listen to those rings .
the mirror who the schools have scared has heard this room .	the mirror who the schools have scared have heard this room .
these forks who fix the customer do n't talk to the books .	these forks who fix the customer does n't talk to the books .
this shirt who the cars could answer was n't making that teacher .	this shirt who the cars could answer were n't making that teacher .
the glasses who the glass had n't talked to do n't visit the library .	the glasses who the glass had n't talked to does n't visit the library .
this glass who those buttons were n't working with is n't keeping those people .	this glass who those buttons were n't working with are n't keeping those people .
these books who this museum could n't bother have confused the book .	these books who this museum could n't bother has confused the book .
those rings who were n't dropping that dentist have lost .	those rings who were n't dropping that dentist has lost .
the buttons who are n't making the dentist have n't talked to this cup .	the buttons who are n't making the dentist has n't talked to this cup .
the chair who was talking to those spoons is n't yelling .	the chair who was talking to those spoons are n't yelling .
these doors who this chair wo n't visit were smiling .	these doors who this chair wo n't visit was smiling .
the trucks who were taking this guy do n't praise the rug .	the trucks who were taking this guy does n't praise the rug .
the bed who works with the beds has heard those boxes .	the bed who works with the beds have heard those boxes .
the windows who the ship must work with have lost that mirror .	the windows who the ship must work with has lost that mirror .
this bed who these schools scared is visiting these dolls .	this bed who these schools scared are visiting these dolls .
this rug who those forks confused is n't whispering .	this rug who those forks confused are n't whispering .
the bags who this crayon could visit have lost .	the bags who this crayon could visit has lost .
this book who had lost these rings does hear the dolls .	this book who had lost these rings do hear the dolls .
the pictures who are n't bringing that customer do n't know this rug .	the pictures who are n't bringing that customer does n't know this rug .
these toys who that glass works with do n't listen to these cars .	these toys who that glass works with does n't listen to these cars .
that mirror who those rings listen to has yelled .	that mirror who those rings listen to have yelled .
those windows who the shirt is bothering are waving .	those windows who the shirt is bothering is waving .
this school who talked to those glasses does wave .	this school who talked to those glasses do wave .
this crayon who can take those women has taught this school .	this crayon who can take those women have taught this school .
these hats who this rug should bother do n't know the hat .	these hats who this rug should bother does n't know the hat .
this shirt who has n't confused the shoes has n't waved .	this shirt who has n't confused the shoes have n't waved .
the crayon who could n't drop the people has n't visited that library .	the crayon who could n't drop the people have n't visited that library .
this plate who these rings are bothering has answered the spoon .	this plate who these rings are bothering have answered the spoon .
the bag who the boxes may bother does praise that hat .	the bag who the boxes may bother do praise that hat .
the cars who were n't cleaning that queen do n't paint .	the cars who were n't cleaning that queen does n't paint .
this school who the buttons were n't bothering has n't helped that car .	this school who the buttons were n't bothering have n't helped that car .
those plates who care for this bowl do n't help that button .	those plates who care for this bowl does n't help that button .
the kitchen who these cups should scare does lie .	the kitchen who these cups should scare do lie .
those dishes who this bottle has n't answered have n't helped the restaurant .	those dishes who this bottle has n't answered has n't helped the restaurant .
the window who these books talked to was n't fixing this girl .	the window who these books talked to were n't fixing this girl .
these shirts who lost this lady are crying .	these shirts who lost this lady is crying .
these candles who threw that patient were n't bothering this doll .	these candles who threw that patient was n't bothering this doll .
these bowls who this bank could n't scare were helping the buttons .	these bowls who this bank could n't scare was helping the buttons .
this box who the spoons were n't visiting was singing .	this box who the spoons were n't visiting were singing .
the hats who work with that candle have talked .	the hats who work with that candle has talked .
the rooms who drop that doctor are visiting these books .	the rooms who drop that doctor is visiting these books .
the bag who these dolls had visited has lost .	the bag who these dolls had visited have lost .
the shirts who had lost this hospital do work with these bottles .	the shirts who had lost this hospital does work with these bottles .
the picture who wo n't hold those teachers does lose these teachers .	the picture who wo n't hold those teachers do lose these teachers .
those rooms who can n't scare the doll have n't fixed these people .	those rooms who can n't scare the doll has n't fixed these people .
these bags who work with the school are n't yelling .	these bags who work with the school is n't yelling .
this kitchen who the glasses praise does n't hear this restaurant .	this kitchen who the glasses praise do n't hear this restaurant .
that hat who these dolls had n't helped has n't scared this glass .	that hat who these dolls had n't helped have n't scared this glass .
the shirts who that library does n't praise have brought these men .	the shirts who that library does n't praise has brought these men .
the dishes who the fork answered do whisper .	the dishes who the fork answered does whisper .
these plates who are moving that adult do n't cry .	these plates who are moving that adult does n't cry .
these beds who may care for this crayon have worked with those bottles .	these beds who may care for this crayon has worked with those bottles .
this room who these plates do n't visit has heard the crayon .	this room who these plates do n't visit have heard the crayon .
these dolls who wo n't clean the teacher have waved .	these dolls who wo n't clean the teacher has waved .
these books who talk to that school were making this adult .	these books who talk to that school was making this adult .
the door who confused these shoes does n't answer this shirt .	the door who confused these shoes do n't answer this shirt .
the chairs who the shoe has scared do n't listen to the rings .	the chairs who the shoe has scared does n't listen to the rings .
those boats who shook the guy have n't talked .	those boats who shook the guy has n't talked .
this doll who those shoes had n't lost does scream .	this doll who those shoes had n't lost do scream .
the boats who the chair was n't visiting have brought this queen .	the boats who the chair was n't visiting has brought this queen .
the bowl who was n't losing the ladies does n't keep the doctor .	the bowl who was n't losing the ladies do n't keep the doctor .
these bottles who answer the box were helping that ship .	these bottles who answer the box was helping that ship .
the museum who these toys help does n't hear this ship .	the museum who these toys help do n't hear this ship .
those hats who should n't shake the patient have n't confused that window .	those hats who should n't shake the patient has n't confused that window .
this doll who the boxes visit does sell the guys .	this doll who the boxes visit do sell the guys .
the rocket who those plates wo n't work with does yell .	the rocket who those plates wo n't work with do yell .
the car who the dishes would n't help does practice .	the car who the dishes would n't help do practice .
this cup who had n't answered the cars is losing those guys .	this cup who had n't answered the cars are losing those guys .
that hat who those plates were talking to has lost the car .	that hat who those plates were talking to have lost the car .
the plate who those pictures bothered does n't visit these dolls .	the plate who those pictures bothered do n't visit these dolls .
this book who these boats must work with does know this rug .	this book who these boats must work with do know this rug .
these doors who stole that man have n't worked with the kitchen .	these doors who stole that man has n't worked with the kitchen .
this book who these plates have n't visited does n't cough .	this book who these plates have n't visited do n't cough .
the cup who scares those candles is n't buying the girls .	the cup who scares those candles are n't buying the girls .
those rings who shake this patient are bothering that mirror .	those rings who shake this patient is bothering that mirror .
the pictures who move that queen were n't making these girls .	the pictures who move that queen was n't making these girls .
those bags who this book had visited were working with this boat .	those bags who this book had visited was working with this boat .
the boat who those rings talk to was bringing that teacher .	the boat who those rings talk to were bringing that teacher .
that ship who the doors have n't helped is n't losing .	that ship who the doors have n't helped are n't losing .
this shoe who drops those men has n't cleaned that doctor .	this shoe who drops those men have n't cleaned that doctor .
that bed who wo n't scare the rings does buy the woman .	that bed who wo n't scare the rings do buy the woman .
the fork who could n't steal the ladies was throwing this driver .	the fork who could n't steal the ladies were throwing this driver .
this door who was n't bothering the schools was making the girl .	this door who was n't bothering the schools were making the girl .
these bowls who visit that candle do n't understand those toys .	these bowls who visit that candle does n't understand those toys .
the books who lose the man do n't cry .	the books who lose the man does n't cry .
the bowls who this window works with do n't sell the queen .	the bowls who this window works with does n't sell the queen .
that restaurant who does n't lose those doctors was laughing .	that restaurant who does n't lose those doctors were laughing .
that bag who had made these people has n't taught those schools .	that bag who had made these people have n't taught those schools .
these cars who the hospital talked to were n't moving the teacher .	these cars who the hospital talked to was n't moving the teacher .
these bottles who the park has n't visited do understand these schools .	these bottles who the park has n't visited does understand these schools .
the forks who are n't taking this man do paint .	the forks who are n't taking this man does paint .
those schools who make the woman were n't visiting these bags .	those schools who make the woman was n't visiting these bags .
those boats who have n't answered that library have n't kept those women .	those boats who have n't answered that library has n't kept those women .
the rings who care for this book do n't cough .	the rings who care for this book does n't cough .
that bag who those trucks worked with does lie .	that bag who those trucks worked with do lie .
that spoon who does n't listen to those hats is n't losing the woman .	that spoon who does n't listen to those hats are n't losing the woman .
the picture who is dropping those guys was n't moving the queen .	the picture who is dropping those guys were n't moving the queen .
that crayon who the doors helped does n't appreciate that picture .	that crayon who the doors helped do n't appreciate that picture .
that kitchen who those boxes praise does n't practice .	that kitchen who those boxes praise do n't practice .
this mirror who those shirts work with does n't take the doctor .	this mirror who those shirts work with do n't take the doctor .
these glasses who the chair was working with do work with the mirror .	these glasses who the chair was working with does work with the mirror .
the chairs who that rocket had n't worked with were smiling .	the chairs who that rocket had n't worked with was smiling .
the rings who had scared the school have n't kept this patient .	the rings who had scared the school has n't kept this patient .
the schools who clean the guy are n't listening to those dishes .	the schools who clean the guy is n't listening to those dishes .
those chairs who move the driver do n't wave .	those chairs who move the driver does n't wave .
the cup who these cars had bothered does work with those boxes .	the cup who these cars had bothered do work with those boxes .
that mirror who had n't talked to those boats has dropped those children .	that mirror who had n't talked to those boats have dropped those children .
the spoons who the button helps do visit those hats .	the spoons who the button helps does visit those hats .
the beds who work with the dish have read .	the beds who work with the dish has read .
these candles who are cleaning that doctor have bothered the shoe .	these candles who are cleaning that doctor has bothered the shoe .
these forks who this park would n't scare do n't care for the shirts .	these forks who this park would n't scare does n't care for the shirts .
the mall who has n't lost the chairs has made the boys .	the mall who has n't lost the chairs have made the boys .
the books who have n't lost that truck have n't moved the teachers .	the books who have n't lost that truck has n't moved the teachers .
these plates who this dish confused have n't lost .	these plates who this dish confused has n't lost .
these forks who this spoon could scare do yell .	these forks who this spoon could scare does yell .
those schools who are bothering the dish were n't losing .	those schools who are bothering the dish was n't losing .
these chairs who are helping that truck have n't found this book .	these chairs who are helping that truck has n't found this book .
this candle who the trucks had helped does move that child .	this candle who the trucks had helped do move that child .
this glass who had n't moved those boys has n't taught that ring .	this glass who had n't moved those boys have n't taught that ring .
the bowls who the door was listening to have n't lost the lady .	the bowls who the door was listening to has n't lost the lady .
those schools who are n't holding this adult are waving .	those schools who are n't holding this adult is waving .
those windows who had talked to that hat do lie .	those windows who had talked to that hat does lie .
these beds who the shoe scares have lost .	these beds who the shoe scares has lost .
those books who must listen to the box have n't cried .	those books who must listen to the box has n't cried .
those rooms who are n't throwing the man do n't answer that mirror .	those rooms who are n't throwing the man does n't answer that mirror .
this ship who makes those children was n't visiting the books .	this ship who makes those children were n't visiting the books .
the schools who this book scares do win .	the schools who this book scares does win .
those books who this bag visited do cry .	those books who this bag visited does cry .
the shoe who threw the doctors does lift that lady .	the shoe who threw the doctors do lift that lady .
those chairs who answered that mall do paint .	those chairs who answered that mall does paint .
those shirts who that rocket does n't bother do n't bother those rings .	those shirts who that rocket does n't bother does n't bother those rings .
that car who can take these women has won .	that car who can take these women have won .
the spoons who talk to this crayon do make that girl .	the spoons who talk to this crayon does make that girl .
the hospital who those glasses should talk to does help that park .	the hospital who those glasses should talk to do help that park .
those bowls who could bring that girl do clean that boy .	those bowls who could bring that girl does clean that boy .
the book who these trucks worked with does scare these books .	the book who these trucks worked with do scare these books .
the park who the books confused does sneeze .	the park who the books confused do sneeze .
those toys who worked with the ring do n't cry .	those toys who worked with the ring does n't cry .
the beds who had n't confused this picture are n't helping these beds .	the beds who had n't confused this picture is n't helping these beds .
these pictures who this car has bothered are n't dropping this patient .	these pictures who this car has bothered is n't dropping this patient .
the mall who can lift these men does n't know the forks .	the mall who can lift these men do n't know the forks .
these dishes who this shirt had n't talked to have visited those dishes .	these dishes who this shirt had n't talked to has visited those dishes .
these books who that bicycle answered do n't cough .	these books who that bicycle answered does n't cough .
the books who keep the king are working with the glasses .	the books who keep the king is working with the glasses .
this truck who has lost those cars has heard those hats .	this truck who has lost those cars have heard those hats .
those cars who steal the adult have n't bought that lady .	those cars who steal the adult has n't bought that lady .
these chairs who that cup did n't answer were buying that boy .	these chairs who that cup did n't answer was buying that boy .
the mirror who has n't visited the rings does n't visit those rings .	the mirror who has n't visited the rings do n't visit those rings .
these cars who have n't scared that button are n't whispering .	these cars who have n't scared that button is n't whispering .
the kitchen who these plates were n't visiting does n't hear these rings .	the kitchen who these plates were n't visiting do n't hear these rings .
that fork who talked to the plates was making that boy .	that fork who talked to the plates were making that boy .
the glass who these hats help has scared the candle .	the glass who these hats help have scared the candle .
that dish who those cars scare has n't found those pictures .	that dish who those cars scare have n't found those pictures .
this bag who talked to these bags has n't heard the doors .	this bag who talked to these bags have n't heard the doors .
the ship who those doors should talk to does bother that rocket .	the ship who those doors should talk to do bother that rocket .
this bicycle who had n't made those men was screaming .	this bicycle who had n't made those men were screaming .
this doll who would talk to the schools does talk to the mall .	this doll who would talk to the schools do talk to the mall .
those forks who the plane was n't working with do n't hear the spoons .	those forks who the plane was n't working with does n't hear the spoons .
that truck who could n't keep the teachers is screaming .	that truck who could n't keep the teachers are screaming .
the dishes who bothered the ship are n't taking the customer .	the dishes who bothered the ship is n't taking the customer .
the plates who this button visited have n't answered that bank .	the plates who this button visited has n't answered that bank .
these bags who had dropped that king do cry .	these bags who had dropped that king does cry .
those toys who moved this child are talking .	those toys who moved this child is talking .
this window who these chairs confused is waving .	this window who these chairs confused are waving .
those rooms who had n't moved that driver have n't found those cups .	those rooms who had n't moved that driver has n't found those cups .
the buttons who are helping that bed do cough .	the buttons who are helping that bed does cough .
this bicycle who helps the plates does find the doctors .	this bicycle who helps the plates do find the doctors .
that hat who talked to those plates does n't practice .	that hat who talked to those plates do n't practice .
this book who lost the bowls has talked to the shirt .	this book who lost the bowls have talked to the shirt .
the couch who the crayons visited does n't work with these beds .	the couch who the crayons visited do n't work with these beds .
those cups who that shoe answered do n't win .	those cups who that shoe answered does n't win .
these dishes who have taken the customer do n't drop the teacher .	these dishes who have taken the customer does n't drop the teacher .
that truck who did n't take these ladies has won .	that truck who did n't take these ladies have won .
this couch who those windows can scare is whispering .	this couch who those windows can scare are whispering .
those books who the hospital wo n't visit were talking .	those books who the hospital wo n't visit was talking .
this park who the candles are n't listening to does sell this customer .	this park who the candles are n't listening to do sell this customer .
those rings who the hospital had answered have answered these rooms .	those rings who the hospital had answered has answered these rooms .
these windows who would lose that person are screaming .	these windows who would lose that person is screaming .
this book who these cars scare is n't listening to that bag .	this book who these cars scare are n't listening to that bag .
the bank who those books did n't help does have that queen .	the bank who those books did n't help do have that queen .
those schools who that fork scares do scare these bowls .	those schools who that fork scares does scare these bowls .
that bank who the hats answered was practicing .	that bank who the hats answered were practicing .
the bottle who is n't cleaning these girls does care for that rug .	the bottle who is n't cleaning these girls do care for that rug .
the dishes who held that lady have thrown these people .	the dishes who held that lady has thrown these people .
those shoes who must work with this dish do n't care for the picture .	those shoes who must work with this dish does n't care for the picture .
this car who should shake the women has n't laughed .	this car who should shake the women have n't laughed .
these boxes who would steal this child were lying .	these boxes who would steal this child was lying .
those cars who that doll is working with do n't exercise .	those cars who that doll is working with does n't exercise .
those bags who the hospital could n't visit are throwing that girl .	those bags who the hospital could n't visit is throwing that girl .
those toys who could make this girl are n't fixing the guy .	those toys who could make this girl is n't fixing the guy .
the dish who talks to the bowls is yelling .	the dish who talks to the bowls are yelling .
those cars who care for the crayon do answer this mall .	those cars who care for the crayon does answer this mall .
that ship who talks to the schools does n't buy these guys .	that ship who talks to the schools do n't buy these guys .
the mirror who these boats listen to was n't throwing this queen .	the mirror who these boats listen to were n't throwing this queen .
the cars who worked with this mirror have talked to the forks .	the cars who worked with this mirror has talked to the forks .
these rooms who this truck should help do cough .	these rooms who this truck should help does cough .
these glasses who were n't fixing the adult do praise these shoes .	these glasses who were n't fixing the adult does praise these shoes .
the book who has n't visited those chairs does appreciate that box .	the book who has n't visited those chairs do appreciate that box .
the rug who these candles did n't visit is n't laughing .	the rug who these candles did n't visit are n't laughing .
this library who the trucks bothered does n't appreciate the bowl .	this library who the trucks bothered do n't appreciate the bowl .
these toys who bring this lady are n't singing .	these toys who bring this lady is n't singing .
that dish who these beds did n't help does n't lose .	that dish who these beds did n't help do n't lose .
the mall who has lost the boys does scream .	the mall who has lost the boys do scream .
these rings who this shirt may talk to do n't lose that child .	these rings who this shirt may talk to does n't lose that child .
the museum who these glasses lost is n't painting .	the museum who these glasses lost are n't painting .
those schools who the bank would scare do scare that bag .	those schools who the bank would scare does scare that bag .
this bed who moves the guys has n't heard the bags .	this bed who moves the guys have n't heard the bags .
those crayons who this chair could praise do care for this rug .	those crayons who this chair could praise does care for this rug .
the dolls who would n't scare that plate do n't paint .	the dolls who would n't scare that plate does n't paint .
those bags who the toy was helping are talking .	those bags who the toy was helping is talking .
those candles who the book does n't visit do talk to the ring .	those candles who the book does n't visit does talk to the ring .
those hats who talk to this bank have n't talked .	those hats who talk to this bank has n't talked .
these books who work with this fork have n't talked .	these books who work with this fork has n't talked .
these beds who this box lost are n't laughing .	these beds who this box lost is n't laughing .
the hospital who is visiting the pictures was losing .	the hospital who is visiting the pictures were losing .
that plate who the beds confused does bother those cars .	that plate who the beds confused do bother those cars .
that mirror who visited those bowls does n't drop that woman .	that mirror who visited those bowls do n't drop that woman .
those candles who this doll can listen to were n't practicing .	those candles who this doll can listen to was n't practicing .
that cup who the trucks can care for was lying .	that cup who the trucks can care for were lying .
these shirts who the doll could n't talk to have n't held the adult .	these shirts who the doll could n't talk to has n't held the adult .
that bottle who those books had talked to has n't answered this park .	that bottle who those books had talked to have n't answered this park .
the room who was n't talking to those dolls does praise this rocket .	the room who was n't talking to those dolls do praise this rocket .
the candle who can n't clean the guys does bring these men .	the candle who can n't clean the guys do bring these men .
the museum who is fixing these men has bothered this kitchen .	the museum who is fixing these men have bothered this kitchen .
the shoe who had n't visited these beds does work with those doors .	the shoe who had n't visited these beds do work with those doors .
those hats who listen to that window do have those children .	those hats who listen to that window does have those children .
that shirt who was visiting these buttons has worked with these glasses .	that shirt who was visiting these buttons have worked with these glasses .
the shoes who the school visited do n't paint .	the shoes who the school visited does n't paint .
the room who the boxes must help has confused that toy .	the room who the boxes must help have confused that toy .
these hats who wo n't bring the dentist have n't talked to the spoons .	these hats who wo n't bring the dentist has n't talked to the spoons .
those candles who that toy lost do throw that queen .	those candles who that toy lost does throw that queen .
these buttons who bothered this toy have lost .	these buttons who bothered this toy has lost .
the rug who these shirts are n't talking to has n't lost this doctor .	the rug who these shirts are n't talking to have n't lost this doctor .
those books who had n't lost this kitchen are losing .	those books who had n't lost this kitchen is losing .
this car who can n't steal the people was n't bothering this fork .	this car who can n't steal the people were n't bothering this fork .
the dishes who the room works with have worked with the restaurant .	the dishes who the room works with has worked with the restaurant .
those toys who this spoon will answer are holding this lady .	those toys who this spoon will answer is holding this lady .
those bottles who had n't bothered that library are cleaning this customer .	those bottles who had n't bothered that library is cleaning this customer .
that door who those bowls scare does n't lose .	that door who those bowls scare do n't lose .
these candles who lost that person do n't sell the driver .	these candles who lost that person does n't sell the driver .
the bottle who these rings do n't praise is n't making that adult .	the bottle who these rings do n't praise are n't making that adult .
these forks who this restaurant was listening to have bothered this plate .	these forks who this restaurant was listening to has bothered this plate .
these crayons who the rug was n't talking to do whisper .	these crayons who the rug was n't talking to does whisper .
those shirts who the school has helped have fixed those men .	those shirts who the school has helped has fixed those men .
the plates who the bed can n't visit do make those women .	the plates who the bed can n't visit does make those women .
these dishes who the bottle helped do care for the book .	these dishes who the bottle helped does care for the book .
this dish who might clean the men is n't bringing the teachers .	this dish who might clean the men are n't bringing the teachers .
these books who that picture has n't worked with have n't bought this dancer .	these books who that picture has n't worked with has n't bought this dancer .
this candle who these bottles had lost has n't fixed this adult .	this candle who these bottles had lost have n't fixed this adult .
this book who has n't lost the doctors has n't painted .	this book who has n't lost the doctors have n't painted .
this rocket who would visit the shirts does answer the car .	this rocket who would visit the shirts do answer the car .
that spoon who those boxes lost has n't moved those ladies .	that spoon who those boxes lost have n't moved those ladies .
those dishes who this window was helping do n't cough .	those dishes who this window was helping does n't cough .
those hats who visit that glass have n't won .	those hats who visit that glass has n't won .
this book who the books are n't helping does n't shake this driver .	this book who the books are n't helping do n't shake this driver .
that hat who has talked to those pictures was visiting this rug .	that hat who has talked to those pictures were visiting this rug .
that bottle who the candles lost has n't painted .	that bottle who the candles lost have n't painted .
the schools who that window was n't visiting do bring that queen .	the schools who that window was n't visiting does bring that queen .
those cars who were n't talking to that book were n't buying this driver .	those cars who were n't talking to that book was n't buying this driver .
those boats who that doll did n't scare do work with the plate .	those boats who that doll did n't scare does work with the plate .
the bed who these bottles are n't listening to is whispering .	the bed who these bottles are n't listening to are whispering .
that doll who those doors could visit was n't laughing .	that doll who those doors could visit were n't laughing .
that hospital who those plates would visit does scare the spoons .	that hospital who those plates would visit do scare the spoons .
those crayons who the hospital wo n't help do n't talk to the doll .	those crayons who the hospital wo n't help does n't talk to the doll .
the shirts who answered that mirror were n't finding that person .	the shirts who answered that mirror was n't finding that person .
the bags who had answered the school do win .	the bags who had answered the school does win .
this book who the plates had n't scared is n't taking the women .	this book who the plates had n't scared are n't taking the women .
the ring who helped the rings does n't exercise .	the ring who helped the rings do n't exercise .
that museum who these rings should n't listen to has n't bought the boys .	that museum who these rings should n't listen to have n't bought the boys .
the bed who those forks were n't bothering was n't singing .	the bed who those forks were n't bothering were n't singing .
this dish who these schools care for does n't wave .	this dish who these schools care for do n't wave .
this restaurant who fixed these guys does scare that button .	this restaurant who fixed these guys do scare that button .
those crayons who help that box were n't losing .	those crayons who help that box was n't losing .
these trucks who fixed the girl have won .	these trucks who fixed the girl has won .
that plate who these crayons can help has taken this customer .	that plate who these crayons can help have taken this customer .
the hat who was n't losing those people does sneeze .	the hat who was n't losing those people do sneeze .
the school who those shirts care for has n't scared this bowl .	the school who those shirts care for have n't scared this bowl .
this room who was taking the boys was finding this girl .	this room who was taking the boys were finding this girl .
this book who bothered the doors was laughing .	this book who bothered the doors were laughing .
the cars who were n't losing the boy do n't practice .	the cars who were n't losing the boy does n't practice .
those spoons who worked with this kitchen are n't painting .	those spoons who worked with this kitchen is n't painting .
that button who is talking to these dolls does n't read .	that button who is talking to these dolls do n't read .
that bottle who these dolls are n't talking to was n't fixing the women .	that bottle who these dolls are n't talking to were n't fixing the women .
that plate who is talking to the cars has read .	that plate who is talking to the cars have read .
these bottles who should sell that boy have laughed .	these bottles who should sell that boy has laughed .
that crayon who is bothering those crayons does n't understand these dolls .	that crayon who is bothering those crayons do n't understand these dolls .
these cars who talked to the car are finding that lady .	these cars who talked to the car is finding that lady .
these schools who this ring will bother have n't taught this book .	these schools who this ring will bother has n't taught this book .
the chairs who were helping the school do n't laugh .	the chairs who were helping the school does n't laugh .
the bags who the plate may scare were n't losing those guys .	the bags who the plate may scare was n't losing those guys .
these shirts who would n't fix the patient have heard the cars .	these shirts who would n't fix the patient has heard the cars .
this book who the doors visit has taught that park .	this book who the doors visit have taught that park .
this candle who was bothering these rings was n't holding the patient .	this candle who was bothering these rings were n't holding the patient .
that box who would n't make these women has won .	that box who would n't make these women have won .
this cup who those boats were n't helping does n't lose .	this cup who those boats were n't helping do n't lose .
the car who the dolls helped is taking this guy .	the car who the dolls helped are taking this guy .
these schools who could answer this mall do n't wave .	these schools who could answer this mall does n't wave .
this hospital who was n't visiting the cups has n't waved .	this hospital who was n't visiting the cups have n't waved .
these trucks who kept the customer do bother those shoes .	these trucks who kept the customer does bother those shoes .
the pictures who that kitchen had n't confused were n't visiting this couch .	the pictures who that kitchen had n't confused was n't visiting this couch .
that candle who shook those children does know that door .	that candle who shook those children do know that door .
that bed who scares those beds does work with the bed .	that bed who scares those beds do work with the bed .
those bags who this rug should work with do n't work with these spoons .	those bags who this rug should work with does n't work with these spoons .
that bicycle who wo n't move those guys has bothered these dishes .	that bicycle who wo n't move those guys have bothered these dishes .
those toys who this hat scares have talked to this book .	those toys who this hat scares has talked to this book .
these crayons who the room can n't talk to have heard the cars .	these crayons who the room can n't talk to has heard the cars .
that school who talks to those windows is n't lying .	that school who talks to those windows are n't lying .
this boat who those books were n't helping does n't exercise .	this boat who those books were n't helping do n't exercise .
the chairs who this room might listen to do move the person .	the chairs who this room might listen to does move the person .
those bottles who might take that king do n't whisper .	those bottles who might take that king does n't whisper .
that dish who is n't moving the ladies is n't buying the girls .	that dish who is n't moving the ladies are n't buying the girls .
that spoon who has n't visited the cars was cleaning the boy .	that spoon who has n't visited the cars were cleaning the boy .
these schools who were n't bothering this bowl do talk .	these schools who were n't bothering this bowl does talk .
those doors who have moved that woman were n't helping this hat .	those doors who have moved that woman was n't helping this hat .
those cars who the plate would answer do teach the cups .	those cars who the plate would answer does teach the cups .
these candles who had n't cleaned the man do n't bring that dentist .	these candles who had n't cleaned the man does n't bring that dentist .
that restaurant who these windows bothered does n't answer these shoes .	that restaurant who these windows bothered do n't answer these shoes .
this ship who the dishes help was n't moving the ladies .	this ship who the dishes help were n't moving the ladies .
this ring who wo n't bring the doctors has n't waved .	this ring who wo n't bring the doctors have n't waved .
those cars who this shirt bothered were crying .	those cars who this shirt bothered was crying .
the couch who the schools had lost is n't lying .	the couch who the schools had lost are n't lying .
this rocket who those trucks work with is n't talking .	this rocket who those trucks work with are n't talking .
this button who wo n't lift these ladies does cough .	this button who wo n't lift these ladies do cough .
this door who these plates care for was waving .	this door who these plates care for were waving .
those doors who this dish works with do n't care for these rooms .	those doors who this dish works with does n't care for these rooms .
the couch who has lost these toys has n't found that window .	the couch who has lost these toys have n't found that window .
the plates who did n't work with the truck have n't fixed those people .	the plates who did n't work with the truck has n't fixed those people .
these cars who the library had talked to do n't shake this woman .	these cars who the library had talked to does n't shake this woman .
the car who these cars did n't work with does move this adult .	the car who these cars did n't work with do move this adult .
those schools who that ring was visiting do n't have the boy .	those schools who that ring was visiting does n't have the boy .
those boats who may make that patient are n't working with this fork .	those boats who may make that patient is n't working with this fork .
the school who these schools could n't scare has n't worked with the schools .	the school who these schools could n't scare have n't worked with the schools .
the bottle who the rings have n't confused was finding this queen .	the bottle who the rings have n't confused were finding this queen .
those windows who bothered this doll are n't throwing the women .	those windows who bothered this doll is n't throwing the women .
this chair who helps those rings is n't dropping those people .	this chair who helps those rings are n't dropping those people .
those plates who drop this woman do read .	those plates who drop this woman does read .
these windows who that mirror talks to are n't holding the woman .	these windows who that mirror talks to is n't holding the woman .
this ship who had cleaned those girls does n't sing .	this ship who had cleaned those girls do n't sing .
these forks who that boat had talked to have held that queen .	these forks who that boat had talked to has held that queen .
the boxes who the ring did n't talk to are n't painting .	the boxes who the ring did n't talk to is n't painting .
these trucks who lost the driver have n't cried .	these trucks who lost the driver has n't cried .
this park who the books help was waving .	this park who the books help were waving .
the plate who these cars are talking to does lift that adult .	the plate who these cars are talking to do lift that adult .
that book who has taken these women was finding this woman .	that book who has taken these women were finding this woman .
that hospital who these plates had confused does n't read .	that hospital who these plates had confused do n't read .
these hats who the hospital had talked to were n't losing that dentist .	these hats who the hospital had talked to was n't losing that dentist .
these rooms who could n't praise the toy do stretch .	these rooms who could n't praise the toy does stretch .
the button who has n't bothered these chairs does n't talk .	the button who has n't bothered these chairs do n't talk .
those glasses who that hat works with do laugh .	those glasses who that hat works with does laugh .
those forks who this kitchen visited are n't teaching that rocket .	those forks who this kitchen visited is n't teaching that rocket .
those trucks who the mirror scared do work with these shirts .	those trucks who the mirror scared does work with these shirts .
that school who these dishes did n't scare was n't helping those books .	that school who these dishes did n't scare were n't helping those books .
that restaurant who the hats had bothered does n't keep this girl .	that restaurant who the hats had bothered do n't keep this girl .
these dolls who that dish must bother have n't found those shoes .	these dolls who that dish must bother has n't found those shoes .
these chairs who this room had talked to do praise the door .	these chairs who this room had talked to does praise the door .
this car who those toys are n't helping has dropped those women .	this car who those toys are n't helping have dropped those women .
the dishes who keep this adult have taken that child .	the dishes who keep this adult has taken that child .
this cup who those toys had n't scared has thrown this dancer .	this cup who those toys had n't scared have thrown this dancer .
that chair who bothered these buttons does n't exercise .	that chair who bothered these buttons do n't exercise .
those bags who praise that shirt have lost the bottles .	those bags who praise that shirt has lost the bottles .
the mall who is n't bothering the cars is n't fixing that king .	the mall who is n't bothering the cars are n't fixing that king .
this bed who the cars would n't work with has taken this customer .	this bed who the cars would n't work with have taken this customer .
that chair who the forks were bothering does know the picture .	that chair who the forks were bothering do know the picture .
those trucks who the candle answered do scream .	those trucks who the candle answered does scream .
the bank who these forks could scare does sneeze .	the bank who these forks could scare do sneeze .
the truck who the books wo n't care for has n't cried .	the truck who the books wo n't care for have n't cried .
that door who the buttons were n't listening to has laughed .	that door who the buttons were n't listening to have laughed .
that couch who these rings bother has n't cleaned these people .	that couch who these rings bother have n't cleaned these people .
this car who does n't praise the boxes has read .	this car who does n't praise the boxes have read .
these books who should n't lift this adult have n't helped that rug .	these books who should n't lift this adult has n't helped that rug .
the plate who held these women does n't shake this teacher .	the plate who held these women do n't shake this teacher .
the rocket who these boats were n't working with does sneeze .	the rocket who these boats were n't working with do sneeze .
those books who this dish worked with have scared the shirts .	those books who this dish worked with has scared the shirts .
the picture who those cups will visit has n't heard this car .	the picture who those cups will visit have n't heard this car .
the cups who the fork is listening to do talk to the cars .	the cups who the fork is listening to does talk to the cars .
these rings who the room works with have n't bothered this boat .	these rings who the room works with has n't bothered this boat .
those plates who do n't care for that truck do n't cry .	those plates who do n't care for that truck does n't cry .
the boats who moved the man do throw this queen .	the boats who moved the man does throw this queen .
the windows who have n't lost the plane do drop those men .	the windows who have n't lost the plane does drop those men .
those bowls who this chair works with do n't find the people .	those bowls who this chair works with does n't find the people .
that restaurant who has n't bothered these boats does n't lose those people .	that restaurant who has n't bothered these boats do n't lose those people .
those rings who are talking to the shirt are laughing .	those rings who are talking to the shirt is laughing .
this crayon who must keep those people has found this kitchen .	this crayon who must keep those people have found this kitchen .
the shoes who bother this bag are lying .	the shoes who bother this bag is lying .
those glasses who should n't care for that bag do wave .	those glasses who should n't care for that bag does wave .
that candle who could n't clean these men has heard this bowl .	that candle who could n't clean these men have heard this bowl .
those buttons who shook that king have lost those girls .	those buttons who shook that king has lost those girls .
those rings who would n't answer that school are n't reading .	those rings who would n't answer that school is n't reading .
these rooms who the candle will talk to do n't cry .	these rooms who the candle will talk to does n't cry .
those boats who this mirror was helping are n't losing the customer .	those boats who this mirror was helping is n't losing the customer .
that bed who scared these shoes is working with those trucks .	that bed who scared these shoes are working with those trucks .
that bottle who was n't talking to these glasses was holding this customer .	that bottle who was n't talking to these glasses were holding this customer .
that hat who these candles wo n't visit does n't hold that king .	that hat who these candles wo n't visit do n't hold that king .
these plates who moved this doctor do clean the ladies .	these plates who moved this doctor does clean the ladies .
these windows who lost the room have n't taught the car .	these windows who lost the room has n't taught the car .
these candles who this rocket has confused are smiling .	these candles who this rocket has confused is smiling .
those dolls who the door works with have heard the ring .	those dolls who the door works with has heard the ring .
that mall who those crayons care for does n't steal these children .	that mall who those crayons care for do n't steal these children .
those plates who have n't fixed that dentist have talked .	those plates who have n't fixed that dentist has talked .
this bottle who has helped the crayons was n't lying .	this bottle who has helped the crayons were n't lying .
those books who the kitchen was helping have n't fixed this person .	those books who the kitchen was helping has n't fixed this person .
that bowl who those cups were listening to does lie .	that bowl who those cups were listening to do lie .
the room who should n't talk to the shoes has thrown this man .	the room who should n't talk to the shoes have thrown this man .
these buttons who scared that museum do paint .	these buttons who scared that museum does paint .
the plate who those doors visited has n't yelled .	the plate who those doors visited have n't yelled .
these cups who that library has n't lost do n't worry the glass .	these cups who that library has n't lost does n't worry the glass .
the plate who these trucks may listen to does n't cry .	the plate who these trucks may listen to do n't cry .
those chairs who that crayon answered have n't worried these buttons .	those chairs who that crayon answered has n't worried these buttons .
that car who holds the children does talk to those crayons .	that car who holds the children do talk to those crayons .
that window who lost those teachers does read .	that window who lost those teachers do read .
this shirt who talks to these books does praise the cars .	this shirt who talks to these books do praise the cars .
that fork who was moving the teachers was singing .	that fork who was moving the teachers were singing .
this library who these forks have n't worked with has n't fixed the doctors .	this library who these forks have n't worked with have n't fixed the doctors .
the mall who those forks bothered does n't bring those guys .	the mall who those forks bothered do n't bring those guys .
these boxes who that boat is n't talking to were n't talking to that ring .	these boxes who that boat is n't talking to was n't talking to that ring .
these cars who answer that door were n't waving .	these cars who answer that door was n't waving .
those books who this museum helps do n't lift these men .	those books who this museum helps does n't lift these men .
these candles who brought the dentist have found those bottles .	these candles who brought the dentist has found those bottles .
the shirts who are shaking that doctor were losing .	the shirts who are shaking that doctor was losing .
this mall who these trucks are n't talking to does n't praise the button .	this mall who these trucks are n't talking to do n't praise the button .
the candles who the car has helped were finding this teacher .	the candles who the car has helped was finding this teacher .
the mirror who the dishes visited does shake these women .	the mirror who the dishes visited do shake these women .
those cars who this school would n't visit have visited the school .	those cars who this school would n't visit has visited the school .
these bowls who bothered that book have painted .	these bowls who bothered that book has painted .
those crayons who dropped the driver do n't sing .	those crayons who dropped the driver does n't sing .
the button who the toys would n't work with was n't fixing the girl .	the button who the toys would n't work with were n't fixing the girl .
these buttons who throw that driver were n't practicing .	these buttons who throw that driver was n't practicing .
the plates who hold that dancer have made those people .	the plates who hold that dancer has made those people .
those plates who lose that teacher are fixing the men .	those plates who lose that teacher is fixing the men .
these shoes who the bottle scares were bothering that plane .	these shoes who the bottle scares was bothering that plane .
these books who are n't listening to the candle do teach the plane .	these books who are n't listening to the candle does teach the plane .
this boat who those shoes are n't bothering does n't bring these children .	this boat who those shoes are n't bothering do n't bring these children .
those cars who this mall answered have n't won .	those cars who this mall answered has n't won .
that box who has n't bothered the buttons is n't waving .	that box who has n't bothered the buttons are n't waving .
the books who would n't praise the book were n't yelling .	the books who would n't praise the book was n't yelling .
these plates who the rocket was n't listening to have heard these schools .	these plates who the rocket was n't listening to has heard these schools .
this plane who the trucks answered has cried .	this plane who the trucks answered have cried .
the rug who is shaking these guys does scare this glass .	the rug who is shaking these guys do scare this glass .
the bicycle who those cars had worked with is waving .	the bicycle who those cars had worked with are waving .
the rooms who the truck is working with were bringing this customer .	the rooms who the truck is working with was bringing this customer .
that shirt who helped the chairs does sneeze .	that shirt who helped the chairs do sneeze .
those schools who helped the hat do know the doll .	those schools who helped the hat does know the doll .
those windows who wo n't work with this glass do exercise .	those windows who wo n't work with this glass does exercise .
the car who those glasses had talked to was practicing .	the car who those glasses had talked to were practicing .
this button who worked with those schools was crying .	this button who worked with those schools were crying .
that park who the hats talked to was n't buying the girl .	that park who the hats talked to were n't buying the girl .
this crayon who had n't visited those candles was n't singing .	this crayon who had n't visited those candles were n't singing .
the mirror who should n't scare those toys does n't bother these buttons .	the mirror who should n't scare those toys do n't bother these buttons .
the crayons who that toy talks to are crying .	the crayons who that toy talks to is crying .
the mirror who has n't helped these bottles is n't screaming .	the mirror who has n't helped these bottles are n't screaming .
this window who took the women does n't appreciate this bed .	this window who took the women do n't appreciate this bed .
the shoes who were n't throwing this adult were n't fixing these teachers .	the shoes who were n't throwing this adult was n't fixing these teachers .
these dishes who that park bothered do n't know the button .	these dishes who that park bothered does n't know the button .
this book who worked with these pictures was losing the woman .	this book who worked with these pictures were losing the woman .
this park who is helping these schools does steal this queen .	this park who is helping these schools do steal this queen .
the books who have n't cleaned this person do n't keep the child .	the books who have n't cleaned this person does n't keep the child .
the couch who had n't dropped these children does worry the fork .	the couch who had n't dropped these children do worry the fork .
those rooms who worked with that mall are n't shaking that guy .	those rooms who worked with that mall is n't shaking that guy .
this shirt who these windows answered does shake those boys .	this shirt who these windows answered do shake those boys .
the museum who these dishes will care for does n't steal the driver .	the museum who these dishes will care for do n't steal the driver .
that candle who the shoes scare has helped this park .	that candle who the shoes scare have helped this park .
those rings who can n't move that guy do n't paint .	those rings who can n't move that guy does n't paint .
these rings who the crayon has n't visited are n't throwing this girl .	these rings who the crayon has n't visited is n't throwing this girl .
this rug who was n't bringing the ladies has held that man .	this rug who was n't bringing the ladies have held that man .
the trucks who answered the chair do yell .	the trucks who answered the chair does yell .
these plates who the hat could n't answer are n't bringing the boys .	these plates who the hat could n't answer is n't bringing the boys .
this fork who those shoes scare has n't thrown those boys .	this fork who those shoes scare have n't thrown those boys .
those doors who did n't shake the boy have waved .	those doors who did n't shake the boy has waved .
this button who the schools worked with does n't find the boy .	this button who the schools worked with do n't find the boy .
those glasses who talk to this door have brought the driver .	those glasses who talk to this door has brought the driver .
the bed who does n't shake these guys has n't taken this queen .	the bed who does n't shake these guys have n't taken this queen .
the bottles who have n't worked with the car are listening to the hats .	the bottles who have n't worked with the car is listening to the hats .
those cups who can bother the library do n't listen to the room .	those cups who can bother the library does n't listen to the room .
that truck who these buttons scared was n't losing .	that truck who these buttons scared were n't losing .
this bowl who the glasses should n't listen to has lost the plane .	this bowl who the glasses should n't listen to have lost the plane .
those shoes who will fix this dentist have laughed .	those shoes who will fix this dentist has laughed .
this window who wo n't scare those doors does n't read .	this window who wo n't scare those doors do n't read .
that window who should n't answer these spoons does n't help those toys .	that window who should n't answer these spoons do n't help those toys .
the bags who helped that picture were n't talking to those bowls .	the bags who helped that picture was n't talking to those bowls .
the rooms who could n't help the car do visit those schools .	the rooms who could n't help the car does visit those schools .
the windows who this doll is helping were n't lying .	the windows who this doll is helping was n't lying .
the candle who these cars are helping is n't making this boy .	the candle who these cars are helping are n't making this boy .
these dishes who the picture bothered have brought those men .	these dishes who the picture bothered has brought those men .
the fork who could n't visit these plates does know this mall .	the fork who could n't visit these plates do know this mall .
that bottle who these books were n't helping does laugh .	that bottle who these books were n't helping do laugh .
the forks who the park was bothering do have those children .	the forks who the park was bothering does have those children .
the candles who the boat had n't talked to do win .	the candles who the boat had n't talked to does win .
those bowls who should talk to this mall do n't sing .	those bowls who should talk to this mall does n't sing .
those cars who the rug was n't talking to do hear these bottles .	those cars who the rug was n't talking to does hear these bottles .
these doors who were n't cleaning the boy were losing that dancer .	these doors who were n't cleaning the boy was losing that dancer .
these doors who sell the doctor do n't find this guy .	these doors who sell the doctor does n't find this guy .
those hats who answer this school were smiling .	those hats who answer this school was smiling .
those books who listen to this picture were laughing .	those books who listen to this picture was laughing .
these toys who the boat talked to have lost these guys .	these toys who the boat talked to has lost these guys .
the hat who lost the children does n't listen to the truck .	the hat who lost the children do n't listen to the truck .
that rug who has thrown the teachers does n't know this rocket .	that rug who has thrown the teachers do n't know this rocket .
these cups who should n't work with that plane have answered this door .	these cups who should n't work with that plane has answered this door .
the car who talks to the schools does n't hear those spoons .	the car who talks to the schools do n't hear those spoons .
those dishes who should drop that dancer do n't laugh .	those dishes who should drop that dancer does n't laugh .
those pictures who this chair does n't praise do appreciate the trucks .	those pictures who this chair does n't praise does appreciate the trucks .
the dolls who were talking to the window do paint .	the dolls who were talking to the window does paint .
the boat who holds these men does n't hear this button .	the boat who holds these men do n't hear this button .
this bottle who can n't praise those hats is talking .	this bottle who can n't praise those hats are talking .
these boxes who shook this patient are n't teaching those windows .	these boxes who shook this patient is n't teaching those windows .
these shoes who cleaned that lady are n't losing this patient .	these shoes who cleaned that lady is n't losing this patient .
these cars who bothered that boat do n't wave .	these cars who bothered that boat does n't wave .
the shirt who does n't keep the doctors does scream .	the shirt who does n't keep the doctors do scream .
the park who might listen to those shirts was lying .	the park who might listen to those shirts were lying .
the schools who this spoon wo n't answer are smiling .	the schools who this spoon wo n't answer is smiling .
the cups who were bringing this queen are losing .	the cups who were bringing this queen is losing .
those chairs who do n't praise that book do hear the crayon .	those chairs who do n't praise that book does hear the crayon .
those spoons who have n't confused the school do n't appreciate these rings .	those spoons who have n't confused the school does n't appreciate these rings .
that candle who those shirts have visited does smile .	that candle who those shirts have visited do smile .
the toy who those boats have confused has talked .	the toy who those boats have confused have talked .
this box who had cleaned the people was n't practicing .	this box who had cleaned the people were n't practicing .
the box who the boxes could help has n't heard that kitchen .	the box who the boxes could help have n't heard that kitchen .
this rocket who those crayons are talking to is listening to those boats .	this rocket who those crayons are talking to are listening to those boats .
those doors who are cleaning the queen have found those children .	those doors who are cleaning the queen has found those children .
these rings who were n't listening to that car do worry the school .	these rings who were n't listening to that car does worry the school .
that candle who has n't answered those books was visiting this book .	that candle who has n't answered those books were visiting this book .
the mall who these chairs work with does praise that bag .	the mall who these chairs work with do praise that bag .
those glasses who the plate has n't helped are n't teaching this rug .	those glasses who the plate has n't helped is n't teaching this rug .
