the boxes were running .	the boxes was running .
the beds are n't reading .	the beds is n't reading .
the dish was bothering these dolls .	the dish were bothering these dolls .
those shirts do n't paint .	those shirts does n't paint .
that door has n't lost this crayon .	that door have n't lost this crayon .
this school has fixed this man .	this school have fixed this man .
that window does have these guys .	that window do have these guys .
the room does n't talk .	the room do n't talk .
these cars have found this kitchen .	these cars has found this kitchen .
these glasses have n't made the adult .	these glasses has n't made the adult .
the hat does n't know the car .	the hat do n't know the car .
those windows were shaking these teachers .	those windows was shaking these teachers .
this hat does talk .	this hat do talk .
that hat does talk .	that hat do talk .
that bank does n't eat .	that bank do n't eat .
these cars do win .	these cars does win .
these cars do n't scream .	these cars does n't scream .
that ship does keep this guy .	that ship do keep this guy .
this glass has taught the plates .	this glass have taught the plates .
the rug was smiling .	the rug were smiling .
those cars were n't dropping these girls .	those cars was n't dropping these girls .
the restaurant has n't heard those dolls .	the restaurant have n't heard those dolls .
this school is working with the picture .	this school are working with the picture .
the bank does n't win .	the bank do n't win .
those glasses do n't stretch .	those glasses does n't stretch .
the schools do n't know this box .	the schools does n't know this box .
this couch has run .	this couch have run .
the shoes do scare that couch .	the shoes does scare that couch .
that bowl does smile .	that bowl do smile .
this plate does n't talk to the bed .	this plate do n't talk to the bed .
that kitchen has n't thrown the teacher .	that kitchen have n't thrown the teacher .
this chair has moved the customer .	this chair have moved the customer .
the box was buying those girls .	the box were buying those girls .
this fork does n't lose these women .	this fork do n't lose these women .
this crayon does shake these children .	this crayon do shake these children .
the car is dropping the lady .	the car are dropping the lady .
the candles were fixing the king .	the candles was fixing the king .
that bed is helping the schools .	that bed are helping the schools .
those crayons do clean that person .	those crayons does clean that person .
those bags do n't clean the teachers .	those bags does n't clean the teachers .
the ship does teach these beds .	the ship do teach these beds .
these cars have run .	these cars has run .
these books have n't laughed .	these books has n't laughed .
the crayon has confused this chair .	the crayon have confused this chair .
the cars do drop this doctor .	the cars does drop this doctor .
that shirt was working with these books .	that shirt were working with these books .
these bags were n't bringing the guys .	these bags was n't bringing the guys .
this bag has n't talked .	this bag have n't talked .
the school was reading .	the school were reading .
the cars do paint .	the cars does paint .
the chair does yell .	the chair do yell .
those bottles have n't heard those plates .	those bottles has n't heard those plates .
this plane does n't move the people .	this plane do n't move the people .
these crayons have waved .	these crayons has waved .
this truck does n't sell these women .	this truck do n't sell these women .
this hospital does n't answer that couch .	this hospital do n't answer that couch .
that plane has n't made those people .	that plane have n't made those people .
these pictures are n't working with the trucks .	these pictures is n't working with the trucks .
the window was n't practicing .	the window were n't practicing .
this car was n't eating .	this car were n't eating .
the hat was n't smiling .	the hat were n't smiling .
that library has lost those cars .	that library have lost those cars .
this hat does hear this doll .	this hat do hear this doll .
these pictures have n't lost the plane .	these pictures has n't lost the plane .
those cups are crying .	those cups is crying .
this boat has fixed the queen .	this boat have fixed the queen .
the shirt does n't smile .	the shirt do n't smile .
the spoon does n't cough .	the spoon do n't cough .
these cars do n't take these guys .	these cars does n't take these guys .
the shoe has n't heard the truck .	the shoe have n't heard the truck .
the bowls do know this car .	the bowls does know this car .
the rocket does know that mall .	the rocket do know that mall .
the spoons do run .	the spoons does run .
this dish does n't answer that fork .	this dish do n't answer that fork .
the button has held this dancer .	the button have held this dancer .
the rocket was shaking that guy .	the rocket were shaking that guy .
those rings have grown .	those rings has grown .
these cups do n't care for that truck .	these cups does n't care for that truck .
the trucks have n't talked .	the trucks has n't talked .
that door does n't sing .	that door do n't sing .
the books do hear the boxes .	the books does hear the boxes .
these boxes do win .	these boxes does win .
those plates were n't moving this boy .	those plates was n't moving this boy .
these chairs do appreciate those candles .	these chairs does appreciate those candles .
the boxes have n't taught those boxes .	the boxes has n't taught those boxes .
that toy does fix the doctor .	that toy do fix the doctor .
this library does n't scream .	this library do n't scream .
that shoe does n't scare the shirt .	that shoe do n't scare the shirt .
those forks do n't praise that shoe .	those forks does n't praise that shoe .
these toys have n't lost these bags .	these toys has n't lost these bags .
the beds do n't work with the truck .	the beds does n't work with the truck .
this hospital does talk to those hats .	this hospital do talk to those hats .
that school does n't work with that library .	that school do n't work with that library .
this car has waved .	this car have waved .
the boat was losing .	the boat were losing .
those chairs have helped those pictures .	those chairs has helped those pictures .
the library has painted .	the library have painted .
these beds were n't whispering .	these beds was n't whispering .
the car has visited the box .	the car have visited the box .
this hospital is lying .	this hospital are lying .
this car does n't laugh .	this car do n't laugh .
this glass does n't win .	this glass do n't win .
that mirror has made this lady .	that mirror have made this lady .
this bowl is n't eating .	this bowl are n't eating .
those trucks are n't cleaning this man .	those trucks is n't cleaning this man .
that candle does paint .	that candle do paint .
the car was visiting the car .	the car were visiting the car .
these rooms do make those women .	these rooms does make those women .
the rug does n't whisper .	the rug do n't whisper .
the bed does n't know this car .	the bed do n't know this car .
the school does yell .	the school do yell .
that truck does n't wave .	that truck do n't wave .
those buttons have brought that guy .	those buttons has brought that guy .
this window does n't sing .	this window do n't sing .
that library was n't growing .	that library were n't growing .
that library has n't talked to that car .	that library have n't talked to that car .
the shirt has taught those beds .	the shirt have taught those beds .
the ship has n't bought this girl .	the ship have n't bought this girl .
that hospital has won .	that hospital have won .
these boats have lost the toy .	these boats has lost the toy .
the kitchen has yelled .	the kitchen have yelled .
the school was n't talking to the toy .	the school were n't talking to the toy .
the dishes are n't shaking this girl .	the dishes is n't shaking this girl .
this hospital has n't laughed .	this hospital have n't laughed .
that mall was n't running .	that mall were n't running .
the door is talking to the mall .	the door are talking to the mall .
that bank does n't sell these people .	that bank do n't sell these people .
the bowls have n't made that girl .	the bowls has n't made that girl .
this museum is n't crying .	this museum are n't crying .
the candle does understand these glasses .	the candle do understand these glasses .
that car does n't lose the dentist .	that car do n't lose the dentist .
those spoons do cough .	those spoons does cough .
the couch was bothering these bowls .	the couch were bothering these bowls .
the cars were n't painting .	the cars was n't painting .
the library has n't scared the picture .	the library have n't scared the picture .
this dish does teach that hospital .	this dish do teach that hospital .
these rings do n't smile .	these rings does n't smile .
that bicycle is whispering .	that bicycle are whispering .
those bottles do bring those ladies .	those bottles does bring those ladies .
these cars do n't answer those trucks .	these cars does n't answer those trucks .
the library was talking .	the library were talking .
those shirts do n't scare the rocket .	those shirts does n't scare the rocket .
the bank has n't cried .	the bank have n't cried .
that book has yelled .	that book have yelled .
these shoes are n't painting .	these shoes is n't painting .
the crayons have n't waved .	the crayons has n't waved .
these pictures do n't know the boxes .	these pictures does n't know the boxes .
the bottles do n't know the dish .	the bottles does n't know the dish .
the school does sell the king .	the school do sell the king .
these bowls have waved .	these bowls has waved .
those bowls have n't laughed .	those bowls has n't laughed .
this door does n't listen to this bank .	this door do n't listen to this bank .
the hat does work with this button .	the hat do work with this button .
the room was n't listening to the boats .	the room were n't listening to the boats .
this button does make those ladies .	this button do make those ladies .
those hats were n't whispering .	those hats was n't whispering .
this spoon was teaching the candles .	this spoon were teaching the candles .
those toys do sell this dentist .	those toys does sell this dentist .
these dolls do n't care for that bag .	these dolls does n't care for that bag .
that cup has run .	that cup have run .
the truck has brought this woman .	the truck have brought this woman .
these crayons were n't talking .	these crayons was n't talking .
this spoon is n't screaming .	this spoon are n't screaming .
this box is n't fixing the men .	this box are n't fixing the men .
that museum does n't praise that bicycle .	that museum do n't praise that bicycle .
these glasses have n't scared that crayon .	these glasses has n't scared that crayon .
this museum does n't have those women .	this museum do n't have those women .
the truck does grow .	the truck do grow .
this ship was n't cleaning this doctor .	this ship were n't cleaning this doctor .
these trucks do n't worry the school .	these trucks does n't worry the school .
the bottles have n't lost the hats .	the bottles has n't lost the hats .
those books do n't lose .	those books does n't lose .
these schools were bothering this book .	these schools was bothering this book .
those cars were talking to this glass .	those cars was talking to this glass .
that door does n't fix these children .	that door do n't fix these children .
these books are taking these women .	these books is taking these women .
that bicycle has n't lost these boys .	that bicycle have n't lost these boys .
that dish has n't lost these books .	that dish have n't lost these books .
the books do n't talk to this restaurant .	the books does n't talk to this restaurant .
these cars have n't helped that door .	these cars has n't helped that door .
these crayons were listening to the beds .	these crayons was listening to the beds .
the dishes were working with the dishes .	the dishes was working with the dishes .
the school has n't grown .	the school have n't grown .
the cups do wave .	the cups does wave .
this mall is n't whispering .	this mall are n't whispering .
those bowls do read .	those bowls does read .
the rug is n't working with the shoe .	the rug are n't working with the shoe .
these windows do n't understand the shirts .	these windows does n't understand the shirts .
the shirts are yelling .	the shirts is yelling .
those toys are n't crying .	those toys is n't crying .
those pictures do cough .	those pictures does cough .
the shoe is n't visiting this box .	the shoe are n't visiting this box .
these bottles do lose .	these bottles does lose .
these windows have n't grown .	these windows has n't grown .
these dolls do cough .	these dolls does cough .
those forks have n't worried that window .	those forks has n't worried that window .
the windows are n't taking those women .	the windows is n't taking those women .
the schools are bothering the window .	the schools is bothering the window .
this shoe is n't laughing .	this shoe are n't laughing .
these chairs have visited these books .	these chairs has visited these books .
that rocket does n't sneeze .	that rocket do n't sneeze .
these shoes do n't appreciate those pictures .	these shoes does n't appreciate those pictures .
these boxes do n't sing .	these boxes does n't sing .
those chairs are n't laughing .	those chairs is n't laughing .
that truck does know that cup .	that truck do know that cup .
the shoes do sing .	the shoes does sing .
those pictures do n't make that child .	those pictures does n't make that child .
this picture has lost .	this picture have lost .
the window does talk .	the window do talk .
that book has n't cried .	that book have n't cried .
the car is n't losing .	the car are n't losing .
this mall does n't practice .	this mall do n't practice .
the door has worried the mall .	the door have worried the mall .
that shoe has found these bottles .	that shoe have found these bottles .
the toy does n't wave .	the toy do n't wave .
those bottles have n't taken the man .	those bottles has n't taken the man .
these cars have n't scared that fork .	these cars has n't scared that fork .
that museum does n't sell that woman .	that museum do n't sell that woman .
the car is throwing that lady .	the car are throwing that lady .
these schools do n't talk to that restaurant .	these schools does n't talk to that restaurant .
that cup has n't taken that adult .	that cup have n't taken that adult .
the bowl is yelling .	the bowl are yelling .
the doll is losing .	the doll are losing .
that hospital was n't learning .	that hospital were n't learning .
those beds do n't smile .	those beds does n't smile .
those schools have found those books .	those schools has found those books .
this toy does yell .	this toy do yell .
that mall does n't know those doors .	that mall do n't know those doors .
the park is n't laughing .	the park are n't laughing .
this book does find this patient .	this book do find this patient .
the toys have n't grown .	the toys has n't grown .
that restaurant has grown .	that restaurant have grown .
the rocket has run .	the rocket have run .
that shirt has answered those spoons .	that shirt have answered those spoons .
the shoes were n't growing .	the shoes was n't growing .
that button is n't bothering these boxes .	that button are n't bothering these boxes .
these cars have n't worried this museum .	these cars has n't worried this museum .
the shirt has waved .	the shirt have waved .
that kitchen has won .	that kitchen have won .
the shoes do n't talk .	the shoes does n't talk .
this candle has n't answered this library .	this candle have n't answered this library .
the bicycle does n't help the boxes .	the bicycle do n't help the boxes .
that spoon has n't run .	that spoon have n't run .
those rings are n't whispering .	those rings is n't whispering .
these rooms are crying .	these rooms is crying .
the hospital does n't sneeze .	the hospital do n't sneeze .
the bottle does know that glass .	the bottle do know that glass .
the cup has read .	the cup have read .
the bicycle was talking to this ship .	the bicycle were talking to this ship .
those glasses do n't keep the guy .	those glasses does n't keep the guy .
the plate has n't laughed .	the plate have n't laughed .
the windows have confused these plates .	the windows has confused these plates .
the hats do n't talk .	the hats does n't talk .
that bowl has helped the hats .	that bowl have helped the hats .
that spoon is n't holding that king .	that spoon are n't holding that king .
the trucks have n't taught these pictures .	the trucks has n't taught these pictures .
this bag does n't hear that park .	this bag do n't hear that park .
the hospital has found this school .	the hospital have found this school .
the spoon has n't worried these pictures .	the spoon have n't worried these pictures .
those buttons have eaten .	those buttons has eaten .
the buttons do know the doors .	the buttons does know the doors .
that rug does n't smile .	that rug do n't smile .
this room has taught this rug .	this room have taught this rug .
the rocket does n't keep the person .	the rocket do n't keep the person .
this truck has read .	this truck have read .
those glasses do cough .	those glasses does cough .
these beds were n't losing .	these beds was n't losing .
the couch is n't visiting that fork .	the couch are n't visiting that fork .
those chairs have heard these bowls .	those chairs has heard these bowls .
the forks have n't helped that shoe .	the forks has n't helped that shoe .
that school has n't brought the guy .	that school have n't brought the guy .
this ring was n't laughing .	this ring were n't laughing .
these schools were n't fixing the dancer .	these schools was n't fixing the dancer .
the schools do n't understand the kitchen .	the schools does n't understand the kitchen .
the doors do n't appreciate this crayon .	the doors does n't appreciate this crayon .
these plates do keep this boy .	these plates does keep this boy .
those schools were n't buying the dentist .	those schools was n't buying the dentist .
those dolls do n't answer the picture .	those dolls does n't answer the picture .
the restaurant is n't keeping the queen .	the restaurant are n't keeping the queen .
that shoe was n't smiling .	that shoe were n't smiling .
those buttons were n't screaming .	those buttons was n't screaming .
the chairs do sing .	the chairs does sing .
this cup does understand the hospital .	this cup do understand the hospital .
these cups do understand that rocket .	these cups does understand that rocket .
this room has n't heard that glass .	this room have n't heard that glass .
those cars were n't helping the school .	those cars was n't helping the school .
that plate does wave .	that plate do wave .
those pictures do n't know the spoon .	those pictures does n't know the spoon .
the ring was n't bringing this patient .	the ring were n't bringing this patient .
those bags have n't helped that school .	those bags has n't helped that school .
the book has made the man .	the book have made the man .
that doll does sell that queen .	that doll do sell that queen .
those shirts have cried .	those shirts has cried .
these books have n't scared the couch .	these books has n't scared the couch .
the window was visiting those glasses .	the window were visiting those glasses .
these cars have talked .	these cars has talked .
these windows do eat .	these windows does eat .
those glasses are n't painting .	those glasses is n't painting .
this boat was n't eating .	this boat were n't eating .
the rug is losing that driver .	the rug are losing that driver .
the rocket does scare the bottle .	the rocket do scare the bottle .
that bank does n't answer that car .	that bank do n't answer that car .
the toy does n't listen to that couch .	the toy do n't listen to that couch .
this bag is n't keeping the guys .	this bag are n't keeping the guys .
these schools do win .	these schools does win .
this boat does cry .	this boat do cry .
the shirt does throw the adult .	the shirt do throw the adult .
the cars do exercise .	the cars does exercise .
this cup has n't heard that couch .	this cup have n't heard that couch .
that mall is talking to the mirror .	that mall are talking to the mirror .
this school has laughed .	this school have laughed .
the window has found the rocket .	the window have found the rocket .
these pictures were n't helping this mirror .	these pictures was n't helping this mirror .
this window has n't lost .	this window have n't lost .
the shoe does bother these glasses .	the shoe do bother these glasses .
the schools have n't run .	the schools has n't run .
those trucks do n't cough .	those trucks does n't cough .
those windows have n't laughed .	those windows has n't laughed .
this button was keeping the men .	this button were keeping the men .
the museum is n't crying .	the museum are n't crying .
that dish does care for those boxes .	that dish do care for those boxes .
these trucks do yell .	these trucks does yell .
those boxes do n't teach the bowl .	those boxes does n't teach the bowl .
that plate has n't worked with the windows .	that plate have n't worked with the windows .
the crayons were n't buying the guy .	the crayons was n't buying the guy .
the dishes have found these toys .	the dishes has found these toys .
that museum does talk to the mall .	that museum do talk to the mall .
the bags have found this plane .	the bags has found this plane .
this doll has learned .	this doll have learned .
these bowls have n't bothered this plate .	these bowls has n't bothered this plate .
the car has n't scared the chairs .	the car have n't scared the chairs .
the crayon has n't worked with the dish .	the crayon have n't worked with the dish .
those candles have brought the men .	those candles has brought the men .
these dolls do n't eat .	these dolls does n't eat .
that ship has worried the bicycle .	that ship have worried the bicycle .
the mirror does n't praise the shirts .	the mirror do n't praise the shirts .
this spoon has n't won .	this spoon have n't won .
these plates do n't wave .	these plates does n't wave .
those cars do talk to the candles .	those cars does talk to the candles .
the boats have worried the books .	the boats has worried the books .
that book has n't found this teacher .	that book have n't found this teacher .
these cars have fixed these women .	these cars has fixed these women .
the plate does n't work with that park .	the plate do n't work with that park .
that shirt does hear the fork .	that shirt do hear the fork .
these boxes do stretch .	these boxes does stretch .
the hat does run .	the hat do run .
that dish does n't move those doctors .	that dish do n't move those doctors .
this library does smile .	this library do smile .
the ship is whispering .	the ship are whispering .
that bed has bothered those toys .	that bed have bothered those toys .
that car was n't practicing .	that car were n't practicing .
these buttons were n't making those guys .	these buttons was n't making those guys .
the schools have n't dropped the customer .	the schools has n't dropped the customer .
this restaurant has n't heard those doors .	this restaurant have n't heard those doors .
that park does n't know the bed .	that park do n't know the bed .
these books do n't lose that dentist .	these books does n't lose that dentist .
the schools do keep the adult .	the schools does keep the adult .
this crayon has learned .	this crayon have learned .
this hat does n't sell those girls .	this hat do n't sell those girls .
this door was n't smiling .	this door were n't smiling .
this fork was n't screaming .	this fork were n't screaming .
this candle has talked .	this candle have talked .
this toy has n't moved the person .	this toy have n't moved the person .
that bicycle has eaten .	that bicycle have eaten .
this car does n't visit that kitchen .	this car do n't visit that kitchen .
that couch was n't losing the doctor .	that couch were n't losing the doctor .
this bank has found these crayons .	this bank have found these crayons .
the school does n't help the bags .	the school do n't help the bags .
this car is n't yelling .	this car are n't yelling .
the bottle was n't visiting these buttons .	the bottle were n't visiting these buttons .
the rocket was n't crying .	the rocket were n't crying .
this mall does n't whisper .	this mall do n't whisper .
these candles have n't worried these boats .	these candles has n't worried these boats .
that hospital was shaking these boys .	that hospital were shaking these boys .
this car has n't learned .	this car have n't learned .
that toy has grown .	that toy have grown .
these shoes do talk .	these shoes does talk .
this hat does appreciate those books .	this hat do appreciate those books .
these beds have n't dropped the adult .	these beds has n't dropped the adult .
the hat does n't bother that crayon .	the hat do n't bother that crayon .
that bed was throwing the children .	that bed were throwing the children .
the chair has moved the guy .	the chair have moved the guy .
these bowls do lose .	these bowls does lose .
those dolls do steal these guys .	those dolls does steal these guys .
the kitchen does stretch .	the kitchen do stretch .
this chair has lost those candles .	this chair have lost those candles .
the shoe was reading .	the shoe were reading .
the shoes were whispering .	the shoes was whispering .
that park has n't run .	that park have n't run .
this bed is n't finding those women .	this bed are n't finding those women .
the windows do know these rings .	the windows does know these rings .
this car was bothering that toy .	this car were bothering that toy .
this museum has n't moved this teacher .	this museum have n't moved this teacher .
this shirt does n't run .	this shirt do n't run .
this library is throwing those people .	this library are throwing those people .
the hat does sneeze .	the hat do sneeze .
those spoons have waved .	those spoons has waved .
this fork was n't helping those books .	this fork were n't helping those books .
the spoon does read .	the spoon do read .
those books have visited this restaurant .	those books has visited this restaurant .
that car is talking to the toys .	that car are talking to the toys .
the chair does n't praise these shoes .	the chair do n't praise these shoes .
that ring has fixed that girl .	that ring have fixed that girl .
this room has n't painted .	this room have n't painted .
these trucks do n't visit the car .	these trucks does n't visit the car .
this chair has n't held the teachers .	this chair have n't held the teachers .
the couch does teach that mirror .	the couch do teach that mirror .
the school does n't yell .	the school do n't yell .
the plates were n't visiting this bowl .	the plates was n't visiting this bowl .
those bottles do run .	those bottles does run .
the spoon has read .	the spoon have read .
this school has held this man .	this school have held this man .
the museum has answered these shirts .	the museum have answered these shirts .
the books do n't find these doctors .	the books does n't find these doctors .
the plates are n't crying .	the plates is n't crying .
those schools have n't eaten .	those schools has n't eaten .
this hospital has n't heard the candles .	this hospital have n't heard the candles .
those buttons have n't lost the girls .	those buttons has n't lost the girls .
those windows do keep that guy .	those windows does keep that guy .
that door has heard this plane .	that door have heard this plane .
the hat does n't eat .	the hat do n't eat .
the hat was laughing .	the hat were laughing .
the bottle does wave .	the bottle do wave .
this boat was dropping those doctors .	this boat were dropping those doctors .
those shoes have scared the park .	those shoes has scared the park .
this cup does yell .	this cup do yell .
that cup has brought that adult .	that cup have brought that adult .
this box does talk to those doors .	this box do talk to those doors .
the windows do hear the bed .	the windows does hear the bed .
that window has n't talked to that shirt .	that window have n't talked to that shirt .
that plane has lost that car .	that plane have lost that car .
the rocket does n't help the crayon .	the rocket do n't help the crayon .
those crayons do scream .	those crayons does scream .
that toy was n't bringing the people .	that toy were n't bringing the people .
those forks were holding that queen .	those forks was holding that queen .
this ship does lie .	this ship do lie .
that room does keep that doctor .	that room do keep that doctor .
the museum does visit the spoons .	the museum do visit the spoons .
the fork does n't keep that guy .	the fork do n't keep that guy .
those glasses have n't heard this park .	those glasses has n't heard this park .
that button does stretch .	that button do stretch .
the ring does n't hear this kitchen .	the ring do n't hear this kitchen .
the shirts have n't dropped those people .	the shirts has n't dropped those people .
that room has lost this chair .	that room have lost this chair .
that plane is teaching those schools .	that plane are teaching those schools .
the doors do n't have the child .	the doors does n't have the child .
that museum does n't care for the mall .	that museum do n't care for the mall .
the room does find the ladies .	the room do find the ladies .
the cups were n't visiting the bed .	the cups was n't visiting the bed .
those boats have taught this candle .	those boats has taught this candle .
the book has n't yelled .	the book have n't yelled .
these bowls do n't scream .	these bowls does n't scream .
this shirt has won .	this shirt have won .
the ring does n't help the cars .	the ring do n't help the cars .
this school does scare that bag .	this school do scare that bag .
those beds are throwing that teacher .	those beds is throwing that teacher .
the mall has found that bottle .	the mall have found that bottle .
the school has fixed the man .	the school have fixed the man .
the cars do n't laugh .	the cars does n't laugh .
these boats were n't making this dancer .	these boats was n't making this dancer .
those boxes do run .	those boxes does run .
those spoons were smiling .	those spoons was smiling .
that bowl is losing .	that bowl are losing .
those bags do n't work with those forks .	those bags does n't work with those forks .
this ship has n't heard this rug .	this ship have n't heard this rug .
the bed does run .	the bed do run .
the cup has n't heard this crayon .	the cup have n't heard this crayon .
that bottle has visited these shoes .	that bottle have visited these shoes .
these dishes do n't scream .	these dishes does n't scream .
the buttons have n't lost .	the buttons has n't lost .
the box has n't worried that glass .	the box have n't worried that glass .
the toys do n't wave .	the toys does n't wave .
these shoes were throwing this girl .	these shoes was throwing this girl .
the bicycle was working with those books .	the bicycle were working with those books .
this room was n't finding this person .	this room were n't finding this person .
that hospital has fixed the woman .	that hospital have fixed the woman .
the ring does grow .	the ring do grow .
this boat has taught the ship .	this boat have taught the ship .
those candles do n't sneeze .	those candles does n't sneeze .
those chairs have cleaned these ladies .	those chairs has cleaned these ladies .
those buttons have dropped this guy .	those buttons has dropped this guy .
these toys have learned .	these toys has learned .
the boxes have moved these women .	the boxes has moved these women .
that bottle is n't waving .	that bottle are n't waving .
the window has n't talked .	the window have n't talked .
this spoon does n't answer these schools .	this spoon do n't answer these schools .
the windows were growing .	the windows was growing .
this box does n't learn .	this box do n't learn .
that plate was singing .	that plate were singing .
that spoon is n't cleaning the adult .	that spoon are n't cleaning the adult .
these bags were working with those rooms .	these bags was working with those rooms .
that museum does n't win .	that museum do n't win .
that shoe has brought the dancer .	that shoe have brought the dancer .
those books have n't heard these bottles .	those books has n't heard these bottles .
these rooms are n't listening to those boats .	these rooms is n't listening to those boats .
the door is n't holding this king .	the door are n't holding this king .
the books have made this customer .	the books has made this customer .
the kitchen has bought the boys .	the kitchen have bought the boys .
the glass was singing .	the glass were singing .
that shoe is n't crying .	that shoe are n't crying .
this hat does n't help that toy .	this hat do n't help that toy .
the toy has scared this crayon .	the toy have scared this crayon .
this bag has n't worked with these forks .	this bag have n't worked with these forks .
the bags are smiling .	the bags is smiling .
that boat does fix this adult .	that boat do fix this adult .
the mall was lying .	the mall were lying .
the library is bringing these children .	the library are bringing these children .
that fork was helping the glasses .	that fork were helping the glasses .
these bags have n't kept this adult .	these bags has n't kept this adult .
the school has kept this adult .	the school have kept this adult .
that picture was finding the dentist .	that picture were finding the dentist .
the cup does learn .	the cup do learn .
the car has kept that person .	the car have kept that person .
those toys do hold this queen .	those toys does hold this queen .
this shoe does n't bother the ring .	this shoe do n't bother the ring .
this door does n't run .	this door do n't run .
that window is n't buying that dancer .	that window are n't buying that dancer .
this bicycle has n't bothered these chairs .	this bicycle have n't bothered these chairs .
those bottles do hold the doctors .	those bottles does hold the doctors .
that bicycle was running .	that bicycle were running .
the hat has n't heard the door .	the hat have n't heard the door .
the toys do answer these bowls .	the toys does answer these bowls .
the mall does n't run .	the mall do n't run .
those windows were n't singing .	those windows was n't singing .
the plates were n't growing .	the plates was n't growing .
this school has yelled .	this school have yelled .
the plane has grown .	the plane have grown .
those rings have n't painted .	those rings has n't painted .
that candle was singing .	that candle were singing .
the spoon does n't grow .	the spoon do n't grow .
these glasses were n't growing .	these glasses was n't growing .
the windows do talk to this ship .	the windows does talk to this ship .
those beds have n't talked to those pictures .	those beds has n't talked to those pictures .
that shoe has n't taught the schools .	that shoe have n't taught the schools .
the toys do n't yell .	the toys does n't yell .
that bag was n't bothering the museum .	that bag were n't bothering the museum .
that dish does care for the chair .	that dish do care for the chair .
these beds have painted .	these beds has painted .
the car is n't bothering the schools .	the car are n't bothering the schools .
the book does sing .	the book do sing .
the library does talk .	the library do talk .
this boat has n't run .	this boat have n't run .
the buttons have n't taught these windows .	the buttons has n't taught these windows .
the buttons have heard the doors .	the buttons has heard the doors .
those trucks do n't read .	those trucks does n't read .
the kitchen does n't sing .	the kitchen do n't sing .
this plate does talk to this plate .	this plate do talk to this plate .
the car was n't holding this boy .	the car were n't holding this boy .
the book does n't exercise .	the book do n't exercise .
the mall was fixing the teachers .	the mall were fixing the teachers .
the museum has n't heard the mall .	the museum have n't heard the mall .
those candles do care for these bottles .	those candles does care for these bottles .
this bank was bringing the teacher .	this bank were bringing the teacher .
the bottle was n't laughing .	the bottle were n't laughing .
this museum does n't know that shirt .	this museum do n't know that shirt .
those crayons were crying .	those crayons was crying .
this room does n't throw the guys .	this room do n't throw the guys .
these beds do steal that customer .	these beds does steal that customer .
that window has n't kept that lady .	that window have n't kept that lady .
this bottle was n't keeping the boys .	this bottle were n't keeping the boys .
those rings have scared that fork .	those rings has scared that fork .
the ship was screaming .	the ship were screaming .
the glasses are n't reading .	the glasses is n't reading .
the window does n't laugh .	the window do n't laugh .
that school has fixed that driver .	that school have fixed that driver .
the buttons have n't bothered the doors .	the buttons has n't bothered the doors .
the shoes have bothered this door .	the shoes has bothered this door .
the bowls have dropped this child .	the bowls has dropped this child .
those cars do n't smile .	those cars does n't smile .
this rug does n't appreciate that dish .	this rug do n't appreciate that dish .
that ring has n't lost these crayons .	that ring have n't lost these crayons .
this bed has n't heard that ship .	this bed have n't heard that ship .
the rings were visiting the ship .	the rings was visiting the ship .
this glass is n't talking to those dolls .	this glass are n't talking to those dolls .
the restaurant does know the plane .	the restaurant do know the plane .
that boat does clean the men .	that boat do clean the men .
the button was learning .	the button were learning .
this candle does care for those glasses .	this candle do care for those glasses .
this glass does n't move this doctor .	this glass do n't move this doctor .
this couch is n't practicing .	this couch are n't practicing .
this plate was n't learning .	this plate were n't learning .
the cars do n't work with that car .	the cars does n't work with that car .
the doors do lose .	the doors does lose .
this bag does n't help the kitchen .	this bag do n't help the kitchen .
the spoon does hear that toy .	the spoon do hear that toy .
the boxes are taking this lady .	the boxes is taking this lady .
these candles do n't appreciate this mall .	these candles does n't appreciate this mall .
the hats were talking .	the hats was talking .
the truck does n't scream .	the truck do n't scream .
that boat is n't smiling .	that boat are n't smiling .
these boats do steal these ladies .	these boats does steal these ladies .
that doll was n't crying .	that doll were n't crying .
this mirror does n't worry the mirror .	this mirror do n't worry the mirror .
this bowl is cleaning that man .	this bowl are cleaning that man .
the book has n't eaten .	the book have n't eaten .
this mirror has made this person .	this mirror have made this person .
the bottle is n't practicing .	the bottle are n't practicing .
this shoe was yelling .	this shoe were yelling .
this bowl is n't teaching this box .	this bowl are n't teaching this box .
this mall was taking the child .	this mall were taking the child .
these rooms do buy these ladies .	these rooms does buy these ladies .
the museum does lift that adult .	the museum do lift that adult .
that library does sell the doctors .	that library do sell the doctors .
that dish is whispering .	that dish are whispering .
this bank has talked .	this bank have talked .
that car is n't moving these women .	that car are n't moving these women .
that bed is n't moving this boy .	that bed are n't moving this boy .
the rings have n't bothered that ring .	the rings has n't bothered that ring .
this car is bothering the kitchen .	this car are bothering the kitchen .
these boxes do n't worry those glasses .	these boxes does n't worry those glasses .
those rooms do praise that room .	those rooms does praise that room .
this car has n't scared this doll .	this car have n't scared this doll .
those schools do n't answer the hospital .	those schools does n't answer the hospital .
that ring does keep that lady .	that ring do keep that lady .
the books were n't listening to these boats .	the books was n't listening to these boats .
that ring has heard the ship .	that ring have heard the ship .
those windows do n't scare these bottles .	those windows does n't scare these bottles .
those bowls do n't know that picture .	those bowls does n't know that picture .
this room does n't hear this museum .	this room do n't hear this museum .
those dishes do sneeze .	those dishes does sneeze .
this hat is n't growing .	this hat are n't growing .
the glasses were n't visiting the restaurant .	the glasses was n't visiting the restaurant .
the plate was n't growing .	the plate were n't growing .
that book was learning .	that book were learning .
that boat does wave .	that boat do wave .
these books do n't run .	these books does n't run .
that bicycle is n't shaking this dentist .	that bicycle are n't shaking this dentist .
those trucks were smiling .	those trucks was smiling .
that school does paint .	that school do paint .
these rings do n't eat .	these rings does n't eat .
these pictures were losing .	these pictures was losing .
the bottle has n't grown .	the bottle have n't grown .
that shoe was making the guys .	that shoe were making the guys .
the plane has taken this driver .	the plane have taken this driver .
that ship does n't lose those people .	that ship do n't lose those people .
the books were running .	the books was running .
that shirt has waved .	that shirt have waved .
the doors were listening to this bowl .	the doors was listening to this bowl .
the bags do exercise .	the bags does exercise .
this hat does n't paint .	this hat do n't paint .
the hats have waved .	the hats has waved .
the museum does n't whisper .	the museum do n't whisper .
the bank has n't fixed this doctor .	the bank have n't fixed this doctor .
this picture has n't confused the shirts .	this picture have n't confused the shirts .
this picture does scare those bowls .	this picture do scare those bowls .
the dish is shaking the adult .	the dish are shaking the adult .
those cups do n't practice .	those cups does n't practice .
that bag does n't know this museum .	that bag do n't know this museum .
the pictures were n't bothering this button .	the pictures was n't bothering this button .
the ship was bringing this king .	the ship were bringing this king .
this plate has n't talked to this glass .	this plate have n't talked to this glass .
the bowls do n't win .	the bowls does n't win .
the trucks have learned .	the trucks has learned .
that box was n't painting .	that box were n't painting .
these cars are n't listening to the boats .	these cars is n't listening to the boats .
those books have yelled .	those books has yelled .
these schools have painted .	these schools has painted .
the picture has read .	the picture have read .
the fork does n't sell this boy .	the fork do n't sell this boy .
the candles have n't fixed this driver .	the candles has n't fixed this driver .
those beds are losing the person .	those beds is losing the person .
the hat is n't whispering .	the hat are n't whispering .
the shoe has n't grown .	the shoe have n't grown .
that bed does hear these rooms .	that bed do hear these rooms .
that kitchen does answer the beds .	that kitchen do answer the beds .
the shoes are shaking that dentist .	the shoes is shaking that dentist .
this bed was n't listening to the bottles .	this bed were n't listening to the bottles .
this library does lose .	this library do lose .
that restaurant was talking to the car .	that restaurant were talking to the car .
the book has read .	the book have read .
the glass has fixed the man .	the glass have fixed the man .
the pictures have n't kept the man .	the pictures has n't kept the man .
the dish does care for the boats .	the dish do care for the boats .
these rings are losing the guys .	these rings is losing the guys .
that library does talk .	that library do talk .
these beds are n't listening to that cup .	these beds is n't listening to that cup .
the doll does teach the crayon .	the doll do teach the crayon .
these trucks do hear this bag .	these trucks does hear this bag .
the hat does n't sneeze .	the hat do n't sneeze .
that mall has n't won .	that mall have n't won .
those candles do sneeze .	those candles does sneeze .
the hospital is n't yelling .	the hospital are n't yelling .
those boats were n't bothering those candles .	those boats was n't bothering those candles .
these plates do lift those guys .	these plates does lift those guys .
that book does n't teach those books .	that book do n't teach those books .
this fork does n't listen to that fork .	this fork do n't listen to that fork .
this car is n't talking .	this car are n't talking .
the crayons do n't win .	the crayons does n't win .
that picture has n't heard those hats .	that picture have n't heard those hats .
this mall does n't learn .	this mall do n't learn .
those hats do n't bring these girls .	those hats does n't bring these girls .
the bowls do praise this rug .	the bowls does praise this rug .
that dish does n't run .	that dish do n't run .
the pictures do n't whisper .	the pictures does n't whisper .
that rocket has laughed .	that rocket have laughed .
that bed does n't talk to that glass .	that bed do n't talk to that glass .
the park has made the patient .	the park have made the patient .
these shirts have eaten .	these shirts has eaten .
those cups have n't talked to the bed .	those cups has n't talked to the bed .
the mall does n't lift those guys .	the mall do n't lift those guys .
the bag is helping these cars .	the bag are helping these cars .
these bags were n't laughing .	these bags was n't laughing .
this car is n't losing .	this car are n't losing .
that restaurant does scare the candle .	that restaurant do scare the candle .
these cars are n't cleaning the girls .	these cars is n't cleaning the girls .
those shoes have n't answered this library .	those shoes has n't answered this library .
that shirt does n't whisper .	that shirt do n't whisper .
these bags are listening to that rug .	these bags is listening to that rug .
those plates have taken these girls .	those plates has taken these girls .
those doors are n't buying that guy .	those doors is n't buying that guy .
that mall has laughed .	that mall have laughed .
this rocket was n't losing the lady .	this rocket were n't losing the lady .
this boat does sing .	this boat do sing .
these shirts do laugh .	these shirts does laugh .
the boxes are n't eating .	the boxes is n't eating .
these crayons have n't eaten .	these crayons has n't eaten .
this hat does n't answer those windows .	this hat do n't answer those windows .
those beds do move this boy .	those beds does move this boy .
the window was n't singing .	the window were n't singing .
this bowl is throwing this lady .	this bowl are throwing this lady .
the schools have won .	the schools has won .
that hospital does n't appreciate the door .	that hospital do n't appreciate the door .
the beds have n't found the picture .	the beds has n't found the picture .
these bags have run .	these bags has run .
the books were singing .	the books was singing .
those forks do care for the picture .	those forks does care for the picture .
the box does n't answer the ship .	the box do n't answer the ship .
the bag is n't laughing .	the bag are n't laughing .
those shoes do n't wave .	those shoes does n't wave .
those candles do n't yell .	those candles does n't yell .
the forks are finding the dancer .	the forks is finding the dancer .
this plane does n't understand the rocket .	this plane do n't understand the rocket .
the bottle was cleaning that teacher .	the bottle were cleaning that teacher .
these schools have n't run .	these schools has n't run .
those boats were eating .	those boats was eating .
this bicycle does sneeze .	this bicycle do sneeze .
that glass does n't know this dish .	that glass do n't know this dish .
this restaurant has confused the forks .	this restaurant have confused the forks .
the glasses do n't work with these forks .	the glasses does n't work with these forks .
the box does n't learn .	the box do n't learn .
the cup has n't answered those windows .	the cup have n't answered those windows .
those boats were losing .	those boats was losing .
that room has moved that adult .	that room have moved that adult .
the mirror has held this person .	the mirror have held this person .
the chair was waving .	the chair were waving .
the schools do visit the bags .	the schools does visit the bags .
the bowl has n't won .	the bowl have n't won .
the fork has n't heard that shoe .	the fork have n't heard that shoe .
those crayons have lost .	those crayons has lost .
these bowls do fix this man .	these bowls does fix this man .
the dolls do n't help that spoon .	the dolls does n't help that spoon .
these books are n't talking .	these books is n't talking .
these cars have lost .	these cars has lost .
this shirt does n't hear the rings .	this shirt do n't hear the rings .
the shirts were practicing .	the shirts was practicing .
that door does n't talk to these forks .	that door do n't talk to these forks .
this dish does n't know the cups .	this dish do n't know the cups .
the shirts do n't praise these spoons .	the shirts does n't praise these spoons .
this ship does cough .	this ship do cough .
that shoe does cough .	that shoe do cough .
the park does yell .	the park do yell .
these dishes have n't heard that cup .	these dishes has n't heard that cup .
the hospital does lie .	the hospital do lie .
the car was running .	the car were running .
that hospital was n't teaching the bag .	that hospital were n't teaching the bag .
those plates have lost .	those plates has lost .
that bed is painting .	that bed are painting .
that bottle was finding this child .	that bottle were finding this child .
these toys have held that doctor .	these toys has held that doctor .
this chair is n't learning .	this chair are n't learning .
that mirror is screaming .	that mirror are screaming .
that box does n't appreciate this chair .	that box do n't appreciate this chair .
this restaurant is screaming .	this restaurant are screaming .
the button is moving this dancer .	the button are moving this dancer .
that rug has n't cleaned these girls .	that rug have n't cleaned these girls .
those boxes were practicing .	those boxes was practicing .
these schools have n't answered these glasses .	these schools has n't answered these glasses .
those boats do scream .	those boats does scream .
that crayon was n't painting .	that crayon were n't painting .
these books have thrown the men .	these books has thrown the men .
this kitchen has n't moved that dentist .	this kitchen have n't moved that dentist .
those spoons do n't smile .	those spoons does n't smile .
these pictures have thrown those teachers .	these pictures has thrown those teachers .
that dish is throwing the person .	that dish are throwing the person .
the crayons do n't hear those shirts .	the crayons does n't hear those shirts .
those plates have n't confused that boat .	those plates has n't confused that boat .
that bed does n't learn .	that bed do n't learn .
that couch does hear the shirts .	that couch do hear the shirts .
the window is n't talking to the doll .	the window are n't talking to the doll .
those chairs have n't grown .	those chairs has n't grown .
that bed was helping these forks .	that bed were helping these forks .
the shoes have talked to this rug .	the shoes has talked to this rug .
the rings do n't sing .	the rings does n't sing .
that spoon does n't lose .	that spoon do n't lose .
that bed does drop the person .	that bed do drop the person .
this mall is n't visiting the picture .	this mall are n't visiting the picture .
that bag does smile .	that bag do smile .
those boats have n't won .	those boats has n't won .
the hat does n't exercise .	the hat do n't exercise .
these hats were n't visiting that chair .	these hats was n't visiting that chair .
that crayon does n't throw these ladies .	that crayon do n't throw these ladies .
the bank does n't wave .	the bank do n't wave .
the dolls have cried .	the dolls has cried .
this bowl does talk to the hat .	this bowl do talk to the hat .
this book does lose .	this book do lose .
that bowl does n't answer the dolls .	that bowl do n't answer the dolls .
these schools have fixed this doctor .	these schools has fixed this doctor .
this shirt has n't lost these men .	this shirt have n't lost these men .
the window does help the window .	the window do help the window .
the candle has n't won .	the candle have n't won .
those glasses do exercise .	those glasses does exercise .
that book is n't listening to that car .	that book are n't listening to that car .
the bottle is yelling .	the bottle are yelling .
the book is listening to the bags .	the book are listening to the bags .
that restaurant is cleaning that queen .	that restaurant are cleaning that queen .
the boat has confused these books .	the boat have confused these books .
these beds are fixing this patient .	these beds is fixing this patient .
those rings have n't run .	those rings has n't run .
this crayon does n't grow .	this crayon do n't grow .
that candle is keeping these women .	that candle are keeping these women .
that book does n't cry .	that book do n't cry .
that couch has run .	that couch have run .
these boxes were growing .	these boxes was growing .
this bed has n't moved this king .	this bed have n't moved this king .
that kitchen is n't eating .	that kitchen are n't eating .
this chair does read .	this chair do read .
the shoe has n't found those bags .	the shoe have n't found those bags .
that park does n't learn .	that park do n't learn .
the crayon has lost the spoons .	the crayon have lost the spoons .
these boats do know the restaurant .	these boats does know the restaurant .
these windows have lost .	these windows has lost .
these books do n't make the dancer .	these books does n't make the dancer .
the pictures have n't heard this cup .	the pictures has n't heard this cup .
that restaurant has answered that room .	that restaurant have answered that room .
this cup has waved .	this cup have waved .
these beds do n't sing .	these beds does n't sing .
those bottles have n't fixed the children .	those bottles has n't fixed the children .
that park does n't clean these teachers .	that park do n't clean these teachers .
that doll does paint .	that doll do paint .
that truck has n't lost .	that truck have n't lost .
this candle has laughed .	this candle have laughed .
those dolls do listen to that hat .	those dolls does listen to that hat .
that car does shake the child .	that car do shake the child .
the truck does bring this boy .	the truck do bring this boy .
this spoon is n't fixing that patient .	this spoon are n't fixing that patient .
that cup does lie .	that cup do lie .
the schools do n't care for the rings .	the schools does n't care for the rings .
the box has waved .	the box have waved .
that school does help this picture .	that school do help this picture .
those chairs are reading .	those chairs is reading .
that car has n't taken this person .	that car have n't taken this person .
that mirror does n't practice .	that mirror do n't practice .
that plane does n't yell .	that plane do n't yell .
those bags do bother the shoes .	those bags does bother the shoes .
the book has n't worked with this crayon .	the book have n't worked with this crayon .
that cup has n't made this adult .	that cup have n't made this adult .
the button does wave .	the button do wave .
those rooms do lose the men .	those rooms does lose the men .
those cups were n't teaching this rocket .	those cups was n't teaching this rocket .
the bags were smiling .	the bags was smiling .
that dish does hear these boats .	that dish do hear these boats .
these books have n't lost .	these books has n't lost .
the ship does throw the dentist .	the ship do throw the dentist .
these buttons are screaming .	these buttons is screaming .
the chair was lying .	the chair were lying .
these schools do grow .	these schools does grow .
the mall does visit these pictures .	the mall do visit these pictures .
that door was n't teaching those hats .	that door were n't teaching those hats .
these boxes were n't bothering the chairs .	these boxes was n't bothering the chairs .
this doll has n't scared the buttons .	this doll have n't scared the buttons .
this cup does laugh .	this cup do laugh .
the ring does answer the museum .	the ring do answer the museum .
this car does n't bring the driver .	this car do n't bring the driver .
that school is n't helping these spoons .	that school are n't helping these spoons .
this truck does hold this patient .	this truck do hold this patient .
that bed does practice .	that bed do practice .
that ship has grown .	that ship have grown .
this spoon does n't shake that dancer .	this spoon do n't shake that dancer .
that bicycle has n't helped this picture .	that bicycle have n't helped this picture .
these beds have n't talked to the bags .	these beds has n't talked to the bags .
that shirt has found that picture .	that shirt have found that picture .
that chair is crying .	that chair are crying .
those glasses do sell the queen .	those glasses does sell the queen .
this ship is bothering that bowl .	this ship are bothering that bowl .
those shoes are teaching this kitchen .	those shoes is teaching this kitchen .
this school does buy that driver .	this school do buy that driver .
this toy has worried this bottle .	this toy have worried this bottle .
this door does teach this couch .	this door do teach this couch .
this rocket has n't scared this mall .	this rocket have n't scared this mall .
the restaurant does steal that boy .	the restaurant do steal that boy .
that toy has heard that chair .	that toy have heard that chair .
the fork does lift that boy .	the fork do lift that boy .
those books are holding the woman .	those books is holding the woman .
this bottle has eaten .	this bottle have eaten .
the crayons do find this person .	the crayons does find this person .
the glass has heard the bank .	the glass have heard the bank .
that hat is dropping the guy .	that hat are dropping the guy .
that shirt has helped that fork .	that shirt have helped that fork .
that mirror does n't understand these boats .	that mirror do n't understand these boats .
that picture is n't waving .	that picture are n't waving .
these forks were smiling .	these forks was smiling .
these rooms are screaming .	these rooms is screaming .
that crayon has worried these beds .	that crayon have worried these beds .
the picture has n't heard that doll .	the picture have n't heard that doll .
that kitchen was teaching that book .	that kitchen were teaching that book .
the mirror is n't listening to the shoes .	the mirror are n't listening to the shoes .
the schools have held that man .	the schools has held that man .
the book was n't fixing that dentist .	the book were n't fixing that dentist .
the trucks do talk to the books .	the trucks does talk to the books .
the hospital has scared this rug .	the hospital have scared this rug .
the door is crying .	the door are crying .
that car was n't visiting this crayon .	that car were n't visiting this crayon .
the crayon has n't kept that person .	the crayon have n't kept that person .
these beds are n't finding the dancer .	these beds is n't finding the dancer .
the windows do n't work with that rocket .	the windows does n't work with that rocket .
these pictures are n't losing this boy .	these pictures is n't losing this boy .
those dishes do n't hear those trucks .	those dishes does n't hear those trucks .
this cup has n't helped that crayon .	this cup have n't helped that crayon .
that plane is n't practicing .	that plane are n't practicing .
these shoes do n't teach the books .	these shoes does n't teach the books .
the candle was smiling .	the candle were smiling .
this hat does bother the bank .	this hat do bother the bank .
these glasses do n't stretch .	these glasses does n't stretch .
the school was n't painting .	the school were n't painting .
this toy has n't cried .	this toy have n't cried .
the cars do n't scare this rocket .	the cars does n't scare this rocket .
that school does n't have the children .	that school do n't have the children .
this picture does n't lie .	this picture do n't lie .
the bag does talk to that shirt .	the bag do talk to that shirt .
the mirror was n't working with the book .	the mirror were n't working with the book .
that glass has cried .	that glass have cried .
the fork has n't taken that doctor .	the fork have n't taken that doctor .
that museum is singing .	that museum are singing .
this candle is n't throwing that dancer .	this candle are n't throwing that dancer .
that toy does n't grow .	that toy do n't grow .
that cup does care for those plates .	that cup do care for those plates .
these toys are growing .	these toys is growing .
that candle was n't losing .	that candle were n't losing .
this spoon does yell .	this spoon do yell .
that car has won .	that car have won .
that room was whispering .	that room were whispering .
that school has answered this bank .	that school have answered this bank .
these boxes have taken this king .	these boxes has taken this king .
those glasses have n't talked to that door .	those glasses has n't talked to that door .
this rocket does n't shake these boys .	this rocket do n't shake these boys .
the trucks have n't answered these pictures .	the trucks has n't answered these pictures .
those boats do n't hear the bottles .	those boats does n't hear the bottles .
the books do n't shake that patient .	the books does n't shake that patient .
this book does n't practice .	this book do n't practice .
those cars do n't stretch .	those cars does n't stretch .
that toy has n't bothered these buttons .	that toy have n't bothered these buttons .
the candles are lying .	the candles is lying .
the box is eating .	the box are eating .
the schools were bothering the truck .	the schools was bothering the truck .
the plates do n't run .	the plates does n't run .
those dishes do n't learn .	those dishes does n't learn .
this library is n't helping that school .	this library are n't helping that school .
the doors have waved .	the doors has waved .
that couch does n't talk to those toys .	that couch do n't talk to those toys .
the beds have n't scared the couch .	the beds has n't scared the couch .
the bicycle is n't making that guy .	the bicycle are n't making that guy .
those beds do care for that shirt .	those beds does care for that shirt .
that book has n't answered that bed .	that book have n't answered that bed .
that plane was working with that book .	that plane were working with that book .
this school does learn .	this school do learn .
that door was n't singing .	that door were n't singing .
that plate is whispering .	that plate are whispering .
this ship does hear the mirror .	this ship do hear the mirror .
the bottle was n't crying .	the bottle were n't crying .
the button does laugh .	the button do laugh .
the books have n't grown .	the books has n't grown .
the kitchen is working with this chair .	the kitchen are working with this chair .
the school has thrown the ladies .	the school have thrown the ladies .
these trucks are n't waving .	these trucks is n't waving .
this mirror was visiting the candles .	this mirror were visiting the candles .
the cars do n't buy these men .	the cars does n't buy these men .
the cups were n't helping that room .	the cups was n't helping that room .
the bowls have n't visited those dolls .	the bowls has n't visited those dolls .
the boxes have made this girl .	the boxes has made this girl .
that room does n't sing .	that room do n't sing .
this spoon does whisper .	this spoon do whisper .
the hats have n't talked to that doll .	the hats has n't talked to that doll .
the boat does bring the doctor .	the boat do bring the doctor .
the rocket is n't listening to that crayon .	the rocket are n't listening to that crayon .
that door is eating .	that door are eating .
that bed was n't reading .	that bed were n't reading .
this kitchen does n't talk to this bicycle .	this kitchen do n't talk to this bicycle .
the plates have n't found the beds .	the plates has n't found the beds .
the boats were smiling .	the boats was smiling .
that bottle does n't scream .	that bottle do n't scream .
these schools do n't sing .	these schools does n't sing .
this mall does cough .	this mall do cough .
these hats are losing .	these hats is losing .
that park was running .	that park were running .
the shirt has grown .	the shirt have grown .
this bag has read .	this bag have read .
that restaurant does n't shake the adult .	that restaurant do n't shake the adult .
the book has heard the dishes .	the book have heard the dishes .
the windows were helping this spoon .	the windows was helping this spoon .
those schools have n't taught the toys .	those schools has n't taught the toys .
