the doll does n't visit this chair .	the dolls does n't visit this chair .
the bags have yelled .	the bag have yelled .
the pictures do n't praise that candle .	the picture do n't praise that candle .
the shirt does keep these girls .	the shirts does keep these girls .
the picture does n't find this doctor .	the pictures does n't find this doctor .
the rooms have eaten .	the room have eaten .
the picture has brought this person .	the pictures has brought this person .
the boat does n't praise that couch .	the boats does n't praise that couch .
the crayon has n't answered the shirt .	the crayons has n't answered the shirt .
the cars have heard the box .	the car have heard the box .
the bed has found the girl .	the beds has found the girl .
the dish does n't know those boxes .	the dishes does n't know those boxes .
the crayon has talked .	the crayons has talked .
the shoe has n't yelled .	the shoes has n't yelled .
the bed does n't eat .	the beds does n't eat .
the room is finding the adult .	the rooms is finding the adult .
the chairs do n't worry that truck .	the chair do n't worry that truck .
the room does drop that queen .	the rooms does drop that queen .
the windows have learned .	the window have learned .
the shoe has n't dropped the boy .	the shoes has n't dropped the boy .
the trucks have n't read .	the truck have n't read .
the plate does n't hear that toy .	the plates does n't hear that toy .
the chair was n't bothering that crayon .	the chairs was n't bothering that crayon .
the school does n't sing .	the schools does n't sing .
the plate does grow .	the plates does grow .
the fork has n't heard this bottle .	the forks has n't heard this bottle .
the shoes are n't teaching the beds .	the shoe are n't teaching the beds .
the shirts do win .	the shirt do win .
the bowl does n't hear this spoon .	the bowls does n't hear this spoon .
the bowls have made this man .	the bowl have made this man .
the plates were talking to that bank .	the plate were talking to that bank .
the plate does listen to that library .	the plates does listen to that library .
the pictures do care for those bowls .	the picture do care for those bowls .
the plate does n't sneeze .	the plates does n't sneeze .
the boat does have that boy .	the boats does have that boy .
the plates have thrown these women .	the plate have thrown these women .
the button does n't lose the person .	the buttons does n't lose the person .
the schools have talked .	the school have talked .
the bags have n't learned .	the bag have n't learned .
the buttons do talk to this school .	the button do talk to this school .
the cars were shaking these women .	the car were shaking these women .
the car has n't confused that bag .	the cars has n't confused that bag .
the school was keeping that man .	the schools was keeping that man .
the doors have visited those rings .	the door have visited those rings .
the bowls were buying those boys .	the bowl were buying those boys .
the windows were n't cleaning the girls .	the window were n't cleaning the girls .
the cups were listening to the hospital .	the cup were listening to the hospital .
the dish has n't heard this doll .	the dishes has n't heard this doll .
the buttons are practicing .	the button are practicing .
the rooms do scare the cups .	the room do scare the cups .
the books do n't teach the crayon .	the book do n't teach the crayon .
the books do n't know these cars .	the book do n't know these cars .
the plates have lost that picture .	the plate have lost that picture .
the bags were n't singing .	the bag were n't singing .
the cups have won .	the cup have won .
the trucks were n't reading .	the truck were n't reading .
the book has n't heard those boats .	the books has n't heard those boats .
the books were n't listening to the dishes .	the book were n't listening to the dishes .
the schools do n't lose that boy .	the school do n't lose that boy .
the schools do win .	the school do win .
the button was n't crying .	the buttons was n't crying .
the buttons were singing .	the button were singing .
the cups were practicing .	the cup were practicing .
the boat does paint .	the boats does paint .
the crayons do n't talk .	the crayon do n't talk .
the bowl was working with these toys .	the bowls was working with these toys .
the ring has n't bothered this glass .	the rings has n't bothered this glass .
the schools are n't visiting this door .	the school are n't visiting this door .
the bag has n't found the spoons .	the bags has n't found the spoons .
the glasses do n't understand that candle .	the glass do n't understand that candle .
the books are n't talking .	the book are n't talking .
the window was singing .	the windows was singing .
the bottles were helping the hats .	the bottle were helping the hats .
the bowl does n't lose .	the bowls does n't lose .
the button has lost the rooms .	the buttons has lost the rooms .
the box is n't cleaning that girl .	the boxes is n't cleaning that girl .
the candles are screaming .	the candle are screaming .
the dishes do n't run .	the dish do n't run .
the button is n't keeping this lady .	the buttons is n't keeping this lady .
the books do n't talk .	the book do n't talk .
the school has n't lost that door .	the schools has n't lost that door .
the cars do n't listen to the button .	the car do n't listen to the button .
the candles have n't answered the doors .	the candle have n't answered the doors .
the boat does n't smile .	the boats does n't smile .
the dish has confused these cars .	the dishes has confused these cars .
the dishes have talked to the park .	the dish have talked to the park .
the cup does n't hear those crayons .	the cups does n't hear those crayons .
the car has bought this adult .	the cars has bought this adult .
the truck does n't sing .	the trucks does n't sing .
the schools do n't yell .	the school do n't yell .
the doll does lift that dentist .	the dolls does lift that dentist .
the plate has n't taken those people .	the plates has n't taken those people .
the windows do know this button .	the window do know this button .
the bed does lose .	the beds does lose .
the rooms have heard the windows .	the room have heard the windows .
the rooms do wave .	the room do wave .
the doors do talk to the couch .	the door do talk to the couch .
the toy does sing .	the toys does sing .
the cup does n't help the candles .	the cups does n't help the candles .
the doll is n't talking .	the dolls is n't talking .
the cars do eat .	the car do eat .
the dish does n't take the children .	the dishes does n't take the children .
the cars are n't learning .	the car are n't learning .
the book was n't bothering that plane .	the books was n't bothering that plane .
the car is talking .	the cars is talking .
the hat has painted .	the hats has painted .
the trucks were learning .	the truck were learning .
the shoe does n't bring this customer .	the shoes does n't bring this customer .
the plate is practicing .	the plates is practicing .
the rings do keep those guys .	the ring do keep those guys .
the picture is eating .	the pictures is eating .
the toys have n't run .	the toy have n't run .
the school does n't answer that bank .	the schools does n't answer that bank .
the picture has n't won .	the pictures has n't won .
the bowls are n't shaking this customer .	the bowl are n't shaking this customer .
the spoons have heard the doors .	the spoon have heard the doors .
the toy was working with the library .	the toys was working with the library .
the hats do run .	the hat do run .
the door has n't learned .	the doors has n't learned .
the hat does throw those men .	the hats does throw those men .
the dish does hear these cars .	the dishes does hear these cars .
the room is holding the driver .	the rooms is holding the driver .
the candles have n't worried the mall .	the candle have n't worried the mall .
the buttons have lost those ladies .	the button have lost those ladies .
the bags are n't crying .	the bag are n't crying .
the plate does n't read .	the plates does n't read .
the bags are running .	the bag are running .
the dish does n't hear this book .	the dishes does n't hear this book .
the chairs do find the woman .	the chair do find the woman .
the glass was finding this king .	the glasses was finding this king .
the chair has painted .	the chairs has painted .
the pictures do listen to this park .	the picture do listen to this park .
the cups do cough .	the cup do cough .
the dish does n't learn .	the dishes does n't learn .
the school is n't teaching that cup .	the schools is n't teaching that cup .
the bags do n't sing .	the bag do n't sing .
the spoons were eating .	the spoon were eating .
the bag does exercise .	the bags does exercise .
the bag does n't win .	the bags does n't win .
the bottle is n't running .	the bottles is n't running .
the rooms do n't steal those doctors .	the room do n't steal those doctors .
the hat does lose this man .	the hats does lose this man .
the bags were n't learning .	the bag were n't learning .
the pictures are listening to the bags .	the picture are listening to the bags .
the glasses are bringing those doctors .	the glass are bringing those doctors .
the bottles have worked with those boxes .	the bottle have worked with those boxes .
the book does n't yell .	the books does n't yell .
the plates do n't stretch .	the plate do n't stretch .
the bed was n't moving the guy .	the beds was n't moving the guy .
the school is n't talking to this chair .	the schools is n't talking to this chair .
the fork is working with the park .	the forks is working with the park .
the books do n't read .	the book do n't read .
the dolls do n't throw that woman .	the doll do n't throw that woman .
the cars were n't dropping those boys .	the car were n't dropping those boys .
the window does listen to that kitchen .	the windows does listen to that kitchen .
the candle is finding this patient .	the candles is finding this patient .
the bags have cleaned these doctors .	the bag have cleaned these doctors .
the cars are eating .	the car are eating .
the box does n't appreciate these doors .	the boxes does n't appreciate these doors .
the boat does listen to those dishes .	the boats does listen to those dishes .
the plates have taught those boats .	the plate have taught those boats .
the shoes have heard that truck .	the shoe have heard that truck .
the doll was n't keeping that dentist .	the dolls was n't keeping that dentist .
the windows were throwing these girls .	the window were throwing these girls .
the crayons do buy the boys .	the crayon do buy the boys .
the schools do answer these boxes .	the school do answer these boxes .
the schools do n't lose .	the school do n't lose .
the shoes are n't learning .	the shoe are n't learning .
the ring was losing those teachers .	the rings was losing those teachers .
the shoe does answer that hospital .	the shoes does answer that hospital .
the boat was n't helping that plane .	the boats was n't helping that plane .
the box has heard the cup .	the boxes has heard the cup .
the buttons do visit the hat .	the button do visit the hat .
the boats were n't painting .	the boat were n't painting .
the bed has talked .	the beds has talked .
the room has moved this teacher .	the rooms has moved this teacher .
the shirts do n't help this car .	the shirt do n't help this car .
the dish does buy this woman .	the dishes does buy this woman .
the bowls do n't wave .	the bowl do n't wave .
the shoe has n't bought that dentist .	the shoes has n't bought that dentist .
the chairs were laughing .	the chair were laughing .
the boats have dropped the boys .	the boat have dropped the boys .
the hat was working with the rug .	the hats was working with the rug .
the shirt does n't bother these glasses .	the shirts does n't bother these glasses .
the shoe is eating .	the shoes is eating .
the books do n't stretch .	the book do n't stretch .
the book was bothering these bottles .	the books was bothering these bottles .
the rings do n't appreciate this shoe .	the ring do n't appreciate this shoe .
the door has n't taken this woman .	the doors has n't taken this woman .
the boats have n't found that child .	the boat have n't found that child .
the box has grown .	the boxes has grown .
the schools are learning .	the school are learning .
the cars do n't worry these schools .	the car do n't worry these schools .
the books were visiting that mall .	the book were visiting that mall .
the boxes have fixed the teacher .	the box have fixed the teacher .
the school has moved the girls .	the schools has moved the girls .
the dolls do n't stretch .	the doll do n't stretch .
the boats have fixed this guy .	the boat have fixed this guy .
the bowl has kept the woman .	the bowls has kept the woman .
the room has taught this ship .	the rooms has taught this ship .
the truck has talked .	the trucks has talked .
the button was losing .	the buttons was losing .
the school has lost .	the schools has lost .
the books were n't working with that school .	the book were n't working with that school .
the cup has waved .	the cups has waved .
the books do cry .	the book do cry .
the box was n't finding that driver .	the boxes was n't finding that driver .
the book has n't read .	the books has n't read .
the pictures were laughing .	the picture were laughing .
the ring was shaking the girl .	the rings was shaking the girl .
the crayon does n't care for the button .	the crayons does n't care for the button .
the cars have n't heard that bowl .	the car have n't heard that bowl .
the cups do n't help these cars .	the cup do n't help these cars .
the spoons were n't reading .	the spoon were n't reading .
the bowls are fixing this boy .	the bowl are fixing this boy .
the school was n't losing this adult .	the schools was n't losing this adult .
the crayon was n't making that dentist .	the crayons was n't making that dentist .
the chair does n't praise the car .	the chairs does n't praise the car .
the candles do n't whisper .	the candle do n't whisper .
the rings were n't finding this woman .	the ring were n't finding this woman .
the picture was n't crying .	the pictures was n't crying .
the pictures do n't stretch .	the picture do n't stretch .
the spoon does exercise .	the spoons does exercise .
the box has found that girl .	the boxes has found that girl .
the toys do hold those teachers .	the toy do hold those teachers .
the boat does n't read .	the boats does n't read .
the shirt has n't painted .	the shirts has n't painted .
the boats are n't waving .	the boat are n't waving .
the schools have n't cried .	the school have n't cried .
the schools are n't helping the dishes .	the school are n't helping the dishes .
the rings are n't smiling .	the ring are n't smiling .
the spoons do smile .	the spoon do smile .
the fork is dropping the teachers .	the forks is dropping the teachers .
the plates have talked to these shoes .	the plate have talked to these shoes .
the plates do n't paint .	the plate do n't paint .
the spoon does n't smile .	the spoons does n't smile .
the hats have n't scared those schools .	the hat have n't scared those schools .
the fork has n't answered that toy .	the forks has n't answered that toy .
the picture was n't growing .	the pictures was n't growing .
the forks do exercise .	the fork do exercise .
the school is growing .	the schools is growing .
the school has bothered these rooms .	the schools has bothered these rooms .
the cars were n't throwing the doctors .	the car were n't throwing the doctors .
the shoe has n't cleaned those men .	the shoes has n't cleaned those men .
the box has n't won .	the boxes has n't won .
the books do n't buy the adult .	the book do n't buy the adult .
the crayon does n't visit the books .	the crayons does n't visit the books .
the cars do visit these schools .	the car do visit these schools .
the books do know these bowls .	the book do know these bowls .
the door does appreciate those trucks .	the doors does appreciate those trucks .
the rooms do n't hear that picture .	the room do n't hear that picture .
the school has eaten .	the schools has eaten .
the cars do have this teacher .	the car do have this teacher .
the school does n't run .	the schools does n't run .
the picture does bother this fork .	the pictures does bother this fork .
the rings were working with these cars .	the ring were working with these cars .
the cup has n't lost .	the cups has n't lost .
the cups do understand that spoon .	the cup do understand that spoon .
the book has taken this king .	the books has taken this king .
the cup is n't working with this plate .	the cups is n't working with this plate .
the school is n't teaching the book .	the schools is n't teaching the book .
the schools do appreciate those crayons .	the school do appreciate those crayons .
the spoon was n't making the woman .	the spoons was n't making the woman .
the schools have n't answered these boats .	the school have n't answered these boats .
the dishes do eat .	the dish do eat .
the dishes have won .	the dish have won .
the bag has moved the man .	the bags has moved the man .
the forks do n't exercise .	the fork do n't exercise .
the car is teaching this ship .	the cars is teaching this ship .
the bowls were growing .	the bowl were growing .
the rings do n't visit those rings .	the ring do n't visit those rings .
the bowls do n't listen to that book .	the bowl do n't listen to that book .
the beds do n't hear that rug .	the bed do n't hear that rug .
the shirt is throwing that man .	the shirts is throwing that man .
the bowl does talk .	the bowls does talk .
the shoe does grow .	the shoes does grow .
the dish is n't practicing .	the dishes is n't practicing .
the truck has helped these books .	the trucks has helped these books .
the boat was throwing these children .	the boats was throwing these children .
the bag does keep this driver .	the bags does keep this driver .
the button is n't helping this plane .	the buttons is n't helping this plane .
the dolls do n't learn .	the doll do n't learn .
the trucks do n't exercise .	the truck do n't exercise .
the trucks have n't painted .	the truck have n't painted .
the dishes were learning .	the dish were learning .
the boat does sell the woman .	the boats does sell the woman .
the hat is bringing the teachers .	the hats is bringing the teachers .
the boats do throw the patient .	the boat do throw the patient .
the glass has n't lost those rooms .	the glasses has n't lost those rooms .
the room does bother those schools .	the rooms does bother those schools .
the dolls do n't take this child .	the doll do n't take this child .
the rings were n't bothering the forks .	the ring were n't bothering the forks .
the trucks have n't heard that glass .	the truck have n't heard that glass .
the ring does hear these rooms .	the rings does hear these rooms .
the dish was buying the teachers .	the dishes was buying the teachers .
the button does n't know this fork .	the buttons does n't know this fork .
the bags have n't heard those candles .	the bag have n't heard those candles .
the schools do care for the spoon .	the school do care for the spoon .
the boxes do n't wave .	the box do n't wave .
the dishes do scare this park .	the dish do scare this park .
the chairs do throw the person .	the chair do throw the person .
the buttons are painting .	the button are painting .
the crayons have eaten .	the crayon have eaten .
the bags have n't taught that mirror .	the bag have n't taught that mirror .
the candle was reading .	the candles was reading .
the chair is n't practicing .	the chairs is n't practicing .
the button was n't talking to this box .	the buttons was n't talking to this box .
the cup does lie .	the cups does lie .
the shoes have helped the bank .	the shoe have helped the bank .
the cups have n't made the guy .	the cup have n't made the guy .
the candle does n't teach the ship .	the candles does n't teach the ship .
the shoe does n't understand the dolls .	the shoes does n't understand the dolls .
the bowls do hold the girl .	the bowl do hold the girl .
the book does lift these girls .	the books does lift these girls .
the button is n't visiting these hats .	the buttons is n't visiting these hats .
the bags are n't working with these bowls .	the bag are n't working with these bowls .
the book has n't taken the man .	the books has n't taken the man .
the plates have n't grown .	the plate have n't grown .
the school does steal those teachers .	the schools does steal those teachers .
the boats have heard these plates .	the boat have heard these plates .
the toys have worried this bowl .	the toy have worried this bowl .
the toy does help the bottle .	the toys does help the bottle .
the boxes have bought that person .	the box have bought that person .
the shoe does n't run .	the shoes does n't run .
the book is listening to the shirt .	the books is listening to the shirt .
the beds have n't heard the spoons .	the bed have n't heard the spoons .
the box has heard that mirror .	the boxes has heard that mirror .
the windows do throw the lady .	the window do throw the lady .
the boxes do n't shake that patient .	the box do n't shake that patient .
the beds were n't losing this guy .	the bed were n't losing this guy .
the doll was n't working with these bags .	the dolls was n't working with these bags .
the forks are n't practicing .	the fork are n't practicing .
the cars do n't drop the guy .	the car do n't drop the guy .
the windows were keeping those ladies .	the window were keeping those ladies .
the shoe does learn .	the shoes does learn .
the book does know this museum .	the books does know this museum .
the doll has laughed .	the dolls has laughed .
the book has n't thrown that driver .	the books has n't thrown that driver .
the chairs are n't whispering .	the chair are n't whispering .
the bowl has n't read .	the bowls has n't read .
the room has answered those spoons .	the rooms has answered those spoons .
the room was n't keeping that queen .	the rooms was n't keeping that queen .
the forks were n't painting .	the fork were n't painting .
the rings have visited the ring .	the ring have visited the ring .
the forks have n't bothered that spoon .	the fork have n't bothered that spoon .
the fork does n't whisper .	the forks does n't whisper .
the boat is n't teaching this ring .	the boats is n't teaching this ring .
the rooms do n't learn .	the room do n't learn .
the boat has n't heard the cup .	the boats has n't heard the cup .
the dishes do n't help the bag .	the dish do n't help the bag .
the door was n't crying .	the doors was n't crying .
the truck does grow .	the trucks does grow .
the glasses do n't take the women .	the glass do n't take the women .
the ring has worried these cups .	the rings has worried these cups .
the rings do n't understand that library .	the ring do n't understand that library .
the door does n't stretch .	the doors does n't stretch .
the room has bought those people .	the rooms has bought those people .
the window has held the patient .	the windows has held the patient .
the hats do n't know those cars .	the hat do n't know those cars .
the cars do appreciate these schools .	the car do appreciate these schools .
the room was singing .	the rooms was singing .
the car does sell the queen .	the cars does sell the queen .
the book does care for that car .	the books does care for that car .
the dolls are moving the women .	the doll are moving the women .
the truck has n't taken the children .	the trucks has n't taken the children .
the boat has found the boys .	the boats has found the boys .
the chairs do cough .	the chair do cough .
the toys do n't care for this bicycle .	the toy do n't care for this bicycle .
the glass does care for the book .	the glasses does care for the book .
the pictures are n't moving the person .	the picture are n't moving the person .
the rings have n't bought this boy .	the ring have n't bought this boy .
the shirts have n't grown .	the shirt have n't grown .
the schools do n't laugh .	the school do n't laugh .
the plates were n't smiling .	the plate were n't smiling .
the window does stretch .	the windows does stretch .
the shirt does hear the glasses .	the shirts does hear the glasses .
the crayon does n't whisper .	the crayons does n't whisper .
the car does lose .	the cars does lose .
the schools have n't worried these schools .	the school have n't worried these schools .
the bag was talking .	the bags was talking .
the cups are n't talking to the cars .	the cup are n't talking to the cars .
the spoons are n't waving .	the spoon are n't waving .
the glasses were n't smiling .	the glass were n't smiling .
the cars do listen to that museum .	the car do listen to that museum .
the cars do n't smile .	the car do n't smile .
the doll has run .	the dolls has run .
the schools were n't talking .	the school were n't talking .
the bottles have n't fixed the adult .	the bottle have n't fixed the adult .
the candles were n't listening to that park .	the candle were n't listening to that park .
the cars do n't learn .	the car do n't learn .
the plate does hear that rug .	the plates does hear that rug .
the bags were n't painting .	the bag were n't painting .
the dishes have n't found that room .	the dish have n't found that room .
the plate has bothered this doll .	the plates has bothered this doll .
the crayons have n't found the bowl .	the crayon have n't found the bowl .
the chairs have painted .	the chair have painted .
the shirt has n't heard this museum .	the shirts has n't heard this museum .
the candle is n't talking to the bowls .	the candles is n't talking to the bowls .
the spoons do n't hear that bag .	the spoon do n't hear that bag .
the bowls are n't waving .	the bowl are n't waving .
the pictures have heard those chairs .	the picture have heard those chairs .
the bottle does listen to that toy .	the bottles does listen to that toy .
the bag does n't read .	the bags does n't read .
the boats have n't bothered the pictures .	the boat have n't bothered the pictures .
the school does talk .	the schools does talk .
the bowls do n't lose .	the bowl do n't lose .
the chair is n't cleaning the girl .	the chairs is n't cleaning the girl .
the door does n't find those girls .	the doors does n't find those girls .
the boat is n't working with that library .	the boats is n't working with that library .
the cars have taken these doctors .	the car have taken these doctors .
the bottles do n't keep those girls .	the bottle do n't keep those girls .
the books have n't laughed .	the book have n't laughed .
the picture was n't practicing .	the pictures was n't practicing .
the cups do work with those schools .	the cup do work with those schools .
the pictures do work with these schools .	the picture do work with these schools .
the ring does wave .	the rings does wave .
the candles do yell .	the candle do yell .
the doors do n't win .	the door do n't win .
the chairs do n't understand the kitchen .	the chair do n't understand the kitchen .
the book was n't practicing .	the books was n't practicing .
the bed is n't running .	the beds is n't running .
the ring is n't talking .	the rings is n't talking .
the truck does n't help that dish .	the trucks does n't help that dish .
the picture has n't made the girls .	the pictures has n't made the girls .
the button does n't stretch .	the buttons does n't stretch .
the fork has eaten .	the forks has eaten .
the dish does help these boxes .	the dishes does help these boxes .
the picture has visited those forks .	the pictures has visited those forks .
the rooms are practicing .	the room are practicing .
the truck is n't taking this doctor .	the trucks is n't taking this doctor .
the shirts are eating .	the shirt are eating .
the school has cleaned the men .	the schools has cleaned the men .
the picture was talking .	the pictures was talking .
the school does talk to these schools .	the schools does talk to these schools .
the windows were laughing .	the window were laughing .
the book was visiting the fork .	the books was visiting the fork .
the crayon has lost the ring .	the crayons has lost the ring .
the chairs are n't bothering this rug .	the chair are n't bothering this rug .
the doll does n't learn .	the dolls does n't learn .
the windows have taken the boy .	the window have taken the boy .
the crayons are holding the king .	the crayon are holding the king .
the box does n't sing .	the boxes does n't sing .
the bowl has learned .	the bowls has learned .
the toys do n't understand those windows .	the toy do n't understand those windows .
the chairs were n't teaching those toys .	the chair were n't teaching those toys .
the pictures are losing .	the picture are losing .
the buttons do have the person .	the button do have the person .
the dish is n't finding those men .	the dishes is n't finding those men .
the rooms are losing .	the room are losing .
the plates do fix these guys .	the plate do fix these guys .
the glass does n't help that book .	the glasses does n't help that book .
the books have n't helped those beds .	the book have n't helped those beds .
the crayon is n't growing .	the crayons is n't growing .
the trucks do n't answer these cups .	the truck do n't answer these cups .
the chairs do n't take the doctor .	the chair do n't take the doctor .
the shoe does n't lift these ladies .	the shoes does n't lift these ladies .
the plate has n't bothered this bed .	the plates has n't bothered this bed .
the picture has n't fixed these girls .	the pictures has n't fixed these girls .
the dishes were singing .	the dish were singing .
the books do work with this kitchen .	the book do work with this kitchen .
the box does fix the ladies .	the boxes does fix the ladies .
the spoon has cried .	the spoons has cried .
the spoons were screaming .	the spoon were screaming .
the button does hear those doors .	the buttons does hear those doors .
the shirts have read .	the shirt have read .
the dolls have talked to the pictures .	the doll have talked to the pictures .
the truck does n't cough .	the trucks does n't cough .
the bag does n't care for the plane .	the bags does n't care for the plane .
the bags do n't visit these chairs .	the bag do n't visit these chairs .
the buttons do lose .	the button do lose .
the cars do n't buy this driver .	the car do n't buy this driver .
the book was practicing .	the books was practicing .
the shoe has helped this restaurant .	the shoes has helped this restaurant .
the button has n't moved those women .	the buttons has n't moved those women .
the school has bothered that bicycle .	the schools has bothered that bicycle .
the hats have n't grown .	the hat have n't grown .
the bottle does n't scare these shoes .	the bottles does n't scare these shoes .
the cups have n't moved this person .	the cup have n't moved this person .
the boat does care for the bottles .	the boats does care for the bottles .
the buttons have eaten .	the button have eaten .
the dish does n't bother the rug .	the dishes does n't bother the rug .
the candle does sing .	the candles does sing .
the toys have n't scared this toy .	the toy have n't scared this toy .
the windows have n't confused this bowl .	the window have n't confused this bowl .
the dolls were taking that queen .	the doll were taking that queen .
the crayons have found that box .	the crayon have found that box .
the rooms have n't eaten .	the room have n't eaten .
the chairs do n't eat .	the chair do n't eat .
the button is running .	the buttons is running .
the car has heard that library .	the cars has heard that library .
the cars have n't waved .	the car have n't waved .
the candle is n't talking to those chairs .	the candles is n't talking to those chairs .
the car does n't listen to those shirts .	the cars does n't listen to those shirts .
the cars were n't working with the museum .	the car were n't working with the museum .
the plate does paint .	the plates does paint .
the books have cried .	the book have cried .
the button has held this teacher .	the buttons has held this teacher .
the book does help those schools .	the books does help those schools .
the glasses do hear the crayons .	the glass do hear the crayons .
the hat does care for this couch .	the hats does care for this couch .
the book is n't keeping those men .	the books is n't keeping those men .
the window does n't worry these schools .	the windows does n't worry these schools .
the books are reading .	the book are reading .
the shirts do n't practice .	the shirt do n't practice .
the car has n't bought this boy .	the cars has n't bought this boy .
the cup has n't yelled .	the cups has n't yelled .
the hats do bother the boats .	the hat do bother the boats .
the book was n't dropping those boys .	the books was n't dropping those boys .
the candles do n't hear the cars .	the candle do n't hear the cars .
the shirt does find the guy .	the shirts does find the guy .
the pictures are n't running .	the picture are n't running .
the dishes do whisper .	the dish do whisper .
the bags have n't lost this hospital .	the bag have n't lost this hospital .
the ring does n't grow .	the rings does n't grow .
the crayons are n't listening to those cups .	the crayon are n't listening to those cups .
the doors have n't fixed this customer .	the door have n't fixed this customer .
the buttons are n't fixing that king .	the button are n't fixing that king .
the dishes do n't sneeze .	the dish do n't sneeze .
the forks do cough .	the fork do cough .
the glass does hear the plate .	the glasses does hear the plate .
the cup does n't sell these teachers .	the cups does n't sell these teachers .
the shoe does steal the guys .	the shoes does steal the guys .
the plate has n't heard this bicycle .	the plates has n't heard this bicycle .
the glass is n't visiting those doors .	the glasses is n't visiting those doors .
the buttons were n't listening to those buttons .	the button were n't listening to those buttons .
the chairs do hear this toy .	the chair do hear this toy .
the toy does n't praise the rooms .	the toys does n't praise the rooms .
the candles do fix this driver .	the candle do fix this driver .
the car has bothered those books .	the cars has bothered those books .
the candle does appreciate the library .	the candles does appreciate the library .
the toy does practice .	the toys does practice .
the chair does hold this king .	the chairs does hold this king .
the door has n't lost .	the doors has n't lost .
the forks are keeping this woman .	the fork are keeping this woman .
the boxes have n't worried those trucks .	the box have n't worried those trucks .
the beds have n't thrown that queen .	the bed have n't thrown that queen .
the cars have cleaned that lady .	the car have cleaned that lady .
the rooms do sell the teacher .	the room do sell the teacher .
the glasses do n't laugh .	the glass do n't laugh .
the bags have n't cried .	the bag have n't cried .
the schools do cry .	the school do cry .
the school has n't kept this person .	the schools has n't kept this person .
the glass does visit the school .	the glasses does visit the school .
the toy was n't helping that book .	the toys was n't helping that book .
the rooms have n't run .	the room have n't run .
the candles have n't talked to these cups .	the candle have n't talked to these cups .
the shirt does n't teach that toy .	the shirts does n't teach that toy .
the beds do n't care for these windows .	the bed do n't care for these windows .
the hat is n't teaching this shoe .	the hats is n't teaching this shoe .
the hat has lost that driver .	the hats has lost that driver .
the car is moving the lady .	the cars is moving the lady .
the candle was eating .	the candles was eating .
the button was n't growing .	the buttons was n't growing .
the bowl has n't taken those people .	the bowls has n't taken those people .
the box was working with this school .	the boxes was working with this school .
the bag has found the schools .	the bags has found the schools .
the picture is moving the girls .	the pictures is moving the girls .
the dolls have lost the hat .	the doll have lost the hat .
the bag was n't crying .	the bags was n't crying .
the truck is n't helping the rocket .	the trucks is n't helping the rocket .
the room does n't drop those men .	the rooms does n't drop those men .
the schools have n't grown .	the school have n't grown .
the schools have n't confused that mall .	the school have n't confused that mall .
the schools have n't visited that picture .	the school have n't visited that picture .
the ring does scream .	the rings does scream .
the school does n't listen to that toy .	the schools does n't listen to that toy .
the hat has confused the ship .	the hats has confused the ship .
the boat does practice .	the boats does practice .
the trucks have n't won .	the truck have n't won .
the bowls are waving .	the bowl are waving .
the hats have n't helped the boats .	the hat have n't helped the boats .
the bag was n't shaking this teacher .	the bags was n't shaking this teacher .
the dish does sell that driver .	the dishes does sell that driver .
the dolls do win .	the doll do win .
the crayon does lose .	the crayons does lose .
the picture is listening to the restaurant .	the pictures is listening to the restaurant .
the toy has n't talked to those bags .	the toys has n't talked to those bags .
the plate does eat .	the plates does eat .
the school has n't cleaned this patient .	the schools has n't cleaned this patient .
the bottle has scared that bag .	the bottles has scared that bag .
the window was n't teaching these doors .	the windows was n't teaching these doors .
the button does n't whisper .	the buttons does n't whisper .
the hat does work with that boat .	the hats does work with that boat .
the door does move these people .	the doors does move these people .
the toys do whisper .	the toy do whisper .
the boats do sneeze .	the boat do sneeze .
the crayons have grown .	the crayon have grown .
the cups have moved those girls .	the cup have moved those girls .
the bag is crying .	the bags is crying .
the school has n't heard the kitchen .	the schools has n't heard the kitchen .
the pictures have found the button .	the picture have found the button .
the plates have fixed the teachers .	the plate have fixed the teachers .
the cars do care for this bag .	the car do care for this bag .
the bag does n't hold that lady .	the bags does n't hold that lady .
the cars were teaching the book .	the car were teaching the book .
the school does n't yell .	the schools does n't yell .
the spoons were losing .	the spoon were losing .
the doll does know this mirror .	the dolls does know this mirror .
the doll does sneeze .	the dolls does sneeze .
the picture is fixing that doctor .	the pictures is fixing that doctor .
the boat has n't read .	the boats has n't read .
the bed does n't listen to these windows .	the beds does n't listen to these windows .
the dishes were smiling .	the dish were smiling .
the doll does have the patient .	the dolls does have the patient .
the boxes are growing .	the box are growing .
the rooms do win .	the room do win .
the shoes do n't steal these guys .	the shoe do n't steal these guys .
the candle has waved .	the candles has waved .
the picture has visited this shoe .	the pictures has visited this shoe .
the toy has heard that rug .	the toys has heard that rug .
the spoons are n't losing those doctors .	the spoon are n't losing those doctors .
the hat has n't scared the shoe .	the hats has n't scared the shoe .
the boat does scream .	the boats does scream .
the fork is n't listening to those windows .	the forks is n't listening to those windows .
the car does clean that queen .	the cars does clean that queen .
the dishes have n't scared these books .	the dish have n't scared these books .
the bowl does n't understand the plate .	the bowls does n't understand the plate .
the glasses do n't throw that adult .	the glass do n't throw that adult .
the bowls have n't fixed the people .	the bowl have n't fixed the people .
the boat was singing .	the boats was singing .
the glass does n't sell that doctor .	the glasses does n't sell that doctor .
the books have n't made these guys .	the book have n't made these guys .
the truck does n't teach that hospital .	the trucks does n't teach that hospital .
the truck has eaten .	the trucks has eaten .
the cups do n't help those chairs .	the cup do n't help those chairs .
the beds do have the king .	the bed do have the king .
the hat has n't lost .	the hats has n't lost .
the bottle is talking to the cars .	the bottles is talking to the cars .
the forks have n't painted .	the fork have n't painted .
the plate has n't kept the customer .	the plates has n't kept the customer .
the dolls do n't cry .	the doll do n't cry .
the doll does n't read .	the dolls does n't read .
the crayon has n't brought the doctors .	the crayons has n't brought the doctors .
the picture does fix this person .	the pictures does fix this person .
the hats have n't brought the girl .	the hat have n't brought the girl .
the ring does n't lie .	the rings does n't lie .
the boat does eat .	the boats does eat .
the shoe has n't lost .	the shoes has n't lost .
the car does bring that driver .	the cars does bring that driver .
the doll has n't found those chairs .	the dolls has n't found those chairs .
the dish has n't dropped these people .	the dishes has n't dropped these people .
the buttons have heard the shirts .	the button have heard the shirts .
the shoe does n't learn .	the shoes does n't learn .
the chair does learn .	the chairs does learn .
the picture does n't hold this dancer .	the pictures does n't hold this dancer .
the pictures do n't smile .	the picture do n't smile .
the candles are making that adult .	the candle are making that adult .
the pictures do n't sing .	the picture do n't sing .
the bottles do know those books .	the bottle do know those books .
the crayon does clean this woman .	the crayons does clean this woman .
the button was screaming .	the buttons was screaming .
the doors were n't shaking the doctor .	the door were n't shaking the doctor .
the schools do wave .	the school do wave .
the windows do n't understand that ship .	the window do n't understand that ship .
the pictures have n't lost this woman .	the picture have n't lost this woman .
the hats do n't lie .	the hat do n't lie .
the car has taken this adult .	the cars has taken this adult .
the room does n't visit this bowl .	the rooms does n't visit this bowl .
the shirt has learned .	the shirts has learned .
the cup is n't eating .	the cups is n't eating .
the candle does n't keep this customer .	the candles does n't keep this customer .
the doll has visited that museum .	the dolls has visited that museum .
the car does bother that bed .	the cars does bother that bed .
the boxes do n't exercise .	the box do n't exercise .
the car does n't listen to this couch .	the cars does n't listen to this couch .
the candle is n't teaching the shirts .	the candles is n't teaching the shirts .
the bowl does grow .	the bowls does grow .
the toy does n't hear those boxes .	the toys does n't hear those boxes .
the chair does hear the bicycle .	the chairs does hear the bicycle .
the bottles were n't teaching that ring .	the bottle were n't teaching that ring .
the school does n't sneeze .	the schools does n't sneeze .
the book does n't keep the woman .	the books does n't keep the woman .
the truck does n't win .	the trucks does n't win .
the dishes have lost the teachers .	the dish have lost the teachers .
the bed has n't found the child .	the beds has n't found the child .
the car has painted .	the cars has painted .
the boats do n't hear that bottle .	the boat do n't hear that bottle .
the shirts do know that rocket .	the shirt do know that rocket .
the bottles do eat .	the bottle do eat .
the shoes have answered that library .	the shoe have answered that library .
the bag does bring the women .	the bags does bring the women .
the candles have n't eaten .	the candle have n't eaten .
the chairs do know this book .	the chair do know this book .
the schools were n't throwing this person .	the school were n't throwing this person .
the car does n't hear the book .	the cars does n't hear the book .
the bed does lie .	the beds does lie .
the book does n't make the women .	the books does n't make the women .
the boat does fix this man .	the boats does fix this man .
the shirt is practicing .	the shirts is practicing .
the toy does stretch .	the toys does stretch .
the shoe has n't moved the ladies .	the shoes has n't moved the ladies .
the candles do n't cough .	the candle do n't cough .
the books are waving .	the book are waving .
the pictures are bringing that teacher .	the picture are bringing that teacher .
the glass was n't losing .	the glasses was n't losing .
the car has bothered those chairs .	the cars has bothered those chairs .
the car was n't singing .	the cars was n't singing .
the chairs were moving this boy .	the chair were moving this boy .
the picture has n't yelled .	the pictures has n't yelled .
the chair does n't whisper .	the chairs does n't whisper .
the glass was n't working with this book .	the glasses was n't working with this book .
the plate was listening to this kitchen .	the plates was listening to this kitchen .
the school has heard that bottle .	the schools has heard that bottle .
the cars do smile .	the car do smile .
the rings have n't taken these ladies .	the ring have n't taken these ladies .
the rings are n't cleaning those guys .	the ring are n't cleaning those guys .
the fork does n't worry the hats .	the forks does n't worry the hats .
the books have yelled .	the book have yelled .
the pictures do n't cough .	the picture do n't cough .
the doll was n't moving that boy .	the dolls was n't moving that boy .
the shirt does n't bring this person .	the shirts does n't bring this person .
the bowls were n't helping those cars .	the bowl were n't helping those cars .
the rings were n't yelling .	the ring were n't yelling .
the cars have n't worked with this hat .	the car have n't worked with this hat .
the trucks have eaten .	the truck have eaten .
the dishes do n't talk .	the dish do n't talk .
the crayon does find these women .	the crayons does find these women .
the fork does n't shake that adult .	the forks does n't shake that adult .
the windows are n't helping that spoon .	the window are n't helping that spoon .
the rings have eaten .	the ring have eaten .
the bags have n't taught the toy .	the bag have n't taught the toy .
the ring is helping these rings .	the rings is helping these rings .
the shirts were n't dropping that lady .	the shirt were n't dropping that lady .
the pictures are n't crying .	the picture are n't crying .
the box was n't bothering those cars .	the boxes was n't bothering those cars .
the beds have n't lost this spoon .	the bed have n't lost this spoon .
the hats have n't lost this person .	the hat have n't lost this person .
the boat does n't lose those children .	the boats does n't lose those children .
the hats were n't working with that button .	the hat were n't working with that button .
the candle does n't talk .	the candles does n't talk .
the shirt is talking to the door .	the shirts is talking to the door .
the toys are n't cleaning that man .	the toy are n't cleaning that man .
the window does n't hear that bag .	the windows does n't hear that bag .
the toy does yell .	the toys does yell .
the crayons do know this car .	the crayon do know this car .
the shirts have n't bought the men .	the shirt have n't bought the men .
the schools do n't steal these women .	the school do n't steal these women .
the glasses have n't worried the car .	the glass have n't worried the car .
the book does know the glasses .	the books does know the glasses .
the fork does understand the ring .	the forks does understand the ring .
the ring does know the couch .	the rings does know the couch .
the spoons have heard that car .	the spoon have heard that car .
the school has n't lost these windows .	the schools has n't lost these windows .
the bowl was fixing this man .	the bowls was fixing this man .
the bag is learning .	the bags is learning .
the beds were bringing that teacher .	the bed were bringing that teacher .
the school has cried .	the schools has cried .
the bed does help the school .	the beds does help the school .
the book does n't sing .	the books does n't sing .
the shirts do n't hear the candle .	the shirt do n't hear the candle .
the glass is n't talking .	the glasses is n't talking .
the spoon has n't taken the patient .	the spoons has n't taken the patient .
the picture does n't read .	the pictures does n't read .
the cars do n't visit that bicycle .	the car do n't visit that bicycle .
the books are n't learning .	the book are n't learning .
the crayon was n't taking the guys .	the crayons was n't taking the guys .
the box has scared this restaurant .	the boxes has scared this restaurant .
the window has n't confused this mirror .	the windows has n't confused this mirror .
the rooms were losing this lady .	the room were losing this lady .
the shirt has held this man .	the shirts has held this man .
the shirts have n't learned .	the shirt have n't learned .
the shoes do exercise .	the shoe do exercise .
the books do teach the book .	the book do teach the book .
the books do n't have this dancer .	the book do n't have this dancer .
the school does read .	the schools does read .
the bowl does n't know this school .	the bowls does n't know this school .
the dish is listening to this bag .	the dishes is listening to this bag .
the bottle does talk to this bed .	the bottles does talk to this bed .
the rooms have n't lost .	the room have n't lost .
the spoons do n't talk to these boats .	the spoon do n't talk to these boats .
the books have n't heard the cup .	the book have n't heard the cup .
the trucks have n't heard the glasses .	the truck have n't heard the glasses .
the dishes are n't teaching this mirror .	the dish are n't teaching this mirror .
the cup has lost this truck .	the cups has lost this truck .
the window does n't laugh .	the windows does n't laugh .
the hats are working with these boxes .	the hat are working with these boxes .
the fork has n't lost this door .	the forks has n't lost this door .
the cars are learning .	the car are learning .
the button has taken those girls .	the buttons has taken those girls .
the crayons have answered this fork .	the crayon have answered this fork .
the book does answer that shirt .	the books does answer that shirt .
the schools have n't won .	the school have n't won .
the dolls have n't worried that bank .	the doll have n't worried that bank .
the shoes have n't waved .	the shoe have n't waved .
the spoon is n't talking .	the spoons is n't talking .
the bottle has run .	the bottles has run .
the plate does care for the spoon .	the plates does care for the spoon .
the toys do n't win .	the toy do n't win .
the windows do n't visit the trucks .	the window do n't visit the trucks .
the dish is bothering this car .	the dishes is bothering this car .
the doors do n't scream .	the door do n't scream .
the bed does n't drop those boys .	the beds does n't drop those boys .
the trucks are painting .	the truck are painting .
the chair has n't worked with that shoe .	the chairs has n't worked with that shoe .
the spoon does run .	the spoons does run .
the bowl was n't bothering that couch .	the bowls was n't bothering that couch .
the school does n't praise the bicycle .	the schools does n't praise the bicycle .
the windows were whispering .	the window were whispering .
the crayon has n't heard the books .	the crayons has n't heard the books .
the window was fixing those guys .	the windows was fixing those guys .
the hats have n't answered that room .	the hat have n't answered that room .
the cup does n't read .	the cups does n't read .
the bottles do n't praise this boat .	the bottle do n't praise this boat .
the bottles are n't moving that driver .	the bottle are n't moving that driver .
the cup does exercise .	the cups does exercise .
the dolls have n't eaten .	the doll have n't eaten .
the fork was n't helping the cars .	the forks was n't helping the cars .
the doors do n't eat .	the door do n't eat .
the shoes have n't bought the man .	the shoe have n't bought the man .
the shoes do hear the hats .	the shoe do hear the hats .
the chair has taken those men .	the chairs has taken those men .
the hats do n't bring the teacher .	the hat do n't bring the teacher .
the candle does drop those men .	the candles does drop those men .
the box does n't talk .	the boxes does n't talk .
the ring has yelled .	the rings has yelled .
the cups do n't paint .	the cup do n't paint .
the buttons were n't laughing .	the button were n't laughing .
the schools have worried that park .	the school have worried that park .
the crayons do know the hat .	the crayon do know the hat .
the cups are n't waving .	the cup are n't waving .
the doll is learning .	the dolls is learning .
the spoon does n't stretch .	the spoons does n't stretch .
the chairs do talk .	the chair do talk .
the shoe does n't praise those doors .	the shoes does n't praise those doors .
the toys have cried .	the toy have cried .
the hat does n't know that hat .	the hats does n't know that hat .
the shoe has n't heard the bowl .	the shoes has n't heard the bowl .
the boat does n't find these guys .	the boats does n't find these guys .
the hats have n't won .	the hat have n't won .
the beds were cleaning those ladies .	the bed were cleaning those ladies .
the bottle was n't growing .	the bottles was n't growing .
the car was n't talking .	the cars was n't talking .
the bottle was n't learning .	the bottles was n't learning .
the spoons were n't eating .	the spoon were n't eating .
the boxes have n't kept the people .	the box have n't kept the people .
the windows have n't talked .	the window have n't talked .
the car does exercise .	the cars does exercise .
the candle has heard the books .	the candles has heard the books .
the crayons have heard those glasses .	the crayon have heard those glasses .
the box has learned .	the boxes has learned .
the school has n't taken that man .	the schools has n't taken that man .
the plate does n't know this door .	the plates does n't know this door .
the buttons do have this customer .	the button do have this customer .
the door is n't singing .	the doors is n't singing .
the school does answer this hospital .	the schools does answer this hospital .
the door has eaten .	the doors has eaten .
the plates have n't dropped that queen .	the plate have n't dropped that queen .
the doll was talking .	the dolls was talking .
the hats do understand the car .	the hat do understand the car .
the boat does know this plate .	the boats does know this plate .
the schools have n't taken the doctor .	the school have n't taken the doctor .
the pictures are bothering those bowls .	the picture are bothering those bowls .
the books do smile .	the book do smile .
the boats do n't hold the boys .	the boat do n't hold the boys .
the ring is n't dropping the king .	the rings is n't dropping the king .
the hat was working with these dishes .	the hats was working with these dishes .
the spoon has n't eaten .	the spoons has n't eaten .
the school is n't visiting that spoon .	the schools is n't visiting that spoon .
the candle has found this person .	the candles has found this person .
the chair is moving this guy .	the chairs is moving this guy .
the crayon has taught those chairs .	the crayons has taught those chairs .
the cup does hear the school .	the cups does hear the school .
the boat is n't visiting this ring .	the boats is n't visiting this ring .
the bottle does n't clean the person .	the bottles does n't clean the person .
the school does cough .	the schools does cough .
the candle is throwing the boys .	the candles is throwing the boys .
the picture has learned .	the pictures has learned .
the bowl was n't reading .	the bowls was n't reading .
the bag does n't bring the child .	the bags does n't bring the child .
the bowls are n't laughing .	the bowl are n't laughing .
the chair has confused the doll .	the chairs has confused the doll .
the schools were n't working with the bowl .	the school were n't working with the bowl .
the bottles do whisper .	the bottle do whisper .
the door does care for the doors .	the doors does care for the doors .
the bag has heard the doors .	the bags has heard the doors .
the button has n't lost these forks .	the buttons has n't lost these forks .
the plate is smiling .	the plates is smiling .
the hat does bother this shoe .	the hats does bother this shoe .
the books are n't losing the children .	the book are n't losing the children .
the windows are n't singing .	the window are n't singing .
the box was n't laughing .	the boxes was n't laughing .
the shoes have held the girls .	the shoe have held the girls .
the school does n't lose .	the schools does n't lose .
the candle has cried .	the candles has cried .
the fork does n't visit these dishes .	the forks does n't visit these dishes .
the buttons have fixed the teachers .	the button have fixed the teachers .
the pictures do n't teach these dolls .	the picture do n't teach these dolls .
the bed is crying .	the beds is crying .
the hat does n't shake the girls .	the hats does n't shake the girls .
the car has worked with the box .	the cars has worked with the box .
the school does exercise .	the schools does exercise .
the doll has n't bothered the window .	the dolls has n't bothered the window .
the rings are n't working with the crayon .	the ring are n't working with the crayon .
the buttons do n't help those rooms .	the button do n't help those rooms .
the books do sneeze .	the book do sneeze .
the shoes do throw the child .	the shoe do throw the child .
the candles are growing .	the candle are growing .
the dishes do sell this man .	the dish do sell this man .
the hats do smile .	the hat do smile .
the fork does know that bag .	the forks does know that bag .
the candles were teaching the bags .	the candle were teaching the bags .
the school does appreciate these schools .	the schools does appreciate these schools .
the rooms do n't steal this teacher .	the room do n't steal this teacher .
the boxes have n't heard the picture .	the box have n't heard the picture .
the dolls do lose that child .	the doll do lose that child .
the bottle was n't smiling .	the bottles was n't smiling .
the picture was visiting this shoe .	the pictures was visiting this shoe .
the books have n't worried that candle .	the book have n't worried that candle .
the ring has n't read .	the rings has n't read .
the bottles do n't lose .	the bottle do n't lose .
the spoons do clean those people .	the spoon do clean those people .
the crayon has painted .	the crayons has painted .
the bowl is working with the bowl .	the bowls is working with the bowl .
the car does n't lose .	the cars does n't lose .
the plate has worried this car .	the plates has worried this car .
the pictures do help this cup .	the picture do help this cup .
the forks do n't answer the doors .	the fork do n't answer the doors .
the book does answer this bag .	the books does answer this bag .
the boxes have run .	the box have run .
the shoes have laughed .	the shoe have laughed .
the beds do n't hold that driver .	the bed do n't hold that driver .
the candle was n't finding the dentist .	the candles was n't finding the dentist .
the glass has n't brought the boys .	the glasses has n't brought the boys .
the bag is running .	the bags is running .
the shoes have n't talked .	the shoe have n't talked .
the school is n't losing .	the schools is n't losing .
the beds are yelling .	the bed are yelling .
the bag has n't taught this mall .	the bags has n't taught this mall .
the ring has n't found those girls .	the rings has n't found those girls .
the crayon does read .	the crayons does read .
the bed does bother the buttons .	the beds does bother the buttons .
the boxes do wave .	the box do wave .
the bottle does n't read .	the bottles does n't read .
the car does sing .	the cars does sing .
the rooms do understand this spoon .	the room do understand this spoon .
the beds have lost the kitchen .	the bed have lost the kitchen .
the book has n't answered that truck .	the books has n't answered that truck .
the book does n't stretch .	the books does n't stretch .
the crayons do smile .	the crayon do smile .
the spoon has found these pictures .	the spoons has found these pictures .
the cars do move the girl .	the car do move the girl .
the windows are eating .	the window are eating .
the books were growing .	the book were growing .
the school has laughed .	the schools has laughed .
the forks have dropped those men .	the fork have dropped those men .
the window was dropping that adult .	the windows was dropping that adult .
the schools do understand this room .	the school do understand this room .
the toys do buy those guys .	the toy do buy those guys .
the ring does shake the driver .	the rings does shake the driver .
the bowl does work with the ship .	the bowls does work with the ship .
the bottles were n't visiting those cups .	the bottle were n't visiting those cups .
the buttons do n't yell .	the button do n't yell .
the bottle does n't sneeze .	the bottles does n't sneeze .
the cups are eating .	the cup are eating .
the plates are n't keeping that customer .	the plate are n't keeping that customer .
the schools do n't lose the child .	the school do n't lose the child .
the schools have n't heard this bowl .	the school have n't heard this bowl .
the rooms are cleaning this guy .	the room are cleaning this guy .
the hat has n't kept that boy .	the hats has n't kept that boy .
the schools are n't making this man .	the school are n't making this man .
the bag does bring that woman .	the bags does bring that woman .
the dishes have kept the women .	the dish have kept the women .
the bowl does talk to that candle .	the bowls does talk to that candle .
the cars have talked .	the car have talked .
the spoon does bother the ship .	the spoons does bother the ship .
the doll has n't eaten .	the dolls has n't eaten .
the bags were eating .	the bag were eating .
the spoon is reading .	the spoons is reading .
the shoe does worry that plane .	the shoes does worry that plane .
the bottle does know the school .	the bottles does know the school .
the ring does yell .	the rings does yell .
the schools do grow .	the school do grow .
the chair has taken this driver .	the chairs has taken this driver .
the dish has lost this park .	the dishes has lost this park .
the shoes do move that teacher .	the shoe do move that teacher .
the hat does grow .	the hats does grow .
the cups do bring the patient .	the cup do bring the patient .
the books have visited the books .	the book have visited the books .
the window does bring the woman .	the windows does bring the woman .
the schools do lift these people .	the school do lift these people .
the rings have n't talked .	the ring have n't talked .
the books were n't crying .	the book were n't crying .
the schools have n't answered the dish .	the school have n't answered the dish .
the rings do n't make that girl .	the ring do n't make that girl .
the book does n't exercise .	the books does n't exercise .
the spoons have painted .	the spoon have painted .
the room has taken the ladies .	the rooms has taken the ladies .
the shoe does bring those children .	the shoes does bring those children .
the plate is n't keeping the patient .	the plates is n't keeping the patient .
the crayon was n't reading .	the crayons was n't reading .
the cups do n't practice .	the cup do n't practice .
the schools are fixing that person .	the school are fixing that person .
the candles have lost .	the candle have lost .
the candle does n't teach those rooms .	the candles does n't teach those rooms .
the pictures have n't eaten .	the picture have n't eaten .
the rings are n't whispering .	the ring are n't whispering .
the rooms have n't heard these spoons .	the room have n't heard these spoons .
the shoe has n't waved .	the shoes has n't waved .
the boat does n't lie .	the boats does n't lie .
the bowl does n't paint .	the bowls does n't paint .
