the cup wo n't see the guys who this museum who dropped those doctors would worry .	the cup wo n't see who this museum who dropped those doctors would worry the guys .
the button could n't know this boy who the book who did n't hold the dancer has n't worked with .	the button could n't know who the book who did n't hold the dancer has n't worked with this boy .
the pictures have n't seen this queen who that mall who the boat should n't know worried .	the pictures have n't seen who that mall who the boat should n't know worried this queen .
the crayons had remembered the man that this kitchen who could wave will know .	the crayons had remembered what this kitchen who could wave will know the man .
these glasses could n't know the hat that the glass who kept the driver has thrown .	these glasses could n't know what the glass who kept the driver has thrown the hat .
this dish had remembered the boys who this doll who must lift the woman worked with .	this dish had remembered who this doll who must lift the woman worked with the boys .
that doll must see the men that those trucks who would sing heard .	that doll must see what those trucks who would sing heard the men .
this book may remember that chair that the mall who heard these cups wo n't sell .	this book may remember what the mall who heard these cups wo n't sell that chair .
this car has known that hat that that candle who fixed the children held .	this car has known what that candle who fixed the children held that hat .
this toy had n't known the women who that box who had n't heard this room has lost .	this toy had n't known who that box who had n't heard this room has lost the women .
the spoon has seen these chairs that that mall who could clean the dentist had cleaned .	the spoon has seen what that mall who could clean the dentist had cleaned these chairs .
those candles must see that man who the windows who know the trucks were visiting .	those candles must see who the windows who know the trucks were visiting that man .
that fork should know this girl who the ring who those hats heard was helping .	that fork should know who the ring who those hats heard was helping this girl .
the plate has n't noticed these teachers who the cups who had laughed talked to .	the plate has n't noticed who the cups who had laughed talked to these teachers .
these hats had remembered the man who these toys who were n't losing had lost .	these hats had remembered who these toys who were n't losing had lost the man .
the pictures would know these teachers who the doors who cough answered .	the pictures would know who the doors who cough answered these teachers .
those cars will forget these forks that the schools who painted shake .	those cars will forget what the schools who painted shake these forks .
those shirts had n't noticed this rocket that this boat who had yelled was fixing .	those shirts had n't noticed what this boat who had yelled was fixing this rocket .
those boats might see the rings that the dishes who had heard those boats keep .	those boats might see what the dishes who had heard those boats keep the rings .
those buttons had n't noticed these glasses that the hats who threw this king shook .	those buttons had n't noticed what the hats who threw this king shook these glasses .
this chair had noticed these shirts that those dishes who do n't know these cars would steal .	this chair had noticed what those dishes who do n't know these cars would steal these shirts .
that mirror has remembered those shoes that these toys who had n't laughed were cleaning .	that mirror has remembered what these toys who had n't laughed were cleaning those shoes .
the boat had known the trucks that that library who had lost made .	the boat had known what that library who had lost made the trucks .
the bowls might forget this guy who the chair who was finding those doctors is bothering .	the bowls might forget who the chair who was finding those doctors is bothering this guy .
the bags may see this doctor who the button who is waving heard .	the bags may see who the button who is waving heard this doctor .
this book had noticed that chair that that bag who the car must know has n't moved .	this book had noticed what that bag who the car must know has n't moved that chair .
these buttons did n't know the doctor that the kitchen who had this adult hears .	these buttons did n't know what the kitchen who had this adult hears the doctor .
the dolls could n't notice this adult who that crayon who had n't yelled was n't visiting .	the dolls could n't notice who that crayon who had n't yelled was n't visiting this adult .
these doors should know that guy who that shirt who the bottle knew might know .	these doors should know who that shirt who the bottle knew might know that guy .
those glasses may forget that boat that the spoons who had n't found that person take .	those glasses may forget what the spoons who had n't found that person take that boat .
those chairs will see those guys who those cars who have lost that man would n't know .	those chairs will see who those cars who have lost that man would n't know those guys .
those shoes have n't remembered this hat that the hat who brings this child moves .	those shoes have n't remembered what the hat who brings this child moves this hat .
that couch can n't notice this guy who the boat who was n't losing helps .	that couch can n't notice who the boat who was n't losing helps this guy .
the chair has remembered this lady who the shoe who would talk is n't bothering .	the chair has remembered who the shoe who would talk is n't bothering this lady .
that box will notice this candle that the chairs who laugh had n't found .	that box will notice what the chairs who laugh had n't found this candle .
this crayon can n't know that bowl that those windows who can n't lose must make .	this crayon can n't know what those windows who can n't lose must make that bowl .
that door had seen the ring that these bowls who were lying take .	that door had seen what these bowls who were lying take the ring .
the hats have seen these plates that this spoon who hears these glasses had n't made .	the hats have seen what this spoon who hears these glasses had n't made these plates .
these shoes could notice this book that these forks who the school had heard will lose .	these shoes could notice what these forks who the school had heard will lose this book .
the dish must remember these books that that button who knows the mall keeps .	the dish must remember what that button who knows the mall keeps these books .
those cups had known the glasses that that book who was lying does n't have .	those cups had known what that book who was lying does n't have the glasses .
the shoes had n't known these candles that the bank who has heard this rocket throws .	the shoes had n't known what the bank who has heard this rocket throws these candles .
these bottles did n't see that plane that that rug who takes those people has .	these bottles did n't see what that rug who takes those people has that plane .
the spoon could remember this chair that that glass who can buy this doctor makes .	the spoon could remember what that glass who can buy this doctor makes this chair .
the forks do n't see those teachers who that spoon who these rings had heard understands .	the forks do n't see who that spoon who these rings had heard understands those teachers .
the rug should see the bag that this candle who knows this button holds .	the rug should see what this candle who knows this button holds the bag .
the toy may know the horse that this school who wo n't smile could know .	the toy may know what this school who wo n't smile could know the horse .
the box had known this dish that the cups who yelled were making .	the box had known what the cups who yelled were making this dish .
these glasses might forget that patient who the glasses who that bank heard have n't confused .	these glasses might forget who the glasses who that bank heard have n't confused that patient .
that picture had n't remembered this plate that the rooms who that hospital knows are cleaning .	that picture had n't remembered what the rooms who that hospital knows are cleaning this plate .
those dishes had known the button that those chairs who can hear the schools have n't brought .	those dishes had known what those chairs who can hear the schools have n't brought the button .
those shirts can know that guy that the buttons who have yelled hear .	those shirts can know what the buttons who have yelled hear that guy .
this ring has n't known that king who the restaurant who knows the beds lost .	this ring has n't known who the restaurant who knows the beds lost that king .
these crayons can n't forget those beds that that bowl who has painted cleaned .	these crayons can n't forget what that bowl who has painted cleaned those beds .
the pictures should know the rocket that the chairs who find this patient kept .	the pictures should know what the chairs who find this patient kept the rocket .
those pictures did n't know those snakes that the spoon who this rug heard might hear .	those pictures did n't know what the spoon who this rug heard might hear those snakes .
these rings have remembered that person who this restaurant who did n't clean this dancer is listening to .	these rings have remembered who this restaurant who did n't clean this dancer is listening to that person .
that bicycle might see that doctor who this ship who does n't hear the schools could teach .	that bicycle might see who this ship who does n't hear the schools could teach that doctor .
the boxes had noticed those crayons that these boats who would n't whisper kept .	the boxes had noticed what these boats who would n't whisper kept those crayons .
the car would see the picture that the boxes who drop those doctors were moving .	the car would see what the boxes who drop those doctors were moving the picture .
this button can know the boy who those buttons who had waved would n't know .	this button can know who those buttons who had waved would n't know the boy .
the window has n't seen these windows that these toys who could n't make that lady lost .	the window has n't seen what these toys who could n't make that lady lost these windows .
that picture might forget this boy who that school who has n't brought those ladies is helping .	that picture might forget who that school who has n't brought those ladies is helping this boy .
that doll has n't known these toys that the schools who fix the dentist lost .	that doll has n't known what the schools who fix the dentist lost these toys .
this rocket had n't noticed these books that the books who knew that doll had n't thrown .	this rocket had n't noticed what the books who knew that doll had n't thrown these books .
the bags had n't known these people who the buttons who the plane heard worked with .	the bags had n't known who the buttons who the plane heard worked with these people .
this door has n't noticed this patient who the ship who the bags knew heard .	this door has n't noticed who the ship who the bags knew heard this patient .
those doors had n't known that crayon that that room who the cars knew could drop .	those doors had n't known what that room who the cars knew could drop that crayon .
these plates do n't notice the picture that that shirt who the plates knew is n't throwing .	these plates do n't notice what that shirt who the plates knew is n't throwing the picture .
those glasses would n't remember that lady who the shirts who sell that girl praise .	those glasses would n't remember who the shirts who sell that girl praise that lady .
the pictures would n't know these hats that this bowl who may hear this book has n't cleaned .	the pictures would n't know what this bowl who may hear this book has n't cleaned these hats .
those beds will know these guys who those dishes who cleaned those teachers could n't teach .	those beds will know who those dishes who cleaned those teachers could n't teach these guys .
this glass could forget these teachers who those bags who were singing worked with .	this glass could forget who those bags who were singing worked with these teachers .
the car has n't seen the women who this fork who could paint did n't help .	the car has n't seen who this fork who could paint did n't help the women .
the crayons have noticed those boxes that those schools who hold this girl take .	the crayons have noticed what those schools who hold this girl take those boxes .
these toys could forget those people who those buttons who took those ladies did n't talk to .	these toys could forget who those buttons who took those ladies did n't talk to those people .
these hats have remembered those windows that this plane who moves that man could fix .	these hats have remembered what this plane who moves that man could fix those windows .
the boat can n't notice the truck that these bottles who are losing must hold .	the boat can n't notice what these bottles who are losing must hold the truck .
the beds can notice these beds that that room who might make this adult could make .	the beds can notice what that room who might make this adult could make these beds .
the spoon will notice the picture that the mirror who has n't waved dropped .	the spoon will notice what the mirror who has n't waved dropped the picture .
that bicycle does n't see the button that that shirt who had this king drops .	that bicycle does n't see what that shirt who had this king drops the button .
this picture will know these guys who those books who heard the buttons are n't helping .	this picture will know who those books who heard the buttons are n't helping these guys .
that fork has n't remembered this truck that these schools who have fixed the man fixed .	that fork has n't remembered what these schools who have fixed the man fixed this truck .
those glasses will remember the spoons that the boat who sang would n't bring .	those glasses will remember what the boat who sang would n't bring the spoons .
the rug may notice the driver that that book who that glass hears had heard .	the rug may notice what that book who that glass hears had heard the driver .
those bowls may see the king who this ship who could hear the car was n't teaching .	those bowls may see who this ship who could hear the car was n't teaching the king .
that shirt should remember the ring that that plane who the pictures heard would n't take .	that shirt should remember what that plane who the pictures heard would n't take the ring .
that picture has n't known those ladies who that ring who had dropped these people taught .	that picture has n't known who that ring who had dropped these people taught those ladies .
that fork would n't know the doctors who those cars who these cars could n't hear bothered .	that fork would n't know who those cars who these cars could n't hear bothered the doctors .
the chair has noticed that chair that those candles who whisper have .	the chair has noticed what those candles who whisper have that chair .
those shoes did n't remember that ship that that door who the plane had n't heard is shaking .	those shoes did n't remember what that door who the plane had n't heard is shaking that ship .
those windows have noticed these bottles that this restaurant who has n't found that driver had made .	those windows have noticed what this restaurant who has n't found that driver had made these bottles .
this boat could n't know these boys who the schools who had the doctor helped .	this boat could n't know who the schools who had the doctor helped these boys .
this cup has n't seen those cars that that bank who this dish heard will take .	this cup has n't seen what that bank who this dish heard will take those cars .
that book wo n't know that customer that those shoes who had n't moved those doctors heard .	that book wo n't know what those shoes who had n't moved those doctors heard that customer .
those dishes will forget the dancer who those rooms who could n't sing do n't listen to .	those dishes will forget who those rooms who could n't sing do n't listen to the dancer .
this ship had n't noticed the children who the couch who may cry can appreciate .	this ship had n't noticed who the couch who may cry can appreciate the children .
those buttons would n't notice this doctor who this doll who that plane knows had n't visited .	those buttons would n't notice who this doll who that plane knows had n't visited this doctor .
these boats might know this dentist who these rooms who have waved work with .	these boats might know who these rooms who have waved work with this dentist .
that bed can remember these glasses that these crayons who that restaurant can n't know were n't losing .	that bed can remember what these crayons who that restaurant can n't know were n't losing these glasses .
the candles may see this customer who that box who has thrown those doctors hears .	the candles may see who that box who has thrown those doctors hears this customer .
these boats should notice these shirts that that kitchen who heard the couch is taking .	these boats should notice what that kitchen who heard the couch is taking these shirts .
that hat must forget this bottle that this toy who sings stole .	that hat must forget what this toy who sings stole this bottle .
the plate must know that bowl that the toys who the schools should n't hear can n't keep .	the plate must know what the toys who the schools should n't hear can n't keep that bowl .
these shoes have n't known these guys who this ship who could n't buy this teacher has n't scared .	these shoes have n't known who this ship who could n't buy this teacher has n't scared these guys .
those cars would n't see the car that the bowl who was n't talking dropped .	those cars would n't see what the bowl who was n't talking dropped the car .
that picture will know those beds that those forks who win kept .	that picture will know what those forks who win kept those beds .
the chairs had n't noticed this shoe that the bottle who knows this library moved .	the chairs had n't noticed what the bottle who knows this library moved this shoe .
these forks did n't notice the person who these boats who brought these children bothered .	these forks did n't notice who these boats who brought these children bothered the person .
these dolls could n't see the adult who these books who had n't lost help .	these dolls could n't see who these books who had n't lost help the adult .
those beds have remembered that glass that that door who this plane knows bought .	those beds have remembered what that door who this plane knows bought that glass .
the cars wo n't forget this picture that the doors who sing were n't shaking .	the cars wo n't forget what the doors who sing were n't shaking this picture .
these beds would n't know those hats that the car who could n't lose had n't taken .	these beds would n't know what the car who could n't lose had n't taken those hats .
these cups have noticed the shirts that that crayon who is n't reading was dropping .	these cups have noticed what that crayon who is n't reading was dropping the shirts .
the books could n't see that glass that the chairs who have n't taken these women were n't holding .	the books could n't see what the chairs who have n't taken these women were n't holding that glass .
these candles have known that plane that this shirt who talked does n't keep .	these candles have known what this shirt who talked does n't keep that plane .
the car does n't notice this child who that glass who might hold these teachers would praise .	the car does n't notice who that glass who might hold these teachers would praise this child .
this car can n't remember those guys who the bowls who had n't painted visited .	this car can n't remember who the bowls who had n't painted visited those guys .
that crayon had noticed that ring that this shoe who has n't kept this person may drop .	that crayon had noticed what this shoe who has n't kept this person may drop that ring .
that couch had n't noticed these doctors who this picture who this box knew was working with .	that couch had n't noticed who this picture who this box knew was working with these doctors .
that car might forget the crayon that the candle who has heard these shirts took .	that car might forget what the candle who has heard these shirts took the crayon .
these chairs must forget the children who the mirror who has read understands .	these chairs must forget who the mirror who has read understands the children .
this bicycle does n't forget the bottle that these schools who practice had made .	this bicycle does n't forget what these schools who practice had made the bottle .
that doll has seen those pictures that the boxes who are laughing are n't buying .	that doll has seen what the boxes who are laughing are n't buying those pictures .
the mirror can notice this fork that the hats who had heard those books did n't steal .	the mirror can notice what the hats who had heard those books did n't steal this fork .
the boat may see that fork that this boat who the schools would hear has n't taken .	the boat may see what this boat who the schools would hear has n't taken that fork .
those windows could notice those shoes that the ship who fixed the customer has n't held .	those windows could notice what the ship who fixed the customer has n't held those shoes .
those buttons had remembered those boats that those bowls who are smiling can n't sell .	those buttons had remembered what those bowls who are smiling can n't sell those boats .
the shirt would notice those boats that the toys who can smile lose .	the shirt would notice what the toys who can smile lose those boats .
the plates had n't remembered the spoon that that toy who knew these toys had n't kept .	the plates had n't remembered what that toy who knew these toys had n't kept the spoon .
the boxes had remembered this lady who these chairs who wo n't hear those boxes had heard .	the boxes had remembered who these chairs who wo n't hear those boxes had heard this lady .
those buttons must notice this glass that this bank who did n't sell this person lost .	those buttons must notice what this bank who did n't sell this person lost this glass .
this car can forget the cups that the dolls who heard this restaurant are n't making .	this car can forget what the dolls who heard this restaurant are n't making the cups .
this shoe would notice this dancer who the crayons who the fork can know answered .	this shoe would notice who the crayons who the fork can know answered this dancer .
the spoons had n't remembered the lady who that bank who could n't win had bothered .	the spoons had n't remembered who that bank who could n't win had bothered the lady .
the ship should n't see the cups that this picture who wo n't hear these trucks brings .	the ship should n't see what this picture who wo n't hear these trucks brings the cups .
those bowls have n't noticed that candle that those schools who the cars knew had n't taken .	those bowls have n't noticed what those schools who the cars knew had n't taken that candle .
that doll did n't forget this bottle that this park who has n't heard the picture is n't losing .	that doll did n't forget what this park who has n't heard the picture is n't losing this bottle .
the shoe might notice that lady who the boxes who those books hear lost .	the shoe might notice who the boxes who those books hear lost that lady .
these crayons should n't know the couch that the bag who these crayons heard is n't cleaning .	these crayons should n't know what the bag who these crayons heard is n't cleaning the couch .
those spoons can n't see this mirror that this dish who that ring knew will shake .	those spoons can n't see what this dish who that ring knew will shake this mirror .
this truck should n't see these candles that that bowl who the library knows made .	this truck should n't see what that bowl who the library knows made these candles .
this window has seen the books that the park who has talked kept .	this window has seen what the park who has talked kept the books .
these buttons have seen those cars that this plane who that shirt knew should keep .	these buttons have seen what this plane who that shirt knew should keep those cars .
this ship had remembered these chairs that the crayons who cry should find .	this ship had remembered what the crayons who cry should find these chairs .
the hat does n't remember that bed that the rings who kept the boys cleaned .	the hat does n't remember what the rings who kept the boys cleaned that bed .
the chairs had n't noticed the fork that that car who those forks hear has n't dropped .	the chairs had n't noticed what that car who those forks hear has n't dropped the fork .
these shoes do n't see this crayon that those beds who buy the doctors cleaned .	these shoes do n't see what those beds who buy the doctors cleaned this crayon .
the plane has n't remembered this plane that this box who was losing found .	the plane has n't remembered what this box who was losing found this plane .
that bowl has n't known this picture that that rug who is n't smiling dropped .	that bowl has n't known what that rug who is n't smiling dropped this picture .
the boats might notice this truck that these hats who lost this doctor do n't take .	the boats might notice what these hats who lost this doctor do n't take this truck .
that plate should notice the crayon that these spoons who make the driver should n't drop .	that plate should notice what these spoons who make the driver should n't drop the crayon .
that ship has n't remembered the cars that those buttons who stole these men had n't bought .	that ship has n't remembered what those buttons who stole these men had n't bought the cars .
that toy had n't remembered that dentist who the dolls who buy these ladies knew .	that toy had n't remembered who the dolls who buy these ladies knew that dentist .
this box does n't notice the woman who the candle who may sneeze taught .	this box does n't notice who the candle who may sneeze taught the woman .
this cup has n't seen this adult who this bowl who this glass had n't heard has heard .	this cup has n't seen who this bowl who this glass had n't heard has heard this adult .
the hat had seen those plates that this toy who might scream could n't drop .	the hat had seen what this toy who might scream could n't drop those plates .
that crayon has n't seen the plane that these shirts who should n't smile are n't bringing .	that crayon has n't seen what these shirts who should n't smile are n't bringing the plane .
those books would n't remember those buttons that this crayon who had n't thrown the men fixed .	those books would n't remember what this crayon who had n't thrown the men fixed those buttons .
this shoe has n't known that man who the bags who heard that bed confused .	this shoe has n't known who the bags who heard that bed confused that man .
this truck can n't notice the glasses that these spoons who know the crayons shake .	this truck can n't notice what these spoons who know the crayons shake the glasses .
that dish did n't know that bicycle that this glass who will know the dish was n't keeping .	that dish did n't know what this glass who will know the dish was n't keeping that bicycle .
the chairs do n't remember this teacher who this hat who is n't laughing had heard .	the chairs do n't remember who this hat who is n't laughing had heard this teacher .
this bowl had remembered the trucks that those beds who knew these cars are making .	this bowl had remembered what those beds who knew these cars are making the trucks .
this glass can n't know this chair that the hats who yell are fixing .	this glass can n't know what the hats who yell are fixing this chair .
this book would remember the beds that the hospital who had n't heard these glasses was n't throwing .	this book would remember what the hospital who had n't heard these glasses was n't throwing the beds .
those dolls have seen the shoes that this book who might practice must bring .	those dolls have seen what this book who might practice must bring the shoes .
this doll may know the bowls that that window who was n't screaming can move .	this doll may know what that window who was n't screaming can move the bowls .
this car may forget that driver who the doll who has talked bothered .	this car may forget who the doll who has talked bothered that driver .
these rings can n't forget the guy who that shoe who cried is n't listening to .	these rings can n't forget who that shoe who cried is n't listening to the guy .
the window should notice this bottle that that shoe who knows that car would drop .	the window should notice what that shoe who knows that car would drop this bottle .
the cars can n't notice the spoon that these dishes who the toys should n't hear took .	the cars can n't notice what these dishes who the toys should n't hear took the spoon .
these cars have known that patient who this truck who is n't losing those boys has taught .	these cars have known who this truck who is n't losing those boys has taught that patient .
these rings must remember the bottle that these schools who bring the driver steal .	these rings must remember what these schools who bring the driver steal the bottle .
those boxes have n't noticed the doors that the bowl who has made the man is n't fixing .	those boxes have n't noticed what the bowl who has made the man is n't fixing the doors .
this truck may notice the boys who those dolls who lose have n't talked to .	this truck may notice who those dolls who lose have n't talked to the boys .
this box might see this plane that the dish who that restaurant could hear brings .	this box might see what the dish who that restaurant could hear brings this plane .
that ring should n't forget this adult who these glasses who have won scare .	that ring should n't forget who these glasses who have won scare this adult .
that book does n't forget this glass that that library who has dropped the women has thrown .	that book does n't forget what that library who has dropped the women has thrown this glass .
those bags can n't remember that bicycle that this car who this library must hear was holding .	those bags can n't remember what this car who this library must hear was holding that bicycle .
these boxes have n't known the men who those windows who can hear the bed are n't listening to .	these boxes have n't known who those windows who can hear the bed are n't listening to the men .
the books will notice those guys that those buttons who could exercise might hear .	the books will notice what those buttons who could exercise might hear those guys .
the couch had n't seen the fork that the schools who dropped this lady had thrown .	the couch had n't seen what the schools who dropped this lady had thrown the fork .
these cups will remember the lady who the crayon who that bed heard heard .	these cups will remember who the crayon who that bed heard heard the lady .
those rings have seen that dish that the bowl who had won shook .	those rings have seen what the bowl who had won shook that dish .
those toys could see that bicycle that that button who did n't know the chairs is n't shaking .	those toys could see what that button who did n't know the chairs is n't shaking that bicycle .
this toy did n't forget the doors that those trucks who throw the dentist must lose .	this toy did n't forget what those trucks who throw the dentist must lose the doors .
that spoon could notice those snakes that these cars who move these boys had heard .	that spoon could notice what these cars who move these boys had heard those snakes .
the window has remembered this customer that those bags who had this guy heard .	the window has remembered what those bags who had this guy heard this customer .
those shirts have seen those windows that the beds who should n't sing can n't bring .	those shirts have seen what the beds who should n't sing can n't bring those windows .
the cars have seen these girls who the park who may know this bank could answer .	the cars have seen who the park who may know this bank could answer these girls .
this shirt did n't forget these girls who those hats who scream heard .	this shirt did n't forget who those hats who scream heard these girls .
these rings must notice those toys that those books who that mall heard can n't lose .	these rings must notice what those books who that mall heard can n't lose those toys .
those boats had remembered that shirt that this doll who fixed this patient was moving .	those boats had remembered what this doll who fixed this patient was moving that shirt .
the ship can n't know that queen who that glass who has heard this school knows .	the ship can n't know who that glass who has heard this school knows that queen .
this window had n't noticed that boy who that car who can read had n't scared .	this window had n't noticed who that car who can read had n't scared that boy .
that candle should see that dancer who the bottles who were reading visit .	that candle should see who the bottles who were reading visit that dancer .
these books had known these doors that this box who hears that dish takes .	these books had known what this box who hears that dish takes these doors .
these buttons do n't remember that book that this mall who has n't heard the spoons did n't have .	these buttons do n't remember what this mall who has n't heard the spoons did n't have that book .
these boats may notice that fork that the window who does n't hear this book has n't brought .	these boats may notice what the window who does n't hear this book has n't brought that fork .
these boats have n't seen that hat that that hat who that glass knew can n't lift .	these boats have n't seen what that hat who that glass knew can n't lift that hat .
these bowls should n't know that queen who that couch who throws this woman did n't praise .	these bowls should n't know who that couch who throws this woman did n't praise that queen .
these shirts would remember those trucks that these chairs who paint steal .	these shirts would remember what these chairs who paint steal those trucks .
that bicycle can see these dishes that this chair who did n't steal the women is holding .	that bicycle can see what this chair who did n't steal the women is holding these dishes .
these bags should n't see these girls who those chairs who these buttons have n't heard might scare .	these bags should n't see who those chairs who these buttons have n't heard might scare these girls .
the plates would n't remember the teachers who this school who hears those spoons found .	the plates would n't remember who this school who hears those spoons found the teachers .
the cups have n't seen those crayons that the restaurant who had n't won has .	the cups have n't seen what the restaurant who had n't won has those crayons .
this fork may see these candles that that button who heard this bicycle made .	this fork may see what that button who heard this bicycle made these candles .
those cups wo n't remember this bed that the windows who whisper made .	those cups wo n't remember what the windows who whisper made this bed .
these chairs can n't forget the rocket that the museum who that shirt should hear brings .	these chairs can n't forget what the museum who that shirt should hear brings the rocket .
this chair had n't remembered the candles that these cars who these buttons heard must move .	this chair had n't remembered what these cars who these buttons heard must move the candles .
these shirts had n't known this teacher who that book who cried should n't know .	these shirts had n't known who that book who cried should n't know this teacher .
that fork has remembered the guys who this glass who yelled would n't hear .	that fork has remembered who this glass who yelled would n't hear the guys .
these cars had noticed the king who those windows who stole this person are listening to .	these cars had noticed who those windows who stole this person are listening to the king .
these candles could remember the mirror that those forks who would n't keep this lady have fixed .	these candles could remember what those forks who would n't keep this lady have fixed the mirror .
those beds had remembered the ship that this car who would hear that bottle shook .	those beds had remembered what this car who would hear that bottle shook the ship .
the mirror does n't notice this king who this book who that school hears knew .	the mirror does n't notice who this book who that school hears knew this king .
the ring should n't notice that dentist who this car who shook these people had n't visited .	the ring should n't notice who this car who shook these people had n't visited that dentist .
these bottles do n't know these people who these boxes who had bought these teachers bother .	these bottles do n't know who these boxes who had bought these teachers bother these people .
those boxes can remember that guy who the ship who the window should n't know has helped .	those boxes can remember who the ship who the window should n't know has helped that guy .
that rocket might know those shoes that this dish who hears the shoe moves .	that rocket might know what this dish who hears the shoe moves those shoes .
these windows have seen the ship that the books who were n't yelling keep .	these windows have seen what the books who were n't yelling keep the ship .
the toy had n't remembered the boats that the door who did n't lose that man makes .	the toy had n't remembered what the door who did n't lose that man makes the boats .
the bottles do n't know that couch that these schools who have n't fixed that patient shake .	the bottles do n't know what these schools who have n't fixed that patient shake that couch .
the plates do n't remember that mirror that those cars who have fixed those men find .	the plates do n't remember what those cars who have fixed those men find that mirror .
that cup does n't know those chairs that these dishes who would n't stretch have n't held .	that cup does n't know what these dishes who would n't stretch have n't held those chairs .
that bed had seen these shoes that those bottles who hold the guy have n't moved .	that bed had seen what those bottles who hold the guy have n't moved these shoes .
this rocket could notice the adult who that crayon who is shaking the boys was talking to .	this rocket could notice who that crayon who is shaking the boys was talking to the adult .
the spoons have n't seen these cups that this rug who sang has cleaned .	the spoons have n't seen what this rug who sang has cleaned these cups .
these spoons have known these shirts that the books who this dish has heard do n't hold .	these spoons have known what the books who this dish has heard do n't hold these shirts .
that bowl has known the shirts that that restaurant who is n't bringing the guys kept .	that bowl has known what that restaurant who is n't bringing the guys kept the shirts .
this cup wo n't see the box that these cars who those pictures had n't heard would bring .	this cup wo n't see what these cars who those pictures had n't heard would bring the box .
the book had noticed the child who this school who must know those plates had lost .	the book had noticed who this school who must know those plates had lost the child .
the box has noticed the doctor who those boats who had taken the driver have n't visited .	the box has noticed who those boats who had taken the driver have n't visited the doctor .
that box has remembered this dentist who that shoe who could have these women will care for .	that box has remembered who that shoe who could have these women will care for this dentist .
the mirror should remember the boy that the bottle who dropped that adult hears .	the mirror should remember what the bottle who dropped that adult hears the boy .
those boats have seen those boxes that these plates who have moved the teachers are throwing .	those boats have seen what these plates who have moved the teachers are throwing those boxes .
those bowls had n't noticed that ship that that car who knows the glasses does n't buy .	those bowls had n't noticed what that car who knows the glasses does n't buy that ship .
the ship will notice this chair that those rings who this chair knows found .	the ship will notice what those rings who this chair knows found this chair .
those shoes had n't noticed that girl who the boat who has talked had n't bothered .	those shoes had n't noticed who the boat who has talked had n't bothered that girl .
this book had seen that doll that this cup who does n't know the windows holds .	this book had seen what this cup who does n't know the windows holds that doll .
the couch has n't remembered those bags that these rings who know this car were n't dropping .	the couch has n't remembered what these rings who know this car were n't dropping those bags .
those toys could n't see the patient who the pictures who win had n't found .	those toys could n't see who the pictures who win had n't found the patient .
this chair had n't known those men who the doors who did n't lose answered .	this chair had n't known who the doors who did n't lose answered those men .
the book must forget these doors that those glasses who knew the shoes must move .	the book must forget what those glasses who knew the shoes must move these doors .
those spoons wo n't notice the boy who this book who should hear the bottles has n't heard .	those spoons wo n't notice who this book who should hear the bottles has n't heard the boy .
those toys have n't seen these children who that kitchen who these books had heard heard .	those toys have n't seen who that kitchen who these books had heard heard these children .
that bicycle had n't remembered the crayon that these shoes who have n't moved these women are finding .	that bicycle had n't remembered what these shoes who have n't moved these women are finding the crayon .
that rug does n't forget this book that that plate who kept the lady found .	that rug does n't forget what that plate who kept the lady found this book .
that car wo n't notice the boys who the park who is reading had heard .	that car wo n't notice who the park who is reading had heard the boys .
those hats do n't forget that customer who the museum who may stretch bothered .	those hats do n't forget who the museum who may stretch bothered that customer .
this crayon had n't noticed these boats that the kitchen who is n't moving this guy shakes .	this crayon had n't noticed what the kitchen who is n't moving this guy shakes these boats .
the hats could remember that plate that this doll who lost moves .	the hats could remember what this doll who lost moves that plate .
this rug could forget the boys who this window who might know these rooms has visited .	this rug could forget who this window who might know these rooms has visited the boys .
the crayons might see these plates that these windows who will hear these rooms can keep .	the crayons might see what these windows who will hear these rooms can keep these plates .
that rug has n't seen the button that the plate who takes that woman did n't hold .	that rug has n't seen what the plate who takes that woman did n't hold the button .
this car has known those toys that that ring who this school will hear bought .	this car has known what that ring who this school will hear bought those toys .
the ship could notice these girls that this car who was taking these girls wo n't know .	the ship could notice what this car who was taking these girls wo n't know these girls .
that rocket will know these hats that that window who the couch knows was n't dropping .	that rocket will know what that window who the couch knows was n't dropping these hats .
this picture could n't notice these windows that this hat who has heard the spoon dropped .	this picture could n't notice what this hat who has heard the spoon dropped these windows .
that couch may notice those doors that this mirror who had read was shaking .	that couch may notice what this mirror who had read was shaking those doors .
those toys might notice that candle that the restaurant who would n't stretch threw .	those toys might notice what the restaurant who would n't stretch threw that candle .
the window would n't see that car that the crayons who cough steal .	the window would n't see what the crayons who cough steal that car .
the rug could n't see those men who the doors who have n't painted heard .	the rug could n't see who the doors who have n't painted heard those men .
this box has known these toys that the kitchen who those shirts can n't hear was throwing .	this box has known what the kitchen who those shirts can n't hear was throwing these toys .
the book would see the picture that the window who shakes the man is making .	the book would see what the window who shakes the man is making the picture .
this hat had noticed these windows that this cup who had lost this patient would make .	this hat had noticed what this cup who had lost this patient would make these windows .
this dish should n't forget those crayons that this bank who the schools heard might find .	this dish should n't forget what this bank who the schools heard might find those crayons .
these dolls will know those ladies who these glasses who may make the dancer should visit .	these dolls will know who these glasses who may make the dancer should visit those ladies .
those shoes have n't noticed those boys who that library who has cried does n't understand .	those shoes have n't noticed who that library who has cried does n't understand those boys .
these forks can forget these teachers who these dolls who sang know .	these forks can forget who these dolls who sang know these teachers .
this window may know this lady who this bed who can wave has n't heard .	this window may know who this bed who can wave has n't heard this lady .
those books had n't noticed the men that these trucks who scream hear .	those books had n't noticed what these trucks who scream hear the men .
that couch can forget these dishes that these glasses who had n't found the guy had brought .	that couch can forget what these glasses who had n't found the guy had brought these dishes .
this ring should n't see this toy that that room who knew that bank will steal .	this ring should n't see what that room who knew that bank will steal this toy .
that bag would n't know the pictures that that ring who would lie has .	that bag would n't know what that ring who would lie has the pictures .
that hat could n't remember that mirror that this picture who that spoon wo n't know was n't fixing .	that hat could n't remember what this picture who that spoon wo n't know was n't fixing that mirror .
those dishes can forget the women who that hospital who could stretch must know .	those dishes can forget who that hospital who could stretch must know the women .
this window would n't notice this ship that those shoes who have n't painted can n't lift .	this window would n't notice what those shoes who have n't painted can n't lift this ship .
the picture had n't remembered these ladies who that shoe who has painted could answer .	the picture had n't remembered who that shoe who has painted could answer these ladies .
those cups would n't remember those women who the rings who would shake that lady knew .	those cups would n't remember who the rings who would shake that lady knew those women .
the rings have noticed that ship that the buttons who do n't bring that boy are n't bringing .	the rings have noticed what the buttons who do n't bring that boy are n't bringing that ship .
this ring should notice that picture that these boxes who talk can n't clean .	this ring should notice what these boxes who talk can n't clean that picture .
those beds should notice the mirror that these glasses who did n't sing have n't moved .	those beds should notice what these glasses who did n't sing have n't moved the mirror .
that window had n't known these men who that hospital who heard these glasses knows .	that window had n't known who that hospital who heard these glasses knows these men .
this doll does n't see the driver who that plane who may have this lady heard .	this doll does n't see who that plane who may have this lady heard the driver .
that shirt had n't seen those plates that those cars who the glasses heard had kept .	that shirt had n't seen what those cars who the glasses heard had kept those plates .
the windows have n't known that chair that that bed who is singing was n't losing .	the windows have n't known what that bed who is singing was n't losing that chair .
the windows would know this bicycle that the boxes who hear these rings should n't bring .	the windows would know what the boxes who hear these rings should n't bring this bicycle .
the pictures had known this crayon that the mall who does n't fix that queen had held .	the pictures had known what the mall who does n't fix that queen had held this crayon .
this plate has known that book that those candles who are keeping these people had .	this plate has known what those candles who are keeping these people had that book .
the toys have seen the woman that these toys who these doors should n't know can know .	the toys have seen what these toys who these doors should n't know can know the woman .
the spoons had remembered the car that these rings who had n't held the driver are n't finding .	the spoons had remembered what these rings who had n't held the driver are n't finding the car .
those cups have n't known the doors that the rooms who smile could keep .	those cups have n't known what the rooms who smile could keep the doors .
those hats should know this adult who this bicycle who could n't win lost .	those hats should know who this bicycle who could n't win lost this adult .
the bottle wo n't see this plate that the dolls who are smiling are making .	the bottle wo n't see what the dolls who are smiling are making this plate .
these plates did n't know this shirt that that bottle who exercises was n't taking .	these plates did n't know what that bottle who exercises was n't taking this shirt .
this box has n't known the glass that those shoes who waved are making .	this box has n't known what those shoes who waved are making the glass .
that book has n't noticed that crayon that these books who would lose find .	that book has n't noticed what these books who would lose find that crayon .
that car could n't remember those books that those books who that plate has n't heard steal .	that car could n't remember what those books who that plate has n't heard steal those books .
these buttons did n't notice this king that this box who fixed those guys must know .	these buttons did n't notice what this box who fixed those guys must know this king .
these cars wo n't remember these glasses that the toys who know the rug lost .	these cars wo n't remember what the toys who know the rug lost these glasses .
the bicycle could forget that queen who the forks who had n't waved had n't heard .	the bicycle could forget who the forks who had n't waved had n't heard that queen .
the rings had remembered the woman who the forks who know these dishes were n't talking to .	the rings had remembered who the forks who know these dishes were n't talking to the woman .
the spoon will know those chairs that this mall who that bicycle knew moves .	the spoon will know what this mall who that bicycle knew moves those chairs .
the candle should n't remember the adult who the crayon who could hear these beds heard .	the candle should n't remember who the crayon who could hear these beds heard the adult .
this dish should n't remember the couch that this park who had won was n't moving .	this dish should n't remember what this park who had won was n't moving the couch .
these books should n't know that chair that those beds who have taken this dancer have taken .	these books should n't know what those beds who have taken this dancer have taken that chair .
the book wo n't know those crayons that this plane who had n't cleaned the guys might lose .	the book wo n't know what this plane who had n't cleaned the guys might lose those crayons .
these cups had noticed that child who the crayon who had heard those hats can n't hear .	these cups had noticed who the crayon who had heard those hats can n't hear that child .
the hat should remember this couch that that room who does n't bring this driver made .	the hat should remember what that room who does n't bring this driver made this couch .
those spoons have n't remembered this man who the box who takes the guy hears .	those spoons have n't remembered who the box who takes the guy hears this man .
the rings have n't known the doctors who the dish who these spoons heard is n't teaching .	the rings have n't known who the dish who these spoons heard is n't teaching the doctors .
this bag has n't noticed that dentist who these boxes who lie hear .	this bag has n't noticed who these boxes who lie hear that dentist .
the bowls should n't know these rings that the cups who heard this spoon were throwing .	the bowls should n't know what the cups who heard this spoon were throwing these rings .
the cup could n't see those books that the shoe who had brought this patient does n't sell .	the cup could n't see what the shoe who had brought this patient does n't sell those books .
the window had n't noticed those ladies who these cups who had n't brought this lady should care for .	the window had n't noticed who these cups who had n't brought this lady should care for those ladies .
those toys had remembered the dish that those doors who that door wo n't hear are making .	those toys had remembered what those doors who that door wo n't hear are making the dish .
those pictures have known the spoons that the buttons who should n't cry should n't shake .	those pictures have known what the buttons who should n't cry should n't shake the spoons .
that spoon will see the boats that that chair who has won bought .	that spoon will see what that chair who has won bought the boats .
those spoons had n't noticed that truck that those boxes who find this lady move .	those spoons had n't noticed what those boxes who find this lady move that truck .
the forks had remembered these people who these dishes who have n't heard that bottle taught .	the forks had remembered who these dishes who have n't heard that bottle taught these people .
those trucks may remember those cars that these rooms who these cars hear bring .	those trucks may remember what these rooms who these cars hear bring those cars .
that plane must see the girls who these rooms who were n't moving this adult have worked with .	that plane must see who these rooms who were n't moving this adult have worked with the girls .
the plate could n't notice these bags that these crayons who that window had n't heard shake .	the plate could n't notice what these crayons who that window had n't heard shake these bags .
this bed has noticed those glasses that these buttons who would clean this girl hold .	this bed has noticed what these buttons who would clean this girl hold those glasses .
those doors do n't remember the doctor who the glass who the buttons know has n't heard .	those doors do n't remember who the glass who the buttons know has n't heard the doctor .
this shirt has seen the cup that the cars who would know that dish dropped .	this shirt has seen what the cars who would know that dish dropped the cup .
this window had noticed those shirts that this school who can win would fix .	this window had noticed what this school who can win would fix those shirts .
the cars had n't remembered the truck that these shoes who should keep these children were losing .	the cars had n't remembered what these shoes who should keep these children were losing the truck .
that ship must see this box that this window who hears those cars should shake .	that ship must see what this window who hears those cars should shake this box .
the chair should n't remember these forks that those books who had heard that school are buying .	the chair should n't remember what those books who had heard that school are buying these forks .
this car has remembered the women who that book who read had n't taught .	this car has remembered who that book who read had n't taught the women .
the candle should n't know that dancer who the door who was n't painting has n't talked to .	the candle should n't know who the door who was n't painting has n't talked to that dancer .
this book did n't forget that person who the window who did n't shake the ladies wo n't teach .	this book did n't forget who the window who did n't shake the ladies wo n't teach that person .
the button does n't know the shirt that that truck who paints holds .	the button does n't know what that truck who paints holds the shirt .
this bicycle had remembered these spoons that the bags who lost buy .	this bicycle had remembered what the bags who lost buy these spoons .
these boats have n't noticed these boats that those windows who are n't yelling had n't brought .	these boats have n't noticed what those windows who are n't yelling had n't brought these boats .
the door can n't forget that man who the windows who have heard that bed must visit .	the door can n't forget who the windows who have heard that bed must visit that man .
those trucks had n't noticed this bowl that those cups who have n't heard those beds are moving .	those trucks had n't noticed what those cups who have n't heard those beds are moving this bowl .
that fork had n't remembered that car that those cars who would n't hold this man could bring .	that fork had n't remembered what those cars who would n't hold this man could bring that car .
the plate does n't know these boys who this doll who was n't reading is n't visiting .	the plate does n't know who this doll who was n't reading is n't visiting these boys .
the cars had n't noticed that teacher who the crayon who hears these cups must understand .	the cars had n't noticed who the crayon who hears these cups must understand that teacher .
those cars may remember the adult who the glasses who hear that restaurant visit .	those cars may remember who the glasses who hear that restaurant visit the adult .
the car can n't see the lady that those books who could n't know this ring hear .	the car can n't see what those books who could n't know this ring hear the lady .
the ship wo n't see this book that these schools who should sing move .	the ship wo n't see what these schools who should sing move this book .
the cups had n't remembered the rings that this shoe who lost had thrown .	the cups had n't remembered what this shoe who lost had thrown the rings .
those beds could remember that doctor who the window who those bottles do n't hear has n't heard .	those beds could remember who the window who those bottles do n't hear has n't heard that doctor .
these pictures have known the bicycle that the doll who knew those toys held .	these pictures have known what the doll who knew those toys held the bicycle .
these pictures had noticed these spoons that the dolls who can n't yell will throw .	these pictures had noticed what the dolls who can n't yell will throw these spoons .
these dolls could know that book that the car who brings the boy keeps .	these dolls could know what the car who brings the boy keeps that book .
these toys may remember this person who the mirror who heard this restaurant knows .	these toys may remember who the mirror who heard this restaurant knows this person .
that ring might notice these spoons that the bed who this car should n't know does n't steal .	that ring might notice what the bed who this car should n't know does n't steal these spoons .
the pictures could n't know those children who that bicycle who might bring those women helps .	the pictures could n't know who that bicycle who might bring those women helps those children .
the plane would n't notice those rabbits that that doll who those rings know heard .	the plane would n't notice what that doll who those rings know heard those rabbits .
that fork had n't seen those candles that the cars who the toy had heard were keeping .	that fork had n't seen what the cars who the toy had heard were keeping those candles .
the windows wo n't remember the child who this bicycle who laughed knows .	the windows wo n't remember who this bicycle who laughed knows the child .
the dishes had n't noticed the shoes that that couch who could exercise must find .	the dishes had n't noticed what that couch who could exercise must find the shoes .
that bicycle might know that woman who the car who bought the people would n't praise .	that bicycle might know who the car who bought the people would n't praise that woman .
those crayons had n't noticed these girls who the spoon who was whispering was n't talking to .	those crayons had n't noticed who the spoon who was whispering was n't talking to these girls .
these shoes should forget these glasses that those plates who the toys hear shook .	these shoes should forget what those plates who the toys hear shook these glasses .
the mirror might remember these boats that the chair who heard that shirt has n't moved .	the mirror might remember what the chair who heard that shirt has n't moved these boats .
these buttons should n't know this bowl that those plates who shook that child had n't found .	these buttons should n't know what those plates who shook that child had n't found this bowl .
the rocket has seen these forks that those pictures who read are moving .	the rocket has seen what those pictures who read are moving these forks .
the crayons had seen these children who these beds who this cup hears heard .	the crayons had seen who these beds who this cup hears heard these children .
those cars have known these teachers who that bank who threw those people knows .	those cars have known who that bank who threw those people knows these teachers .
those boats had remembered that shoe that the bank who knew that car was moving .	those boats had remembered what the bank who knew that car was moving that shoe .
these forks might know the chair that these schools who these pictures know steal .	these forks might know what these schools who these pictures know steal the chair .
that plate had n't known the children that the cups who those rings know had n't heard .	that plate had n't known what the cups who those rings know had n't heard the children .
this plane has known this girl who these shirts who know the room scared .	this plane has known who these shirts who know the room scared this girl .
the boats should n't notice these doors that this cup who stole the ladies threw .	the boats should n't notice what this cup who stole the ladies threw these doors .
these candles do n't see the candles that those bottles who are n't losing drop .	these candles do n't see what those bottles who are n't losing drop the candles .
the doors would see that mouse that those doors who did n't lose hear .	the doors would see what those doors who did n't lose hear that mouse .
these plates had n't noticed the girl who this hospital who these toys have n't heard knows .	these plates had n't noticed who this hospital who these toys have n't heard knows the girl .
that bed should n't know that rocket that that crayon who was n't shaking this child keeps .	that bed should n't know what that crayon who was n't shaking this child keeps that rocket .
that plate had seen those boys who the crayon who might hear this fork works with .	that plate had seen who the crayon who might hear this fork works with those boys .
the couch has n't remembered those toys that that mirror who is shaking the king had taken .	the couch has n't remembered what that mirror who is shaking the king had taken those toys .
those bowls did n't notice the candle that that bottle who held these women could steal .	those bowls did n't notice what that bottle who held these women could steal the candle .
the car should forget that plane that the hat who this glass had n't heard fixed .	the car should forget what the hat who this glass had n't heard fixed that plane .
the glass will see the dogs that the rings who won heard .	the glass will see what the rings who won heard the dogs .
this bowl has n't remembered that patient who the spoon who was n't making this queen was n't working with .	this bowl has n't remembered who the spoon who was n't making this queen was n't working with that patient .
the fork does n't know the hat that these candles who are screaming have n't kept .	the fork does n't know what these candles who are screaming have n't kept the hat .
those cars must remember the girls who this crayon who those buttons had heard had heard .	those cars must remember who this crayon who those buttons had heard had heard the girls .
these trucks have noticed those guys who this picture who knows the bags might understand .	these trucks have noticed who this picture who knows the bags might understand those guys .
the boats had noticed that bag that the glass who the doll should hear held .	the boats had noticed what the glass who the doll should hear held that bag .
this truck can see those books that this glass who had heard those glasses bought .	this truck can see what this glass who had heard those glasses bought those books .
the car has known that ship that these rooms who had waved had .	the car has known what these rooms who had waved had that ship .
this ship has n't noticed that boat that the mirror who kept the person can n't take .	this ship has n't noticed what the mirror who kept the person can n't take that boat .
these dishes have n't seen those hats that that car who moved the girl may make .	these dishes have n't seen what that car who moved the girl may make those hats .
the glass could forget the girl who those bottles who can lose the guys knew .	the glass could forget who those bottles who can lose the guys knew the girl .
those chairs may see those books that that chair who is smiling was n't holding .	those chairs may see what that chair who is smiling was n't holding those books .
the book can see this cup that these windows who had lost the lady have dropped .	the book can see what these windows who had lost the lady have dropped this cup .
that bowl could remember that bicycle that the dolls who had n't brought these ladies steal .	that bowl could remember what the dolls who had n't brought these ladies steal that bicycle .
the pictures have n't remembered that door that this restaurant who is n't cleaning the teacher has n't fixed .	the pictures have n't remembered what this restaurant who is n't cleaning the teacher has n't fixed that door .
the toys wo n't remember those shirts that the hat who heard these windows kept .	the toys wo n't remember what the hat who heard these windows kept those shirts .
those pictures had seen the toy that the buttons who can n't hear that hospital had n't cleaned .	those pictures had seen what the buttons who can n't hear that hospital had n't cleaned the toy .
that bottle has n't remembered the king who this plate who had fixed the ladies can appreciate .	that bottle has n't remembered who this plate who had fixed the ladies can appreciate the king .
the hats should n't remember the women who these books who could know that kitchen are n't bothering .	the hats should n't remember who these books who could know that kitchen are n't bothering the women .
this hat should see these guys who this door who is n't bringing the boys could know .	this hat should see who this door who is n't bringing the boys could know these guys .
the shoe has noticed the plane that the ship who the ship did n't hear was n't making .	the shoe has noticed what the ship who the ship did n't hear was n't making the plane .
that chair should n't forget this truck that the bag who will find that teacher was n't finding .	that chair should n't forget what the bag who will find that teacher was n't finding this truck .
those cars would n't know this woman who the restaurant who is n't losing had talked to .	those cars would n't know who the restaurant who is n't losing had talked to this woman .
the rug has remembered this customer who the books who heard that bottle teach .	the rug has remembered who the books who heard that bottle teach this customer .
these toys can n't remember this truck that the window who brings this person has n't dropped .	these toys can n't remember what the window who brings this person has n't dropped this truck .
these forks would n't forget this car that this room who should cough can find .	these forks would n't forget what this room who should cough can find this car .
these cups have n't noticed that bottle that that plate who has kept the children should n't fix .	these cups have n't noticed what that plate who has kept the children should n't fix that bottle .
those cars would know this shoe that that plate who had n't waved bought .	those cars would know what that plate who had n't waved bought this shoe .
this hat had remembered the spoon that that room who the door hears has fixed .	this hat had remembered what that room who the door hears has fixed the spoon .
the spoon wo n't see this child who the dish who had n't painted has visited .	the spoon wo n't see who the dish who had n't painted has visited this child .
this car has n't seen the driver who that bed who might know the car knew .	this car has n't seen who that bed who might know the car knew the driver .
those crayons would see the man who those bags who lose this girl praise .	those crayons would see who those bags who lose this girl praise the man .
the toys have n't remembered the guys who this crayon who has n't brought this woman hears .	the toys have n't remembered who this crayon who has n't brought this woman hears the guys .
the cars could remember the buttons that the book who had n't laughed has lost .	the cars could remember what the book who had n't laughed has lost the buttons .
the bicycle wo n't see the plates that that book who hears this car fixed .	the bicycle wo n't see what that book who hears this car fixed the plates .
the rocket should n't know that dish that the cups who bought that girl dropped .	the rocket should n't know what the cups who bought that girl dropped that dish .
this doll does n't notice the shoe that that room who has n't heard that ring fixed .	this doll does n't notice what that room who has n't heard that ring fixed the shoe .
these chairs wo n't forget those boats that those pictures who should n't cry were n't making .	these chairs wo n't forget what those pictures who should n't cry were n't making those boats .
those trucks do n't forget this boat that the shoes who sang are n't dropping .	those trucks do n't forget what the shoes who sang are n't dropping this boat .
those crayons have n't seen this shirt that this restaurant who exercises cleaned .	those crayons have n't seen what this restaurant who exercises cleaned this shirt .
this bicycle must notice these cups that this hat who had n't laughed stole .	this bicycle must notice what this hat who had n't laughed stole these cups .
that boat wo n't forget the forks that the fork who painted throws .	that boat wo n't forget what the fork who painted throws the forks .
these shoes had n't remembered that button that the hospital who knows that plate kept .	these shoes had n't remembered what the hospital who knows that plate kept that button .
the beds had noticed the girl who the restaurant who waved is n't listening to .	the beds had noticed who the restaurant who waved is n't listening to the girl .
those chairs can n't remember this book that those candles who stretch had n't thrown .	those chairs can n't remember what those candles who stretch had n't thrown this book .
this ship did n't see the button that that book who bought that driver was making .	this ship did n't see what that book who bought that driver was making the button .
this rug had noticed this doctor who this rocket who was n't making those doctors does n't praise .	this rug had noticed who this rocket who was n't making those doctors does n't praise this doctor .
this bag did n't remember the children who the glasses who know these bottles might care for .	this bag did n't remember who the glasses who know these bottles might care for the children .
this truck has n't remembered that toy that the kitchen who sang is throwing .	this truck has n't remembered what the kitchen who sang is throwing that toy .
the bags should know this crayon that these cars who should n't throw these people fix .	the bags should know what these cars who should n't throw these people fix this crayon .
that glass has n't remembered the dish that the museum who that kitchen hears must hold .	that glass has n't remembered what the museum who that kitchen hears must hold the dish .
that box wo n't remember that shirt that these toys who this school has heard make .	that box wo n't remember what these toys who this school has heard make that shirt .
the button might know the shoe that that button who those bowls knew had n't held .	the button might know what that button who those bowls knew had n't held the shoe .
that crayon should see that patient that these pictures who wo n't scream knew .	that crayon should see what these pictures who wo n't scream knew that patient .
that crayon has n't noticed this ship that that bowl who had n't cleaned the customer makes .	that crayon has n't noticed what that bowl who had n't cleaned the customer makes this ship .
the doors would n't remember that rocket that the cars who clean this teacher are finding .	the doors would n't remember what the cars who clean this teacher are finding that rocket .
this hat had n't remembered the boats that those rooms who can n't throw that lady could n't find .	this hat had n't remembered what those rooms who can n't throw that lady could n't find the boats .
that book must notice that teacher that the shirts who know the room heard .	that book must notice what the shirts who know the room heard that teacher .
the bowls have n't noticed the shirt that those beds who were singing were n't fixing .	the bowls have n't noticed what those beds who were singing were n't fixing the shirt .
that bed had n't noticed those shoes that this car who heard these crayons has n't cleaned .	that bed had n't noticed what this car who heard these crayons has n't cleaned those shoes .
the plates should remember those guys who these cups who win were n't listening to .	the plates should remember who these cups who win were n't listening to those guys .
that spoon could n't forget the book that this book who reads has n't made .	that spoon could n't forget what this book who reads has n't made the book .
that mirror has remembered this button that this school who reads makes .	that mirror has remembered what this school who reads makes this button .
that bottle had n't noticed the man who this button who had n't heard these bowls was teaching .	that bottle had n't noticed who this button who had n't heard these bowls was teaching the man .
the door had remembered those toys that that book who knows the shoes has thrown .	the door had remembered what that book who knows the shoes has thrown those toys .
the button has remembered that patient who that bed who would n't hear these dolls has n't confused .	the button has remembered who that bed who would n't hear these dolls has n't confused that patient .
this picture has seen this crayon that this bed who had kept that dentist is bringing .	this picture has seen what this bed who had kept that dentist is bringing this crayon .
those glasses have n't noticed the boxes that the book who knows these beds was holding .	those glasses have n't noticed what the book who knows these beds was holding the boxes .
this car had n't seen the toys that this glass who is n't singing had n't cleaned .	this car had n't seen what this glass who is n't singing had n't cleaned the toys .
that bag can n't know these spoons that that bottle who had n't heard the car had n't bought .	that bag can n't know what that bottle who had n't heard the car had n't bought these spoons .
that crayon should see those buttons that the forks who were smiling stole .	that crayon should see what the forks who were smiling stole those buttons .
that car had remembered that fork that those schools who have cried are bringing .	that car had remembered what those schools who have cried are bringing that fork .
the pictures can n't remember that door that the rooms who know these trucks are shaking .	the pictures can n't remember what the rooms who know these trucks are shaking that door .
the plates had seen the plates that the dolls who fixed this child could n't throw .	the plates had seen what the dolls who fixed this child could n't throw the plates .
those forks should know this bottle that that boat who has n't talked would shake .	those forks should know what that boat who has n't talked would shake this bottle .
that boat had n't noticed these bags that those candles who the boxes have n't heard fix .	that boat had n't noticed what those candles who the boxes have n't heard fix these bags .
these beds could know this picture that this bed who should n't stretch threw .	these beds could know what this bed who should n't stretch threw this picture .
this fork can n't know this shirt that those boats who won cleaned .	this fork can n't know what those boats who won cleaned this shirt .
this bag will see those cups that these schools who sing were fixing .	this bag will see what these schools who sing were fixing those cups .
that shoe can n't notice the girl who the bowls who should n't move that dancer should answer .	that shoe can n't notice who the bowls who should n't move that dancer should answer the girl .
the beds should forget this woman who that mirror who had n't held the man does n't listen to .	the beds should forget who that mirror who had n't held the man does n't listen to this woman .
these cars had remembered this window that those pictures who did n't whisper could move .	these cars had remembered what those pictures who did n't whisper could move this window .
this ring can know this bed that the candle who lost has found .	this ring can know what the candle who lost has found this bed .
these windows had seen that boy who this chair who has n't brought those children knows .	these windows had seen who this chair who has n't brought those children knows that boy .
those hats have noticed this doll that the bed who has heard the doors had n't dropped .	those hats have noticed what the bed who has heard the doors had n't dropped this doll .
the doors had n't known this book that this bed who is smiling makes .	the doors had n't known what this bed who is smiling makes this book .
those spoons have seen this girl who the car who talked was n't listening to .	those spoons have seen who the car who talked was n't listening to this girl .
this plane has n't known this adult who this kitchen who had made this doctor is n't bothering .	this plane has n't known who this kitchen who had made this doctor is n't bothering this adult .
these dishes should n't see that chair that these schools who scream keep .	these dishes should n't see what these schools who scream keep that chair .
the plates should n't see this shirt that the restaurant who the button did n't know is bringing .	the plates should n't see what the restaurant who the button did n't know is bringing this shirt .
these books wo n't see this window that those shoes who had heard those beds drop .	these books wo n't see what those shoes who had heard those beds drop this window .
this rocket could notice those bottles that that rocket who has heard that book had made .	this rocket could notice what that rocket who has heard that book had made those bottles .
those cups have remembered these boats that these beds who lost the women have n't found .	those cups have remembered what these beds who lost the women have n't found these boats .
the cup had remembered that patient who these spoons who heard this spoon are working with .	the cup had remembered who these spoons who heard this spoon are working with that patient .
those beds have n't noticed those children who the school who would n't hear the bags knows .	those beds have n't noticed who the school who would n't hear the bags knows those children .
that mirror did n't notice this patient who those candles who should n't hear this rug know .	that mirror did n't notice who those candles who should n't hear this rug know this patient .
the rocket does n't know this guy who those hats who must bring the patient found .	the rocket does n't know who those hats who must bring the patient found this guy .
that bowl has known the trucks that these bowls who do n't yell throw .	that bowl has known what these bowls who do n't yell throw the trucks .
those buttons did n't notice these dolls that the bowl who reads moves .	those buttons did n't notice what the bowl who reads moves these dolls .
those bowls can notice the hats that this hat who the books know had brought .	those bowls can notice what this hat who the books know had brought the hats .
the shoes must see the window that this glass who keeps the dentist would bring .	the shoes must see what this glass who keeps the dentist would bring the window .
this hat has seen those toys that the door who the bicycle heard shook .	this hat has seen what the door who the bicycle heard shook those toys .
this ring can n't forget that rocket that the boat who sang takes .	this ring can n't forget what the boat who sang takes that rocket .
that car had remembered the cars that this boat who would n't whisper had n't thrown .	that car had remembered what this boat who would n't whisper had n't thrown the cars .
those spoons had n't known those teachers who that cup who knew those boxes had n't talked to .	those spoons had n't known who that cup who knew those boxes had n't talked to those teachers .
those books have seen this lady who the trucks who have n't thrown those women worried .	those books have seen who the trucks who have n't thrown those women worried this lady .
that toy will forget these doctors who those schools who talked knew .	that toy will forget who those schools who talked knew these doctors .
that window can forget the pictures that these boats who won sell .	that window can forget what these boats who won sell the pictures .
that window has known this dancer who that glass who sings had n't heard .	that window has known who that glass who sings had n't heard this dancer .
the glasses had n't seen the cars that the bottles who have lost this teacher should bring .	the glasses had n't seen what the bottles who have lost this teacher should bring the cars .
this bicycle could notice those buttons that those schools who knew the spoon throw .	this bicycle could notice what those schools who knew the spoon throw those buttons .
this doll has n't known the man who these crayons who brought this teacher talk to .	this doll has n't known who these crayons who brought this teacher talk to the man .
this ship might notice these shirts that that kitchen who has read was keeping .	this ship might notice what that kitchen who has read was keeping these shirts .
the bowls wo n't know these women who the toy who could n't fix these women must scare .	the bowls wo n't know who the toy who could n't fix these women must scare these women .
that hat wo n't notice the doctor who this dish who was losing this lady did n't worry .	that hat wo n't notice who this dish who was losing this lady did n't worry the doctor .
the glasses should see these forks that these rooms who took those ladies will drop .	the glasses should see what these rooms who took those ladies will drop these forks .
that bowl would remember that rocket that those glasses who this mirror had n't heard had .	that bowl would remember what those glasses who this mirror had n't heard had that rocket .
the books had remembered that driver who the chairs who the school can n't hear had n't answered .	the books had remembered who the chairs who the school can n't hear had n't answered that driver .
the toy had seen the shoes that this bank who laughed has held .	the toy had seen what this bank who laughed has held the shoes .
the bowl could know the buttons that the spoon who wo n't laugh cleaned .	the bowl could know what the spoon who wo n't laugh cleaned the buttons .
those doors did n't forget these boxes that this spoon who throws those doctors was n't shaking .	those doors did n't forget what this spoon who throws those doctors was n't shaking these boxes .
the hats have seen that crayon that the bed who must drop this king can n't move .	the hats have seen what the bed who must drop this king can n't move that crayon .
these hats had remembered this ship that the rings who are n't moving the guys wo n't keep .	these hats had remembered what the rings who are n't moving the guys wo n't keep this ship .
these bowls had known the teacher who the glasses who have n't talked should hear .	these bowls had known who the glasses who have n't talked should hear the teacher .
that button must notice this cup that the ship who has lost this person does n't hold .	that button must notice what the ship who has lost this person does n't hold this cup .
the boxes wo n't forget that rocket that this picture who that park has heard is holding .	the boxes wo n't forget what this picture who that park has heard is holding that rocket .
those windows had n't noticed the candle that the box who cries threw .	those windows had n't noticed what the box who cries threw the candle .
that fork had noticed the toy that this plate who made these boys drops .	that fork had noticed what this plate who made these boys drops the toy .
that bag did n't notice these men who the room who won must know .	that bag did n't notice who the room who won must know these men .
these cars have known those doctors who the car who is crying heard .	these cars have known who the car who is crying heard those doctors .
the glasses do n't see the fork that these forks who were n't reading lose .	the glasses do n't see what these forks who were n't reading lose the fork .
those windows would n't see that bottle that these bowls who had dropped this king were making .	those windows would n't see what these bowls who had dropped this king were making that bottle .
that bed had remembered these rings that the bank who lost might buy .	that bed had remembered what the bank who lost might buy these rings .
that plane might see this lady who those forks who this ring knows have heard .	that plane might see who those forks who this ring knows have heard this lady .
the boxes must see those pictures that the room who may take the children has n't cleaned .	the boxes must see what the room who may take the children has n't cleaned those pictures .
the candles should know this button that that box who did n't know those candles did n't steal .	the candles should know what that box who did n't know those candles did n't steal this button .
that crayon can forget the customer who this couch who has n't heard those spoons would scare .	that crayon can forget who this couch who has n't heard those spoons would scare the customer .
these buttons do n't remember this truck that those dishes who shake the boy were making .	these buttons do n't remember what those dishes who shake the boy were making this truck .
the shoe could n't see the lady who these rooms who smile have taught .	the shoe could n't see who these rooms who smile have taught the lady .
this bicycle has remembered those teachers who these schools who stole the customer have heard .	this bicycle has remembered who these schools who stole the customer have heard those teachers .
the dolls have n't remembered those books that those books who knew these dishes find .	the dolls have n't remembered what those books who knew these dishes find those books .
the bottles have n't noticed those dishes that these cars who that button wo n't know threw .	the bottles have n't noticed what these cars who that button wo n't know threw those dishes .
those doors can forget the men that this bottle who those cars know heard .	those doors can forget what this bottle who those cars know heard the men .
this rug did n't see the ship that those schools who know these hats had n't fixed .	this rug did n't see what those schools who know these hats had n't fixed the ship .
the hat has noticed this book that those shoes who that boat hears sell .	the hat has noticed what those shoes who that boat hears sell this book .
the cup has n't noticed these rings that that box who that bowl might know brings .	the cup has n't noticed what that box who that bowl might know brings these rings .
this spoon would n't remember those candles that the dish who should cry bought .	this spoon would n't remember what the dish who should cry bought those candles .
that door may see that bowl that this plane who was n't losing has cleaned .	that door may see what this plane who was n't losing has cleaned that bowl .
the doll must notice those girls who that chair who might hear the toys could n't know .	the doll must notice who that chair who might hear the toys could n't know those girls .
that car might forget this ring that that book who should n't shake these guys brings .	that car might forget what that book who should n't shake these guys brings this ring .
these pictures can see that lady that those crayons who have n't yelled knew .	these pictures can see what those crayons who have n't yelled knew that lady .
these doors could forget that bed that those windows who those plates could n't hear might find .	these doors could forget what those windows who those plates could n't hear might find that bed .
that candle had n't seen the women who this ring who those shirts hear could listen to .	that candle had n't seen who this ring who those shirts hear could listen to the women .
those forks had n't seen that bag that the ring who the chairs had heard made .	those forks had n't seen what the ring who the chairs had heard made that bag .
these dolls can forget those girls who this school who has bought these women talks to .	these dolls can forget who this school who has bought these women talks to those girls .
that bag could n't remember those shirts that these forks who would n't sing have fixed .	that bag could n't remember what these forks who would n't sing have fixed those shirts .
the bottle had known that lady who those bags who read would talk to .	the bottle had known who those bags who read would talk to that lady .
this spoon has seen the ship that that bicycle who had that lady is taking .	this spoon has seen what that bicycle who had that lady is taking the ship .
that door could forget that plate that those trucks who that school heard have lost .	that door could forget what those trucks who that school heard have lost that plate .
these books have remembered that doctor who this picture who the glass had heard has n't worked with .	these books have remembered who this picture who the glass had heard has n't worked with that doctor .
the books did n't remember that mirror that the school who could stretch had n't found .	the books did n't remember what the school who could stretch had n't found that mirror .
those spoons have n't seen these rings that that bottle who these schools knew can make .	those spoons have n't seen what that bottle who these schools knew can make these rings .
the boats have remembered the man who that bicycle who hears that window heard .	the boats have remembered who that bicycle who hears that window heard the man .
this bed should n't know those toys that this hat who drops that doctor dropped .	this bed should n't know what this hat who drops that doctor dropped those toys .
the doors have known the king that that bicycle who should n't scream might know .	the doors have known what that bicycle who should n't scream might know the king .
the shoe did n't know the lady who that glass who throws those people hears .	the shoe did n't know who that glass who throws those people hears the lady .
the shirt can n't know these books that those rooms who do n't yell can steal .	the shirt can n't know what those rooms who do n't yell can steal these books .
that spoon could n't remember the mirror that those cars who were n't making the customer shake .	that spoon could n't remember what those cars who were n't making the customer shake the mirror .
that truck must notice these girls who the schools who are n't singing had answered .	that truck must notice who the schools who are n't singing had answered these girls .
the dish does n't remember the cup that the bed who wo n't shake the child has bought .	the dish does n't remember what the bed who wo n't shake the child has bought the cup .
that mirror could n't see that car that the shirts who wo n't win might take .	that mirror could n't see what the shirts who wo n't win might take that car .
those shirts might know this couch that those toys who lost fix .	those shirts might know what those toys who lost fix this couch .
the button has n't known the guys that those boxes who knew this car wo n't hear .	the button has n't known what those boxes who knew this car wo n't hear the guys .
these shirts have n't noticed this dancer who the buttons who will take that dancer heard .	these shirts have n't noticed who the buttons who will take that dancer heard this dancer .
the glasses should forget the shoes that those pictures who that library heard fixed .	the glasses should forget what those pictures who that library heard fixed the shoes .
that dish does n't know that ship that the mall who is n't laughing has .	that dish does n't know what the mall who is n't laughing has that ship .
those candles have seen the boy who this ship who the book knows had helped .	those candles have seen who this ship who the book knows had helped the boy .
this hat has seen this window that these bottles who have n't heard the boats had held .	this hat has seen what these bottles who have n't heard the boats had held this window .
the pictures had n't seen this cup that the beds who have this patient can hold .	the pictures had n't seen what the beds who have this patient can hold this cup .
those cars have n't known this hat that these cars who the school hears have fixed .	those cars have n't known what these cars who the school hears have fixed this hat .
these windows may see this doll that the spoon who keeps this man will drop .	these windows may see what the spoon who keeps this man will drop this doll .
that doll could n't see that customer who that spoon who had n't yelled knows .	that doll could n't see who that spoon who had n't yelled knows that customer .
those bottles have n't noticed the guys who the box who waves knew .	those bottles have n't noticed who the box who waves knew the guys .
those plates could n't see that lady who those hats who knew this spoon work with .	those plates could n't see who those hats who knew this spoon work with that lady .
the dolls could remember this couch that these windows who can n't sneeze found .	the dolls could remember what these windows who can n't sneeze found this couch .
the spoons could n't forget those dolls that the bowls who are making that dancer were n't taking .	the spoons could n't forget what the bowls who are making that dancer were n't taking those dolls .
these books had n't remembered the shirts that the mirror who might shake this boy fixed .	these books had n't remembered what the mirror who might shake this boy fixed the shirts .
the forks had seen that mirror that the cars who were yelling would shake .	the forks had seen what the cars who were yelling would shake that mirror .
the shoes should forget the beds that the bag who has n't fixed the ladies was holding .	the shoes should forget what the bag who has n't fixed the ladies was holding the beds .
that couch had n't seen that candle that the park who would laugh wo n't lift .	that couch had n't seen what the park who would laugh wo n't lift that candle .
these chairs did n't remember this ring that the cars who have n't won are n't dropping .	these chairs did n't remember what the cars who have n't won are n't dropping this ring .
the books could n't remember those girls who the toys who had n't heard that plate heard .	the books could n't remember who the toys who had n't heard that plate heard those girls .
these forks would n't see this dish that the crayon who could shake the man kept .	these forks would n't see what the crayon who could shake the man kept this dish .
those bottles could forget the forks that the glasses who that plate knows were dropping .	those bottles could forget what the glasses who that plate knows were dropping the forks .
those boxes can remember that plate that these books who have n't lost clean .	those boxes can remember what these books who have n't lost clean that plate .
these hats should n't remember these forks that this plane who was n't losing this person was n't keeping .	these hats should n't remember what this plane who was n't losing this person was n't keeping these forks .
this door will see these beds that those glasses who lost have .	this door will see what those glasses who lost have these beds .
these windows do n't remember that customer who these shoes who take the teacher help .	these windows do n't remember who these shoes who take the teacher help that customer .
those trucks have remembered the hats that the cups who paint were n't shaking .	those trucks have remembered what the cups who paint were n't shaking the hats .
those books have n't noticed the dish that the bowls who win made .	those books have n't noticed what the bowls who win made the dish .
that cup can n't notice those pictures that these dishes who read did n't take .	that cup can n't notice what these dishes who read did n't take those pictures .
the dolls have seen the girl who those books who buy the boys lost .	the dolls have seen who those books who buy the boys lost the girl .
these shoes have n't known this shoe that the toy who this plane did n't know drops .	these shoes have n't known what the toy who this plane did n't know drops this shoe .
the chairs should n't notice the button that these shoes who won would n't steal .	the chairs should n't notice what these shoes who won would n't steal the button .
those shirts could know those boxes that these bowls who had won must bring .	those shirts could know what these bowls who had won must bring those boxes .
that ring would n't forget the rug that these glasses who should sneeze are buying .	that ring would n't forget what these glasses who should sneeze are buying the rug .
this picture must forget the ship that the crayons who the school did n't hear lift .	this picture must forget what the crayons who the school did n't hear lift the ship .
those shoes wo n't remember this doctor who those hats who should n't whisper would teach .	those shoes wo n't remember who those hats who should n't whisper would teach this doctor .
these hats have known the ladies who the school who has waved hears .	these hats have known who the school who has waved hears the ladies .
the hats have n't seen these trucks that the shirt who the glass heard shook .	the hats have n't seen what the shirt who the glass heard shook these trucks .
this ship will know the ring that this rug who should n't hear the plane is n't throwing .	this ship will know what this rug who should n't hear the plane is n't throwing the ring .
these bottles would see the window that the dolls who can n't practice move .	these bottles would see what the dolls who can n't practice move the window .
that bowl has n't noticed the glasses that the door who this bag heard made .	that bowl has n't noticed what the door who this bag heard made the glasses .
the rug had n't seen the boys who that bag who can hold those doctors could bother .	the rug had n't seen who that bag who can hold those doctors could bother the boys .
these chairs had n't known these doctors who the spoons who have n't lost this driver can n't teach .	these chairs had n't known who the spoons who have n't lost this driver can n't teach these doctors .
these crayons had noticed the lady who this dish who those dishes had heard heard .	these crayons had noticed who this dish who those dishes had heard heard the lady .
the chairs could n't notice the fork that those rooms who lift these children have cleaned .	the chairs could n't notice what those rooms who lift these children have cleaned the fork .
the chair has n't known these ladies who that school who will lift the girl hears .	the chair has n't known who that school who will lift the girl hears these ladies .
that chair should know the car that those schools who did n't laugh made .	that chair should know what those schools who did n't laugh made the car .
these cups might know these pictures that that park who those schools should n't hear will find .	these cups might know what that park who those schools should n't hear will find these pictures .
the plates have seen those cars that those pictures who win are n't finding .	the plates have seen what those pictures who win are n't finding those cars .
these cups can know this shoe that the cup who cried held .	these cups can know what the cup who cried held this shoe .
the shirt could know the candles that this ring who had n't painted was buying .	the shirt could know what this ring who had n't painted was buying the candles .
these shirts will remember this crayon that these buttons who these cups had heard bring .	these shirts will remember what these buttons who these cups had heard bring this crayon .
these books must see those shoes that this rocket who knew that park is n't taking .	these books must see what this rocket who knew that park is n't taking those shoes .
this shirt has n't seen that bed that this glass who this plate knows kept .	this shirt has n't seen what this glass who this plate knows kept that bed .
the cup should forget this person who the shoes who the cups hear knew .	the cup should forget who the shoes who the cups hear knew this person .
the bags should n't know the teacher who these beds who the window did n't know might talk to .	the bags should n't know who these beds who the window did n't know might talk to the teacher .
the rings must know those boys who those bottles who know this car could care for .	the rings must know who those bottles who know this car could care for those boys .
the bowls must notice the books that that candle who knows these pictures moves .	the bowls must notice what that candle who knows these pictures moves the books .
this shoe could remember the door that the forks who these candles must know bring .	this shoe could remember what the forks who these candles must know bring the door .
these boats have seen the bottles that that window who had n't laughed has thrown .	these boats have seen what that window who had n't laughed has thrown the bottles .
the bags may notice this bowl that those boats who have n't heard that door fixed .	the bags may notice what those boats who have n't heard that door fixed this bowl .
the books may forget these cars that those plates who must keep the boys held .	the books may forget what those plates who must keep the boys held these cars .
the books do n't notice this bowl that these spoons who might whisper have lost .	the books do n't notice what these spoons who might whisper have lost this bowl .
the bottles would n't see the bicycle that the schools who hear these candles fixed .	the bottles would n't see what the schools who hear these candles fixed the bicycle .
that bowl has remembered those doctors who the bags who are n't lying should n't answer .	that bowl has remembered who the bags who are n't lying should n't answer those doctors .
this bowl wo n't forget those shoes that these trucks who have heard the rings take .	this bowl wo n't forget what these trucks who have heard the rings take those shoes .
the dolls can know these dishes that this glass who could n't wave threw .	the dolls can know what this glass who could n't wave threw these dishes .
that shirt will notice those boxes that the hats who win do n't find .	that shirt will notice what the hats who win do n't find those boxes .
these forks had noticed this adult who this park who had lost talked to .	these forks had noticed who this park who had lost talked to this adult .
the trucks had remembered this queen who those forks who were n't holding the teacher have heard .	the trucks had remembered who those forks who were n't holding the teacher have heard this queen .
these bags had seen the toy that that candle who sang had .	these bags had seen what that candle who sang had the toy .
these windows had n't noticed these bottles that the box who has n't heard those dishes was n't making .	these windows had n't noticed what the box who has n't heard those dishes was n't making these bottles .
this box has n't seen the teacher who these schools who throw these children heard .	this box has n't seen who these schools who throw these children heard the teacher .
the door had known the boy who these forks who are n't yelling heard .	the door had known who these forks who are n't yelling heard the boy .
this bottle had n't remembered these hats that the shoes who could n't have the people can lose .	this bottle had n't remembered what the shoes who could n't have the people can lose these hats .
those forks have n't known that button that that truck who takes the driver was n't moving .	those forks have n't known what that truck who takes the driver was n't moving that button .
the books have n't known the door that these trucks who will find the teacher fix .	the books have n't known what these trucks who will find the teacher fix the door .
these pictures must notice the beds that that dish who was throwing this patient had kept .	these pictures must notice what that dish who was throwing this patient had kept the beds .
the window has seen that queen who that shoe who these cups hear knows .	the window has seen who that shoe who these cups hear knows that queen .
this car had n't seen the bowl that those candles who talked have .	this car had n't seen what those candles who talked have the bowl .
these dolls had known the picture that those chairs who could cry might lift .	these dolls had known what those chairs who could cry might lift the picture .
those windows had n't remembered that customer who the crayon who is yelling had n't taught .	those windows had n't remembered who the crayon who is yelling had n't taught that customer .
that rocket did n't know this man who the buttons who did n't lift that customer must praise .	that rocket did n't know who the buttons who did n't lift that customer must praise this man .
that rug has seen that hat that these forks who may make this queen fixed .	that rug has seen what these forks who may make this queen fixed that hat .
the spoons do n't see the boy who this bed who will yell scared .	the spoons do n't see who this bed who will yell scared the boy .
the hats could know these boys who the hospital who moves these doctors would n't know .	the hats could know who the hospital who moves these doctors would n't know these boys .
the dishes have noticed the dish that the bags who will lose find .	the dishes have noticed what the bags who will lose find the dish .
the bowls have remembered the guy who the bank who exercises knows .	the bowls have remembered who the bank who exercises knows the guy .
the shirts did n't know the bicycle that this chair who knows this car took .	the shirts did n't know what this chair who knows this car took the bicycle .
the rings had remembered that doctor who the ship who did n't know the spoons has n't heard .	the rings had remembered who the ship who did n't know the spoons has n't heard that doctor .
the bag had n't known these teachers that the cup who kept these doctors can n't know .	the bag had n't known what the cup who kept these doctors can n't know these teachers .
these bottles wo n't remember those shirts that the car who exercises had thrown .	these bottles wo n't remember what the car who exercises had thrown those shirts .
these pictures would n't notice that shoe that this library who can take this driver made .	these pictures would n't notice what this library who can take this driver made that shoe .
this plane can n't forget that ring that the candles who lost were fixing .	this plane can n't forget what the candles who lost were fixing that ring .
the crayon has noticed that couch that that rug who had n't bought this man had thrown .	the crayon has noticed what that rug who had n't bought this man had thrown that couch .
those cars can remember this doctor who this rug who the school knows answered .	those cars can remember who this rug who the school knows answered this doctor .
the window has remembered those toys that these beds who should n't hear the bag have n't cleaned .	the window has remembered what these beds who should n't hear the bag have n't cleaned those toys .
these buttons can n't notice this adult who these hats who would have those people hear .	these buttons can n't notice who these hats who would have those people hear this adult .
the bicycle has n't known that rocket that the cup who drops the woman could n't lose .	the bicycle has n't known what the cup who drops the woman could n't lose that rocket .
those crayons have n't known that fork that those bowls who could n't practice moved .	those crayons have n't known what those bowls who could n't practice moved that fork .
the bowl had noticed those buttons that the cup who the school may know fixed .	the bowl had noticed what the cup who the school may know fixed those buttons .
the door did n't know that man who the beds who hear this doll answer .	the door did n't know who the beds who hear this doll answer that man .
those trucks have seen that girl that those books who cleaned these guys could n't hear .	those trucks have seen what those books who cleaned these guys could n't hear that girl .
those pictures do n't forget that rug that the plates who found that child throw .	those pictures do n't forget what the plates who found that child throw that rug .
this mirror has known these guys who these shirts who were n't singing talk to .	this mirror has known who these shirts who were n't singing talk to these guys .
the dolls could remember those children who the trucks who should talk worked with .	the dolls could remember who the trucks who should talk worked with those children .
that doll had noticed the picture that that box who those rooms hear is n't bringing .	that doll had noticed what that box who those rooms hear is n't bringing the picture .
those bags can remember the pictures that this shirt who has n't heard the chairs would n't clean .	those bags can remember what this shirt who has n't heard the chairs would n't clean the pictures .
these toys had noticed the children who the dishes who sing hear .	these toys had noticed who the dishes who sing hear the children .
the window must remember the glass that this fork who does n't laugh would n't bring .	the window must remember what this fork who does n't laugh would n't bring the glass .
the glass had n't remembered these cups that this rug who stole these girls kept .	the glass had n't remembered what this rug who stole these girls kept these cups .
those beds could n't forget the men who that toy who has n't taken this girl worked with .	those beds could n't forget who that toy who has n't taken this girl worked with the men .
those bottles have seen this customer who these cups who had n't cleaned the person had heard .	those bottles have seen who these cups who had n't cleaned the person had heard this customer .
the shoe wo n't know this dancer who these windows who know the ship have n't worked with .	the shoe wo n't know who these windows who know the ship have n't worked with this dancer .
those chairs should remember that bottle that the mall who won cleaned .	those chairs should remember what the mall who won cleaned that bottle .
that ring could remember that fork that this picture who the restaurant can n't hear did n't bring .	that ring could remember what this picture who the restaurant can n't hear did n't bring that fork .
the spoon had n't noticed that rug that the boxes who win held .	the spoon had n't noticed what the boxes who win held that rug .
those books should n't remember the spoon that those crayons who lie have n't lost .	those books should n't remember what those crayons who lie have n't lost the spoon .
this bed must remember this woman who this museum who lost the children has heard .	this bed must remember who this museum who lost the children has heard this woman .
that fork had n't noticed that hat that that mall who takes the patient could hold .	that fork had n't noticed what that mall who takes the patient could hold that hat .
that door has n't seen these guys who those rooms who practice visited .	that door has n't seen who those rooms who practice visited these guys .
the glasses would forget this doctor who that crayon who does n't yell knows .	the glasses would forget who that crayon who does n't yell knows this doctor .
that crayon will see this dish that that truck who could n't cough is n't taking .	that crayon will see what that truck who could n't cough is n't taking this dish .
the button had n't known the children who that park who this window has n't heard has answered .	the button had n't known who that park who this window has n't heard has answered the children .
those cups have n't seen those cups that that shoe who heard that candle can n't throw .	those cups have n't seen what that shoe who heard that candle can n't throw those cups .
these trucks would forget this bird that those chairs who practice hear .	these trucks would forget what those chairs who practice hear this bird .
these dolls had seen the bags that those buttons who these books hear were n't keeping .	these dolls had seen what those buttons who these books hear were n't keeping the bags .
this hat has n't seen these boxes that that glass who the bed could know has dropped .	this hat has n't seen what that glass who the bed could know has dropped these boxes .
that bed will notice these crayons that those shirts who the chair would n't hear had cleaned .	that bed will notice what those shirts who the chair would n't hear had cleaned these crayons .
the bowl has n't noticed these toys that that chair who those rings may know had .	the bowl has n't noticed what that chair who those rings may know had these toys .
the dolls had seen those rings that the shirts who had n't yelled will throw .	the dolls had seen what the shirts who had n't yelled will throw those rings .
that bed has n't seen those girls who that restaurant who had n't lost that lady worried .	that bed has n't seen who that restaurant who had n't lost that lady worried those girls .
those buttons wo n't know the hat that those rooms who lift those people had brought .	those buttons wo n't know what those rooms who lift those people had brought the hat .
these plates will know the driver who those pictures who were n't screaming did n't know .	these plates will know who those pictures who were n't screaming did n't know the driver .
this truck had seen the bottle that the crayon who the glass could know should fix .	this truck had seen what the crayon who the glass could know should fix the bottle .
that cup can see the children who this museum who takes this lady had n't heard .	that cup can see who this museum who takes this lady had n't heard the children .
this boat can n't know these doctors who those dolls who had n't kept the queen answer .	this boat can n't know who those dolls who had n't kept the queen answer these doctors .
that bicycle had n't noticed those doctors who that room who was n't cleaning the person is n't helping .	that bicycle had n't noticed who that room who was n't cleaning the person is n't helping those doctors .
that rocket wo n't forget those boxes that this doll who reads is n't bringing .	that rocket wo n't forget what this doll who reads is n't bringing those boxes .
those trucks had n't seen those books that this button who read has n't dropped .	those trucks had n't seen what this button who read has n't dropped those books .
those dishes could notice these dolls that this plane who has won has cleaned .	those dishes could notice what this plane who has won has cleaned these dolls .
this book has remembered that shirt that these dolls who cry were n't cleaning .	this book has remembered what these dolls who cry were n't cleaning that shirt .
these bags had known this bicycle that the cars who the plates know fix .	these bags had known what the cars who the plates know fix this bicycle .
that cup had n't seen this man who the mirror who does n't find the girl bothered .	that cup had n't seen who the mirror who does n't find the girl bothered this man .
that window would notice these boxes that those bags who heard those pictures had found .	that window would notice what those bags who heard those pictures had found these boxes .
the crayons would notice the king who the mall who was moving that dancer was n't visiting .	the crayons would notice who the mall who was moving that dancer was n't visiting the king .
that bottle had n't known this couch that the mall who had cleaned that dentist is n't dropping .	that bottle had n't known what the mall who had cleaned that dentist is n't dropping this couch .
the shoe had n't remembered the mirror that the cars who cried are n't making .	the shoe had n't remembered what the cars who cried are n't making the mirror .
that plane has known this button that the candle who has n't yelled brings .	that plane has known what the candle who has n't yelled brings this button .
the shoes had noticed these dishes that these dishes who are cleaning that lady are moving .	the shoes had noticed what these dishes who are cleaning that lady are moving these dishes .
that bed has n't known the women who these candles who were making those girls could bother .	that bed has n't known who these candles who were making those girls could bother the women .
this fork has seen this ring that this bed who does n't buy the teachers can n't hold .	this fork has seen what this bed who does n't buy the teachers can n't hold this ring .
that bowl had n't remembered the plates that those rooms who the park heard shook .	that bowl had n't remembered what those rooms who the park heard shook the plates .
the beds should n't remember this turtle that those toys who would n't lift that boy can n't know .	the beds should n't remember what those toys who would n't lift that boy can n't know this turtle .
that ring can forget those plates that this ring who heard this bicycle fixed .	that ring can forget what this ring who heard this bicycle fixed those plates .
this spoon had n't noticed that doctor who this hospital who heard the doll helps .	this spoon had n't noticed who this hospital who heard the doll helps that doctor .
the shirts had noticed that truck that the plane who knows this car might steal .	the shirts had noticed what the plane who knows this car might steal that truck .
those hats must see the bowl that these books who made those ladies were n't finding .	those hats must see what these books who made those ladies were n't finding the bowl .
this boat had known this dancer who the cup who can n't hear that fork talks to .	this boat had known who the cup who can n't hear that fork talks to this dancer .
the books had n't known that cat that the bank who has n't heard that bottle could hear .	the books had n't known what the bank who has n't heard that bottle could hear that cat .
these forks have remembered the book that that bed who those buttons would n't hear takes .	these forks have remembered what that bed who those buttons would n't hear takes the book .
that hat has n't known the crayon that the car who was n't dropping this king would buy .	that hat has n't known what the car who was n't dropping this king would buy the crayon .
those plates have noticed the person who those spoons who this cup should n't know should scare .	those plates have noticed who those spoons who this cup should n't know should scare the person .
these dolls have n't known this adult who this spoon who the chair knew is working with .	these dolls have n't known who this spoon who the chair knew is working with this adult .
that plate should n't notice this hat that the spoon who did n't hear the hats could have .	that plate should n't notice what the spoon who did n't hear the hats could have this hat .
these rings can n't remember the hats that that shirt who had heard these shoes threw .	these rings can n't remember what that shirt who had heard these shoes threw the hats .
this book had n't noticed this shoe that those bags who that glass could n't know are n't holding .	this book had n't noticed what those bags who that glass could n't know are n't holding this shoe .
that glass had noticed the shoes that those boxes who had read bought .	that glass had noticed what those boxes who had read bought the shoes .
those plates had n't noticed the candles that the door who paints brings .	those plates had n't noticed what the door who paints brings the candles .
that bicycle had n't seen this mirror that that doll who had the children wo n't make .	that bicycle had n't seen what that doll who had the children wo n't make this mirror .
the glass must notice these shirts that the dishes who are lying can move .	the glass must notice what the dishes who are lying can move these shirts .
that toy has remembered that picture that these forks who are losing the adult may drop .	that toy has remembered what these forks who are losing the adult may drop that picture .
that mirror would n't remember that king who the window who could n't sneeze would n't know .	that mirror would n't remember who the window who could n't sneeze would n't know that king .
these cars wo n't remember this man who that plane who has heard the shirt heard .	these cars wo n't remember who that plane who has heard the shirt heard this man .
these bowls have remembered that candle that that book who has talked could n't lift .	these bowls have remembered what that book who has talked could n't lift that candle .
the couch had remembered that king who that restaurant who hears these cups should n't worry .	the couch had remembered who that restaurant who hears these cups should n't worry that king .
that bottle can n't remember the spoons that the museum who the boxes do n't hear made .	that bottle can n't remember what the museum who the boxes do n't hear made the spoons .
this rocket must remember the book that this hat who had laughed had .	this rocket must remember what this hat who had laughed had the book .
the bottles did n't know the fork that this bed who may know that ship has n't cleaned .	the bottles did n't know what this bed who may know that ship has n't cleaned the fork .
this toy has remembered that boat that the truck who that bank knew is keeping .	this toy has remembered what the truck who that bank knew is keeping that boat .
those boats had seen the boat that that car who hears this book should take .	those boats had seen what that car who hears this book should take the boat .
these candles might notice that lady who these boats who are singing worry .	these candles might notice who these boats who are singing worry that lady .
this truck could remember this lady who the plane who shakes those men knows .	this truck could remember who the plane who shakes those men knows this lady .
those spoons have n't seen that patient who those doors who cleaned the king had heard .	those spoons have n't seen who those doors who cleaned the king had heard that patient .
those boats can remember that boy who the book who exercises had n't heard .	those boats can remember who the book who exercises had n't heard that boy .
that fork had known that toy that the dish who must exercise cleaned .	that fork had known what the dish who must exercise cleaned that toy .
these shoes might know those cups that the bottle who the pictures heard keeps .	these shoes might know what the bottle who the pictures heard keeps those cups .
these boxes have known the bowl that the pictures who wo n't make this dentist would n't steal .	these boxes have known what the pictures who wo n't make this dentist would n't steal the bowl .
that doll has n't remembered the adult who these doors who took these children hear .	that doll has n't remembered who these doors who took these children hear the adult .
the windows had n't seen the girls who those shirts who cry confused .	the windows had n't seen who those shirts who cry confused the girls .
the bags might forget this hat that these cars who those candles did n't hear should lose .	the bags might forget what these cars who those candles did n't hear should lose this hat .
that window had n't remembered that shoe that this box who had n't found that king was n't buying .	that window had n't remembered what this box who had n't found that king was n't buying that shoe .
the rings have noticed the plate that that book who cries is n't making .	the rings have noticed what that book who cries is n't making the plate .
these books would n't know the ship that that park who had n't cried was finding .	these books would n't know what that park who had n't cried was finding the ship .
that door may notice these ladies who this door who lost hears .	that door may notice who this door who lost hears these ladies .
this doll could n't remember this ring that these shirts who are n't painting hold .	this doll could n't remember what these shirts who are n't painting hold this ring .
these shirts do n't know those chairs that the candles who do n't hear that fork would n't keep .	these shirts do n't know what the candles who do n't hear that fork would n't keep those chairs .
the forks have n't seen those dolls that the hat who had n't heard those glasses moves .	the forks have n't seen what the hat who had n't heard those glasses moves those dolls .
this cup has n't known that fork that this plate who has n't yelled has made .	this cup has n't known what this plate who has n't yelled has made that fork .
the boats had n't remembered the dolls that those books who win had n't kept .	the boats had n't remembered what those books who win had n't kept the dolls .
those bowls must remember the bag that the truck who the rug would n't hear may shake .	those bowls must remember what the truck who the rug would n't hear may shake the bag .
those shoes had n't remembered that plane that that mirror who lost the adult drops .	those shoes had n't remembered what that mirror who lost the adult drops that plane .
the bags have noticed those boys who that window who hears the hospital heard .	the bags have noticed who that window who hears the hospital heard those boys .
the shoes should forget this glass that these rings who must know this shoe did n't drop .	the shoes should forget what these rings who must know this shoe did n't drop this glass .
the trucks can see those candles that the cars who can make those girls will lose .	the trucks can see what the cars who can make those girls will lose those candles .
that shoe can n't remember that fork that those trucks who have painted have n't kept .	that shoe can n't remember what those trucks who have painted have n't kept that fork .
this dish had remembered those rings that the library who had n't heard this bag fixed .	this dish had remembered what the library who had n't heard this bag fixed those rings .
those bowls had noticed this turtle that the crayon who would n't lose hears .	those bowls had noticed what the crayon who would n't lose hears this turtle .
the cars wo n't forget the picture that the room who moves the customer wo n't lift .	the cars wo n't forget what the room who moves the customer wo n't lift the picture .
the dishes had n't known those hats that those dishes who were n't moving that patient kept .	the dishes had n't known what those dishes who were n't moving that patient kept those hats .
this mirror will notice the adult who the crayons who must stretch know .	this mirror will notice who the crayons who must stretch know the adult .
this toy has n't remembered this king who those shoes who that plate would hear were n't helping .	this toy has n't remembered who those shoes who that plate would hear were n't helping this king .
those dolls might forget the customer who this car who won should understand .	those dolls might forget who this car who won should understand the customer .
those books had known those boys who the forks who should n't lose know .	those books had known who the forks who should n't lose know those boys .
the shirts have remembered that box that the cup who is reading is losing .	the shirts have remembered what the cup who is reading is losing that box .
that shirt will forget this cup that that rocket who might hear these bottles cleaned .	that shirt will forget what that rocket who might hear these bottles cleaned this cup .
the dolls can remember this hat that that box who has n't moved this man threw .	the dolls can remember what that box who has n't moved this man threw this hat .
that book has known the fork that these toys who these hats had n't heard steal .	that book has known what these toys who these hats had n't heard steal the fork .
those doors can know that car that the bed who this fork knew had n't kept .	those doors can know what the bed who this fork knew had n't kept that car .
the bag has n't seen the girl who the cars who those rooms know had worked with .	the bag has n't seen who the cars who those rooms know had worked with the girl .
those rings might know the dishes that that car who can whisper was holding .	those rings might know what that car who can whisper was holding the dishes .
these hats will see those doors that that door who had n't brought the ladies did n't steal .	these hats will see what that door who had n't brought the ladies did n't steal those doors .
these cars may know that boy who the box who drops the adult is visiting .	these cars may know who the box who drops the adult is visiting that boy .
this boat has n't seen the shirt that this school who these pictures can know makes .	this boat has n't seen what this school who these pictures can know makes the shirt .
these forks had n't remembered this couch that the boats who steal the queen found .	these forks had n't remembered what the boats who steal the queen found this couch .
the bags could forget the bowl that the plates who are n't waving should n't lift .	the bags could forget what the plates who are n't waving should n't lift the bowl .
the doll will remember that rug that these doors who know the forks hold .	the doll will remember what these doors who know the forks hold that rug .
the glass has remembered those boxes that these toys who will whisper bring .	the glass has remembered what these toys who will whisper bring those boxes .
those forks do n't see the teachers who the glass who the room knew could scare .	those forks do n't see who the glass who the room knew could scare the teachers .
this fork would notice those people who the schools who that book knew were n't bothering .	this fork would notice who the schools who that book knew were n't bothering those people .
the spoon should n't notice the book that that mall who these spoons should know had n't cleaned .	the spoon should n't notice what that mall who these spoons should know had n't cleaned the book .
these dishes can notice this patient who the picture who exercises might know .	these dishes can notice who the picture who exercises might know this patient .
those forks had noticed the doors that these beds who hear this ship take .	those forks had noticed what these beds who hear this ship take the doors .
that box has n't seen those ladies who those spoons who heard those plates had lost .	that box has n't seen who those spoons who heard those plates had lost those ladies .
that button has n't noticed the crayon that those dolls who lost have bought .	that button has n't noticed what those dolls who lost have bought the crayon .
this book must know those bowls that this mirror who does n't lie did n't lose .	this book must know what this mirror who does n't lie did n't lose those bowls .
those buttons might remember these ladies who that museum who the hat can know would bother .	those buttons might remember who that museum who the hat can know would bother these ladies .
those cars would n't know these doctors who the ring who that hat knows talks to .	those cars would n't know who the ring who that hat knows talks to these doctors .
that rug has n't seen these men who the schools who are n't taking that person have n't worried .	that rug has n't seen who the schools who are n't taking that person have n't worried these men .
the windows have known this hat that these chairs who wo n't lift the children lost .	the windows have known what these chairs who wo n't lift the children lost this hat .
the dishes can n't see this hat that this ship who was n't bringing the customer takes .	the dishes can n't see what this ship who was n't bringing the customer takes this hat .
these books do n't remember that box that the rings who had n't heard the box were throwing .	these books do n't remember what the rings who had n't heard the box were throwing that box .
these plates had known this fork that that mall who was n't cleaning the lady would n't hold .	these plates had known what that mall who was n't cleaning the lady would n't hold this fork .
these books should n't forget that book that these doors who did n't hear the dish have made .	these books should n't forget what these doors who did n't hear the dish have made that book .
those shirts do n't notice the button that that car who that spoon knows may sell .	those shirts do n't notice what that car who that spoon knows may sell the button .
the fork has n't noticed those books that this shirt who had n't made this boy must buy .	the fork has n't noticed what this shirt who had n't made this boy must buy those books .
the shoe can n't remember these men that this fork who cries hears .	the shoe can n't remember what this fork who cries hears these men .
the toy may see these bottles that the bank who bought these teachers moves .	the toy may see what the bank who bought these teachers moves these bottles .
that box should n't see that person who those bowls who this crayon should n't hear have n't heard .	that box should n't see who those bowls who this crayon should n't hear have n't heard that person .
the boats could n't see the bottle that these shirts who that book knows would n't buy .	the boats could n't see what these shirts who that book knows would n't buy the bottle .
the car does n't forget the hats that that button who those plates may hear brought .	the car does n't forget what that button who those plates may hear brought the hats .
the toy could see the door that those rooms who the bicycle hears are finding .	the toy could see what those rooms who the bicycle hears are finding the door .
these spoons should see this car that these dishes who cried could bring .	these spoons should see what these dishes who cried could bring this car .
the doors have n't remembered those rings that the rug who is fixing that boy could n't keep .	the doors have n't remembered what the rug who is fixing that boy could n't keep those rings .
that book can n't know these plates that these cars who lost those boys have found .	that book can n't know what these cars who lost those boys have found these plates .
that car had n't noticed the forks that these beds who did n't scream were moving .	that car had n't noticed what these beds who did n't scream were moving the forks .
that chair must forget the trucks that this bag who wo n't win kept .	that chair must forget what this bag who wo n't win kept the trucks .
the beds have seen these rings that these forks who must stretch had n't found .	the beds have seen what these forks who must stretch had n't found these rings .
these forks wo n't notice that glass that these cups who did n't throw the children had n't taken .	these forks wo n't notice what these cups who did n't throw the children had n't taken that glass .
this plate had n't noticed those doctors who the candles who threw those teachers can n't talk to .	this plate had n't noticed who the candles who threw those teachers can n't talk to those doctors .
this book has n't noticed that adult who this park who this dish could know had heard .	this book has n't noticed who this park who this dish could know had heard that adult .
that ship wo n't see the adult who these shirts who took that teacher might understand .	that ship wo n't see who these shirts who took that teacher might understand the adult .
the dolls must know that boat that this rug who the shoe can hear wo n't clean .	the dolls must know what this rug who the shoe can hear wo n't clean that boat .
that bed has n't known the ship that the dishes who those windows hear were finding .	that bed has n't known what the dishes who those windows hear were finding the ship .
the plane had n't remembered this car that these hats who would sell those girls stole .	the plane had n't remembered what these hats who would sell those girls stole this car .
these forks should n't notice this car that this library who found that boy is n't finding .	these forks should n't notice what this library who found that boy is n't finding this car .
this shoe would forget the glasses that the park who was shaking those ladies should make .	this shoe would forget what the park who was shaking those ladies should make the glasses .
that glass had n't seen that truck that the library who the schools knew found .	that glass had n't seen what the library who the schools knew found that truck .
that cup had remembered the door that this car who knows those windows moved .	that cup had remembered what this car who knows those windows moved the door .
the rug wo n't notice those books that the couch who those bottles do n't know fixed .	the rug wo n't notice what the couch who those bottles do n't know fixed those books .
that shirt will remember those hats that these glasses who should wave held .	that shirt will remember what these glasses who should wave held those hats .
the beds should remember those girls that the bags who that toy can n't hear knew .	the beds should remember what the bags who that toy can n't hear knew those girls .
those plates can see the fork that this park who may hear these crayons has n't moved .	those plates can see what this park who may hear these crayons has n't moved the fork .
the trucks could see the dentist who that chair who this doll wo n't hear was n't bothering .	the trucks could see who that chair who this doll wo n't hear was n't bothering the dentist .
that plane had noticed the patient who the bed who moves that teacher can answer .	that plane had noticed who the bed who moves that teacher can answer the patient .
that door has remembered those spoons that the toy who heard the pictures is keeping .	that door has remembered what the toy who heard the pictures is keeping those spoons .
the trucks had n't known these girls who these shoes who are n't fixing the doctors could hear .	the trucks had n't known who these shoes who are n't fixing the doctors could hear these girls .
these books have n't known that car that the toy who is crying could hold .	these books have n't known what the toy who is crying could hold that car .
the dolls have n't noticed that fork that the books who this couch knew would n't make .	the dolls have n't noticed what the books who this couch knew would n't make that fork .
this picture may remember those cars that those dishes who scream must move .	this picture may remember what those dishes who scream must move those cars .
this rug had seen those candles that that bowl who the dishes knew moves .	this rug had seen what that bowl who the dishes knew moves those candles .
the door can know these toys that these dolls who yelled would n't find .	the door can know what these dolls who yelled would n't find these toys .
those shoes have known the bag that this bowl who could win must clean .	those shoes have known what this bowl who could win must clean the bag .
this picture may know this man that the toy who knew this bed has n't heard .	this picture may know what the toy who knew this bed has n't heard this man .
those dolls have seen the windows that these dishes who the ship had n't heard should take .	those dolls have seen what these dishes who the ship had n't heard should take the windows .
that chair wo n't see that queen who the mall who waves scared .	that chair wo n't see who the mall who waves scared that queen .
this ring would forget these bowls that that mall who cried had n't found .	this ring would forget what that mall who cried had n't found these bowls .
the bottles had known that shirt that the books who can n't hear those schools have n't brought .	the bottles had known what the books who can n't hear those schools have n't brought that shirt .
the bowls have noticed these teachers who these chairs who talk must know .	the bowls have noticed who these chairs who talk must know these teachers .
this bowl can n't forget the crayons that those trucks who were n't lying should take .	this bowl can n't forget what those trucks who were n't lying should take the crayons .
this toy must see the buttons that the shoes who shake this dancer lift .	this toy must see what the shoes who shake this dancer lift the buttons .
the bag did n't notice the driver who the mirror who has n't thrown this dancer lost .	the bag did n't notice who the mirror who has n't thrown this dancer lost the driver .
the cup should n't see that ring that that rug who was n't fixing that child held .	the cup should n't see what that rug who was n't fixing that child held that ring .
those toys wo n't forget that window that the doll who knew these beds had n't dropped .	those toys wo n't forget what the doll who knew these beds had n't dropped that window .
the cup has seen this spoon that the museum who should n't paint has n't held .	the cup has seen what the museum who should n't paint has n't held this spoon .
these bags should n't notice the bicycle that these dolls who knew that bag did n't make .	these bags should n't notice what these dolls who knew that bag did n't make the bicycle .
these doors had n't seen that bed that these hats who those cars wo n't know moved .	these doors had n't seen what these hats who those cars wo n't know moved that bed .
those bowls have remembered the chairs that the crayon who can whisper should n't throw .	those bowls have remembered what the crayon who can whisper should n't throw the chairs .
the chair might remember the shoe that the crayon who moves this adult can lift .	the chair might remember what the crayon who moves this adult can lift the shoe .
these hats have remembered that rocket that these bags who were n't waving shook .	these hats have remembered what these bags who were n't waving shook that rocket .
the crayons have remembered those rings that those shoes who were n't yelling were n't bringing .	the crayons have remembered what those shoes who were n't yelling were n't bringing those rings .
these candles would forget the glasses that these rings who fix this man find .	these candles would forget what these rings who fix this man find the glasses .
the beds have remembered the glass that the bed who the cups know drops .	the beds have remembered what the bed who the cups know drops the glass .
the spoon has seen this door that these dolls who did n't hold the people might clean .	the spoon has seen what these dolls who did n't hold the people might clean this door .
the cars may remember the picture that those shirts who hold these doctors had n't made .	the cars may remember what those shirts who hold these doctors had n't made the picture .
this shoe has seen that picture that the beds who move that child bring .	this shoe has seen what the beds who move that child bring that picture .
these buttons had n't remembered these girls who these bowls who did n't sneeze teach .	these buttons had n't remembered who these bowls who did n't sneeze teach these girls .
those beds had noticed that car that the bottles who cleaned these men made .	those beds had noticed what the bottles who cleaned these men made that car .
those spoons will see that window that this doll who did n't find this man held .	those spoons will see what this doll who did n't find this man held that window .
those books should forget this boy who the ring who does n't hear that chair knows .	those books should forget who the ring who does n't hear that chair knows this boy .
those glasses wo n't remember these bowls that the books who that car knows could n't have .	those glasses wo n't remember what the books who that car knows could n't have these bowls .
the boat does n't see this boat that the window who kept the men had cleaned .	the boat does n't see what the window who kept the men had cleaned this boat .
these crayons could n't remember the book that the plane who the shirt can n't know cleaned .	these crayons could n't remember what the plane who the shirt can n't know cleaned the book .
that chair should n't notice that fork that that bag who had heard this hospital might take .	that chair should n't notice what that bag who had heard this hospital might take that fork .
that plane may know these beds that that spoon who should wave was n't dropping .	that plane may know what that spoon who should wave was n't dropping these beds .
that rug should forget the plate that the schools who yell threw .	that rug should forget what the schools who yell threw the plate .
that book will see those boys who that hospital who is losing this king had heard .	that book will see who that hospital who is losing this king had heard those boys .
those bowls have n't known the crayons that those bottles who had heard that rug will bring .	those bowls have n't known what those bottles who had heard that rug will bring the crayons .
this chair has seen this shirt that that mirror who would n't smile was n't holding .	this chair has seen what that mirror who would n't smile was n't holding this shirt .
those forks can n't forget that candle that this school who wo n't stretch shakes .	those forks can n't forget what this school who wo n't stretch shakes that candle .
these windows wo n't know the children who that hospital who the book would n't know helped .	these windows wo n't know who that hospital who the book would n't know helped the children .
that rocket has n't noticed this child who those bags who will hear those rings talk to .	that rocket has n't noticed who those bags who will hear those rings talk to this child .
that fork had seen the boys who this candle who was smiling should work with .	that fork had seen who this candle who was smiling should work with the boys .
those toys have known the chair that those books who paint had moved .	those toys have known what those books who paint had moved the chair .
that couch would remember this ring that the toy who this hospital heard is holding .	that couch would remember what the toy who this hospital heard is holding this ring .
that ship did n't notice that truck that those schools who heard that room fixed .	that ship did n't notice what those schools who heard that room fixed that truck .
those bottles have known the rocket that that car who had n't bought this child had n't held .	those bottles have known what that car who had n't bought this child had n't held the rocket .
that box could see those dishes that that box who may hear the book has n't found .	that box could see what that box who may hear the book has n't found those dishes .
the chair could n't notice these women who the rocket who was n't reading heard .	the chair could n't notice who the rocket who was n't reading heard these women .
the car had n't remembered this spoon that the bicycle who those boxes know has n't lost .	the car had n't remembered what the bicycle who those boxes know has n't lost this spoon .
these dolls would n't forget this cup that the book who has n't lost those boys had moved .	these dolls would n't forget what the book who has n't lost those boys had moved this cup .
the toy has seen the women who these rings who are n't shaking these people appreciate .	the toy has seen who these rings who are n't shaking these people appreciate the women .
the shoes have seen the bowls that the car who those cups had heard dropped .	the shoes have seen what the car who those cups had heard dropped the bowls .
those crayons would n't know that dancer who the dolls who moved the children did n't worry .	those crayons would n't know who the dolls who moved the children did n't worry that dancer .
the bottles have n't known the bottle that that door who can n't know the cars holds .	the bottles have n't known what that door who can n't know the cars holds the bottle .
that car will know that bag that the boxes who were n't screaming do n't steal .	that car will know what the boxes who were n't screaming do n't steal that bag .
the dish can notice this guy who this boat who was dropping the men should n't appreciate .	the dish can notice who this boat who was dropping the men should n't appreciate this guy .
the hats have remembered those windows that the windows who this dish knows lift .	the hats have remembered what the windows who this dish knows lift those windows .
these spoons do n't see the guys who those schools who did n't whisper are n't working with .	these spoons do n't see who those schools who did n't whisper are n't working with the guys .
the crayon will see those windows that this door who had this queen bought .	the crayon will see what this door who had this queen bought those windows .
those dolls had known these bowls that that window who was buying those ladies brings .	those dolls had known what that window who was buying those ladies brings these bowls .
the button had remembered those dishes that that bicycle who knew this ship was buying .	the button had remembered what that bicycle who knew this ship was buying those dishes .
the rings had n't noticed the toys that that school who moved the patient was moving .	the rings had n't noticed what that school who moved the patient was moving the toys .
the cars had remembered those doors that the box who would sing will move .	the cars had remembered what the box who would sing will move those doors .
these toys have noticed this book that this shirt who is n't losing did n't lift .	these toys have noticed what this shirt who is n't losing did n't lift this book .
that toy might forget this doctor who the rocket who had read talked to .	that toy might forget who the rocket who had read talked to this doctor .
those forks have n't known the ship that the forks who can n't lift these men do n't have .	those forks have n't known what the forks who can n't lift these men do n't have the ship .
those shirts will forget this dish that those chairs who this picture knows were fixing .	those shirts will forget what those chairs who this picture knows were fixing this dish .
those windows did n't know this crayon that this ring who is n't crying shakes .	those windows did n't know what this ring who is n't crying shakes this crayon .
this plate would forget this cup that this plate who could n't lie has n't lost .	this plate would forget what this plate who could n't lie has n't lost this cup .
the door had n't known this king who those spoons who are painting can n't help .	the door had n't known who those spoons who are painting can n't help this king .
the door will forget the bag that that bed who those glasses have heard lost .	the door will forget what that bed who those glasses have heard lost the bag .
those cars would forget that rocket that the doors who must sing have cleaned .	those cars would forget what the doors who must sing have cleaned that rocket .
the boats have n't noticed the car that those crayons who that museum does n't hear made .	the boats have n't noticed what those crayons who that museum does n't hear made the car .
this doll can n't see these ladies who that door who was cleaning that customer has n't worked with .	this doll can n't see who that door who was cleaning that customer has n't worked with these ladies .
this mirror can n't know these toys that the hats who had the teachers wo n't bring .	this mirror can n't know what the hats who had the teachers wo n't bring these toys .
those cars had seen that car that that car who took the man dropped .	those cars had seen what that car who took the man dropped that car .
that chair had n't seen these rings that the boat who was throwing this teacher was dropping .	that chair had n't seen what the boat who was throwing this teacher was dropping these rings .
these boats do n't know the birds that these glasses who were whispering know .	these boats do n't know what these glasses who were whispering know the birds .
that door would n't forget these cars that the museum who wo n't know the spoon fixed .	that door would n't forget what the museum who wo n't know the spoon fixed these cars .
the bottles have noticed the glass that the truck who is lying has taken .	the bottles have noticed what the truck who is lying has taken the glass .
that rocket had n't known the crayon that this room who the dolls heard had dropped .	that rocket had n't known what this room who the dolls heard had dropped the crayon .
those bottles must remember that fork that those beds who took these guys were n't losing .	those bottles must remember what those beds who took these guys were n't losing that fork .
the crayon might notice that plane that the pictures who know that candle are dropping .	the crayon might notice what the pictures who know that candle are dropping that plane .
those windows had n't seen the ladies who that car who should stretch would hear .	those windows had n't seen who that car who should stretch would hear the ladies .
that bicycle could n't see the king who that park who is whispering heard .	that bicycle could n't see who that park who is whispering heard the king .
the picture can notice those doors that that window who has cried has .	the picture can notice what that window who has cried has those doors .
those buttons must forget that bicycle that that hospital who that mirror knows found .	those buttons must forget what that hospital who that mirror knows found that bicycle .
the door has noticed the adult that these schools who were n't cleaning that king wo n't hear .	the door has noticed what these schools who were n't cleaning that king wo n't hear the adult .
those toys had n't known the box that the room who knows the restaurant found .	those toys had n't known what the room who knows the restaurant found the box .
the dolls would n't see that bag that that library who had n't painted had n't moved .	the dolls would n't see what that library who had n't painted had n't moved that bag .
that candle had known this toy that the bed who could sing takes .	that candle had known what the bed who could sing takes this toy .
the car should forget this guy who the bag who that mirror knew visited .	the car should forget who the bag who that mirror knew visited this guy .
the plates should n't forget the boats that this dish who had n't made that woman is n't losing .	the plates should n't forget what this dish who had n't made that woman is n't losing the boats .
that bottle has n't remembered the candles that these hats who are n't moving this teacher are holding .	that bottle has n't remembered what these hats who are n't moving this teacher are holding the candles .
these pictures have noticed this candle that those pictures who should n't drop this adult hold .	these pictures have noticed what those pictures who should n't drop this adult hold this candle .
these shirts have n't seen this crayon that the truck who those books did n't know was keeping .	these shirts have n't seen what the truck who those books did n't know was keeping this crayon .
the plate has known this bowl that those shoes who those shoes would n't hear threw .	the plate has known what those shoes who those shoes would n't hear threw this bowl .
these boats would n't see these candles that these buttons who clean that driver can n't move .	these boats would n't see what these buttons who clean that driver can n't move these candles .
those buttons have known the dentist who the park who can move those women may know .	those buttons have known who the park who can move those women may know the dentist .
these rings have remembered this box that these boxes who do n't laugh stole .	these rings have remembered what these boxes who do n't laugh stole this box .
these chairs had n't known this bicycle that the boats who this park could know were n't throwing .	these chairs had n't known what the boats who this park could know were n't throwing this bicycle .
that rug can know these boys who that window who has n't taken the boy would n't hear .	that rug can know who that window who has n't taken the boy would n't hear these boys .
that truck has n't noticed that ship that the button who was n't waving might throw .	that truck has n't noticed what the button who was n't waving might throw that ship .
those plates might notice that king that those bowls who should clean this man heard .	those plates might notice what those bowls who should clean this man heard that king .
the windows can know the candle that that room who knew these trucks has .	the windows can know what that room who knew these trucks has the candle .
this fork could n't forget the dancer who these pictures who hear the books were n't working with .	this fork could n't forget who these pictures who hear the books were n't working with the dancer .
the bowls do n't see this mirror that that couch who was laughing has n't found .	the bowls do n't see what that couch who was laughing has n't found this mirror .
that hat could know this adult who that library who fixed those men bothered .	that hat could know who that library who fixed those men bothered this adult .
the door can n't forget this plate that this box who that school hears kept .	the door can n't forget what this box who that school hears kept this plate .
those books had noticed this rocket that those plates who are n't crying had found .	those books had noticed what those plates who are n't crying had found this rocket .
that plane would n't notice that king who the plate who knows those pictures had n't confused .	that plane would n't notice who the plate who knows those pictures had n't confused that king .
these doors will forget that child who those shirts who cried would hear .	these doors will forget who those shirts who cried would hear that child .
this cup may forget the hat that this doll who the dish hears held .	this cup may forget what this doll who the dish hears held the hat .
that picture does n't remember those women who these candles who sang taught .	that picture does n't remember who these candles who sang taught those women .
the shoes had n't known that doctor who the car who can n't lose the man had taught .	the shoes had n't known who the car who can n't lose the man had taught that doctor .
this ship had n't remembered the man who the couch who reads has n't helped .	this ship had n't remembered who the couch who reads has n't helped the man .
these cars can n't forget this rug that that button who might exercise throws .	these cars can n't forget what that button who might exercise throws this rug .
those forks had n't remembered those boys who these hats who must steal these people knew .	those forks had n't remembered who these hats who must steal these people knew those boys .
this rocket had seen the women who the plane who heard those dolls had n't talked to .	this rocket had seen who the plane who heard those dolls had n't talked to the women .
this boat had n't known that man who those schools who lose have heard .	this boat had n't known who those schools who lose have heard that man .
this hat would n't see that glass that those dishes who clean this king drop .	this hat would n't see what those dishes who clean this king drop that glass .
those shirts had n't known these boats that the ship who paints was finding .	those shirts had n't known what the ship who paints was finding these boats .
these boxes would n't see these windows that that book who heard the bags was holding .	these boxes would n't see what that book who heard the bags was holding these windows .
that ship would n't see that car that this bowl who did n't sell this driver is fixing .	that ship would n't see what this bowl who did n't sell this driver is fixing that car .
those dishes have n't seen this patient who those buttons who know this hospital have heard .	those dishes have n't seen who those buttons who know this hospital have heard this patient .
those cars had n't noticed the ship that the car who has n't read fixed .	those cars had n't noticed what the car who has n't read fixed the ship .
that candle must remember this doctor who the buttons who practice can n't visit .	that candle must remember who the buttons who practice can n't visit this doctor .
these trucks may remember the children who this school who has n't fixed those guys heard .	these trucks may remember who this school who has n't fixed those guys heard the children .
that spoon had n't noticed these candles that this bottle who those dolls hear will bring .	that spoon had n't noticed what this bottle who those dolls hear will bring these candles .
that plate did n't forget this book that that door who the hat hears lost .	that plate did n't forget what that door who the hat hears lost this book .
the bottle has known that teacher who that museum who would n't know the doll does n't hear .	the bottle has known who that museum who would n't know the doll does n't hear that teacher .
those beds had remembered that shirt that those boats who sneeze find .	those beds had remembered what those boats who sneeze find that shirt .
these doors can n't notice the shirt that this box who is n't taking that doctor was holding .	these doors can n't notice what this box who is n't taking that doctor was holding the shirt .
this bottle may know that candle that those chairs who those dishes heard might drop .	this bottle may know what those chairs who those dishes heard might drop that candle .
that ship may forget the girl who that hat who those doors have heard would n't praise .	that ship may forget who that hat who those doors have heard would n't praise the girl .
those cups have remembered the books that that ship who had n't lost this person cleaned .	those cups have remembered what that ship who had n't lost this person cleaned the books .
the chair had seen this rocket that that car who had found those boys took .	the chair had seen what that car who had found those boys took this rocket .
this plate will remember those glasses that that rug who the plate did n't know moves .	this plate will remember what that rug who the plate did n't know moves those glasses .
these crayons may see the truck that those cups who are n't practicing are throwing .	these crayons may see what those cups who are n't practicing are throwing the truck .
the box should notice the car that this truck who sang is finding .	the box should notice what this truck who sang is finding the car .
this plate would n't know this plate that those books who were n't shaking this dentist are n't keeping .	this plate would n't know what those books who were n't shaking this dentist are n't keeping this plate .
this fork can n't know those doctors who the mirror who cries must hear .	this fork can n't know who the mirror who cries must hear those doctors .
the rug would know that bag that these toys who talk can drop .	the rug would know what these toys who talk can drop that bag .
this bicycle could n't see this dog that that bicycle who could have that teacher hears .	this bicycle could n't see what that bicycle who could have that teacher hears this dog .
that candle has n't noticed the shoes that these cars who must move this man keep .	that candle has n't noticed what these cars who must move this man keep the shoes .
that chair should remember the horse that these hats who may lie knew .	that chair should remember what these hats who may lie knew the horse .
these bowls do n't remember the window that these trucks who painted wo n't bring .	these bowls do n't remember what these trucks who painted wo n't bring the window .
that plate can n't see that glass that that park who shook this doctor took .	that plate can n't see what that park who shook this doctor took that glass .
the picture should n't see those forks that these books who the cars knew were shaking .	the picture should n't see what these books who the cars knew were shaking those forks .
these dolls will forget that dentist who that boat who should n't stretch helps .	these dolls will forget who that boat who should n't stretch helps that dentist .
this candle had n't known that toy that the bags who have n't heard the dish must throw .	this candle had n't known what the bags who have n't heard the dish must throw that toy .
these rings have n't noticed this dancer who the forks who took that woman visit .	these rings have n't noticed who the forks who took that woman visit this dancer .
this dish must notice those toys that these cups who are n't keeping the boy lift .	this dish must notice what these cups who are n't keeping the boy lift those toys .
the mirror has remembered the guy who the ship who the fork heard might help .	the mirror has remembered who the ship who the fork heard might help the guy .
that doll will remember this doll that those hats who the truck hears shook .	that doll will remember what those hats who the truck hears shook this doll .
this glass had n't seen that plane that that bed who could n't stretch moved .	this glass had n't seen what that bed who could n't stretch moved that plane .
these shoes had n't remembered that man that that ship who was n't lying knew .	these shoes had n't remembered what that ship who was n't lying knew that man .
the dolls could remember these people that the car who those toys can n't hear hears .	the dolls could remember what the car who those toys can n't hear hears these people .
those cups had n't remembered the book that that shoe who had taken that person had cleaned .	those cups had n't remembered what that shoe who had taken that person had cleaned the book .
the bed had remembered those chairs that that ring who drops that dancer is n't making .	the bed had remembered what that ring who drops that dancer is n't making those chairs .
that door can n't notice that mirror that those boxes who might smile moved .	that door can n't notice what those boxes who might smile moved that mirror .
the spoons had n't noticed those people who that school who is finding this queen must teach .	the spoons had n't noticed who that school who is finding this queen must teach those people .
the bowls would forget these girls who the glass who might win would understand .	the bowls would forget who the glass who might win would understand these girls .
that car has noticed the ladies who this room who paints knew .	that car has noticed who this room who paints knew the ladies .
the picture has n't known that car that these cars who these windows knew wo n't throw .	the picture has n't known what these cars who these windows knew wo n't throw that car .
the shoe may remember that boy who the cup who would n't bring the people scared .	the shoe may remember who the cup who would n't bring the people scared that boy .
this bowl may forget the ring that that shoe who could sing wo n't have .	this bowl may forget what that shoe who could sing wo n't have the ring .
that truck should see that king who the cars who heard the bag have n't bothered .	that truck should see who the cars who heard the bag have n't bothered that king .
