this shirt learned that this shirt confused that crayon .	this shirt learned who this shirt confused that crayon .
the mirror learned that these spoons have n't bothered the glass .	the mirror learned who these spoons have n't bothered the glass .
the chairs remembered that the rooms had confused the book .	the chairs remembered who the rooms had confused the book .
those books had n't remembered that the bags praise that rug .	those books had n't remembered who the bags praise that rug .
those toys remembered that those dolls bother those shirts .	those toys remembered who those dolls bother those shirts .
the books may learn that this box would bother those hats .	the books may learn who this box would bother those hats .
the fork does n't learn that those cars had bothered those boxes .	the fork does n't learn who those cars had bothered those boxes .
those boats see that this picture did n't scare these toys .	those boats see who this picture did n't scare these toys .
those glasses learned that this candle confused those windows .	those glasses learned who this candle confused those windows .
those bags notice that the boats have scared that cup .	those bags notice who the boats have scared that cup .
this rug has known that those pictures confused the truck .	this rug has known who those pictures confused the truck .
this spoon noticed that these beds are n't bothering those cups .	this spoon noticed who these beds are n't bothering those cups .
that car realized that the crayons hate that glass .	that car realized who the crayons hate that glass .
that book would n't see that the car can like that crayon .	that book would n't see who the car can like that crayon .
that dish forgot that the truck may scare those dishes .	that dish forgot who the truck may scare those dishes .
these glasses have noticed that this candle likes the rocket .	these glasses have noticed who this candle likes the rocket .
the toys know that those hats will hate these boxes .	the toys know who those hats will hate these boxes .
the button may realize that these dishes might scare this boat .	the button may realize who these dishes might scare this boat .
the dishes realized that these chairs bothered the candles .	the dishes realized who these chairs bothered the candles .
those dolls see that the doll confused the kitchen .	those dolls see who the doll confused the kitchen .
these hats noticed that that plane has liked the dolls .	these hats noticed who that plane has liked the dolls .
the bed saw that these candles should scare that car .	the bed saw who these candles should scare that car .
the shoes must remember that that shoe might bother the couch .	the shoes must remember who that shoe might bother the couch .
the rings knew that that truck liked that toy .	the rings knew who that truck liked that toy .
the buttons had learned that this school might hate these bags .	the buttons had learned who this school might hate these bags .
the glasses should n't know that the box has bothered those shirts .	the glasses should n't know who the box has bothered those shirts .
those bottles notice that that school confused this mall .	those bottles notice who that school confused this mall .
the book had learned that the hats praise those boxes .	the book had learned who the hats praise those boxes .
the buttons did n't realize that those crayons appreciate that bicycle .	the buttons did n't realize who those crayons appreciate that bicycle .
the book would know that this button scares these bottles .	the book would know who this button scares these bottles .
these cars noticed that the cars have confused these dolls .	these cars noticed who the cars have confused these dolls .
those bowls will see that these bags were bothering the car .	those bowls will see who these bags were bothering the car .
this rocket knew that this bed does n't appreciate that rug .	this rocket knew who this bed does n't appreciate that rug .
that bag will remember that the museum would bother this bowl .	that bag will remember who the museum would bother this bowl .
this plate must learn that that shoe does n't praise that mall .	this plate must learn who that shoe does n't praise that mall .
this door can n't learn that the spoon should hate those dolls .	this door can n't learn who the spoon should hate those dolls .
the picture can n't know that the cups have n't bothered the pictures .	the picture can n't know who the cups have n't bothered the pictures .
the glass knew that these boxes have n't liked this window .	the glass knew who these boxes have n't liked this window .
these bottles have known that the plane would n't hate this doll .	these bottles have known who the plane would n't hate this doll .
that hat would notice that the picture liked those boxes .	that hat would notice who the picture liked those boxes .
the rocket learned that those bottles scare the windows .	the rocket learned who those bottles scare the windows .
these shoes can n't notice that the window does n't hate these candles .	these shoes can n't notice who the window does n't hate these candles .
these candles should n't know that these dishes have n't confused this glass .	these candles should n't know who these dishes have n't confused this glass .
the cups have n't remembered that the glasses might appreciate that dish .	the cups have n't remembered who the glasses might appreciate that dish .
the bags remember that those candles were n't bothering that rug .	the bags remember who those candles were n't bothering that rug .
that shoe had n't seen that this book confused this car .	that shoe had n't seen who this book confused this car .
that couch had seen that these buttons confused that book .	that couch had seen who these buttons confused that book .
that rug forgot that these books might appreciate these candles .	that rug forgot who these books might appreciate these candles .
those candles wo n't see that the toy has confused the truck .	those candles wo n't see who the toy has confused the truck .
that ship knew that that shirt must like the couch .	that ship knew who that shirt must like the couch .
this bottle has n't noticed that this museum would appreciate those shirts .	this bottle has n't noticed who this museum would appreciate those shirts .
those glasses saw that the bank would scare that bottle .	those glasses saw who the bank would scare that bottle .
the bags had n't realized that that book confused the box .	the bags had n't realized who that book confused the box .
these chairs had known that this school has liked that fork .	these chairs had known who this school has liked that fork .
these rings have noticed that those trucks bother that book .	these rings have noticed who those trucks bother that book .
these beds have n't learned that the candles should n't scare the ship .	these beds have n't learned who the candles should n't scare the ship .
the pictures should n't see that this fork has n't liked the trucks .	the pictures should n't see who this fork has n't liked the trucks .
this hat saw that the candle scares this cup .	this hat saw who the candle scares this cup .
the beds remember that that button would bother the schools .	the beds remember who that button would bother the schools .
these chairs have realized that the hospital had scared those rings .	these chairs have realized who the hospital had scared those rings .
the rocket sees that these crayons bother those pictures .	the rocket sees who these crayons bother those pictures .
the books may know that that book scared these crayons .	the books may know who that book scared these crayons .
this glass has known that the picture has n't scared the ship .	this glass has known who the picture has n't scared the ship .
the shoe knows that the crayon had scared the shirts .	the shoe knows who the crayon had scared the shirts .
the shirt will forget that that couch had scared those plates .	the shirt will forget who that couch had scared those plates .
that plane saw that the spoon confused that school .	that plane saw who the spoon confused that school .
the glasses notice that the buttons might hate the chairs .	the glasses notice who the buttons might hate the chairs .
those boxes forget that those bottles do n't praise those books .	those boxes forget who those bottles do n't praise those books .
those dishes remember that this glass would like the books .	those dishes remember who this glass would like the books .
those plates forgot that the bicycle wo n't praise this picture .	those plates forgot who the bicycle wo n't praise this picture .
the windows forget that the book liked this button .	the windows forget who the book liked this button .
the shoes would n't realize that the rug can scare those chairs .	the shoes would n't realize who the rug can scare those chairs .
the cars should n't forget that the car must like those dolls .	the cars should n't forget who the car must like those dolls .
that picture has n't learned that those dolls have liked that museum .	that picture has n't learned who those dolls have liked that museum .
those books realize that those cars had bothered this door .	those books realize who those cars had bothered this door .
those bottles had remembered that these schools can n't appreciate those bottles .	those bottles had remembered who these schools can n't appreciate those bottles .
the shirt knows that this dish likes those pictures .	the shirt knows who this dish likes those pictures .
that glass will realize that that hospital can like the rocket .	that glass will realize who that hospital can like the rocket .
those bottles learned that those schools confused the mirror .	those bottles learned who those schools confused the mirror .
those toys noticed that those cups scare this door .	those toys noticed who those cups scare this door .
that rug sees that these doors had n't confused those beds .	that rug sees who these doors had n't confused those beds .
the cup learned that the candles liked the couch .	the cup learned who the candles liked the couch .
the forks had n't seen that this kitchen liked those candles .	the forks had n't seen who this kitchen liked those candles .
the bowl saw that the boats praise these shirts .	the bowl saw who the boats praise these shirts .
these crayons remembered that these spoons have n't scared that plane .	these crayons remembered who these spoons have n't scared that plane .
this car has n't remembered that those schools liked those schools .	this car has n't remembered who those schools liked those schools .
the fork had noticed that this bicycle scared this couch .	the fork had noticed who this bicycle scared this couch .
the windows forget that those glasses scare that fork .	the windows forget who those glasses scare that fork .
those cups see that these toys bother those bowls .	those cups see who these toys bother those bowls .
the plate wo n't forget that the rooms scare these rings .	the plate wo n't forget who the rooms scare these rings .
the bowl forgot that the window had bothered that shoe .	the bowl forgot who the window had bothered that shoe .
this crayon saw that that bottle likes the books .	this crayon saw who that bottle likes the books .
this button has learned that those dishes bother that crayon .	this button has learned who those dishes bother that crayon .
those bags realize that the park confused this plane .	those bags realize who the park confused this plane .
this book remembered that that bicycle bothered the dolls .	this book remembered who that bicycle bothered the dolls .
the dolls see that this boat scares these schools .	the dolls see who this boat scares these schools .
the chairs noticed that the glasses might bother these bowls .	the chairs noticed who the glasses might bother these bowls .
that book might see that that school confused the plate .	that book might see who that school confused the plate .
the chair remembered that these schools are n't bothering the book .	the chair remembered who these schools are n't bothering the book .
these chairs would see that those forks scared that shoe .	these chairs would see who those forks scared that shoe .
the plane saw that the toy wo n't like the bag .	the plane saw who the toy wo n't like the bag .
the crayons must learn that this bag will bother the shoe .	the crayons must learn who this bag will bother the shoe .
those bottles wo n't learn that the bed does n't scare these windows .	those bottles wo n't learn who the bed does n't scare these windows .
those spoons remember that the windows like that fork .	those spoons remember who the windows like that fork .
the door sees that this candle was bothering the shoes .	the door sees who this candle was bothering the shoes .
the plate does n't notice that the bag was bothering the hospital .	the plate does n't notice who the bag was bothering the hospital .
the boats had n't learned that that library liked that school .	the boats had n't learned who that library liked that school .
that glass has realized that the boxes are bothering the shoe .	that glass has realized who the boxes are bothering the shoe .
this bottle noticed that those books hate this spoon .	this bottle noticed who those books hate this spoon .
the bed knows that these hats might scare these schools .	the bed knows who these hats might scare these schools .
this candle had known that the chair was bothering the window .	this candle had known who the chair was bothering the window .
these spoons know that the shoes would n't scare these chairs .	these spoons know who the shoes would n't scare these chairs .
these hats remember that those crayons liked this crayon .	these hats remember who those crayons liked this crayon .
these crayons learned that the cars confused that museum .	these crayons learned who the cars confused that museum .
this plate remembered that these schools had confused those spoons .	this plate remembered who these schools had confused those spoons .
the shirts notice that the dolls confused that school .	the shirts notice who the dolls confused that school .
this door had seen that the library could n't bother those rings .	this door had seen who the library could n't bother those rings .
the plates have seen that this toy can n't praise the schools .	the plates have seen who this toy can n't praise the schools .
the crayon realized that the dolls have n't liked the restaurant .	the crayon realized who the dolls have n't liked the restaurant .
these candles see that the rocket could n't praise that park .	these candles see who the rocket could n't praise that park .
the rocket knew that the bowls had scared these chairs .	the rocket knew who the bowls had scared these chairs .
that glass should see that the school confused that hat .	that glass should see who the school confused that hat .
the book had seen that this shoe had liked those shoes .	the book had seen who this shoe had liked those shoes .
the button would remember that those pictures could n't like these trucks .	the button would remember who those pictures could n't like these trucks .
those shirts remembered that the glasses had bothered the couch .	those shirts remembered who the glasses had bothered the couch .
the windows had n't remembered that those bags may bother that bank .	the windows had n't remembered who those bags may bother that bank .
these trucks remembered that the shoes did n't hate those pictures .	these trucks remembered who the shoes did n't hate those pictures .
these glasses had n't noticed that that ring would hate this book .	these glasses had n't noticed who that ring would hate this book .
these shoes had n't seen that those shirts had liked these hats .	these shoes had n't seen who those shirts had liked these hats .
the hat has realized that the bowls must hate the doors .	the hat has realized who the bowls must hate the doors .
the beds know that this dish likes that truck .	the beds know who this dish likes that truck .
those candles can notice that that school confused those books .	those candles can notice who that school confused those books .
these boats realized that that kitchen is bothering the shirt .	these boats realized who that kitchen is bothering the shirt .
this bag noticed that this car confused the books .	this bag noticed who this car confused the books .
these shirts forget that those cars confused these books .	these shirts forget who those cars confused these books .
the windows realized that this crayon could n't bother that hat .	the windows realized who this crayon could n't bother that hat .
the ship may see that this glass has liked the glasses .	the ship may see who this glass has liked the glasses .
this plate can n't see that those toys had scared the cars .	this plate can n't see who those toys had scared the cars .
this boat learned that the ship should n't appreciate these windows .	this boat learned who the ship should n't appreciate these windows .
those plates remember that this rug has n't liked that school .	those plates remember who this rug has n't liked that school .
the dishes had learned that the car is bothering those chairs .	the dishes had learned who the car is bothering those chairs .
those bowls noticed that the mall liked the bowls .	those bowls noticed who the mall liked the bowls .
these books did n't know that that glass has n't liked this plate .	these books did n't know who that glass has n't liked this plate .
the rug can n't forget that this truck scared those doors .	the rug can n't forget who this truck scared those doors .
these rings have learned that that mall can n't hate the ship .	these rings have learned who that mall can n't hate the ship .
those shoes remembered that the bag can hate this spoon .	those shoes remembered who the bag can hate this spoon .
that car does n't remember that the crayon had n't confused those bowls .	that car does n't remember who the crayon had n't confused those bowls .
these trucks would n't see that these bottles can n't bother the rug .	these trucks would n't see who these bottles can n't bother the rug .
those shirts have n't realized that those buttons had confused the restaurant .	those shirts have n't realized who those buttons had confused the restaurant .
that button knows that the bed liked these candles .	that button knows who the bed liked these candles .
this door has n't noticed that that boat could appreciate this book .	this door has n't noticed who that boat could appreciate this book .
these books did n't realize that these candles do n't praise that plane .	these books did n't realize who these candles do n't praise that plane .
those chairs knew that this kitchen likes those forks .	those chairs knew who this kitchen likes those forks .
the candle had n't noticed that these hats have scared that glass .	the candle had n't noticed who these hats have scared that glass .
these doors have realized that these plates like this bank .	these doors have realized who these plates like this bank .
these windows forgot that the bags could n't scare these glasses .	these windows forgot who the bags could n't scare these glasses .
that bottle learned that the bag scared these trucks .	that bottle learned who the bag scared these trucks .
that bag has learned that these boxes liked this bottle .	that bag has learned who these boxes liked this bottle .
this glass knew that the cups can n't like the hat .	this glass knew who the cups can n't like the hat .
this car did n't see that the boxes appreciate that chair .	this car did n't see who the boxes appreciate that chair .
this dish should notice that those toys scare that hospital .	this dish should notice who those toys scare that hospital .
this window has n't learned that that cup was bothering this park .	this window has n't learned who that cup was bothering this park .
those toys forget that those cars bothered this crayon .	those toys forget who those cars bothered this crayon .
this button must know that those cups praise those hats .	this button must know who those cups praise those hats .
this picture has n't remembered that that spoon had n't liked this boat .	this picture has n't remembered who that spoon had n't liked this boat .
this doll noticed that these pictures had scared the dish .	this doll noticed who these pictures had scared the dish .
the rings have n't remembered that this kitchen confused this hospital .	the rings have n't remembered who this kitchen confused this hospital .
this dish could remember that the school can n't scare the plate .	this dish could remember who the school can n't scare the plate .
the car will learn that this bank would n't like the shirt .	the car will learn who this bank would n't like the shirt .
those bowls know that the pictures scared that school .	those bowls know who the pictures scared that school .
this door realized that that bottle would n't hate that bank .	this door realized who that bottle would n't hate that bank .
this spoon realized that that bank has bothered the spoons .	this spoon realized who that bank has bothered the spoons .
the shirt might forget that the beds could n't praise those forks .	the shirt might forget who the beds could n't praise those forks .
the plate realized that that school is bothering the windows .	the plate realized who that school is bothering the windows .
these books have known that the chairs should n't scare this bicycle .	these books have known who the chairs should n't scare this bicycle .
that shirt had remembered that those books could praise this bowl .	that shirt had remembered who those books could praise this bowl .
the car remembered that those cars are bothering the room .	the car remembered who those cars are bothering the room .
the button should forget that those trucks had n't scared this shoe .	the button should forget who those trucks had n't scared this shoe .
this bag does n't remember that those doors bother this school .	this bag does n't remember who those doors bother this school .
the candles remembered that this restaurant has n't bothered the books .	the candles remembered who this restaurant has n't bothered the books .
this bottle could notice that the spoon confused the beds .	this bottle could notice who the spoon confused the beds .
the shoes forgot that the rooms have confused this toy .	the shoes forgot who the rooms have confused this toy .
the bottles remembered that the bicycle might hate those boxes .	the bottles remembered who the bicycle might hate those boxes .
the plane could realize that that room is bothering the rings .	the plane could realize who that room is bothering the rings .
those rings would n't see that the room will hate those doors .	those rings would n't see who the room will hate those doors .
the books had noticed that the boat will bother this book .	the books had noticed who the boat will bother this book .
these shoes might notice that these boats praise those dolls .	these shoes might notice who these boats praise those dolls .
the books will realize that the park likes the shirts .	the books will realize who the park likes the shirts .
those toys noticed that this shirt confused this dish .	those toys noticed who this shirt confused this dish .
this bottle knows that that rocket is n't bothering the car .	this bottle knows who that rocket is n't bothering the car .
those boats remembered that that bank must bother this door .	those boats remembered who that bank must bother this door .
this shoe had known that those rings appreciate these cars .	this shoe had known who those rings appreciate these cars .
the bottle may see that these schools may hate the books .	the bottle may see who these schools may hate the books .
these plates could remember that those crayons scare these pictures .	these plates could remember who those crayons scare these pictures .
the bowls have noticed that this rocket has n't confused the buttons .	the bowls have noticed who this rocket has n't confused the buttons .
that bowl wo n't forget that those spoons bothered the ship .	that bowl wo n't forget who those spoons bothered the ship .
the forks could n't know that these forks would n't scare this couch .	the forks could n't know who these forks would n't scare this couch .
those dolls saw that this library bothered these pictures .	those dolls saw who this library bothered these pictures .
those boxes had n't known that those bags would scare that library .	those boxes had n't known who those bags would scare that library .
that window knew that that truck had bothered that hospital .	that window knew who that truck had bothered that hospital .
the plates realized that these dishes bothered those cars .	the plates realized who these dishes bothered those cars .
the rings have n't seen that the glasses could praise that school .	the rings have n't seen who the glasses could praise that school .
this fork had n't noticed that those schools had n't scared these schools .	this fork had n't noticed who those schools had n't scared these schools .
this boat can n't learn that this mirror may praise this park .	this boat can n't learn who this mirror may praise this park .
the bags remember that that bank has n't confused the button .	the bags remember who that bank has n't confused the button .
the car would learn that the cars bother that bag .	the car would learn who the cars bother that bag .
this picture must learn that those rooms are n't bothering the ring .	this picture must learn who those rooms are n't bothering the ring .
those shoes would forget that the restaurant scares those books .	those shoes would forget who the restaurant scares those books .
those buttons do n't remember that that mirror confused the hospital .	those buttons do n't remember who that mirror confused the hospital .
the shirt would n't know that those forks had n't confused these boxes .	the shirt would n't know who those forks had n't confused these boxes .
the doors forgot that this hat is n't bothering that candle .	the doors forgot who this hat is n't bothering that candle .
the picture realized that the cars do n't like this book .	the picture realized who the cars do n't like this book .
the crayons saw that this cup wo n't scare that shirt .	the crayons saw who this cup wo n't scare that shirt .
the cars knew that these schools liked those boxes .	the cars knew who these schools liked those boxes .
the boats may see that that candle had n't liked the doll .	the boats may see who that candle had n't liked the doll .
these toys wo n't learn that the ship had liked these doors .	these toys wo n't learn who the ship had liked these doors .
the candles had known that those crayons were bothering this library .	the candles had known who those crayons were bothering this library .
these plates have n't noticed that the truck confused the crayon .	these plates have n't noticed who the truck confused the crayon .
this bed could know that this school scares the shirts .	this bed could know who this school scares the shirts .
these cars had seen that the chairs had n't confused this hat .	these cars had seen who the chairs had n't confused this hat .
these rings have learned that those schools hate the beds .	these rings have learned who those schools hate the beds .
this book noticed that that glass scared that rug .	this book noticed who that glass scared that rug .
the window does n't forget that that museum would like these schools .	the window does n't forget who that museum would like these schools .
this boat forgot that the forks have n't bothered that room .	this boat forgot who the forks have n't bothered that room .
this book must remember that the spoons should like this museum .	this book must remember who the spoons should like this museum .
these bottles would forget that the books liked that button .	these bottles would forget who the books liked that button .
those buttons do n't notice that the fork scares that car .	those buttons do n't notice who the fork scares that car .
those glasses did n't forget that those dishes were bothering that car .	those glasses did n't forget who those dishes were bothering that car .
the bags will remember that these schools had n't bothered the candles .	the bags will remember who these schools had n't bothered the candles .
these candles will notice that these chairs had scared this mirror .	these candles will notice who these chairs had scared this mirror .
those boats did n't learn that that hospital likes the window .	those boats did n't learn who that hospital likes the window .
the candles see that those plates like these cars .	the candles see who those plates like these cars .
the door saw that the box was bothering this couch .	the door saw who the box was bothering this couch .
those forks have n't learned that those cars may appreciate this shirt .	those forks have n't learned who those cars may appreciate this shirt .
these crayons forgot that that kitchen liked the hat .	these crayons forgot who that kitchen liked the hat .
the glasses forget that the couch likes the plate .	the glasses forget who the couch likes the plate .
those hats see that the couch has n't scared the doll .	those hats see who the couch has n't scared the doll .
the doors would n't remember that those cars might appreciate the dish .	the doors would n't remember who those cars might appreciate the dish .
those shirts noticed that that box has n't confused those boxes .	those shirts noticed who that box has n't confused those boxes .
the crayons realized that that bank will praise those trucks .	the crayons realized who that bank will praise those trucks .
this chair has n't seen that the window has n't liked this dish .	this chair has n't seen who the window has n't liked this dish .
these dishes noticed that that candle has confused the bottles .	these dishes noticed who that candle has confused the bottles .
this crayon knows that this hat has n't bothered these books .	this crayon knows who this hat has n't bothered these books .
that toy had known that the candle confused the shirt .	that toy had known who the candle confused the shirt .
the boxes learn that those chairs praise the forks .	the boxes learn who those chairs praise the forks .
those shoes saw that the rings are n't bothering the doll .	those shoes saw who the rings are n't bothering the doll .
those cups forget that the trucks have bothered this museum .	those cups forget who the trucks have bothered this museum .
these books had n't realized that these bags like this ring .	these books had n't realized who these bags like this ring .
these forks saw that this box bothered that restaurant .	these forks saw who this box bothered that restaurant .
that couch must forget that this spoon scares that park .	that couch must forget who this spoon scares that park .
this picture forgot that that ship liked those doors .	this picture forgot who that ship liked those doors .
the couch does n't notice that the boat confused the spoon .	the couch does n't notice who the boat confused the spoon .
that rocket learned that the plate does n't appreciate the bank .	that rocket learned who the plate does n't appreciate the bank .
these crayons remembered that the rocket has n't liked the rug .	these crayons remembered who the rocket has n't liked the rug .
the pictures realized that the shirt had liked the bicycle .	the pictures realized who the shirt had liked the bicycle .
those candles forget that those beds have n't bothered those bags .	those candles forget who those beds have n't bothered those bags .
those plates saw that this toy had liked the plane .	those plates saw who this toy had liked the plane .
this rug can learn that that book must praise the school .	this rug can learn who that book must praise the school .
those dolls noticed that that window could n't like that chair .	those dolls noticed who that window could n't like that chair .
the rug noticed that the glass was bothering these bags .	the rug noticed who the glass was bothering these bags .
the toy noticed that this bank has liked those buttons .	the toy noticed who this bank has liked those buttons .
those cups learned that the shirts praise the glass .	those cups learned who the shirts praise the glass .
the shirt may forget that the picture scares this rocket .	the shirt may forget who the picture scares this rocket .
these plates noticed that that doll does n't like these windows .	these plates noticed who that doll does n't like these windows .
the shoes should n't forget that the trucks must hate the windows .	the shoes should n't forget who the trucks must hate the windows .
these crayons learn that that book scared those windows .	these crayons learn who that book scared those windows .
these bottles may remember that this fork does n't hate this ship .	these bottles may remember who this fork does n't hate this ship .
the doll saw that this book has n't scared the bottles .	the doll saw who this book has n't scared the bottles .
those bottles realize that these bags may appreciate this mirror .	those bottles realize who these bags may appreciate this mirror .
the door has n't remembered that that bag had n't confused the book .	the door has n't remembered who that bag had n't confused the book .
this rug has n't learned that the candles have liked these cars .	this rug has n't learned who the candles have liked these cars .
the button could n't notice that those cars can n't praise those crayons .	the button could n't notice who those cars can n't praise those crayons .
those books saw that the truck scared this car .	those books saw who the truck scared this car .
these bottles had n't known that the room can bother that bottle .	these bottles had n't known who the room can bother that bottle .
the ring has n't learned that that book has scared those forks .	the ring has n't learned who that book has scared those forks .
these candles will remember that this room could n't praise this mirror .	these candles will remember who this room could n't praise this mirror .
this car saw that these dolls bothered these forks .	this car saw who these dolls bothered these forks .
the bottles must notice that the hat would n't appreciate the shirt .	the bottles must notice who the hat would n't appreciate the shirt .
these buttons could n't know that the bottle could like the ring .	these buttons could n't know who the bottle could like the ring .
the box learned that this rug confused the chairs .	the box learned who this rug confused the chairs .
the hat can n't notice that that bag may praise the ship .	the hat can n't notice who that bag may praise the ship .
the chair wo n't see that this truck liked these plates .	the chair wo n't see who this truck liked these plates .
those dishes noticed that those rooms like those plates .	those dishes noticed who those rooms like those plates .
these dishes had remembered that the bank may like those pictures .	these dishes had remembered who the bank may like those pictures .
that mirror remembered that those chairs could n't appreciate the windows .	that mirror remembered who those chairs could n't appreciate the windows .
the rug knew that the restaurant might hate the window .	the rug knew who the restaurant might hate the window .
the glasses knew that those forks confused this window .	the glasses knew who those forks confused this window .
the boat knew that that spoon scares this boat .	the boat knew who that spoon scares this boat .
the ring has n't learned that these beds scare these bottles .	the ring has n't learned who these beds scare these bottles .
the toys notice that that truck has scared the couch .	the toys notice who that truck has scared the couch .
those bowls had realized that that shirt had n't scared that restaurant .	those bowls had realized who that shirt had n't scared that restaurant .
these doors forget that the candles had n't liked that chair .	these doors forget who the candles had n't liked that chair .
that book noticed that this fork does n't bother that ship .	that book noticed who this fork does n't bother that ship .
the dolls saw that the dishes bothered these windows .	the dolls saw who the dishes bothered these windows .
these doors realize that those schools had n't bothered the picture .	these doors realize who those schools had n't bothered the picture .
these glasses must remember that the cars had scared this toy .	these glasses must remember who the cars had scared this toy .
the picture should n't learn that the museum is bothering these schools .	the picture should n't learn who the museum is bothering these schools .
the book has n't known that this door may hate those chairs .	the book has n't known who this door may hate those chairs .
those cars learned that this window will like that mall .	those cars learned who this window will like that mall .
those spoons realized that the boxes do n't praise those schools .	those spoons realized who the boxes do n't praise those schools .
the doors notice that those buttons could n't appreciate those books .	the doors notice who those buttons could n't appreciate those books .
those books have learned that the hat should bother the school .	those books have learned who the hat should bother the school .
these shoes see that those buttons bothered that box .	these shoes see who those buttons bothered that box .
the bags have remembered that this shoe bothered the kitchen .	the bags have remembered who this shoe bothered the kitchen .
those candles had n't noticed that these boats will bother the park .	those candles had n't noticed who these boats will bother the park .
that cup knew that these rooms had n't liked these doors .	that cup knew who these rooms had n't liked these doors .
the bicycle had seen that this box scares those books .	the bicycle had seen who this box scares those books .
the shoe had learned that those pictures have scared that bag .	the shoe had learned who those pictures have scared that bag .
that book has remembered that the museum has bothered that school .	that book has remembered who the museum has bothered that school .
this rocket had learned that these beds had bothered the museum .	this rocket had learned who these beds had bothered the museum .
these shoes may remember that the rooms had bothered this book .	these shoes may remember who the rooms had bothered this book .
the book forgot that those cars had scared those cars .	the book forgot who those cars had scared those cars .
the chair learned that the plane scares these books .	the chair learned who the plane scares these books .
these bottles had n't realized that this mirror liked the doors .	these bottles had n't realized who this mirror liked the doors .
the boats could remember that that kitchen has n't confused this car .	the boats could remember who that kitchen has n't confused this car .
the bags noticed that those crayons bothered those buttons .	the bags noticed who those crayons bothered those buttons .
these cups would n't remember that this candle has n't liked this boat .	these cups would n't remember who this candle has n't liked this boat .
that mirror saw that that car confused this ring .	that mirror saw who that car confused this ring .
these boxes knew that the boxes have bothered this car .	these boxes knew who the boxes have bothered this car .
that box forgot that those candles liked this fork .	that box forgot who those candles liked this fork .
these bowls do n't forget that those schools liked those dishes .	these bowls do n't forget who those schools liked those dishes .
those glasses would n't know that that fork may like these rings .	those glasses would n't know who that fork may like these rings .
the box has n't noticed that that kitchen could n't hate this fork .	the box has n't noticed who that kitchen could n't hate this fork .
the couch saw that this shoe would bother that library .	the couch saw who this shoe would bother that library .
this toy had n't learned that the bank confused the books .	this toy had n't learned who the bank confused the books .
that chair had n't seen that that shoe was n't bothering that library .	that chair had n't seen who that shoe was n't bothering that library .
this mirror remembered that the glasses praise the button .	this mirror remembered who the glasses praise the button .
these cars learn that the shoes confused this room .	these cars learn who the shoes confused this room .
that plane could n't see that that dish likes the shirt .	that plane could n't see who that dish likes the shirt .
those cars have n't noticed that those rings praise these schools .	those cars have n't noticed who those rings praise these schools .
that bag saw that this crayon has n't liked those books .	that bag saw who this crayon has n't liked those books .
the window wo n't forget that that kitchen had n't confused these candles .	the window wo n't forget who that kitchen had n't confused these candles .
that truck knows that the rocket can n't scare the glasses .	that truck knows who the rocket can n't scare the glasses .
that crayon knew that this door would n't praise those chairs .	that crayon knew who this door would n't praise those chairs .
these cups will see that that rug does n't like this car .	these cups will see who that rug does n't like this car .
those rings have learned that the candles confused the spoons .	those rings have learned who the candles confused the spoons .
the dolls could n't remember that the couch was n't bothering the window .	the dolls could n't remember who the couch was n't bothering the window .
these trucks remember that those forks were bothering the plates .	these trucks remember who those forks were bothering the plates .
these books may forget that the dishes would n't bother the book .	these books may forget who the dishes would n't bother the book .
the book remembered that that school scared that window .	the book remembered who that school scared that window .
those candles know that those dishes had scared that plane .	those candles know who those dishes had scared that plane .
these pictures learn that this kitchen was n't bothering the candles .	these pictures learn who this kitchen was n't bothering the candles .
the boxes forgot that these schools bother the bank .	the boxes forgot who these schools bother the bank .
these shirts can see that the boat scares this bicycle .	these shirts can see who the boat scares this bicycle .
this door sees that the mall will hate the plates .	this door sees who the mall will hate the plates .
that bowl has noticed that that mall should hate this car .	that bowl has noticed who that mall should hate this car .
these boats see that these beds confused the cars .	these boats see who these beds confused the cars .
the spoon would remember that the bottle might praise that car .	the spoon would remember who the bottle might praise that car .
this candle noticed that these bowls bother this library .	this candle noticed who these bowls bother this library .
these trucks knew that these bowls confused this bicycle .	these trucks knew who these bowls confused this bicycle .
those glasses forget that this ship is bothering the spoons .	those glasses forget who this ship is bothering the spoons .
the cars see that that box has confused this candle .	the cars see who that box has confused this candle .
the spoon has known that the chairs do n't appreciate that kitchen .	the spoon has known who the chairs do n't appreciate that kitchen .
these dolls know that these pictures must bother the doors .	these dolls know who these pictures must bother the doors .
those books had seen that the room may scare that school .	those books had seen who the room may scare that school .
this shoe sees that this doll had n't scared these hats .	this shoe sees who this doll had n't scared these hats .
those bottles learn that that chair is bothering the book .	those bottles learn who that chair is bothering the book .
this bowl could n't forget that those trucks are bothering the shirt .	this bowl could n't forget who those trucks are bothering the shirt .
those bowls see that the book is bothering these cups .	those bowls see who the book is bothering these cups .
these glasses have n't known that that couch likes the bank .	these glasses have n't known who that couch likes the bank .
those cars can n't notice that this toy scared that crayon .	those cars can n't notice who this toy scared that crayon .
the pictures knew that the toy likes that park .	the pictures knew who the toy likes that park .
these buttons will realize that those bags must scare the windows .	these buttons will realize who those bags must scare the windows .
that shirt had seen that this plane had confused these candles .	that shirt had seen who this plane had confused these candles .
the bottles have learned that the candle likes the boat .	the bottles have learned who the candle likes the boat .
the cups realize that these crayons like these plates .	the cups realize who these crayons like these plates .
those doors learned that the bowls appreciate this bed .	those doors learned who the bowls appreciate this bed .
the bottles noticed that the museum has liked that museum .	the bottles noticed who the museum has liked that museum .
those dishes forgot that these books will scare these toys .	those dishes forgot who these books will scare these toys .
these pictures can notice that those chairs could bother this rocket .	these pictures can notice who those chairs could bother this rocket .
those pictures forgot that those shoes may hate that cup .	those pictures forgot who those shoes may hate that cup .
those doors know that the bag liked those rooms .	those doors know who the bag liked those rooms .
this book will see that this mirror will bother that doll .	this book will see who this mirror will bother that doll .
the plates learn that this shoe must bother that room .	the plates learn who this shoe must bother that room .
the trucks have remembered that these buttons praise these bags .	the trucks have remembered who these buttons praise these bags .
those beds notice that the library has n't confused that couch .	those beds notice who the library has n't confused that couch .
these forks forgot that that restaurant wo n't hate these cars .	these forks forgot who that restaurant wo n't hate these cars .
this bottle had realized that these books liked these books .	this bottle had realized who these books liked these books .
this rocket may remember that this mall scares this school .	this rocket may remember who this mall scares this school .
those books see that this mirror should n't scare this boat .	those books see who this mirror should n't scare this boat .
the spoons saw that those bottles should n't scare those chairs .	the spoons saw who those bottles should n't scare those chairs .
these chairs forget that the park scared the cup .	these chairs forget who the park scared the cup .
that cup wo n't see that the cups bother those chairs .	that cup wo n't see who the cups bother those chairs .
those boxes had remembered that the bicycle is n't bothering the crayon .	those boxes had remembered who the bicycle is n't bothering the crayon .
the doors should n't forget that those cups could n't like this boat .	the doors should n't forget who those cups could n't like this boat .
these toys would n't see that these schools can n't praise these chairs .	these toys would n't see who these schools can n't praise these chairs .
that shoe knows that those rings confused the shirt .	that shoe knows who those rings confused the shirt .
those rings forgot that the toys must hate these shirts .	those rings forgot who the toys must hate these shirts .
that cup has n't learned that this museum would n't bother that crayon .	that cup has n't learned who this museum would n't bother that crayon .
these beds learned that those rings confused those cars .	these beds learned who those rings confused those cars .
the rings knew that this couch bothered the museum .	the rings knew who this couch bothered the museum .
this crayon had noticed that those books must scare those dishes .	this crayon had noticed who those books must scare those dishes .
the bags know that the bowls were bothering the cup .	the bags know who the bowls were bothering the cup .
that rocket can n't remember that those bowls may praise the shoe .	that rocket can n't remember who those bowls may praise the shoe .
those pictures know that the park has bothered the boxes .	those pictures know who the park has bothered the boxes .
this button noticed that those beds were bothering those bowls .	this button noticed who those beds were bothering those bowls .
this plane had n't remembered that the cars praise that restaurant .	this plane had n't remembered who the cars praise that restaurant .
the cars learn that the cars scare that dish .	the cars learn who the cars scare that dish .
this dish forgot that that spoon can bother the schools .	this dish forgot who that spoon can bother the schools .
these bottles must see that that fork did n't like this hospital .	these bottles must see who that fork did n't like this hospital .
these shoes wo n't notice that those schools hate those toys .	these shoes wo n't notice who those schools hate those toys .
these glasses remember that the button may praise those schools .	these glasses remember who the button may praise those schools .
the spoons noticed that those toys liked the restaurant .	the spoons noticed who those toys liked the restaurant .
the bottles had n't known that the kitchen bothered the park .	the bottles had n't known who the kitchen bothered the park .
this car can n't notice that the buttons bother this school .	this car can n't notice who the buttons bother this school .
the cups forgot that the button confused the book .	the cups forgot who the button confused the book .
those cups should notice that this bed liked those shoes .	those cups should notice who this bed liked those shoes .
this bottle could n't learn that those toys hate the windows .	this bottle could n't learn who those toys hate the windows .
these pictures wo n't remember that the shirt scared the pictures .	these pictures wo n't remember who the shirt scared the pictures .
this plate has learned that this restaurant had n't bothered this book .	this plate has learned who this restaurant had n't bothered this book .
the shoe sees that this rocket is n't bothering the school .	the shoe sees who this rocket is n't bothering the school .
these bags must forget that these schools had n't liked these shoes .	these bags must forget who these schools had n't liked these shoes .
the forks have seen that these dolls scare the schools .	the forks have seen who these dolls scare the schools .
those books have n't remembered that the picture scares these schools .	those books have n't remembered who the picture scares these schools .
those pictures realized that the shoes scared those pictures .	those pictures realized who the shoes scared those pictures .
these pictures have known that those bottles praise the mirror .	these pictures have known who those bottles praise the mirror .
this book forgot that this bed should n't scare these beds .	this book forgot who this bed should n't scare these beds .
this mirror can know that those books did n't scare that bag .	this mirror can know who those books did n't scare that bag .
these books knew that that box has scared the chairs .	these books knew who that box has scared the chairs .
that candle knows that the bowls bothered the schools .	that candle knows who the bowls bothered the schools .
the hats know that the cars praise that kitchen .	the hats know who the cars praise that kitchen .
those bowls could n't remember that the shirts are bothering the mirror .	those bowls could n't remember who the shirts are bothering the mirror .
these cars realized that the forks might praise that toy .	these cars realized who the forks might praise that toy .
this crayon might know that those cars do n't bother these beds .	this crayon might know who those cars do n't bother these beds .
the plate has known that that hat must bother the cups .	the plate has known who that hat must bother the cups .
those bowls wo n't know that the chair has liked the pictures .	those bowls wo n't know who the chair has liked the pictures .
the hat knows that the bags would n't scare these buttons .	the hat knows who the bags would n't scare these buttons .
this book had n't noticed that this candle bothered these cars .	this book had n't noticed who this candle bothered these cars .
that cup has noticed that that shirt must scare that hospital .	that cup has noticed who that shirt must scare that hospital .
the dishes realized that those cars scare this bed .	the dishes realized who those cars scare this bed .
that chair could realize that those books appreciate the glass .	that chair could realize who those books appreciate the glass .
the shoe saw that these pictures have n't scared these schools .	the shoe saw who these pictures have n't scared these schools .
those doors remembered that these rings have bothered that rug .	those doors remembered who these rings have bothered that rug .
the books have known that this candle must appreciate that bowl .	the books have known who this candle must appreciate that bowl .
these dolls notice that these books have n't bothered the button .	these dolls notice who these books have n't bothered the button .
the boxes remember that these rings should n't scare this button .	the boxes remember who these rings should n't scare this button .
these beds can realize that these windows hate the school .	these beds can realize who these windows hate the school .
these books have n't noticed that those bowls must appreciate those pictures .	these books have n't noticed who those bowls must appreciate those pictures .
the books may notice that this candle has scared those bottles .	the books may notice who this candle has scared those bottles .
that boat sees that those hats will like this shirt .	that boat sees who those hats will like this shirt .
those spoons forget that the window is bothering this ring .	those spoons forget who the window is bothering this ring .
the glasses saw that this plate bothered these buttons .	the glasses saw who this plate bothered these buttons .
this picture might realize that the candles were bothering the shirts .	this picture might realize who the candles were bothering the shirts .
the buttons realized that these cars bothered the door .	the buttons realized who these cars bothered the door .
these chairs see that the hat had n't bothered those cars .	these chairs see who the hat had n't bothered those cars .
these shirts realized that these books praise that glass .	these shirts realized who these books praise that glass .
these books should notice that that crayon would n't hate this spoon .	these books should notice who that crayon would n't hate this spoon .
those boats forgot that these boats appreciate that kitchen .	those boats forgot who these boats appreciate that kitchen .
these cars have n't realized that the car scared this plate .	these cars have n't realized who the car scared this plate .
this bicycle has n't learned that this dish has scared that rug .	this bicycle has n't learned who this dish has scared that rug .
the bag saw that the bottles hate the pictures .	the bag saw who the bottles hate the pictures .
those dolls can n't remember that those dishes had liked this chair .	those dolls can n't remember who those dishes had liked this chair .
the picture may notice that these chairs may appreciate these schools .	the picture may notice who these chairs may appreciate these schools .
those cups did n't know that that plane scared the mall .	those cups did n't know who that plane scared the mall .
that bag knew that these cars may hate these bags .	that bag knew who these cars may hate these bags .
these books had known that the shirts bothered the door .	these books had known who the shirts bothered the door .
these forks can n't know that this bicycle scared the candles .	these forks can n't know who this bicycle scared the candles .
this glass knew that these bottles confused this restaurant .	this glass knew who these bottles confused this restaurant .
these cups have learned that this hat is n't bothering those rings .	these cups have learned who this hat is n't bothering those rings .
the bed did n't notice that this bag had n't liked the pictures .	the bed did n't notice who this bag had n't liked the pictures .
the candle had realized that the books can praise those dishes .	the candle had realized who the books can praise those dishes .
those forks have realized that these boxes are bothering the bag .	those forks have realized who these boxes are bothering the bag .
that bowl had n't seen that those shoes hate this car .	that bowl had n't seen who those shoes hate this car .
these books see that the truck confused that picture .	these books see who the truck confused that picture .
this ship can remember that this window has liked that glass .	this ship can remember who this window has liked that glass .
this door realized that these bottles are n't bothering the bag .	this door realized who these bottles are n't bothering the bag .
this boat saw that the book wo n't like this window .	this boat saw who the book wo n't like this window .
those glasses should n't forget that the dishes scared that candle .	those glasses should n't forget who the dishes scared that candle .
that door knows that the park liked that box .	that door knows who the park liked that box .
the chair wo n't remember that those shirts had n't liked these bottles .	the chair wo n't remember who those shirts had n't liked these bottles .
those bowls know that these windows praise this truck .	those bowls know who these windows praise this truck .
that box should n't know that this library does n't hate the picture .	that box should n't know who this library does n't hate the picture .
this cup has n't learned that the kitchen should n't appreciate that bed .	this cup has n't learned who the kitchen should n't appreciate that bed .
these glasses had noticed that these bowls liked the cars .	these glasses had noticed who these bowls liked the cars .
these candles had realized that those cups will hate these candles .	these candles had realized who those cups will hate these candles .
the bowl knew that that couch must hate this kitchen .	the bowl knew who that couch must hate this kitchen .
the toys notice that those schools like these bowls .	the toys notice who those schools like these bowls .
those books learned that the cars bothered those beds .	those books learned who the cars bothered those beds .
the chair must learn that the toys scared those buttons .	the chair must learn who the toys scared those buttons .
the dolls realize that this car had bothered the cars .	the dolls realize who this car had bothered the cars .
this bottle forgot that those spoons confused the bowls .	this bottle forgot who those spoons confused the bowls .
these candles know that the park would bother this shirt .	these candles know who the park would bother this shirt .
these chairs should see that that dish has n't bothered these pictures .	these chairs should see who that dish has n't bothered these pictures .
this chair forgot that these candles praise this ship .	this chair forgot who these candles praise this ship .
this plate knew that that button bothered the door .	this plate knew who that button bothered the door .
these crayons can n't notice that this cup should praise the school .	these crayons can n't notice who this cup should praise the school .
the couch should remember that those windows bothered the ring .	the couch should remember who those windows bothered the ring .
that car learned that the schools like the button .	that car learned who the schools like the button .
these forks have realized that this bed had n't scared that restaurant .	these forks have realized who this bed had n't scared that restaurant .
the crayon knew that the books appreciate that picture .	the crayon knew who the books appreciate that picture .
this boat had n't learned that the button wo n't scare the hats .	this boat had n't learned who the button wo n't scare the hats .
the books will notice that this hat has n't confused the schools .	the books will notice who this hat has n't confused the schools .
this bed sees that that car should appreciate the button .	this bed sees who that car should appreciate the button .
these forks forgot that this chair would like the hospital .	these forks forgot who this chair would like the hospital .
this plane realized that this car might hate this fork .	this plane realized who this car might hate this fork .
that plate wo n't see that these books will bother that candle .	that plate wo n't see who these books will bother that candle .
the couch should notice that this hat likes the bank .	the couch should notice who this hat likes the bank .
those dishes may see that that picture confused the schools .	those dishes may see who that picture confused the schools .
these dishes saw that these pictures scared that couch .	these dishes saw who these pictures scared that couch .
that toy could n't learn that the mirror has n't scared that button .	that toy could n't learn who the mirror has n't scared that button .
those bags remember that the glass could praise that door .	those bags remember who the glass could praise that door .
these boats had n't known that these rooms appreciate that rug .	these boats had n't known who these rooms appreciate that rug .
these rings forgot that the books bother this school .	these rings forgot who the books bother this school .
that rocket forgot that the cup could scare the car .	that rocket forgot who the cup could scare the car .
the chair learned that those dolls scared those spoons .	the chair learned who those dolls scared those spoons .
these dishes noticed that this room bothered the glasses .	these dishes noticed who this room bothered the glasses .
those cars should n't realize that that hospital likes that box .	those cars should n't realize who that hospital likes that box .
this bag had realized that this door scared that plane .	this bag had realized who this door scared that plane .
the dishes had known that those dolls should scare these books .	the dishes had known who those dolls should scare these books .
the rocket sees that these chairs scare the mirror .	the rocket sees who these chairs scare the mirror .
the chairs have n't realized that the doll likes the hats .	the chairs have n't realized who the doll likes the hats .
this mirror had n't realized that those crayons bother those bottles .	this mirror had n't realized who those crayons bother those bottles .
these hats have n't seen that the hat had scared those shoes .	these hats have n't seen who the hat had scared those shoes .
the dish has remembered that that rug could bother the bank .	the dish has remembered who that rug could bother the bank .
this picture learned that this rug scared these boats .	this picture learned who this rug scared these boats .
those crayons will forget that this candle had n't bothered these glasses .	those crayons will forget who this candle had n't bothered these glasses .
this bowl has n't known that this door had n't scared those boxes .	this bowl has n't known who this door had n't scared those boxes .
the button has realized that those windows would scare this school .	the button has realized who those windows would scare this school .
the shoes noticed that that bowl liked these boats .	the shoes noticed who that bowl liked these boats .
those shoes notice that the fork had n't liked the bags .	those shoes notice who the fork had n't liked the bags .
the dishes should n't learn that those buttons confused that toy .	the dishes should n't learn who those buttons confused that toy .
the bags had realized that that school has scared these dishes .	the bags had realized who that school has scared these dishes .
these bottles learn that the chair scares the museum .	these bottles learn who the chair scares the museum .
the couch can learn that these plates scare that school .	the couch can learn who these plates scare that school .
these bottles knew that these shoes praise the rings .	these bottles knew who these shoes praise the rings .
the plane has known that the chair can n't scare the fork .	the plane has known who the chair can n't scare the fork .
the cars must know that these toys should n't praise the buttons .	the cars must know who these toys should n't praise the buttons .
that bag may learn that the car likes this button .	that bag may learn who the car likes this button .
the boats have known that these bags have confused that bed .	the boats have known who these bags have confused that bed .
that toy had seen that this dish liked the dolls .	that toy had seen who this dish liked the dolls .
the candles see that the forks confused the boat .	the candles see who the forks confused the boat .
the cup remembered that the car confused the toys .	the cup remembered who the car confused the toys .
the hats would n't know that this window may praise this plane .	the hats would n't know who this window may praise this plane .
the bottles remembered that these boxes could n't bother the toy .	the bottles remembered who these boxes could n't bother the toy .
those dishes have n't seen that the spoon scares that toy .	those dishes have n't seen who the spoon scares that toy .
that book had n't seen that the ring had n't bothered that candle .	that book had n't seen who the ring had n't bothered that candle .
those cups have n't realized that these windows liked these pictures .	those cups have n't realized who these windows liked these pictures .
these cars learned that these schools praise those shoes .	these cars learned who these schools praise those shoes .
the crayon knows that this mall may appreciate those books .	the crayon knows who this mall may appreciate those books .
the beds have n't known that the boats have n't confused the windows .	the beds have n't known who the boats have n't confused the windows .
that couch has n't known that that bag could n't praise the doll .	that couch has n't known who that bag could n't praise the doll .
those dolls learn that these crayons like the buttons .	those dolls learn who these crayons like the buttons .
this plane would n't learn that this museum confused this candle .	this plane would n't learn who this museum confused this candle .
that plate realized that that bicycle bothered these dolls .	that plate realized who that bicycle bothered these dolls .
this shirt did n't see that that book would scare these candles .	this shirt did n't see who that book would scare these candles .
those plates knew that the glasses like the windows .	those plates knew who the glasses like the windows .
this book knew that the park has n't scared that cup .	this book knew who the park has n't scared that cup .
the picture has remembered that those forks had n't scared that rocket .	the picture has remembered who those forks had n't scared that rocket .
those books see that those forks praise this school .	those books see who those forks praise this school .
the bottle learned that this couch confused that school .	the bottle learned who this couch confused that school .
that plane could see that the fork had n't bothered this park .	that plane could see who the fork had n't bothered this park .
the bed might forget that the buttons hate those cups .	the bed might forget who the buttons hate those cups .
those shirts have noticed that that fork likes the candle .	those shirts have noticed who that fork likes the candle .
these beds realize that those bags scared that mirror .	these beds realize who those bags scared that mirror .
those shirts knew that these schools bothered those cars .	those shirts knew who these schools bothered those cars .
the crayons learned that the toys scared the rocket .	the crayons learned who the toys scared the rocket .
the cup might remember that the dish has scared those bowls .	the cup might remember who the dish has scared those bowls .
those pictures notice that the mall liked the restaurant .	those pictures notice who the mall liked the restaurant .
this window noticed that those schools hate that museum .	this window noticed who those schools hate that museum .
those plates must see that that kitchen bothered the window .	those plates must see who that kitchen bothered the window .
the toys had realized that these plates like the doors .	the toys had realized who these plates like the doors .
these trucks should remember that those boats appreciate the candle .	these trucks should remember who those boats appreciate the candle .
the car realized that this plane could appreciate this couch .	the car realized who this plane could appreciate this couch .
these glasses noticed that this toy confused the candles .	these glasses noticed who this toy confused the candles .
this cup knew that this plate has scared that rug .	this cup knew who this plate has scared that rug .
those buttons forget that that car should appreciate these shirts .	those buttons forget who that car should appreciate these shirts .
the rings had n't remembered that this library wo n't appreciate this fork .	the rings had n't remembered who this library wo n't appreciate this fork .
these crayons forget that that boat can scare the kitchen .	these crayons forget who that boat can scare the kitchen .
those dishes would know that that couch must hate these books .	those dishes would know who that couch must hate these books .
this doll should remember that the fork is n't bothering those rings .	this doll should remember who the fork is n't bothering those rings .
those bowls remember that those schools must hate the buttons .	those bowls remember who those schools must hate the buttons .
these crayons forget that those cars like the school .	these crayons forget who those cars like the school .
that book forgot that the trucks do n't appreciate that bottle .	that book forgot who the trucks do n't appreciate that bottle .
these books knew that this doll confused those crayons .	these books knew who this doll confused those crayons .
these hats learned that this restaurant scared this bowl .	these hats learned who this restaurant scared this bowl .
this window would n't notice that the spoons bothered the buttons .	this window would n't notice who the spoons bothered the buttons .
the forks had n't remembered that these forks like this school .	the forks had n't remembered who these forks like this school .
the bottles forget that the bowl has scared this school .	the bottles forget who the bowl has scared this school .
that cup knows that that bed would n't praise that rug .	that cup knows who that bed would n't praise that rug .
this cup learned that those rooms had n't scared those hats .	this cup learned who those rooms had n't scared those hats .
that car learned that the pictures bothered that rug .	that car learned who the pictures bothered that rug .
those cups had known that that doll is bothering that bottle .	those cups had known who that doll is bothering that bottle .
these cars would see that the shoes were bothering this park .	these cars would see who the shoes were bothering this park .
these beds know that those shoes like this plane .	these beds know who those shoes like this plane .
that toy sees that these books might scare this rocket .	that toy sees who these books might scare this rocket .
the ring should forget that the dolls bother that dish .	the ring should forget who the dolls bother that dish .
these shirts notice that the library scared those cups .	these shirts notice who the library scared those cups .
that bicycle has known that that kitchen confused these boats .	that bicycle has known who that kitchen confused these boats .
the hats can remember that the bank would scare that shoe .	the hats can remember who the bank would scare that shoe .
that bag had remembered that that hat did n't scare these bottles .	that bag had remembered who that hat did n't scare these bottles .
those cars have realized that these crayons confused that school .	those cars have realized who these crayons confused that school .
those trucks realize that these hats bother these boats .	those trucks realize who these hats bother these boats .
these shirts know that these shoes have n't bothered the cars .	these shirts know who these shoes have n't bothered the cars .
these bags learned that the bag liked that spoon .	these bags learned who the bag liked that spoon .
these dishes would n't forget that those glasses bother the library .	these dishes would n't forget who those glasses bother the library .
the cars noticed that the candles confused that park .	the cars noticed who the candles confused that park .
the bowl has n't learned that the glass liked the crayons .	the bowl has n't learned who the glass liked the crayons .
that ship had learned that the restaurant has confused that bank .	that ship had learned who the restaurant has confused that bank .
these bags remember that those cups do n't scare that rug .	these bags remember who those cups do n't scare that rug .
those rings remembered that the restaurant should like those schools .	those rings remembered who the restaurant should like those schools .
the window might realize that that restaurant will bother this car .	the window might realize who that restaurant will bother this car .
the cars learned that that doll scared that ship .	the cars learned who that doll scared that ship .
the dolls would see that those schools may bother the car .	the dolls would see who those schools may bother the car .
the shoes had n't realized that that dish had n't bothered these hats .	the shoes had n't realized who that dish had n't bothered these hats .
these books should n't learn that that bicycle has liked that cup .	these books should n't learn who that bicycle has liked that cup .
the boxes see that those dishes bother this couch .	the boxes see who those dishes bother this couch .
the trucks forget that the dishes might scare this library .	the trucks forget who the dishes might scare this library .
these bags have remembered that this school may hate these dolls .	these bags have remembered who this school may hate these dolls .
that box has learned that the hat may scare the glasses .	that box has learned who the hat may scare the glasses .
the rug learned that this truck confused that car .	the rug learned who this truck confused that car .
this ring would n't forget that the plates should n't praise this ring .	this ring would n't forget who the plates should n't praise this ring .
these candles must remember that the spoons could hate this ring .	these candles must remember who the spoons could hate this ring .
that ring forgot that this bag will scare those toys .	that ring forgot who this bag will scare those toys .
that ship realized that the shirt does n't hate those trucks .	that ship realized who the shirt does n't hate those trucks .
those pictures saw that the library had liked the bottles .	those pictures saw who the library had liked the bottles .
the bottles will notice that those boats scared the bowl .	the bottles will notice who those boats scared the bowl .
these books do n't notice that this restaurant had n't bothered those pictures .	these books do n't notice who this restaurant had n't bothered those pictures .
this door should n't learn that this book could n't hate these boats .	this door should n't learn who this book could n't hate these boats .
the shoe may realize that this spoon had n't liked that shirt .	the shoe may realize who this spoon had n't liked that shirt .
this fork knew that the pictures scare the cup .	this fork knew who the pictures scare the cup .
the plane forgot that these bottles wo n't like that plane .	the plane forgot who these bottles wo n't like that plane .
the chair sees that those plates liked that library .	the chair sees who those plates liked that library .
those cars realize that these glasses scare that window .	those cars realize who these glasses scare that window .
the trucks had learned that this bag had scared that glass .	the trucks had learned who this bag had scared that glass .
the cups see that the library did n't bother that book .	the cups see who the library did n't bother that book .
this dish realized that the cars bothered the boat .	this dish realized who the cars bothered the boat .
these rings should know that that fork did n't scare the ship .	these rings should know who that fork did n't scare the ship .
these shoes forgot that that bag had liked this couch .	these shoes forgot who that bag had liked this couch .
the shoes learned that those hats could n't appreciate these dolls .	the shoes learned who those hats could n't appreciate these dolls .
these crayons can n't realize that the rug likes this mirror .	these crayons can n't realize who the rug likes this mirror .
those pictures may learn that these hats did n't scare this bed .	those pictures may learn who these hats did n't scare this bed .
the bowl forgot that the dishes bothered these cars .	the bowl forgot who the dishes bothered these cars .
the book learned that that car scares those hats .	the book learned who that car scares those hats .
that shirt wo n't see that those pictures had n't confused the shirts .	that shirt wo n't see who those pictures had n't confused the shirts .
those windows realized that the rooms have scared that chair .	those windows realized who the rooms have scared that chair .
the bowl should n't see that this dish can n't like this toy .	the bowl should n't see who this dish can n't like this toy .
those bottles may know that the doors had bothered this museum .	those bottles may know who the doors had bothered this museum .
the plates learn that this school has n't confused the car .	the plates learn who this school has n't confused the car .
the books wo n't see that those crayons confused the cup .	the books wo n't see who those crayons confused the cup .
the cars realize that the forks appreciate that shoe .	the cars realize who the forks appreciate that shoe .
the toy realized that that candle will scare that bicycle .	the toy realized who that candle will scare that bicycle .
those bowls must realize that those crayons are bothering the plate .	those bowls must realize who those crayons are bothering the plate .
those bottles should n't see that the bottles have n't bothered this cup .	those bottles should n't see who the bottles have n't bothered this cup .
that glass knew that the button has bothered these spoons .	that glass knew who the button has bothered these spoons .
the books should n't realize that these boats could n't like these spoons .	the books should n't realize who these boats could n't like these spoons .
that candle might know that this bottle should n't praise the door .	that candle might know who this bottle should n't praise the door .
that book could learn that those boxes had n't bothered those chairs .	that book could learn who those boxes had n't bothered those chairs .
that couch does n't realize that the schools confused those cars .	that couch does n't realize who the schools confused those cars .
those bottles remember that the kitchen was bothering the fork .	those bottles remember who the kitchen was bothering the fork .
these pictures would n't realize that those books scared this car .	these pictures would n't realize who those books scared this car .
the ring remembered that the plates confused this school .	the ring remembered who the plates confused this school .
these hats knew that that rocket will scare that crayon .	these hats knew who that rocket will scare that crayon .
the bowls forgot that the cars appreciate this kitchen .	the bowls forgot who the cars appreciate this kitchen .
that hat forgot that this mall did n't scare the dishes .	that hat forgot who this mall did n't scare the dishes .
those glasses forget that the museum had confused the box .	those glasses forget who the museum had confused the box .
these glasses noticed that the fork may scare the box .	these glasses noticed who the fork may scare the box .
those beds can know that those trucks must appreciate the shoes .	those beds can know who those trucks must appreciate the shoes .
these plates forgot that the dishes liked that bottle .	these plates forgot who the dishes liked that bottle .
these doors would n't know that this car will praise those shirts .	these doors would n't know who this car will praise those shirts .
the books know that that rug would hate the button .	the books know who that rug would hate the button .
this bottle sees that these shirts are n't bothering that shoe .	this bottle sees who these shirts are n't bothering that shoe .
these bottles learned that the boats would n't scare this bowl .	these bottles learned who the boats would n't scare this bowl .
these glasses should learn that the toy scared these hats .	these glasses should learn who the toy scared these hats .
these chairs remember that those buttons like those shoes .	these chairs remember who those buttons like those shoes .
those hats can realize that these rooms scared those hats .	those hats can realize who these rooms scared those hats .
the door had seen that the candle might scare the window .	the door had seen who the candle might scare the window .
the car had noticed that the windows scare the box .	the car had noticed who the windows scare the box .
this mirror realized that the rooms liked that museum .	this mirror realized who the rooms liked that museum .
that book noticed that this button was n't bothering the cars .	that book noticed who this button was n't bothering the cars .
the car noticed that those cars scare that bicycle .	the car noticed who those cars scare that bicycle .
these cars noticed that that window liked the fork .	these cars noticed who that window liked the fork .
that plane remembered that this ship is n't bothering the box .	that plane remembered who this ship is n't bothering the box .
these hats realized that these bowls liked that picture .	these hats realized who these bowls liked that picture .
those rings had n't realized that this box is n't bothering the car .	those rings had n't realized who this box is n't bothering the car .
the glass sees that this truck could appreciate the book .	the glass sees who this truck could appreciate the book .
those doors had n't known that that boat has n't scared these bowls .	those doors had n't known who that boat has n't scared these bowls .
these buttons saw that this couch has n't scared this kitchen .	these buttons saw who this couch has n't scared this kitchen .
these bottles forgot that that room was bothering those rings .	these bottles forgot who that room was bothering those rings .
the cars should notice that these books scared the bottle .	the cars should notice who these books scared the bottle .
the door could n't realize that that spoon has liked the couch .	the door could n't realize who that spoon has liked the couch .
that crayon learned that the schools confused that doll .	that crayon learned who the schools confused that doll .
those chairs forget that the bottle scared those cars .	those chairs forget who the bottle scared those cars .
the window will notice that those dolls appreciate this dish .	the window will notice who those dolls appreciate this dish .
those plates would n't know that these toys had n't bothered this plate .	those plates would n't know who these toys had n't bothered this plate .
the chairs had known that those rings liked the box .	the chairs had known who those rings liked the box .
that plane must learn that that plate was bothering those rings .	that plane must learn who that plate was bothering those rings .
the boat knows that the museum had n't scared that bottle .	the boat knows who the museum had n't scared that bottle .
the mirror knew that these shirts have n't bothered those dolls .	the mirror knew who these shirts have n't bothered those dolls .
that plate sees that those dishes were bothering this ring .	that plate sees who those dishes were bothering this ring .
those shirts have n't noticed that the candle liked this bank .	those shirts have n't noticed who the candle liked this bank .
this shoe has n't learned that these bags do n't bother the shoe .	this shoe has n't learned who these bags do n't bother the shoe .
this candle can realize that these bottles are n't bothering this plate .	this candle can realize who these bottles are n't bothering this plate .
that doll noticed that these cars could appreciate this kitchen .	that doll noticed who these cars could appreciate this kitchen .
those bowls have noticed that the candles might scare these dolls .	those bowls have noticed who the candles might scare these dolls .
this couch realized that the school confused those shirts .	this couch realized who the school confused those shirts .
the books should n't know that the school had n't liked those dishes .	the books should n't know who the school had n't liked those dishes .
these windows would see that that mirror scares this restaurant .	these windows would see who that mirror scares this restaurant .
the book can learn that those books scare that rug .	the book can learn who those books scare that rug .
the bag might realize that that hospital had liked the cars .	the bag might realize who that hospital had liked the cars .
that boat wo n't see that that rocket had n't confused those buttons .	that boat wo n't see who that rocket had n't confused those buttons .
the books had n't known that the car had liked that ring .	the books had n't known who the car had liked that ring .
those dishes do n't see that that mirror can like that plane .	those dishes do n't see who that mirror can like that plane .
the plate has n't seen that this dish would bother the cups .	the plate has n't seen who this dish would bother the cups .
the plate noticed that those cups will bother this hospital .	the plate noticed who those cups will bother this hospital .
the glasses do n't see that the spoon was bothering that doll .	the glasses do n't see who the spoon was bothering that doll .
that bed must forget that that room liked the bowl .	that bed must forget who that room liked the bowl .
those bottles had noticed that the bag should n't appreciate that mall .	those bottles had noticed who the bag should n't appreciate that mall .
the window has n't realized that these schools should hate this book .	the window has n't realized who these schools should hate this book .
these books have n't realized that the spoons bother those schools .	these books have n't realized who the spoons bother those schools .
these plates see that the bags have n't bothered those bags .	these plates see who the bags have n't bothered those bags .
this toy has n't seen that this truck scares the forks .	this toy has n't seen who this truck scares the forks .
those crayons have n't realized that that school did n't praise those bags .	those crayons have n't realized who that school did n't praise those bags .
this candle forgot that this rocket would scare these books .	this candle forgot who this rocket would scare these books .
that book had realized that those beds could appreciate the crayons .	that book had realized who those beds could appreciate the crayons .
those doors might realize that this plane must like the chairs .	those doors might realize who this plane must like the chairs .
the plate sees that these dishes confused these doors .	the plate sees who these dishes confused these doors .
the fork has learned that that kitchen has confused this box .	the fork has learned who that kitchen has confused this box .
those cars had n't seen that the books liked the toys .	those cars had n't seen who the books liked the toys .
the car remembered that those dolls are bothering the dish .	the car remembered who those dolls are bothering the dish .
those dishes see that those bags liked the trucks .	those dishes see who those bags liked the trucks .
these books have learned that that couch could appreciate the car .	these books have learned who that couch could appreciate the car .
this car has realized that this chair can like these bags .	this car has realized who this chair can like these bags .
this picture has learned that those windows had bothered the park .	this picture has learned who those windows had bothered the park .
these trucks saw that those schools scared these boats .	these trucks saw who those schools scared these boats .
those crayons remembered that these schools have scared this room .	those crayons remembered who these schools have scared this room .
these windows notice that the boxes must praise the plate .	these windows notice who the boxes must praise the plate .
those toys could n't forget that these shoes would n't bother this rug .	those toys could n't forget who these shoes would n't bother this rug .
the cups saw that that couch could hate those rooms .	the cups saw who that couch could hate those rooms .
these books remember that these beds like these dolls .	these books remember who these beds like these dolls .
that dish will know that the bowl confused these windows .	that dish will know who the bowl confused these windows .
that picture had n't known that the chairs scare the windows .	that picture had n't known who the chairs scare the windows .
that rug would n't see that those bowls have scared those doors .	that rug would n't see who those bowls have scared those doors .
that bowl has n't noticed that the toys like this window .	that bowl has n't noticed who the toys like this window .
the hat had remembered that those dishes could n't like those dolls .	the hat had remembered who those dishes could n't like those dolls .
the truck realized that this park can n't praise this car .	the truck realized who this park can n't praise this car .
those shoes had noticed that this toy should n't hate those spoons .	those shoes had noticed who this toy should n't hate those spoons .
those shirts must know that the windows were bothering the plate .	those shirts must know who the windows were bothering the plate .
the window learned that those spoons had bothered this picture .	the window learned who those spoons had bothered this picture .
those buttons learned that those toys had n't scared these bottles .	those buttons learned who those toys had n't scared these bottles .
the bottle knows that the boats praise this crayon .	the bottle knows who the boats praise this crayon .
the book does n't forget that that plate has n't liked those buttons .	the book does n't forget who that plate has n't liked those buttons .
these bowls learned that those dishes appreciate the truck .	these bowls learned who those dishes appreciate the truck .
these spoons know that those cars can praise the bicycle .	these spoons know who those cars can praise the bicycle .
the fork saw that those schools had bothered these schools .	the fork saw who those schools had bothered these schools .
the plate noticed that that rocket can hate that hat .	the plate noticed who that rocket can hate that hat .
that window realized that these toys had n't liked the shoe .	that window realized who these toys had n't liked the shoe .
that glass had seen that that ring likes those candles .	that glass had seen who that ring likes those candles .
the dolls learned that these chairs scare those cups .	the dolls learned who these chairs scare those cups .
that car can n't forget that the books had n't confused this restaurant .	that car can n't forget who the books had n't confused this restaurant .
this car has realized that this ring might like the button .	this car has realized who this ring might like the button .
the picture has realized that the box was n't bothering this kitchen .	the picture has realized who the box was n't bothering this kitchen .
these dishes had n't known that those pictures have liked these forks .	these dishes had n't known who those pictures have liked these forks .
that dish can n't forget that this plate has confused these trucks .	that dish can n't forget who this plate has confused these trucks .
that bottle might notice that this door scared the cars .	that bottle might notice who this door scared the cars .
those cars will learn that those doors bother that door .	those cars will learn who those doors bother that door .
this candle has remembered that those crayons bother the pictures .	this candle has remembered who those crayons bother the pictures .
the dishes might remember that that park is bothering this spoon .	the dishes might remember who that park is bothering this spoon .
the car should n't forget that those dolls are bothering the mirror .	the car should n't forget who those dolls are bothering the mirror .
the cup could n't see that this museum should n't hate this rug .	the cup could n't see who this museum should n't hate this rug .
the button has n't learned that this window has n't bothered that candle .	the button has n't learned who this window has n't bothered that candle .
the books see that those rings should n't like this bowl .	the books see who those rings should n't like this bowl .
those toys do n't learn that these beds do n't appreciate that rug .	those toys do n't learn who these beds do n't appreciate that rug .
these spoons can n't realize that the candle scared these buttons .	these spoons can n't realize who the candle scared these buttons .
the truck does n't notice that those schools liked the bowl .	the truck does n't notice who those schools liked the bowl .
that chair realized that that restaurant had liked those bags .	that chair realized who that restaurant had liked those bags .
those trucks may know that that couch had bothered that museum .	those trucks may know who that couch had bothered that museum .
those crayons forget that the schools were n't bothering the boat .	those crayons forget who the schools were n't bothering the boat .
these glasses saw that the schools hate those schools .	these glasses saw who the schools hate those schools .
that rug has seen that those hats would bother these pictures .	that rug has seen who those hats would bother these pictures .
those shoes remember that that book likes these cups .	those shoes remember who that book likes these cups .
these cups notice that the glass confused those doors .	these cups notice who the glass confused those doors .
this cup would n't know that the mirror could n't scare these books .	this cup would n't know who the mirror could n't scare these books .
the shoes could learn that this picture might praise that toy .	the shoes could learn who this picture might praise that toy .
those forks forget that those books hate the rocket .	those forks forget who those books hate the rocket .
the plate can learn that that box had n't bothered those glasses .	the plate can learn who that box had n't bothered those glasses .
the crayons have n't realized that these cups like these trucks .	the crayons have n't realized who these cups like these trucks .
that book may notice that the window should appreciate those bottles .	that book may notice who the window should appreciate those bottles .
this book had n't seen that the cup can n't praise those schools .	this book had n't seen who the cup can n't praise those schools .
the car noticed that those bags have bothered that ring .	the car noticed who those bags have bothered that ring .
the plane would know that the cup has n't scared these hats .	the plane would know who the cup has n't scared these hats .
this rocket has n't known that the mall scares the buttons .	this rocket has n't known who the mall scares the buttons .
these beds see that this candle would n't scare this bag .	these beds see who this candle would n't scare this bag .
the truck has n't remembered that these cars can n't appreciate the hats .	the truck has n't remembered who these cars can n't appreciate the hats .
that book had n't known that the hats confused the park .	that book had n't known who the hats confused the park .
the spoons can n't notice that the book had n't liked that candle .	the spoons can n't notice who the book had n't liked that candle .
these chairs forgot that this rug had bothered those doors .	these chairs forgot who this rug had bothered those doors .
that mirror knows that those cars had scared that museum .	that mirror knows who those cars had scared that museum .
the forks can realize that the windows bother this car .	the forks can realize who the windows bother this car .
that chair had learned that those boats can praise the books .	that chair had learned who those boats can praise the books .
the box must see that these toys are n't bothering these crayons .	the box must see who these toys are n't bothering these crayons .
the cars saw that these cars confused those windows .	the cars saw who these cars confused those windows .
those dolls noticed that that school would like this ship .	those dolls noticed who that school would like this ship .
those buttons remember that the shirts do n't scare the chair .	those buttons remember who the shirts do n't scare the chair .
these plates forgot that this boat liked those forks .	these plates forgot who this boat liked those forks .
the window could remember that those toys had scared that dish .	the window could remember who those toys had scared that dish .
those bowls saw that the bottles have confused that toy .	those bowls saw who the bottles have confused that toy .
those candles see that this window must hate that bottle .	those candles see who this window must hate that bottle .
these cups remember that the button had n't liked the plane .	these cups remember who the button had n't liked the plane .
those shirts had learned that these rooms confused this chair .	those shirts had learned who these rooms confused this chair .
that truck noticed that the ring likes this library .	that truck noticed who the ring likes this library .
that book could learn that that car can appreciate this rocket .	that book could learn who that car can appreciate this rocket .
those cups may forget that this spoon did n't bother that window .	those cups may forget who this spoon did n't bother that window .
these pictures remembered that the crayon can n't bother that bicycle .	these pictures remembered who the crayon can n't bother that bicycle .
those cups might know that that hat does n't like these rings .	those cups might know who that hat does n't like these rings .
the plates forgot that this ship scared the rug .	the plates forgot who this ship scared the rug .
those bags have n't realized that this cup likes the bank .	those bags have n't realized who this cup likes the bank .
those buttons would realize that these bottles would n't hate the bowl .	those buttons would realize who these bottles would n't hate the bowl .
these crayons had n't seen that those dishes would bother these bowls .	these crayons had n't seen who those dishes would bother these bowls .
that button had remembered that that book should bother the park .	that button had remembered who that book should bother the park .
the bed should n't notice that that school confused that ring .	the bed should n't notice who that school confused that ring .
the bags remember that the shoes did n't like these cars .	the bags remember who the shoes did n't like these cars .
the rings would know that that toy could n't like this mirror .	the rings would know who that toy could n't like this mirror .
the dishes could remember that these windows scared those dishes .	the dishes could remember who these windows scared those dishes .
the ring has learned that the couch can appreciate the car .	the ring has learned who the couch can appreciate the car .
this cup noticed that the book has scared the kitchen .	this cup noticed who the book has scared the kitchen .
these cars have learned that the button has confused those books .	these cars have learned who the button has confused those books .
the doors had seen that the rings bothered that toy .	the doors had seen who the rings bothered that toy .
the rings notice that that kitchen would n't appreciate those dolls .	the rings notice who that kitchen would n't appreciate those dolls .
these dishes notice that the buttons hate the school .	these dishes notice who the buttons hate the school .
the shoes should n't know that that restaurant has bothered the dishes .	the shoes should n't know who that restaurant has bothered the dishes .
these books had noticed that this car could n't scare the candles .	these books had noticed who this car could n't scare the candles .
those cars remembered that the picture had liked that shirt .	those cars remembered who the picture had liked that shirt .
these plates had n't noticed that these glasses will praise the shirts .	these plates had n't noticed who these glasses will praise the shirts .
those boats have noticed that this toy bothered those cars .	those boats have noticed who this toy bothered those cars .
that car knows that that museum must like these glasses .	that car knows who that museum must like these glasses .
these windows can forget that these buttons like that chair .	these windows can forget who these buttons like that chair .
that ship remembered that that ship was n't bothering those schools .	that ship remembered who that ship was n't bothering those schools .
these plates have seen that that school should n't scare the windows .	these plates have seen who that school should n't scare the windows .
this candle forgot that this picture had n't bothered that school .	this candle forgot who this picture had n't bothered that school .
these cars have n't noticed that those chairs bother these glasses .	these cars have n't noticed who those chairs bother these glasses .
that shoe forgot that the bowl was n't bothering the door .	that shoe forgot who the bowl was n't bothering the door .
these beds forget that these toys appreciate those trucks .	these beds forget who these toys appreciate those trucks .
the cars had n't learned that that bottle had scared those candles .	the cars had n't learned who that bottle had scared those candles .
these cars noticed that these boats have n't liked this mirror .	these cars noticed who these boats have n't liked this mirror .
this shirt has n't realized that those hats will appreciate the box .	this shirt has n't realized who those hats will appreciate the box .
the cars would n't notice that the truck had liked the couch .	the cars would n't notice who the truck had liked the couch .
the candles had n't remembered that the crayons bothered these chairs .	the candles had n't remembered who the crayons bothered these chairs .
these cars remember that the boxes had n't liked that plate .	these cars remember who the boxes had n't liked that plate .
that car has remembered that the cars like the window .	that car has remembered who the cars like the window .
the crayons had known that the boat scared these cups .	the crayons had known who the boat scared these cups .
this crayon should remember that those rings bother these glasses .	this crayon should remember who those rings bother these glasses .
the hat had noticed that that book bothered these pictures .	the hat had noticed who that book bothered these pictures .
these spoons could n't see that these doors hate the bag .	these spoons could n't see who these doors hate the bag .
the ring noticed that this truck is n't bothering the shoes .	the ring noticed who this truck is n't bothering the shoes .
these boxes know that the hat should n't appreciate that bed .	these boxes know who the hat should n't appreciate that bed .
these books did n't forget that this book confused this mirror .	these books did n't forget who this book confused this mirror .
these chairs know that these trucks bothered this bag .	these chairs know who these trucks bothered this bag .
the cars would remember that those plates liked that truck .	the cars would remember who those plates liked that truck .
those bags had noticed that this toy should n't bother these shoes .	those bags had noticed who this toy should n't bother these shoes .
those cars forget that the mirror must scare the rings .	those cars forget who the mirror must scare the rings .
the bags saw that the forks praise that bank .	the bags saw who the forks praise that bank .
the bowls learned that these windows have n't confused the dolls .	the bowls learned who these windows have n't confused the dolls .
those cups have known that the trucks had n't liked those spoons .	those cups have known who the trucks had n't liked those spoons .
the dishes will realize that these rooms liked this car .	the dishes will realize who these rooms liked this car .
the toys remembered that this library did n't bother those spoons .	the toys remembered who this library did n't bother those spoons .
those glasses had known that the beds had bothered that truck .	those glasses had known who the beds had bothered that truck .
this shirt realized that these bottles had scared the dishes .	this shirt realized who these bottles had scared the dishes .
the fork realized that the bed liked this rug .	the fork realized who the bed liked this rug .
those pictures should n't notice that the picture bothered this window .	those pictures should n't notice who the picture bothered this window .
these candles forgot that that mall did n't hate this bottle .	these candles forgot who that mall did n't hate this bottle .
the hats should see that the windows are n't bothering these bottles .	the hats should see who the windows are n't bothering these bottles .
those dishes have learned that this doll should n't appreciate the book .	those dishes have learned who this doll should n't appreciate the book .
this bowl knew that these dishes did n't like the school .	this bowl knew who these dishes did n't like the school .
the dolls know that this cup wo n't bother this car .	the dolls know who this cup wo n't bother this car .
the crayon knows that these cars bothered the bottle .	the crayon knows who these cars bothered the bottle .
those bottles have known that those windows can praise this shoe .	those bottles have known who those windows can praise this shoe .
that bed should forget that the shirt wo n't praise the button .	that bed should forget who the shirt wo n't praise the button .
this box has noticed that this rug was n't bothering these glasses .	this box has noticed who this rug was n't bothering these glasses .
the shirts had realized that these dolls scared the cars .	the shirts had realized who these dolls scared the cars .
these spoons have known that the plate is bothering this car .	these spoons have known who the plate is bothering this car .
those pictures know that that door is n't bothering these books .	those pictures know who that door is n't bothering these books .
the dolls have noticed that that crayon bothered that book .	the dolls have noticed who that crayon bothered that book .
this car had n't noticed that this bicycle wo n't bother that dish .	this car had n't noticed who this bicycle wo n't bother that dish .
the books see that these trucks had n't confused that bag .	the books see who these trucks had n't confused that bag .
that candle saw that that doll had scared that button .	that candle saw who that doll had scared that button .
that fork had n't seen that these spoons had n't confused the windows .	that fork had n't seen who these spoons had n't confused the windows .
the doors had n't seen that that library had confused the door .	the doors had n't seen who that library had confused the door .
the chairs have n't seen that those pictures scared those plates .	the chairs have n't seen who those pictures scared those plates .
those rings have learned that those rings have scared the beds .	those rings have learned who those rings have scared the beds .
that door could n't know that the glasses like these dishes .	that door could n't know who the glasses like these dishes .
those glasses realize that those schools had n't confused the glass .	those glasses realize who those schools had n't confused the glass .
the shirt would n't realize that this library will hate the bowls .	the shirt would n't realize who this library will hate the bowls .
these toys learn that that book bothered these books .	these toys learn who that book bothered these books .
that bottle had seen that those dishes should like the school .	that bottle had seen who those dishes should like the school .
this toy realized that this bank did n't hate those spoons .	this toy realized who this bank did n't hate those spoons .
the cup had known that that dish would appreciate the park .	the cup had known who that dish would appreciate the park .
this box could remember that those windows like the plates .	this box could remember who those windows like the plates .
the buttons see that this crayon can bother the car .	the buttons see who this crayon can bother the car .
those plates know that that shoe had scared these boxes .	those plates know who that shoe had scared these boxes .
the chairs have n't realized that those dishes could appreciate this mirror .	the chairs have n't realized who those dishes could appreciate this mirror .
that mirror might remember that the school could scare that glass .	that mirror might remember who the school could scare that glass .
those trucks know that the doll had confused the forks .	those trucks know who the doll had confused the forks .
these windows could notice that these plates had liked that plate .	these windows could notice who these plates had liked that plate .
that mirror has n't realized that the toy bothered these toys .	that mirror has n't realized who the toy bothered these toys .
these hats forget that those beds can n't scare the chair .	these hats forget who those beds can n't scare the chair .
those rings have n't known that these shoes were bothering those doors .	those rings have n't known who these shoes were bothering those doors .
the shirts should know that the boat could praise that picture .	the shirts should know who the boat could praise that picture .
those dolls know that that mall had n't scared that boat .	those dolls know who that mall had n't scared that boat .
those shoes remembered that those boats should bother the schools .	those shoes remembered who those boats should bother the schools .
these boats had n't known that that doll will hate that school .	these boats had n't known who that doll will hate that school .
those toys could realize that that library bothered the bicycle .	those toys could realize who that library bothered the bicycle .
the toys knew that the bowl did n't like these windows .	the toys knew who the bowl did n't like these windows .
these toys forget that the cups hate the truck .	these toys forget who the cups hate the truck .
the cars see that this mall bothered that button .	the cars see who this mall bothered that button .
that door should know that the shoe had confused the park .	that door should know who the shoe had confused the park .
that book might remember that these bags bothered the window .	that book might remember who these bags bothered the window .
that plate remembered that that restaurant liked this bank .	that plate remembered who that restaurant liked this bank .
these windows forgot that this truck should like this picture .	these windows forgot who this truck should like this picture .
the bed can forget that that window liked the bowl .	the bed can forget who that window liked the bowl .
the bowls wo n't realize that the glass liked those dishes .	the bowls wo n't realize who the glass liked those dishes .
the picture did n't learn that the bowls have confused the school .	the picture did n't learn who the bowls have confused the school .
the dishes do n't know that these doors are n't bothering that plane .	the dishes do n't know who these doors are n't bothering that plane .
the buttons might remember that these rooms hate this library .	the buttons might remember who these rooms hate this library .
these books knew that that library has bothered that book .	these books knew who that library has bothered that book .
the plane noticed that these dishes can appreciate this ring .	the plane noticed who these dishes can appreciate this ring .
the shoes would know that the boats should appreciate this ring .	the shoes would know who the boats should appreciate this ring .
these glasses could forget that those hats liked this picture .	these glasses could forget who those hats liked this picture .
those chairs had learned that those books confused this bicycle .	those chairs had learned who those books confused this bicycle .
these candles remember that these glasses hate those toys .	these candles remember who these glasses hate those toys .
this picture learned that those rooms are bothering the trucks .	this picture learned who those rooms are bothering the trucks .
these buttons had noticed that the buttons had n't liked the door .	these buttons had noticed who the buttons had n't liked the door .
the shirts see that the toy would n't like this bowl .	the shirts see who the toy would n't like this bowl .
the door has known that those doors should praise the dishes .	the door has known who those doors should praise the dishes .
this car sees that the rooms scare these pictures .	this car sees who the rooms scare these pictures .
those boats wo n't forget that these bottles appreciate this cup .	those boats wo n't forget who these bottles appreciate this cup .
the bag noticed that these cars hate the couch .	the bag noticed who these cars hate the couch .
the trucks saw that the spoons confused this rocket .	the trucks saw who the spoons confused this rocket .
those windows could n't forget that those cups have scared the buttons .	those windows could n't forget who those cups have scared the buttons .
that button has n't known that the door would n't scare this museum .	that button has n't known who the door would n't scare this museum .
this cup had noticed that this room liked the candles .	this cup had noticed who this room liked the candles .
these pictures realize that the glasses appreciate that plate .	these pictures realize who the glasses appreciate that plate .
that dish has learned that that hat is n't bothering the car .	that dish has learned who that hat is n't bothering the car .
those buttons realize that this toy scared the boats .	those buttons realize who this toy scared the boats .
that fork remembered that this mall scares those shoes .	that fork remembered who this mall scares those shoes .
those windows realized that this hospital did n't scare the cups .	those windows realized who this hospital did n't scare the cups .
the dolls see that those boats liked those pictures .	the dolls see who those boats liked those pictures .
that plane will learn that the schools like this kitchen .	that plane will learn who the schools like this kitchen .
those chairs had n't realized that that plate should praise the cars .	those chairs had n't realized who that plate should praise the cars .
the button should learn that the schools did n't appreciate that shirt .	the button should learn who the schools did n't appreciate that shirt .
the rings had n't seen that this toy has n't confused those shoes .	the rings had n't seen who this toy has n't confused those shoes .
those buttons remembered that the book will bother the crayons .	those buttons remembered who the book will bother the crayons .
the spoons see that these toys might praise those dolls .	the spoons see who these toys might praise those dolls .
those bags should see that the museum scared that toy .	those bags should see who the museum scared that toy .
that couch saw that the button likes the car .	that couch saw who the button likes the car .
this crayon can n't learn that this picture could hate this bottle .	this crayon can n't learn who this picture could hate this bottle .
the shoes learned that these cars appreciate these rooms .	the shoes learned who these cars appreciate these rooms .
the toys realized that the park was bothering this car .	the toys realized who the park was bothering this car .
the shirts could see that the forks liked those bowls .	the shirts could see who the forks liked those bowls .
the crayons know that the beds bother the boxes .	the crayons know who the beds bother the boxes .
that bag had n't realized that those rings scare those windows .	that bag had n't realized who those rings scare those windows .
that glass had n't seen that the car liked these boxes .	that glass had n't seen who the car liked these boxes .
that picture remembered that those dolls have n't liked the couch .	that picture remembered who those dolls have n't liked the couch .
the spoons have n't realized that these candles should n't hate the boats .	the spoons have n't realized who these candles should n't hate the boats .
the shoe noticed that that candle has scared that mall .	the shoe noticed who that candle has scared that mall .
those windows realize that the bags had confused those cars .	those windows realize who the bags had confused those cars .
these toys realize that the bowl wo n't praise that room .	these toys realize who the bowl wo n't praise that room .
this ring saw that these hats confused this chair .	this ring saw who these hats confused this chair .
the books have n't remembered that those dolls have liked this plane .	the books have n't remembered who those dolls have liked this plane .
this fork saw that the glasses scared those cars .	this fork saw who the glasses scared those cars .
the crayon sees that that shirt scared these glasses .	the crayon sees who that shirt scared these glasses .
the cars can n't remember that the cup had bothered the crayons .	the cars can n't remember who the cup had bothered the crayons .
this cup had noticed that these dolls confused the toys .	this cup had noticed who these dolls confused the toys .
these spoons had known that those pictures wo n't appreciate that school .	these spoons had known who those pictures wo n't appreciate that school .
those boxes notice that that kitchen had n't scared this museum .	those boxes notice who that kitchen had n't scared this museum .
that window does n't know that those cars scare these rooms .	that window does n't know who those cars scare these rooms .
the shoe can n't realize that that doll scares the doors .	the shoe can n't realize who that doll scares the doors .
that shoe learned that the park can n't scare this kitchen .	that shoe learned who the park can n't scare this kitchen .
the boats realized that that ship wo n't hate this rug .	the boats realized who that ship wo n't hate this rug .
those boats can forget that the window would like that school .	those boats can forget who the window would like that school .
the book saw that these bags are bothering the couch .	the book saw who these bags are bothering the couch .
those glasses have remembered that the dish liked those hats .	those glasses have remembered who the dish liked those hats .
this book did n't realize that the kitchen can n't scare that bed .	this book did n't realize who the kitchen can n't scare that bed .
the hats remembered that those glasses did n't scare those dolls .	the hats remembered who those glasses did n't scare those dolls .
this truck wo n't remember that the boats can n't appreciate those schools .	this truck wo n't remember who the boats can n't appreciate those schools .
that door knows that the schools could appreciate that ring .	that door knows who the schools could appreciate that ring .
this book had known that this bowl had liked that book .	this book had known who this bowl had liked that book .
those glasses will realize that the cup was bothering the crayons .	those glasses will realize who the cup was bothering the crayons .
the buttons could n't see that the dolls will scare that hat .	the buttons could n't see who the dolls will scare that hat .
those spoons see that these schools bothered that chair .	those spoons see who these schools bothered that chair .
that candle could learn that those books scared the boats .	that candle could learn who those books scared the boats .
the rug does n't learn that these dolls had n't bothered the mall .	the rug does n't learn who these dolls had n't bothered the mall .
that dish sees that the bicycle may bother this school .	that dish sees who the bicycle may bother this school .
this mirror noticed that that dish had confused this mirror .	this mirror noticed who that dish had confused this mirror .
the toys have known that those dolls have bothered that car .	the toys have known who those dolls have bothered that car .
these windows had n't noticed that those plates have n't scared these glasses .	these windows had n't noticed who those plates have n't scared these glasses .
the books must learn that this candle has liked that car .	the books must learn who this candle has liked that car .
the bottles could n't see that the plane had liked those beds .	the bottles could n't see who the plane had liked those beds .
the crayon saw that that rocket has scared this doll .	the crayon saw who that rocket has scared this doll .
the plane may forget that the doors had n't bothered these cars .	the plane may forget who the doors had n't bothered these cars .
this crayon sees that that book scared this bowl .	this crayon sees who that book scared this bowl .
this car had n't known that those books like that plate .	this car had n't known who those books like that plate .
this mirror had known that the books scare that school .	this mirror had known who the books scare that school .
the car will realize that these crayons confused that car .	the car will realize who these crayons confused that car .
the windows learned that these crayons have n't liked this bag .	the windows learned who these crayons have n't liked this bag .
this boat realized that that cup has liked these bags .	this boat realized who that cup has liked these bags .
the pictures realized that that button liked that library .	the pictures realized who that button liked that library .
these cars can know that the plate likes the shoe .	these cars can know who the plate likes the shoe .
these boats would know that that rocket likes this plane .	these boats would know who that rocket likes this plane .
the plate has n't noticed that this bed had n't bothered the restaurant .	the plate has n't noticed who this bed had n't bothered the restaurant .
those glasses should know that the spoon had n't liked that rocket .	those glasses should know who the spoon had n't liked that rocket .
