this toy had realized what the bottles who are n't dropping that guy are n't keeping .	this toy had realized that the bottles who are n't dropping that guy are n't keeping .
these dolls knew who those shoes who had the children appreciate .	these dolls knew that those shoes who had the children appreciate .
the dishes saw what those trucks who the boat hears hold .	the dishes saw that those trucks who the boat hears hold .
the truck must learn what those pictures who could steal the dancer can sell .	the truck must learn that those pictures who could steal the dancer can sell .
this bed knew what the rooms who are n't shaking that guy may bring .	this bed knew that the rooms who are n't shaking that guy may bring .
the buttons would n't know what the plane who should hear this bowl will sell .	the buttons would n't know that the plane who should hear this bowl will sell .
the bicycle has n't realized what the schools who this picture has n't heard might buy .	the bicycle has n't realized that the schools who this picture has n't heard might buy .
those rings know who those shirts who can hear the bowls like .	those rings know that those shirts who can hear the bowls like .
the candles have n't realized what those trucks who are n't smiling would buy .	the candles have n't realized that those trucks who are n't smiling would buy .
that shirt saw what those plates who should lose those boys find .	that shirt saw that those plates who should lose those boys find .
these doors could n't realize what these bottles who would know that hospital are n't finding .	these doors could n't realize that these bottles who would know that hospital are n't finding .
the truck does n't forget what this mirror who should n't win has n't kept .	the truck does n't forget that this mirror who should n't win has n't kept .
the crayon remembered what this box who fixed that adult holds .	the crayon remembered that this box who fixed that adult holds .
the dolls would forget what this boat who is losing was taking .	the dolls would forget that this boat who is losing was taking .
the boats knew what this plate who the couch would know had held .	the boats knew that this plate who the couch would know had held .
the forks do n't realize what the car who held this person can n't steal .	the forks do n't realize that the car who held this person can n't steal .
the boxes have n't learned what the hats who hear the boxes find .	the boxes have n't learned that the hats who hear the boxes find .
this shoe might remember what this couch who those rings have n't heard keeps .	this shoe might remember that this couch who those rings have n't heard keeps .
the button realized what those rings who sell the dentist have n't found .	the button realized that those rings who sell the dentist have n't found .
the doors have n't learned what this door who sings had n't made .	the doors have n't learned that this door who sings had n't made .
those doors have remembered what these cars who must win take .	those doors have remembered that these cars who must win take .
the bottle could n't see what that bowl who could n't lose should n't sell .	the bottle could n't see that that bowl who could n't lose should n't sell .
this car learned who this restaurant who bought those guys had n't scared .	this car learned that this restaurant who bought those guys had n't scared .
the dishes learn who the dolls who hear those shoes appreciate .	the dishes learn that the dolls who hear those shoes appreciate .
those books remembered what this car who hears these rings must bring .	those books remembered that this car who hears these rings must bring .
that rug wo n't see what that school who moves those children was n't bringing .	that rug wo n't see that that school who moves those children was n't bringing .
these beds remembered who the room who fixed these guys has n't bothered .	these beds remembered that the room who fixed these guys has n't bothered .
that boat wo n't see what those rings who brought the ladies could n't keep .	that boat wo n't see that those rings who brought the ladies could n't keep .
these glasses saw what those boxes who those schools hear are n't finding .	these glasses saw that those boxes who those schools hear are n't finding .
these dishes remembered what this library who the restaurant hears does n't bring .	these dishes remembered that this library who the restaurant hears does n't bring .
that bowl has remembered what this bottle who was n't yelling has found .	that bowl has remembered that this bottle who was n't yelling has found .
these books had n't learned what this book who that bank should hear is keeping .	these books had n't learned that this book who that bank should hear is keeping .
the doll realized what these forks who yelled hold .	the doll realized that these forks who yelled hold .
these books had n't known what those shoes who had held these teachers found .	these books had n't known that those shoes who had held these teachers found .
these bottles have realized who these spoons who had made those teachers can n't hate .	these bottles have realized that these spoons who had made those teachers can n't hate .
the cup had n't learned what the bicycle who knows this school has n't fixed .	the cup had n't learned that the bicycle who knows this school has n't fixed .
that bottle knew who this candle who is throwing these ladies scared .	that bottle knew that this candle who is throwing these ladies scared .
these boats learned what that ring who heard the candles is fixing .	these boats learned that that ring who heard the candles is fixing .
this bicycle has learned who the ring who the windows have heard could n't scare .	this bicycle has learned that the ring who the windows have heard could n't scare .
those spoons can learn what this mirror who the chairs should n't hear has n't fixed .	those spoons can learn that this mirror who the chairs should n't hear has n't fixed .
the bed saw who the beds who those windows knew may like .	the bed saw that the beds who those windows knew may like .
those spoons forgot what the library who reads should sell .	those spoons forgot that the library who reads should sell .
the doors know who this plane who lost might scare .	the doors know that this plane who lost might scare .
the book did n't learn what that window who may shake this boy can n't bring .	the book did n't learn that that window who may shake this boy can n't bring .
this hat had realized what these cups who could n't hear these bowls have n't taken .	this hat had realized that these cups who could n't hear these bowls have n't taken .
the boat knows who these plates who the boats know confused .	the boat knows that these plates who the boats know confused .
the dolls remember what these buttons who made these teachers might take .	the dolls remember that these buttons who made these teachers might take .
these windows learn who the rug who shakes that king had liked .	these windows learn that the rug who shakes that king had liked .
those forks have n't known what this doll who waved brings .	those forks have n't known that this doll who waved brings .
that hat realized what this bag who the rooms could n't know is fixing .	that hat realized that this bag who the rooms could n't know is fixing .
those dishes should realize what the dish who that book heard bought .	those dishes should realize that the dish who that book heard bought .
the rug had noticed what this couch who heard those plates brings .	the rug had noticed that this couch who heard those plates brings .
the dish learned what the window who had fixed the dancer wo n't make .	the dish learned that the window who had fixed the dancer wo n't make .
that crayon should n't remember what these boats who the kitchen heard fixed .	that crayon should n't remember that these boats who the kitchen heard fixed .
this hat has n't known who the schools who will hear the restaurant have liked .	this hat has n't known that the schools who will hear the restaurant have liked .
those doors remembered who this bowl who should know this crayon had confused .	those doors remembered that this bowl who should know this crayon had confused .
these cups have n't seen what those boxes who brought those doctors are n't fixing .	these cups have n't seen that those boxes who brought those doctors are n't fixing .
the bowl has remembered who those candles who heard that school will scare .	the bowl has remembered that those candles who heard that school will scare .
this cup knew what this library who must know the doors should find .	this cup knew that this library who must know the doors should find .
those crayons can notice what that restaurant who painted was n't taking .	those crayons can notice that that restaurant who painted was n't taking .
this plate may realize who those books who have n't made those teachers bother .	this plate may realize that those books who have n't made those teachers bother .
those boxes notice what this bank who heard the spoon fixed .	those boxes notice that this bank who heard the spoon fixed .
the dolls remembered who the restaurant who those pictures knew scared .	the dolls remembered that the restaurant who those pictures knew scared .
that chair will remember what the hospital who must clean those people held .	that chair will remember that the hospital who must clean those people held .
those bowls have known what this museum who those books know makes .	those bowls have known that this museum who those books know makes .
the pictures knew who the glasses who smile appreciate .	the pictures knew that the glasses who smile appreciate .
that plane would n't realize who the schools who lose like .	that plane would n't realize that the schools who lose like .
these pictures learned what that hospital who these boxes heard did n't hold .	these pictures learned that that hospital who these boxes heard did n't hold .
these crayons should n't remember what that spoon who might laugh had kept .	these crayons should n't remember that that spoon who might laugh had kept .
these candles learned what the toy who the spoons do n't hear holds .	these candles learned that the toy who the spoons do n't hear holds .
the shirts wo n't forget what that spoon who won makes .	the shirts wo n't forget that that spoon who won makes .
that doll learned what the cars who must buy the person have n't kept .	that doll learned that the cars who must buy the person have n't kept .
the bag saw what those chairs who those bottles had n't heard keep .	the bag saw that those chairs who those bottles had n't heard keep .
the windows saw what that park who is dropping this doctor should n't hold .	the windows saw that that park who is dropping this doctor should n't hold .
the bags saw what that bowl who was n't taking the king was n't buying .	the bags saw that that bowl who was n't taking the king was n't buying .
these candles did n't know what the candles who would know this hospital were n't holding .	these candles did n't know that the candles who would know this hospital were n't holding .
the truck could know what this button who this boat knew found .	the truck could know that this button who this boat knew found .
the rocket forgot who these doors who paint scare .	the rocket forgot that these doors who paint scare .
that shoe learned what those bottles who had n't painted were n't taking .	that shoe learned that those bottles who had n't painted were n't taking .
these cups can n't realize who those schools who are losing liked .	these cups can n't realize that those schools who are losing liked .
that ship should n't forget what these plates who wo n't wave held .	that ship should n't forget that these plates who wo n't wave held .
these cups had n't realized who that bed who had n't won was n't bothering .	these cups had n't realized that that bed who had n't won was n't bothering .
the windows notice who those rings who had n't lost hate .	the windows notice that those rings who had n't lost hate .
the shoes have seen what the button who knew this fork is n't making .	the shoes have seen that the button who knew this fork is n't making .
these windows had n't noticed what that doll who this dish did n't know will make .	these windows had n't noticed that that doll who this dish did n't know will make .
the bottles realize what those chairs who hear this bottle had made .	the bottles realize that those chairs who hear this bottle had made .
that window knew who those bowls who have laughed liked .	that window knew that those bowls who have laughed liked .
the shirts have noticed what these books who would n't move this queen would fix .	the shirts have noticed that these books who would n't move this queen would fix .
that car has learned what the button who won may buy .	that car has learned that the button who won may buy .
the chairs forgot what the bags who the books had heard have n't brought .	the chairs forgot that the bags who the books had heard have n't brought .
these forks wo n't realize what this truck who those doors have n't heard has n't fixed .	these forks wo n't realize that this truck who those doors have n't heard has n't fixed .
these books had n't learned who this park who was smiling would bother .	these books had n't learned that this park who was smiling would bother .
the window may see what this book who has n't yelled would n't fix .	the window may see that this book who has n't yelled would n't fix .
that door can n't realize what these schools who may move this customer were fixing .	that door can n't realize that these schools who may move this customer were fixing .
those spoons must remember who these bottles who do n't yell appreciate .	those spoons must remember that these bottles who do n't yell appreciate .
these trucks wo n't realize who the plate who did n't win has bothered .	these trucks wo n't realize that the plate who did n't win has bothered .
the shoe noticed what these dishes who would n't whisper were fixing .	the shoe noticed that these dishes who would n't whisper were fixing .
the bowls forget who that car who may know those doors may bother .	the bowls forget that that car who may know those doors may bother .
the spoon noticed who the dish who knew this restaurant was n't bothering .	the spoon noticed that the dish who knew this restaurant was n't bothering .
these buttons would n't see who this bed who had n't won would appreciate .	these buttons would n't see that this bed who had n't won would appreciate .
this rocket did n't know who the books who those chairs will know bothered .	this rocket did n't know that the books who those chairs will know bothered .
that couch wo n't see what that ring who was crying held .	that couch wo n't see that that ring who was crying held .
those hats notice what the ship who this plate heard made .	those hats notice that the ship who this plate heard made .
this couch remembered what those chairs who the forks knew make .	this couch remembered that those chairs who the forks knew make .
that candle did n't forget what these beds who sing stole .	that candle did n't forget that these beds who sing stole .
this spoon may see who those crayons who have n't heard the boat liked .	this spoon may see that those crayons who have n't heard the boat liked .
those candles would know what these schools who may fix this dentist fixed .	those candles would know that these schools who may fix this dentist fixed .
the trucks forget what the library who exercises was n't keeping .	the trucks forget that the library who exercises was n't keeping .
these hats may realize what these boats who would n't hear these doors must sell .	these hats may realize that these boats who would n't hear these doors must sell .
the car can n't realize who that shirt who hears that museum has liked .	the car can n't realize that that shirt who hears that museum has liked .
the cup saw what that book who would n't steal the king holds .	the cup saw that that book who would n't steal the king holds .
that truck wo n't remember what the school who the buttons had heard does n't hold .	that truck wo n't remember that the school who the buttons had heard does n't hold .
that hat can know what the cars who painted were taking .	that hat can know that the cars who painted were taking .
the boats saw what those crayons who are finding those men had found .	the boats saw that those crayons who are finding those men had found .
the chairs had seen what the fork who sang stole .	the chairs had seen that the fork who sang stole .
the box has n't seen who those beds who were n't taking that king bothered .	the box has n't seen that those beds who were n't taking that king bothered .
those books can n't forget what these schools who knew the forks buy .	those books can n't forget that these schools who knew the forks buy .
this door did n't realize what the fork who this hospital knew has n't taken .	this door did n't realize that the fork who this hospital knew has n't taken .
that doll wo n't forget who these cups who hear these books had n't scared .	that doll wo n't forget that these cups who hear these books had n't scared .
the glass forgot what this mall who had the women bought .	the glass forgot that this mall who had the women bought .
the truck realized what these cars who that mirror wo n't hear would keep .	the truck realized that these cars who that mirror wo n't hear would keep .
that bowl noticed what those glasses who had n't held this driver are making .	that bowl noticed that those glasses who had n't held this driver are making .
the window can n't realize what these schools who have cried might take .	the window can n't realize that these schools who have cried might take .
the box sees what that mall who is holding this doctor brings .	the box sees that that mall who is holding this doctor brings .
these cars would n't forget what the bottle who moves this customer had n't found .	these cars would n't forget that the bottle who moves this customer had n't found .
the picture has known who those cups who were n't talking must scare .	the picture has known that those cups who were n't talking must scare .
these cars saw what the boxes who could know that ring will fix .	these cars saw that the boxes who could know that ring will fix .
the shoes have n't noticed what that mirror who had heard those pictures bought .	the shoes have n't noticed that that mirror who had heard those pictures bought .
this rocket did n't see who those beds who are smiling wo n't appreciate .	this rocket did n't see that those beds who are smiling wo n't appreciate .
these dishes had learned what these windows who knew these hats had bought .	these dishes had learned that these windows who knew these hats had bought .
that toy saw what this fork who has n't heard this window took .	that toy saw that this fork who has n't heard this window took .
that button learned who these boxes who may hold that man hate .	that button learned that these boxes who may hold that man hate .
those cups learned who this doll who keeps those teachers is n't bothering .	those cups learned that this doll who keeps those teachers is n't bothering .
the ship has learned who this shoe who could hear that glass might appreciate .	the ship has learned that this shoe who could hear that glass might appreciate .
that button realized who these bowls who can n't cry bother .	that button realized that these bowls who can n't cry bother .
that rocket would know who the book who has talked liked .	that rocket would know that the book who has talked liked .
the shirt remembered who the hats who are yelling confused .	the shirt remembered that the hats who are yelling confused .
that door may realize what those boxes who were painting had bought .	that door may realize that those boxes who were painting had bought .
the hats forget what these hats who know this restaurant take .	the hats forget that these hats who know this restaurant take .
that box has n't known what these boxes who this rug knows have taken .	that box has n't known that these boxes who this rug knows have taken .
that bicycle should learn what this kitchen who is n't bringing those women brings .	that bicycle should learn that this kitchen who is n't bringing those women brings .
these doors saw what this boat who reads is n't making .	these doors saw that this boat who reads is n't making .
that toy could remember what the school who would n't whisper may fix .	that toy could remember that the school who would n't whisper may fix .
the beds learn who these cars who will hear that school praise .	the beds learn that these cars who will hear that school praise .
the plate has n't learned what the book who has n't cleaned the man held .	the plate has n't learned that the book who has n't cleaned the man held .
that box knows what these spoons who heard that mall had taken .	that box knows that these spoons who heard that mall had taken .
these glasses forget what this bowl who has n't held those men keeps .	these glasses forget that this bowl who has n't held those men keeps .
the buttons noticed what that bank who is finding this girl could hold .	the buttons noticed that that bank who is finding this girl could hold .
this car remembered who that park who wo n't sing has liked .	this car remembered that that park who wo n't sing has liked .
these shoes saw what these schools who exercise have found .	these shoes saw that these schools who exercise have found .
this dish sees what that book who had n't fixed the dentist bought .	this dish sees that that book who had n't fixed the dentist bought .
the bag had realized who the beds who bought these doctors scared .	the bag had realized that the beds who bought these doctors scared .
the spoon should remember who this car who is buying the children should like .	the spoon should remember that this car who is buying the children should like .
this picture can n't forget what this glass who reads has n't fixed .	this picture can n't forget that this glass who reads has n't fixed .
the cups see what this plane who had heard the room should bring .	the cups see that this plane who had heard the room should bring .
these hats would n't learn what that kitchen who that ring had heard fixed .	these hats would n't learn that that kitchen who that ring had heard fixed .
these doors had n't seen what the crayons who were n't yelling took .	these doors had n't seen that the crayons who were n't yelling took .
the chairs see what those cars who were reading buy .	the chairs see that those cars who were reading buy .
these dishes notice what this mirror who has n't cried makes .	these dishes notice that this mirror who has n't cried makes .
these buttons remembered who that mall who was n't reading may hate .	these buttons remembered that that mall who was n't reading may hate .
these shirts can know what this glass who heard the chair holds .	these shirts can know that this glass who heard the chair holds .
the dishes could learn who the boats who can sell these children are n't bothering .	the dishes could learn that the boats who can sell these children are n't bothering .
these doors should n't remember who that bag who can n't buy the children likes .	these doors should n't remember that that bag who can n't buy the children likes .
those windows had n't noticed what the bowls who this fork knew were n't taking .	those windows had n't noticed that the bowls who this fork knew were n't taking .
those pictures have learned what the shirts who are n't fixing that child had taken .	those pictures have learned that the shirts who are n't fixing that child had taken .
that box knows who that door who did n't know the pictures might hate .	that box knows that that door who did n't know the pictures might hate .
those cars might see who those buttons who these books heard will hate .	those cars might see that those buttons who these books heard will hate .
these glasses have noticed what the schools who were whispering have found .	these glasses have noticed that the schools who were whispering have found .
those dolls had seen what these pictures who had n't won would n't hold .	those dolls had seen that these pictures who had n't won would n't hold .
the boxes saw what the boxes who lose might make .	the boxes saw that the boxes who lose might make .
those cars realize who these forks who can lose should bother .	those cars realize that these forks who can lose should bother .
this door must remember what this boat who was n't yelling would n't steal .	this door must remember that this boat who was n't yelling would n't steal .
the doll forgot who the hats who hear the plates would hate .	the doll forgot that the hats who hear the plates would hate .
these spoons could n't see what the bank who wo n't lose would n't sell .	these spoons could n't see that the bank who wo n't lose would n't sell .
that car saw what the truck who the bicycle had n't heard had n't kept .	that car saw that the truck who the bicycle had n't heard had n't kept .
those crayons can n't remember what that car who heard these bowls keeps .	those crayons can n't remember that that car who heard these bowls keeps .
the box has known what this rocket who did n't hear this rocket should n't take .	the box has known that this rocket who did n't hear this rocket should n't take .
this rocket learned what the restaurant who knows the cups had n't made .	this rocket learned that the restaurant who knows the cups had n't made .
those doors forget what the school who throws that adult kept .	those doors forget that the school who throws that adult kept .
the dishes see who this bag who does n't stretch did n't scare .	the dishes see that this bag who does n't stretch did n't scare .
these buttons had n't noticed what the room who could hear this toy was n't buying .	these buttons had n't noticed that the room who could hear this toy was n't buying .
those boats have realized what that museum who is n't buying these women must hold .	those boats have realized that that museum who is n't buying these women must hold .
that toy has learned what this ring who that toy might hear had brought .	that toy has learned that this ring who that toy might hear had brought .
the plate wo n't learn what the book who has n't heard this school is n't finding .	the plate wo n't learn that the book who has n't heard this school is n't finding .
that couch knows what the buttons who those glasses might know make .	that couch knows that the buttons who those glasses might know make .
that car knows what the park who can take that queen is n't buying .	that car knows that the park who can take that queen is n't buying .
those toys saw what this mirror who was moving the girls has brought .	those toys saw that this mirror who was moving the girls has brought .
the shirts could forget what these shoes who could hear the shirt were n't holding .	the shirts could forget that these shoes who could hear the shirt were n't holding .
those bags have noticed who this school who cries will hate .	those bags have noticed that this school who cries will hate .
this boat can remember who the bed who throws those girls has liked .	this boat can remember that the bed who throws those girls has liked .
that glass should n't know what the boxes who knew the picture kept .	that glass should n't know that the boxes who knew the picture kept .
these doors should n't realize who this bowl who is painting has confused .	these doors should n't realize that this bowl who is painting has confused .
the cups realize what this rug who has n't found this lady will keep .	the cups realize that this rug who has n't found this lady will keep .
this ring had n't remembered who the cars who read had n't bothered .	this ring had n't remembered that the cars who read had n't bothered .
these rings may learn what those shirts who can n't hold those teachers stole .	these rings may learn that those shirts who can n't hold those teachers stole .
the trucks realize what that mall who must cough bought .	the trucks realize that that mall who must cough bought .
the mirror saw what the button who is n't talking should n't fix .	the mirror saw that the button who is n't talking should n't fix .
the shoes have remembered who these spoons who know the plate have scared .	the shoes have remembered that these spoons who know the plate have scared .
this picture knows what the cars who that ship should hear have found .	this picture knows that the cars who that ship should hear have found .
the boxes have n't learned what the crayon who was n't smiling was buying .	the boxes have n't learned that the crayon who was n't smiling was buying .
that chair has n't known who this book who had n't waved scared .	that chair has n't known that this book who had n't waved scared .
those trucks can notice what the dolls who had moved this lady keep .	those trucks can notice that the dolls who had moved this lady keep .
the book has known what the books who should know that hospital can n't keep .	the book has known that the books who should know that hospital can n't keep .
the glasses noticed who this plate who knows the glass liked .	the glasses noticed that this plate who knows the glass liked .
these rings had n't realized who the chairs who make this patient were n't bothering .	these rings had n't realized that the chairs who make this patient were n't bothering .
the bed had n't known what these buttons who lie bought .	the bed had n't known that these buttons who lie bought .
the mirror forgot what this button who talked could n't hold .	the mirror forgot that this button who talked could n't hold .
the shirt has n't realized who the book who could cry should bother .	the shirt has n't realized that the book who could cry should bother .
the bowls can realize who that crayon who is laughing should n't like .	the bowls can realize that that crayon who is laughing should n't like .
the book forgot what the windows who heard the candle steal .	the book forgot that the windows who heard the candle steal .
those beds forgot who the book who sings will scare .	those beds forgot that the book who sings will scare .
this ship realized what this boat who reads can n't fix .	this ship realized that this boat who reads can n't fix .
this candle can notice what that couch who that library can hear holds .	this candle can notice that that couch who that library can hear holds .
that door knows what the cups who cried can buy .	that door knows that the cups who cried can buy .
that bowl forgot what the cup who throws that teacher was n't keeping .	that bowl forgot that the cup who throws that teacher was n't keeping .
these windows remembered what the hospital who is waving could make .	these windows remembered that the hospital who is waving could make .
the cars had remembered what the shirts who this toy hears are n't holding .	the cars had remembered that the shirts who this toy hears are n't holding .
the pictures have known what those rings who must fix those women are n't holding .	the pictures have known that those rings who must fix those women are n't holding .
these pictures had noticed what that school who that door will hear had n't kept .	these pictures had noticed that that school who that door will hear had n't kept .
the car does n't learn who those chairs who lost like .	the car does n't learn that those chairs who lost like .
these doors did n't see what the shoe who the boats heard must fix .	these doors did n't see that the shoe who the boats heard must fix .
the car learned what this car who the fork wo n't hear could n't steal .	the car learned that this car who the fork wo n't hear could n't steal .
that box can n't see who the doors who talk are bothering .	that box can n't see that the doors who talk are bothering .
these chairs would forget who this door who knew the kitchen had bothered .	these chairs would forget that this door who knew the kitchen had bothered .
this fork has n't known what those doors who can smile fixed .	this fork has n't known that those doors who can smile fixed .
those spoons had remembered who this toy who is n't dropping the guy could n't hate .	those spoons had remembered that this toy who is n't dropping the guy could n't hate .
the shirt had n't realized who the cars who hear this bed should appreciate .	the shirt had n't realized that the cars who hear this bed should appreciate .
the truck has learned what that crayon who the library knew bought .	the truck has learned that that crayon who the library knew bought .
these chairs remembered what these shoes who the couch heard hold .	these chairs remembered that these shoes who the couch heard hold .
the bag may learn what that restaurant who would talk might sell .	the bag may learn that that restaurant who would talk might sell .
that shirt can n't remember what the book who is n't crying would fix .	that shirt can n't remember that the book who is n't crying would fix .
the beds have n't known what this box who could exercise is n't fixing .	the beds have n't known that this box who could exercise is n't fixing .
the ring had n't remembered what that restaurant who has laughed is n't finding .	the ring had n't remembered that that restaurant who has laughed is n't finding .
the beds do n't notice what that kitchen who heard these chairs stole .	the beds do n't notice that that kitchen who heard these chairs stole .
those bags forgot what the beds who had n't found the king can n't hold .	those bags forgot that the beds who had n't found the king can n't hold .
these toys should n't forget what those bottles who sneeze had n't bought .	these toys should n't forget that those bottles who sneeze had n't bought .
the toy realized what that candle who has heard these bowls makes .	the toy realized that that candle who has heard these bowls makes .
the chairs had noticed who that room who has lost should n't like .	the chairs had noticed that that room who has lost should n't like .
the door has noticed who those spoons who do n't fix those children had confused .	the door has noticed that those spoons who do n't fix those children had confused .
the candle can learn what the library who could sell the women stole .	the candle can learn that the library who could sell the women stole .
those books saw what that box who was lying is buying .	those books saw that that box who was lying is buying .
those candles have n't realized what the school who that spoon can n't know makes .	those candles have n't realized that the school who that spoon can n't know makes .
the shoe realized who the pictures who are n't shaking the adult have n't liked .	the shoe realized that the pictures who are n't shaking the adult have n't liked .
that box forgot who the books who these schools could hear praise .	that box forgot that the books who these schools could hear praise .
these bowls remembered what the books who the chair should n't hear buy .	these bowls remembered that the books who the chair should n't hear buy .
the door noticed what that bicycle who had n't fixed those ladies will sell .	the door noticed that that bicycle who had n't fixed those ladies will sell .
this doll saw what this ring who has n't waved takes .	this doll saw that this ring who has n't waved takes .
the cars realized what the cups who lost could n't fix .	the cars realized that the cups who lost could n't fix .
those rings learn what the bed who takes that patient can n't sell .	those rings learn that the bed who takes that patient can n't sell .
those cars could n't realize what these cars who drop this lady were making .	those cars could n't realize that these cars who drop this lady were making .
the boats must notice what these cars who the beds heard were n't fixing .	the boats must notice that these cars who the beds heard were n't fixing .
those shirts forgot what the rings who can lie hold .	those shirts forgot that the rings who can lie hold .
those pictures know what the room who paints bought .	those pictures know that the room who paints bought .
this shoe has known what this chair who exercises had n't made .	this shoe has known that this chair who exercises had n't made .
those crayons learned what the bowl who should n't scream is buying .	those crayons learned that the bowl who should n't scream is buying .
these dolls know who this shirt who hears these hats has n't confused .	these dolls know that this shirt who hears these hats has n't confused .
this book will see what this bed who made the adult brought .	this book will see that this bed who made the adult brought .
this ship sees what the glasses who could n't move those ladies sell .	this ship sees that the glasses who could n't move those ladies sell .
those rings realized who this car who the dishes hear confused .	those rings realized that this car who the dishes hear confused .
this dish learned what the beds who lie are n't holding .	this dish learned that the beds who lie are n't holding .
the rocket saw what these candles who the dolls heard are making .	the rocket saw that these candles who the dolls heard are making .
that rocket will notice what these doors who are fixing these doctors stole .	that rocket will notice that these doors who are fixing these doctors stole .
the box has known what the shoes who won were n't bringing .	the box has known that the shoes who won were n't bringing .
this bowl remembered who the mirror who would n't wave bothered .	this bowl remembered that the mirror who would n't wave bothered .
the bag can n't notice who the rooms who are n't yelling could n't scare .	the bag can n't notice that the rooms who are n't yelling could n't scare .
that mirror must notice what the doll who this library should know can n't hold .	that mirror must notice that the doll who this library should know can n't hold .
these spoons knew what the box who was shaking these doctors may buy .	these spoons knew that the box who was shaking these doctors may buy .
the pictures forgot who these crayons who know that hospital could n't appreciate .	the pictures forgot that these crayons who know that hospital could n't appreciate .
the chair had known what the shoes who know that kitchen would n't bring .	the chair had known that the shoes who know that kitchen would n't bring .
those dishes know who the candle who did n't clean those guys had confused .	those dishes know that the candle who did n't clean those guys had confused .
those plates know who the trucks who have kept that customer were n't bothering .	those plates know that the trucks who have kept that customer were n't bothering .
that spoon might remember what the cup who might hold this queen was n't making .	that spoon might remember that the cup who might hold this queen was n't making .
the doll remembered who those buttons who that mall knew bother .	the doll remembered that those buttons who that mall knew bother .
that plate can n't forget what that room who does n't make this dancer brought .	that plate can n't forget that that room who does n't make this dancer brought .
the beds remember who the plane who this book would hear has n't liked .	the beds remember that the plane who this book would hear has n't liked .
these pictures have seen what that room who had n't waved fixed .	these pictures have seen that that room who had n't waved fixed .
that ring had n't realized who the book who the schools have n't heard would n't appreciate .	that ring had n't realized that the book who the schools have n't heard would n't appreciate .
this spoon would know what this truck who the trucks would n't know fixed .	this spoon would know that this truck who the trucks would n't know fixed .
this bed saw who this museum who is n't singing scares .	this bed saw that this museum who is n't singing scares .
those boats had known what that hospital who had laughed brings .	those boats had known that that hospital who had laughed brings .
these bowls could know who that plane who the spoon knew did n't hate .	these bowls could know that that plane who the spoon knew did n't hate .
this truck could know who this truck who had heard this hat should hate .	this truck could know that this truck who had heard this hat should hate .
that crayon had n't realized what that park who can n't find that queen keeps .	that crayon had n't realized that that park who can n't find that queen keeps .
these plates learned what those books who could n't clean that girl bring .	these plates learned that those books who could n't clean that girl bring .
those cars learn what those dolls who had heard this hospital hold .	those cars learn that those dolls who had heard this hospital hold .
the plane learned who those trucks who were n't whispering appreciate .	the plane learned that those trucks who were n't whispering appreciate .
that plane can n't notice who this plane who might steal the person confused .	that plane can n't notice that this plane who might steal the person confused .
these cups noticed what those boats who could n't cry would fix .	these cups noticed that those boats who could n't cry would fix .
the toy could n't remember who that window who the bed knew had bothered .	the toy could n't remember that that window who the bed knew had bothered .
the shirts had n't realized who this museum who should n't scream has n't scared .	the shirts had n't realized that this museum who should n't scream has n't scared .
that ship would learn what those pictures who should clean that queen had found .	that ship would learn that those pictures who should clean that queen had found .
the dishes forget what those schools who shake these boys might find .	the dishes forget that those schools who shake these boys might find .
these shoes know what this kitchen who has the woman had bought .	these shoes know that this kitchen who has the woman had bought .
the window realized what those rings who do n't sing had n't brought .	the window realized that those rings who do n't sing had n't brought .
the bag can n't remember what that window who waved found .	the bag can n't remember that that window who waved found .
the glasses remembered what the spoons who these hats have n't heard have kept .	the glasses remembered that the spoons who these hats have n't heard have kept .
the button noticed what those buttons who are crying could take .	the button noticed that those buttons who are crying could take .
those dolls knew who this plate who has heard the picture might praise .	those dolls knew that this plate who has heard the picture might praise .
the bottle has remembered what the cups who shook that dancer were keeping .	the bottle has remembered that the cups who shook that dancer were keeping .
that ship had seen who that fork who that window heard can praise .	that ship had seen that that fork who that window heard can praise .
these books learn who the hat who could n't fix the women wo n't scare .	these books learn that the hat who could n't fix the women wo n't scare .
those spoons realize who that car who those dishes had n't heard was bothering .	those spoons realize that that car who those dishes had n't heard was bothering .
the door may notice what the dishes who take that patient might steal .	the door may notice that the dishes who take that patient might steal .
the shirt had n't learned what these schools who did n't stretch were n't buying .	the shirt had n't learned that these schools who did n't stretch were n't buying .
those bottles learned who the cups who yelled hate .	those bottles learned that the cups who yelled hate .
those crayons saw what the bowls who knew that shirt had n't taken .	those crayons saw that the bowls who knew that shirt had n't taken .
the cars do n't know who these bowls who hear this picture appreciate .	the cars do n't know that these bowls who hear this picture appreciate .
this hat had learned what that plane who has talked did n't find .	this hat had learned that that plane who has talked did n't find .
those cars might learn who the cars who lost have n't liked .	those cars might learn that the cars who lost have n't liked .
these dolls realize what the toys who heard these schools found .	these dolls realize that the toys who heard these schools found .
those windows should notice what the boat who was n't moving the guy will buy .	those windows should notice that the boat who was n't moving the guy will buy .
the toy remembered what these plates who lost that patient find .	the toy remembered that these plates who lost that patient find .
the bags have realized what this car who the mirror does n't hear keeps .	the bags have realized that this car who the mirror does n't hear keeps .
these candles had n't noticed what the restaurant who the toys have n't heard is n't buying .	these candles had n't noticed that the restaurant who the toys have n't heard is n't buying .
that chair noticed who the restaurant who moves those doctors likes .	that chair noticed that the restaurant who moves those doctors likes .
those bags notice what the bag who will exercise has n't fixed .	those bags notice that the bag who will exercise has n't fixed .
these boats may see what that bicycle who has n't thrown that queen should keep .	these boats may see that that bicycle who has n't thrown that queen should keep .
this crayon could n't remember what the mall who paints has made .	this crayon could n't remember that the mall who paints has made .
the bottles had n't realized what this chair who waves was finding .	the bottles had n't realized that this chair who waves was finding .
the doll knows what the shirt who has n't cried may take .	the doll knows that the shirt who has n't cried may take .
these dishes would n't know what the glasses who are losing this man keep .	these dishes would n't know that the glasses who are losing this man keep .
these boxes remember what these forks who took that dentist make .	these boxes remember that these forks who took that dentist make .
the bottles remember what this crayon who yelled wo n't take .	the bottles remember that this crayon who yelled wo n't take .
this mirror noticed what that bottle who would n't sing was n't fixing .	this mirror noticed that that bottle who would n't sing was n't fixing .
these chairs noticed who these candles who have n't waved have scared .	these chairs noticed that these candles who have n't waved have scared .
this plate must see what these cups who did n't sneeze could n't buy .	this plate must see that these cups who did n't sneeze could n't buy .
those cars have noticed who the boats who know that plate like .	those cars have noticed that the boats who know that plate like .
these candles had n't learned who those books who had talked can appreciate .	these candles had n't learned that those books who had talked can appreciate .
those books had known what that hat who would n't stretch should n't hold .	those books had known that that hat who would n't stretch should n't hold .
these bags forgot what those dishes who lost this woman steal .	these bags forgot that those dishes who lost this woman steal .
the chairs remembered what those boxes who take those doctors can n't buy .	the chairs remembered that those boxes who take those doctors can n't buy .
the doll has n't known who this picture who did n't drop this woman did n't like .	the doll has n't known that this picture who did n't drop this woman did n't like .
these hats learn what that bicycle who exercises kept .	these hats learn that that bicycle who exercises kept .
the crayon must notice who these books who could talk like .	the crayon must notice that these books who could talk like .
these hats would n't know who these windows who are n't dropping those children had bothered .	these hats would n't know that these windows who are n't dropping those children had bothered .
this bed knows what this ring who must win brings .	this bed knows that this ring who must win brings .
the shoes learn who this rocket who makes this boy should n't scare .	the shoes learn that this rocket who makes this boy should n't scare .
those boats can n't forget who those beds who can n't have the customer are bothering .	those boats can n't forget that those beds who can n't have the customer are bothering .
that car had n't seen who the dishes who that mall does n't know can bother .	that car had n't seen that the dishes who that mall does n't know can bother .
the cars learned what this truck who found these girls brings .	the cars learned that this truck who found these girls brings .
the cars remembered who that glass who the plate heard will scare .	the cars remembered that that glass who the plate heard will scare .
the ship had n't learned who these bags who should hear this book hate .	the ship had n't learned that these bags who should hear this book hate .
the car had n't remembered what this bowl who wo n't hold that patient was n't finding .	the car had n't remembered that this bowl who wo n't hold that patient was n't finding .
these windows saw who this school who moved these teachers was bothering .	these windows saw that this school who moved these teachers was bothering .
these glasses could n't remember what the car who the school should n't know was buying .	these glasses could n't remember that the car who the school should n't know was buying .
these beds had n't known who these schools who wave have confused .	these beds had n't known that these schools who wave have confused .
the bowls would notice what that shoe who that chair knows should buy .	the bowls would notice that that shoe who that chair knows should buy .
these bags have n't learned who those bottles who know the truck liked .	these bags have n't learned that those bottles who know the truck liked .
that bowl wo n't notice what this bowl who that rocket knew was making .	that bowl wo n't notice that this bowl who that rocket knew was making .
these trucks had n't noticed who these cars who know the bag have liked .	these trucks had n't noticed that these cars who know the bag have liked .
these dishes saw who the toys who moved this teacher scare .	these dishes saw that the toys who moved this teacher scare .
the box knew what the bed who this plate heard kept .	the box knew that the bed who this plate heard kept .
these toys notice who that candle who will sell that customer was bothering .	these toys notice that that candle who will sell that customer was bothering .
these trucks have n't realized what the mirror who was n't lying is n't fixing .	these trucks have n't realized that the mirror who was n't lying is n't fixing .
these bottles have n't remembered what the ring who the pictures hear had n't bought .	these bottles have n't remembered that the ring who the pictures hear had n't bought .
the cars realized what that museum who the ship hears has brought .	the cars realized that that museum who the ship hears has brought .
the forks had n't noticed what these chairs who paint fixed .	the forks had n't noticed that these chairs who paint fixed .
the box can n't notice what the plate who would win had n't found .	the box can n't notice that the plate who would win had n't found .
the bowls will remember what these bags who should know those buttons stole .	the bowls will remember that these bags who should know those buttons stole .
that rocket forgot what these windows who were n't cleaning the doctor had found .	that rocket forgot that these windows who were n't cleaning the doctor had found .
the chair sees what that room who should n't read makes .	the chair sees that that room who should n't read makes .
those bags learn what these beds who win bring .	those bags learn that these beds who win bring .
the plane does n't see what that picture who has n't heard the bottles would n't bring .	the plane does n't see that that picture who has n't heard the bottles would n't bring .
this plate had seen what that glass who would throw that dancer was keeping .	this plate had seen that that glass who would throw that dancer was keeping .
this bottle will realize who the library who this chair should hear had n't scared .	this bottle will realize that the library who this chair should hear had n't scared .
those bags wo n't notice who that spoon who can n't have the children scares .	those bags wo n't notice that that spoon who can n't have the children scares .
this glass knew who these forks who lie praise .	this glass knew that these forks who lie praise .
those crayons forget what these bottles who took this dancer fixed .	those crayons forget that these bottles who took this dancer fixed .
the boats had n't seen who those plates who the cup has n't heard bothered .	the boats had n't seen that those plates who the cup has n't heard bothered .
the candle has n't noticed what these dolls who are n't buying the guy steal .	the candle has n't noticed that these dolls who are n't buying the guy steal .
those pictures will forget what the ring who is laughing had n't fixed .	those pictures will forget that the ring who is laughing had n't fixed .
this shoe has n't known what these dolls who wo n't stretch were n't holding .	this shoe has n't known that these dolls who wo n't stretch were n't holding .
this bowl sees what that mall who was n't holding that dentist stole .	this bowl sees that that mall who was n't holding that dentist stole .
these dolls remembered what the window who paints bought .	these dolls remembered that the window who paints bought .
these bottles may realize what these beds who would know those dishes find .	these bottles may realize that these beds who would know those dishes find .
those cars have seen what that restaurant who was yelling must bring .	those cars have seen that that restaurant who was yelling must bring .
these chairs remember what these dolls who can n't stretch hold .	these chairs remember that these dolls who can n't stretch hold .
the chairs know who these plates who could n't drop the doctors bother .	the chairs know that these plates who could n't drop the doctors bother .
the ship forgot what this kitchen who heard this bottle would n't take .	the ship forgot that this kitchen who heard this bottle would n't take .
these glasses learn what those dolls who yelled could n't hold .	these glasses learn that those dolls who yelled could n't hold .
those chairs had learned who the bowls who would n't smile should n't praise .	those chairs had learned that the bowls who would n't smile should n't praise .
the shirts noticed who the doll who is whispering has n't scared .	the shirts noticed that the doll who is whispering has n't scared .
the rings would n't notice what that picture who is n't painting is n't finding .	the rings would n't notice that that picture who is n't painting is n't finding .
this candle knows who this shoe who the fork has heard had n't confused .	this candle knows that this shoe who the fork has heard had n't confused .
that book has seen what the door who was n't moving these doctors was n't making .	that book has seen that the door who was n't moving these doctors was n't making .
these bowls have n't known what the schools who know these bottles bring .	these bowls have n't known that the schools who know these bottles bring .
those cups see who this car who this couch did n't hear likes .	those cups see that this car who this couch did n't hear likes .
those buttons remembered who those cars who shook the doctors will scare .	those buttons remembered that those cars who shook the doctors will scare .
this chair has n't learned what the plane who might hear those shoes does n't take .	this chair has n't learned that the plane who might hear those shoes does n't take .
the picture has n't remembered what those crayons who sang had n't made .	the picture has n't remembered that those crayons who sang had n't made .
these books noticed who the bank who is n't dropping the person had n't bothered .	these books noticed that the bank who is n't dropping the person had n't bothered .
this bag had seen what the crayons who will know this hospital steal .	this bag had seen that the crayons who will know this hospital steal .
the plates have noticed what this rug who that dish knew took .	the plates have noticed that this rug who that dish knew took .
those hats remember what that hospital who should n't know those cups makes .	those hats remember that that hospital who should n't know those cups makes .
this rocket had noticed what the crayons who heard this kitchen fixed .	this rocket had noticed that the crayons who heard this kitchen fixed .
the plate knew what these cups who have cleaned the dancer buy .	the plate knew that these cups who have cleaned the dancer buy .
those shirts realize what those glasses who wo n't keep this child had found .	those shirts realize that those glasses who wo n't keep this child had found .
this ring should notice who these doors who do n't hear that toy could n't appreciate .	this ring should notice that these doors who do n't hear that toy could n't appreciate .
those hats may remember what this bottle who had waved had n't bought .	those hats may remember that this bottle who had waved had n't bought .
these cars realize what those hats who wo n't talk are finding .	these cars realize that those hats who wo n't talk are finding .
the dish had noticed what the fork who was cleaning that child took .	the dish had noticed that the fork who was cleaning that child took .
that plane saw who those rings who waved hate .	that plane saw that those rings who waved hate .
this bed had n't known what these shirts who know that shoe are n't keeping .	this bed had n't known that these shirts who know that shoe are n't keeping .
these rings can know what the plates who threw the ladies will keep .	these rings can know that the plates who threw the ladies will keep .
these plates realize what that boat who that park had heard brings .	these plates realize that that boat who that park had heard brings .
the trucks remember who that mall who sings scared .	the trucks remember that that mall who sings scared .
the candles had known what that bed who would n't fix this customer had fixed .	the candles had known that that bed who would n't fix this customer had fixed .
the toys learned what the mirror who keeps the child brings .	the toys learned that the mirror who keeps the child brings .
these shirts had remembered what that spoon who is n't buying that child brought .	these shirts had remembered that that spoon who is n't buying that child brought .
these trucks had remembered what the cups who stretch must take .	these trucks had remembered that the cups who stretch must take .
the mirror sees what that bowl who does n't talk is n't keeping .	the mirror sees that that bowl who does n't talk is n't keeping .
that plate had n't noticed who those cars who that button can n't know had n't scared .	that plate had n't noticed that those cars who that button can n't know had n't scared .
the car knows who those windows who fix that queen will scare .	the car knows that those windows who fix that queen will scare .
the shirts remembered who the cars who might cough could n't bother .	the shirts remembered that the cars who might cough could n't bother .
this cup saw who this mall who does n't read scares .	this cup saw that this mall who does n't read scares .
the trucks learned what those doors who should n't hear those plates were buying .	the trucks learned that those doors who should n't hear those plates were buying .
the couch could n't see who that ship who these dolls know has n't scared .	the couch could n't see that that ship who these dolls know has n't scared .
this book has seen who the candle who brought these guys could appreciate .	this book has seen that the candle who brought these guys could appreciate .
those cars noticed who that bowl who won wo n't like .	those cars noticed that that bowl who won wo n't like .
this cup knows what the doors who are n't yelling could make .	this cup knows that the doors who are n't yelling could make .
those rings must forget who those crayons who laughed bothered .	those rings must forget that those crayons who laughed bothered .
these windows learned who that box who has n't talked has n't scared .	these windows learned that that box who has n't talked has n't scared .
this bag had n't known who that library who must make those boys scares .	this bag had n't known that that library who must make those boys scares .
the cup has n't noticed what those windows who were n't throwing this lady can sell .	the cup has n't noticed that those windows who were n't throwing this lady can sell .
the book had n't seen who those buttons who heard the crayon bother .	the book had n't seen that those buttons who heard the crayon bother .
these shirts should n't know who the rug who hears these doors might appreciate .	these shirts should n't know that the rug who hears these doors might appreciate .
this picture did n't realize who the dolls who knew that crayon could praise .	this picture did n't realize that the dolls who knew that crayon could praise .
this car realized who the windows who were waving confused .	this car realized that the windows who were waving confused .
the dish would forget who those forks who will hear this spoon had n't bothered .	the dish would forget that those forks who will hear this spoon had n't bothered .
those dolls would n't know what this doll who hears these cups took .	those dolls would n't know that this doll who hears these cups took .
these crayons must learn what this candle who shakes the teacher was keeping .	these crayons must learn that this candle who shakes the teacher was keeping .
those candles notice what this school who wo n't hear that bottle is n't taking .	those candles notice that this school who wo n't hear that bottle is n't taking .
those toys have n't remembered what that car who must paint may fix .	those toys have n't remembered that that car who must paint may fix .
the hats knew who these rooms who the dish knows hate .	the hats knew that these rooms who the dish knows hate .
the bag had realized what that restaurant who the kitchen would hear has n't kept .	the bag had realized that that restaurant who the kitchen would hear has n't kept .
these books forget what the candles who the hats should know held .	these books forget that the candles who the hats should know held .
the button realized what these bags who the school did n't know brought .	the button realized that these bags who the school did n't know brought .
this chair did n't see what these books who this bottle had n't heard were n't bringing .	this chair did n't see that these books who this bottle had n't heard were n't bringing .
the candles realize what those toys who were keeping that lady had found .	the candles realize that those toys who were keeping that lady had found .
the shirts have n't seen what that glass who wo n't clean the boy was n't buying .	the shirts have n't seen that that glass who wo n't clean the boy was n't buying .
that door had n't noticed what the hats who lose the men sell .	that door had n't noticed that the hats who lose the men sell .
these chairs learn what that bicycle who makes those ladies had n't brought .	these chairs learn that that bicycle who makes those ladies had n't brought .
that plane can remember what the cups who hear those toys fix .	that plane can remember that the cups who hear those toys fix .
those candles learn what the bank who was whispering could n't take .	those candles learn that the bank who was whispering could n't take .
the bowls should see what these trucks who stretch were n't buying .	the bowls should see that these trucks who stretch were n't buying .
the book had realized what the dishes who lie are n't holding .	the book had realized that the dishes who lie are n't holding .
the boat would n't notice what this kitchen who will cry should take .	the boat would n't notice that this kitchen who will cry should take .
the ship learned what that doll who can hear this bowl takes .	the ship learned that that doll who can hear this bowl takes .
this button noticed what the toy who does n't bring that teacher will buy .	this button noticed that the toy who does n't bring that teacher will buy .
the bottles do n't realize who that boat who knew these chairs has n't bothered .	the bottles do n't realize that that boat who knew these chairs has n't bothered .
that window had remembered what this spoon who talked held .	that window had remembered that this spoon who talked held .
the cars remembered what this school who exercises was n't fixing .	the cars remembered that this school who exercises was n't fixing .
that box had n't seen what the crayons who knew these rooms buy .	that box had n't seen that the crayons who knew these rooms buy .
the hats noticed what this crayon who must lose can steal .	the hats noticed that this crayon who must lose can steal .
the shirts had n't known who these spoons who are throwing this dancer bother .	the shirts had n't known that these spoons who are throwing this dancer bother .
this rug forgot who this couch who does n't make that driver had bothered .	this rug forgot that this couch who does n't make that driver had bothered .
that truck sees what that door who shakes this customer has n't bought .	that truck sees that that door who shakes this customer has n't bought .
the car noticed what the pictures who would sneeze could make .	the car noticed that the pictures who would sneeze could make .
the bowls know who that hospital who is smiling likes .	the bowls know that that hospital who is smiling likes .
those boxes saw what those beds who were n't bringing this dentist were buying .	those boxes saw that those beds who were n't bringing this dentist were buying .
the box would know what the candle who wo n't practice held .	the box would know that the candle who wo n't practice held .
the spoon did n't learn who that dish who would scream does n't scare .	the spoon did n't learn that that dish who would scream does n't scare .
this bed has n't seen who that picture who knows that couch has bothered .	this bed has n't seen that that picture who knows that couch has bothered .
the crayons remember what these books who sing wo n't bring .	the crayons remember that these books who sing wo n't bring .
these glasses knew what the toy who hears those buttons has found .	these glasses knew that the toy who hears those buttons has found .
those trucks notice what that picture who sang had n't held .	those trucks notice that that picture who sang had n't held .
this car remembered what this boat who hears the rooms is finding .	this car remembered that this boat who hears the rooms is finding .
these boats had realized who the hats who this doll knew appreciate .	these boats had realized that the hats who this doll knew appreciate .
those shirts forget what these candles who clean the adult might bring .	those shirts forget that these candles who clean the adult might bring .
this bottle saw what the button who should n't wave stole .	this bottle saw that the button who should n't wave stole .
these dolls realize who these shirts who have n't painted hate .	these dolls realize that these shirts who have n't painted hate .
these plates will know what these boxes who must take that boy fixed .	these plates will know that these boxes who must take that boy fixed .
that chair would notice what that ring who had n't kept that lady will steal .	that chair would notice that that ring who had n't kept that lady will steal .
the chair realized who those schools who sing praise .	the chair realized that those schools who sing praise .
that couch had seen who the books who had yelled could appreciate .	that couch had seen that the books who had yelled could appreciate .
these doors will see who the rings who have n't heard this bank appreciate .	these doors will see that the rings who have n't heard this bank appreciate .
that chair might realize who these dolls who find this customer have liked .	that chair might realize that these dolls who find this customer have liked .
the pictures have n't noticed who this bank who that doll heard could praise .	the pictures have n't noticed that this bank who that doll heard could praise .
those forks saw what this dish who did n't sing was finding .	those forks saw that this dish who did n't sing was finding .
those dolls realize what that room who lost the doctors can n't fix .	those dolls realize that that room who lost the doctors can n't fix .
the hats forget who the buttons who have read have bothered .	the hats forget that the buttons who have read have bothered .
these plates know what this rug who the rings would know fixed .	these plates know that this rug who the rings would know fixed .
those bags learned what that button who should n't win is n't finding .	those bags learned that that button who should n't win is n't finding .
those dishes see what that rocket who makes the adult stole .	those dishes see that that rocket who makes the adult stole .
the shoes had known what the doll who was singing has brought .	the shoes had known that the doll who was singing has brought .
these books had noticed what these shoes who had heard this bed would take .	these books had noticed that these shoes who had heard this bed would take .
this car sees what those bowls who are holding the dentist must bring .	this car sees that those bowls who are holding the dentist must bring .
this plane can n't know what the bank who cries had bought .	this plane can n't know that the bank who cries had bought .
those dishes can learn what the mall who wo n't know that toy is fixing .	those dishes can learn that the mall who wo n't know that toy is fixing .
that window has n't known what the book who these buttons knew bought .	that window has n't known that the book who these buttons knew bought .
these glasses learned what the bed who had dropped this doctor had n't made .	these glasses learned that the bed who had dropped this doctor had n't made .
this dish knows who these buttons who know that bicycle will like .	this dish knows that these buttons who know that bicycle will like .
the bag remembered what that mall who was n't yelling bought .	the bag remembered that that mall who was n't yelling bought .
that dish does n't realize what these doors who wo n't sneeze took .	that dish does n't realize that these doors who wo n't sneeze took .
the fork learned what that cup who hears those spoons must buy .	the fork learned that that cup who hears those spoons must buy .
those books learn what these windows who do n't find that dancer should keep .	those books learn that these windows who do n't find that dancer should keep .
the book has remembered what this crayon who is bringing that teacher would n't find .	the book has remembered that this crayon who is bringing that teacher would n't find .
the shirt should forget what that mall who was n't losing the guys kept .	the shirt should forget that that mall who was n't losing the guys kept .
this bowl had n't remembered who the car who is cleaning the driver confused .	this bowl had n't remembered that the car who is cleaning the driver confused .
those bottles noticed who these cars who could take that man had scared .	those bottles noticed that these cars who could take that man had scared .
that box learned what this plate who wo n't cough has n't made .	that box learned that this plate who wo n't cough has n't made .
this ring could see what those rings who will throw the king were n't bringing .	this ring could see that those rings who will throw the king were n't bringing .
those cars could n't realize what this book who has n't made that dentist took .	those cars could n't realize that this book who has n't made that dentist took .
that truck knew what those hats who lose are n't holding .	that truck knew that those hats who lose are n't holding .
these plates had n't learned who those windows who would n't yell might hate .	these plates had n't learned that those windows who would n't yell might hate .
these forks knew what this glass who may sell those teachers bought .	these forks knew that this glass who may sell those teachers bought .
those boats had known what the hat who was n't losing must fix .	those boats had known that the hat who was n't losing must fix .
these bowls notice what these doors who should n't sneeze bring .	these bowls notice that these doors who should n't sneeze bring .
those candles should forget what that school who bought this woman was n't keeping .	those candles should forget that that school who bought this woman was n't keeping .
the dolls see what that bottle who has n't heard the book is making .	the dolls see that that bottle who has n't heard the book is making .
that doll learned who this hospital who that car must hear scares .	that doll learned that this hospital who that car must hear scares .
these cars can remember who those bowls who could exercise liked .	these cars can remember that those bowls who could exercise liked .
this hat saw what the windows who should hear the buttons had made .	this hat saw that the windows who should hear the buttons had made .
these books realize what the books who have this lady found .	these books realize that the books who have this lady found .
the spoons forget what the book who cries has n't made .	the spoons forget that the book who cries has n't made .
the mirror forgot what this school who had n't cleaned the men was n't holding .	the mirror forgot that this school who had n't cleaned the men was n't holding .
those candles forget what the cups who sneeze bought .	those candles forget that the cups who sneeze bought .
the dolls forgot what the ring who has bought this dentist has n't bought .	the dolls forgot that the ring who has bought this dentist has n't bought .
these bags knew what the boat who would know this school was n't finding .	these bags knew that the boat who would know this school was n't finding .
the bowls remembered what this doll who bought this doctor is n't fixing .	the bowls remembered that this doll who bought this doctor is n't fixing .
the car knows what the boats who should smile sell .	the car knows that the boats who should smile sell .
that plate did n't learn who the pictures who hear this park bother .	that plate did n't learn that the pictures who hear this park bother .
this book may realize who those forks who cry praise .	this book may realize that those forks who cry praise .
these beds know what this school who would stretch will buy .	these beds know that this school who would stretch will buy .
that button can n't remember what the doors who brought that woman hold .	that button can n't remember that the doors who brought that woman hold .
the trucks learn who the bags who have this customer had n't liked .	the trucks learn that the bags who have this customer had n't liked .
those beds had n't known what those shirts who have n't yelled would keep .	those beds had n't known that those shirts who have n't yelled would keep .
those candles knew who these cars who had heard this candle had liked .	those candles knew that these cars who had heard this candle had liked .
that button forgot what the window who heard this car stole .	that button forgot that the window who heard this car stole .
the glass has n't seen who that shirt who had heard these spoons had liked .	the glass has n't seen that that shirt who had heard these spoons had liked .
these candles could notice who this shoe who may yell would bother .	these candles could notice that this shoe who may yell would bother .
that toy had n't remembered what these cups who have fixed that lady have brought .	that toy had n't remembered that these cups who have fixed that lady have brought .
this bed could n't know who the toys who the bottle can know had n't liked .	this bed could n't know that the toys who the bottle can know had n't liked .
the car might see what the rooms who hear those shirts steal .	the car might see that the rooms who hear those shirts steal .
those buttons have learned what these doors who have n't taken the guy found .	those buttons have learned that these doors who have n't taken the guy found .
the bags will know what those books who made that child would n't hold .	the bags will know that those books who made that child would n't hold .
that car had realized who the mall who is n't moving this king can hate .	that car had realized that the mall who is n't moving this king can hate .
those trucks had remembered who that ship who the school heard bothered .	those trucks had remembered that that ship who the school heard bothered .
that toy has n't seen what that window who wo n't stretch has held .	that toy has n't seen that that window who wo n't stretch has held .
this plane has n't noticed what that rocket who that car hears is n't buying .	this plane has n't noticed that that rocket who that car hears is n't buying .
those bottles could n't notice what that bottle who has n't brought this girl brings .	those bottles could n't notice that that bottle who has n't brought this girl brings .
that ring sees who the button who the buttons heard had n't scared .	that ring sees that the button who the buttons heard had n't scared .
those plates may learn who that park who those cups know had liked .	those plates may learn that that park who those cups know had liked .
the truck knows what the mall who knows this shoe brings .	the truck knows that the mall who knows this shoe brings .
these bags see who these boats who this hospital hears should hate .	these bags see that these boats who this hospital hears should hate .
this rug learned what that hat who heard these schools is n't buying .	this rug learned that that hat who heard these schools is n't buying .
these cars had n't noticed what that toy who knew the dishes took .	these cars had n't noticed that that toy who knew the dishes took .
this plate must see what the crayon who has moved this girl is n't keeping .	this plate must see that the crayon who has moved this girl is n't keeping .
those cups had n't known who the hat who has talked had bothered .	those cups had n't known that the hat who has talked had bothered .
the books had n't seen what these schools who take the girls would n't take .	the books had n't seen that these schools who take the girls would n't take .
the bags do n't see what that cup who the buttons might know takes .	the bags do n't see that that cup who the buttons might know takes .
these books know what the plane who will yell found .	these books know that the plane who will yell found .
the toy remembered what these windows who these pictures hear have held .	the toy remembered that these windows who these pictures hear have held .
that shoe sees who these shirts who throw the patient had confused .	that shoe sees that these shirts who throw the patient had confused .
these crayons see who the shoe who waves confused .	these crayons see that the shoe who waves confused .
this glass has learned who the glasses who heard the picture hate .	this glass has learned that the glasses who heard the picture hate .
the fork wo n't forget what these glasses who would cry bought .	the fork wo n't forget that these glasses who would cry bought .
the books learn who that crayon who knew those toys can n't appreciate .	the books learn that that crayon who knew those toys can n't appreciate .
these shirts had realized what these chairs who were lying hold .	these shirts had realized that these chairs who were lying hold .
the plates noticed what that shirt who may talk wo n't make .	the plates noticed that that shirt who may talk wo n't make .
this glass saw what this book who the cars know would steal .	this glass saw that this book who the cars know would steal .
that window learned who those candles who the chair had heard bothered .	that window learned that those candles who the chair had heard bothered .
the books knew who that school who wo n't sing should bother .	the books knew that that school who wo n't sing should bother .
these candles have remembered what those beds who the hats wo n't hear brought .	these candles have remembered that those beds who the hats wo n't hear brought .
that book had n't remembered what these spoons who bought the women found .	that book had n't remembered that these spoons who bought the women found .
the cars remembered who those hats who knew the glass praise .	the cars remembered that those hats who knew the glass praise .
this candle can n't learn what these boxes who that fork heard can sell .	this candle can n't learn that these boxes who that fork heard can sell .
the cup learned who these plates who knew this chair scared .	the cup learned that these plates who knew this chair scared .
the bottles realize who those cars who those schools have n't heard would praise .	the bottles realize that those cars who those schools have n't heard would praise .
those cars realized what that bowl who knew those boats will fix .	those cars realized that that bowl who knew those boats will fix .
the windows saw what the books who hear that plane steal .	the windows saw that the books who hear that plane steal .
these plates have seen what the boats who can cry fixed .	these plates have seen that the boats who can cry fixed .
that dish has n't remembered who these shoes who lost the child may appreciate .	that dish has n't remembered that these shoes who lost the child may appreciate .
the car does n't see what this candle who wo n't hear these rooms keeps .	the car does n't see that this candle who wo n't hear these rooms keeps .
this doll has realized who the rings who have lost praise .	this doll has realized that the rings who have lost praise .
the boat had learned who the schools who must sing have liked .	the boat had learned that the schools who must sing have liked .
these pictures forget what these pictures who that bag may hear are buying .	these pictures forget that these pictures who that bag may hear are buying .
the picture realized who the books who hear that candle liked .	the picture realized that the books who hear that candle liked .
the rings might realize who the crayon who had n't heard the rings likes .	the rings might realize that the crayon who had n't heard the rings likes .
the button has remembered what these boxes who could bring this queen made .	the button has remembered that these boxes who could bring this queen made .
the cars notice what those buttons who were bringing that child might fix .	the cars notice that those buttons who were bringing that child might fix .
that door should n't forget who these boats who lose would n't appreciate .	that door should n't forget that these boats who lose would n't appreciate .
these bowls have n't realized who that glass who had n't brought that patient scared .	these bowls have n't realized that that glass who had n't brought that patient scared .
those dishes knew what the rug who the bank should n't hear is fixing .	those dishes knew that the rug who the bank should n't hear is fixing .
that boat does n't know what this library who should hear that picture had n't found .	that boat does n't know that this library who should hear that picture had n't found .
those pictures must know who the car who the cars heard has scared .	those pictures must know that the car who the cars heard has scared .
this bottle had learned who those cars who shook the men were bothering .	this bottle had learned that those cars who shook the men were bothering .
these candles might learn who these boxes who might win confused .	these candles might learn that these boxes who might win confused .
that picture had n't realized what the dolls who have found this adult can fix .	that picture had n't realized that the dolls who have found this adult can fix .
the toys have n't noticed what this cup who may hear this hospital has brought .	the toys have n't noticed that this cup who may hear this hospital has brought .
the pictures noticed what these rings who can know the boats take .	the pictures noticed that these rings who can know the boats take .
those cars have known what these bowls who take those women fix .	those cars have known that these bowls who take those women fix .
those candles see who the spoons who do n't wave might like .	those candles see that the spoons who do n't wave might like .
those chairs see who the windows who the book had n't heard confused .	those chairs see that the windows who the book had n't heard confused .
this spoon saw what this book who lost brought .	this spoon saw that this book who lost brought .
this cup must know what the rooms who that glass heard will keep .	this cup must know that the rooms who that glass heard will keep .
these pictures can n't notice what that chair who can n't hear this dish was n't fixing .	these pictures can n't notice that that chair who can n't hear this dish was n't fixing .
that candle has n't seen who the library who knew this car bothered .	that candle has n't seen that the library who knew this car bothered .
the book saw who this plane who stole the adult could hate .	the book saw that this plane who stole the adult could hate .
these books had n't seen what the candle who was n't finding the driver makes .	these books had n't seen that the candle who was n't finding the driver makes .
the cars might notice who the truck who was singing bothered .	the cars might notice that the truck who was singing bothered .
this dish realized what these rings who must bring that guy have n't found .	this dish realized that these rings who must bring that guy have n't found .
the bowls should remember who this bed who stole this woman does n't like .	the bowls should remember that this bed who stole this woman does n't like .
the boats know what those shirts who have lost must take .	the boats know that those shirts who have lost must take .
that bed forgot who these bottles who were n't finding the girl bothered .	that bed forgot that these bottles who were n't finding the girl bothered .
the crayon knew what this toy who has n't talked is finding .	the crayon knew that this toy who has n't talked is finding .
the beds have seen who those trucks who can n't know these cars can praise .	the beds have seen that those trucks who can n't know these cars can praise .
that bottle has remembered what this car who knows the pictures found .	that bottle has remembered that this car who knows the pictures found .
the boat forgot what this glass who has n't heard these crayons takes .	the boat forgot that this glass who has n't heard these crayons takes .
these boats learn who that fork who has the person would n't bother .	these boats learn that that fork who has the person would n't bother .
these toys noticed what this school who won can make .	these toys noticed that this school who won can make .
those spoons realized who the plate who is n't losing has n't bothered .	those spoons realized that the plate who is n't losing has n't bothered .
the books remember what these buttons who drop these boys were n't holding .	the books remember that these buttons who drop these boys were n't holding .
that plate noticed what the chairs who should n't know the rings take .	that plate noticed that the chairs who should n't know the rings take .
these trucks had seen who those hats who knew these shirts like .	these trucks had seen that those hats who knew these shirts like .
those books have noticed what these schools who would throw those girls were n't keeping .	those books have noticed that these schools who would throw those girls were n't keeping .
this bicycle sees what those pictures who have n't won steal .	this bicycle sees that those pictures who have n't won steal .
this car has learned what this school who has lost the children has brought .	this car has learned that this school who has lost the children has brought .
the pictures know who the plates who can make that driver liked .	the pictures know that the plates who can make that driver liked .
this hat saw who those beds who were n't screaming do n't praise .	this hat saw that those beds who were n't screaming do n't praise .
these books learn what this library who this bed will know had found .	these books learn that this library who this bed will know had found .
that book had realized what those toys who keep those people hold .	that book had realized that those toys who keep those people hold .
these bags would realize what the toys who these bags hear will hold .	these bags would realize that the toys who these bags hear will hold .
this couch had n't known who these pictures who this candle heard bothered .	this couch had n't known that these pictures who this candle heard bothered .
that box knows what the shirts who are n't making the doctors found .	that box knows that the shirts who are n't making the doctors found .
the shoes may know what this hat who would n't paint was making .	the shoes may know that this hat who would n't paint was making .
this box has n't known what those pictures who cleaned this adult kept .	this box has n't known that those pictures who cleaned this adult kept .
the bottles do n't remember what this school who those bowls will know was n't finding .	the bottles do n't remember that this school who those bowls will know was n't finding .
the shirts noticed what the bottles who took the customer have n't kept .	the shirts noticed that the bottles who took the customer have n't kept .
the trucks know what that school who makes this patient is n't bringing .	the trucks know that that school who makes this patient is n't bringing .
the toys had n't seen what that ship who yelled might find .	the toys had n't seen that that ship who yelled might find .
those bags could n't remember who the windows who wo n't wave were bothering .	those bags could n't remember that the windows who wo n't wave were bothering .
those pictures could n't learn what that car who kept these people makes .	those pictures could n't learn that that car who kept these people makes .
the buttons could n't realize what this candle who knows these bowls should n't take .	the buttons could n't realize that this candle who knows these bowls should n't take .
these glasses have n't noticed who these dolls who did n't scream confused .	these glasses have n't noticed that these dolls who did n't scream confused .
those dishes had learned who the shirt who waves had n't confused .	those dishes had learned that the shirt who waves had n't confused .
that doll realized who the museum who these hats knew confused .	that doll realized that the museum who these hats knew confused .
that rug must remember who the glass who must bring this dancer bothered .	that rug must remember that the glass who must bring this dancer bothered .
the dishes can realize what the books who found the adult buy .	the dishes can realize that the books who found the adult buy .
this glass forgot who this truck who this rug knew was bothering .	this glass forgot that this truck who this rug knew was bothering .
the cars remember who the plates who had n't dropped these women hate .	the cars remember that the plates who had n't dropped these women hate .
this book knows what that picture who that plane heard keeps .	this book knows that that picture who that plane heard keeps .
those beds forgot what the cars who lost were n't taking .	those beds forgot that the cars who lost were n't taking .
these crayons may forget what the spoons who talk are n't buying .	these crayons may forget that the spoons who talk are n't buying .
the bottles had n't noticed what the forks who are reading stole .	the bottles had n't noticed that the forks who are reading stole .
those buttons must see who the hospital who was practicing has n't liked .	those buttons must see that the hospital who was practicing has n't liked .
these spoons had n't learned who these cars who heard these dolls are n't bothering .	these spoons had n't learned that these cars who heard these dolls are n't bothering .
the cup saw what those plates who were n't making the adult found .	the cup saw that those plates who were n't making the adult found .
that ship knows who these boxes who hear these schools should n't hate .	that ship knows that these boxes who hear these schools should n't hate .
the toy forgot what the schools who that bank did n't know fixed .	the toy forgot that the schools who that bank did n't know fixed .
the candles notice what this restaurant who has n't yelled held .	the candles notice that this restaurant who has n't yelled held .
this box noticed who these schools who will have this queen might hate .	this box noticed that these schools who will have this queen might hate .
the door can learn what these buttons who sang made .	the door can learn that these buttons who sang made .
this plane could learn who that fork who heard the crayon would appreciate .	this plane could learn that that fork who heard the crayon would appreciate .
the ship has n't realized what the chair who these crayons can n't know had n't fixed .	the ship has n't realized that the chair who these crayons can n't know had n't fixed .
this truck has n't learned what this library who was n't shaking this dancer should take .	this truck has n't learned that this library who was n't shaking this dancer should take .
that hat saw what the windows who will clean that driver can take .	that hat saw that the windows who will clean that driver can take .
those shoes see what those dishes who heard this toy fixed .	those shoes see that those dishes who heard this toy fixed .
those glasses could learn what the fork who had n't talked found .	those glasses could learn that the fork who had n't talked found .
the beds had n't realized what the trucks who those cars hear fix .	the beds had n't realized that the trucks who those cars hear fix .
this picture has seen what this school who fixed the girl found .	this picture has seen that this school who fixed the girl found .
this plate forgot who the room who had n't bought the man can n't hate .	this plate forgot that the room who had n't bought the man can n't hate .
these bottles had realized who the plate who drops that queen could appreciate .	these bottles had realized that the plate who drops that queen could appreciate .
this book knows who the bowls who that ring had n't heard bother .	this book knows that the bowls who that ring had n't heard bother .
the car saw what that plane who may hear this dish had kept .	the car saw that that plane who may hear this dish had kept .
these pictures could n't realize what the couch who is yelling found .	these pictures could n't realize that the couch who is yelling found .
the dish learned what the boat who the candle had n't heard can steal .	the dish learned that the boat who the candle had n't heard can steal .
these bottles realize what the candles who lost the child took .	these bottles realize that the candles who lost the child took .
the book had n't noticed what those schools who had heard the shoes hold .	the book had n't noticed that those schools who had heard the shoes hold .
the bag knows who these books who that window heard scared .	the bag knows that these books who that window heard scared .
the beds forget what those cups who sneeze have brought .	the beds forget that those cups who sneeze have brought .
those windows remember who the glass who does n't hear the crayons likes .	those windows remember that the glass who does n't hear the crayons likes .
the cars saw what this book who that restaurant did n't hear bought .	the cars saw that this book who that restaurant did n't hear bought .
the hat would see what the forks who should n't hear the schools have kept .	the hat would see that the forks who should n't hear the schools have kept .
that book had seen what this shoe who would n't take these women was buying .	that book had seen that this shoe who would n't take these women was buying .
the shoe had realized who those trucks who smile have bothered .	the shoe had realized that those trucks who smile have bothered .
the plates do n't remember what the bags who would hear this bottle buy .	the plates do n't remember that the bags who would hear this bottle buy .
the plates saw what the cups who had n't found the girls stole .	the plates saw that the cups who had n't found the girls stole .
the cars notice who those rooms who have n't found those girls are bothering .	the cars notice that those rooms who have n't found those girls are bothering .
the plate should n't see what these schools who were finding the child are finding .	the plate should n't see that these schools who were finding the child are finding .
the couch has n't realized what these rings who are crying held .	the couch has n't realized that these rings who are crying held .
those forks learned who that bed who has n't heard the beds liked .	those forks learned that that bed who has n't heard the beds liked .
those cars know what those trucks who wo n't win were buying .	those cars know that those trucks who wo n't win were buying .
these cars wo n't learn who this book who knows this hat has n't scared .	these cars wo n't learn that this book who knows this hat has n't scared .
those glasses noticed who the spoon who heard the schools bothered .	those glasses noticed that the spoon who heard the schools bothered .
this hat should see who those hats who stretch have scared .	this hat should see that those hats who stretch have scared .
the books did n't learn who the cup who hears the cars could praise .	the books did n't learn that the cup who hears the cars could praise .
that button realized who those boxes who read scare .	that button realized that those boxes who read scare .
that picture knew what that hat who has n't heard the school held .	that picture knew that that hat who has n't heard the school held .
the books noticed what the cars who those books knew should n't take .	the books noticed that the cars who those books knew should n't take .
this couch knew what these books who have read took .	this couch knew that these books who have read took .
the bowls know what this doll who these trucks have heard fixed .	the bowls know that this doll who these trucks have heard fixed .
this plate has known what these plates who were reading had n't fixed .	this plate has known that these plates who were reading had n't fixed .
the cups learned what the bed who the truck can n't know fixed .	the cups learned that the bed who the truck can n't know fixed .
this fork realized what that rug who that museum has heard is making .	this fork realized that that rug who that museum has heard is making .
those buttons learned who the school who had n't lost has n't scared .	those buttons learned that the school who had n't lost has n't scared .
the plates could remember who those boats who are waving bother .	the plates could remember that those boats who are waving bother .
this doll would n't see who this fork who was waving bothered .	this doll would n't see that this fork who was waving bothered .
these trucks had realized what those glasses who the glass heard were n't keeping .	these trucks had realized that those glasses who the glass heard were n't keeping .
those doors could remember who these doors who this book does n't hear had n't liked .	those doors could remember that these doors who this book does n't hear had n't liked .
the dish noticed what that window who is n't practicing kept .	the dish noticed that that window who is n't practicing kept .
those candles may remember what this truck who has n't dropped the customer kept .	those candles may remember that this truck who has n't dropped the customer kept .
those bags do n't notice what this doll who can smile is n't fixing .	those bags do n't notice that this doll who can smile is n't fixing .
those shoes would n't realize what the bank who did n't lie wo n't hold .	those shoes would n't realize that the bank who did n't lie wo n't hold .
these bags saw who that plate who is talking must bother .	these bags saw that that plate who is talking must bother .
this bottle realized who the bowls who keep the queen liked .	this bottle realized that the bowls who keep the queen liked .
these boxes do n't learn what this mirror who these trucks did n't hear is taking .	these boxes do n't learn that this mirror who these trucks did n't hear is taking .
this door has n't remembered what the library who kept the man bought .	this door has n't remembered that the library who kept the man bought .
this bottle has known what the dish who hears this button does n't find .	this bottle has known that the dish who hears this button does n't find .
that bed realized who those spoons who had n't heard the toy wo n't hate .	that bed realized that those spoons who had n't heard the toy wo n't hate .
this chair has learned what the mirror who the library had n't heard found .	this chair has learned that the mirror who the library had n't heard found .
those buttons can n't notice what this dish who the bottle should hear held .	those buttons can n't notice that this dish who the bottle should hear held .
the forks know what this park who heard these rings must find .	the forks know that this park who heard these rings must find .
these shirts remember who those boats who knew that ship had n't bothered .	these shirts remember that those boats who knew that ship had n't bothered .
the bottle has n't realized who this bowl who is laughing has bothered .	the bottle has n't realized that this bowl who is laughing has bothered .
that window has n't noticed who these cups who can n't whisper scare .	that window has n't noticed that these cups who can n't whisper scare .
those trucks know what this mirror who yelled was making .	those trucks know that this mirror who yelled was making .
those glasses learn what that school who waved must hold .	those glasses learn that that school who waved must hold .
the car will learn what that shoe who waved would steal .	the car will learn that that shoe who waved would steal .
the crayons should know who these chairs who threw the person were n't bothering .	the crayons should know that these chairs who threw the person were n't bothering .
the buttons realize what the hospital who would n't smile could n't sell .	the buttons realize that the hospital who would n't smile could n't sell .
the bottle may see what those doors who knew those shirts have n't bought .	the bottle may see that those doors who knew those shirts have n't bought .
that mirror sees what those plates who kept that driver take .	that mirror sees that those plates who kept that driver take .
these bags have noticed who the spoons who the chairs should n't hear scare .	these bags have noticed that the spoons who the chairs should n't hear scare .
the trucks see what the bag who is n't yelling brings .	the trucks see that the bag who is n't yelling brings .
the books notice who the hospital who this truck heard must scare .	the books notice that the hospital who this truck heard must scare .
this toy learned what these spoons who that glass knows have n't kept .	this toy learned that these spoons who that glass knows have n't kept .
those spoons wo n't learn who this room who can n't find the doctors has scared .	those spoons wo n't learn that this room who can n't find the doctors has scared .
these trucks learned who the park who heard these forks likes .	these trucks learned that the park who heard these forks likes .
this spoon has n't noticed what the plane who made the adult had n't brought .	this spoon has n't noticed that the plane who made the adult had n't brought .
the spoon had n't known who these cars who have laughed like .	the spoon had n't known that these cars who have laughed like .
this shoe might remember what those toys who this fork heard are n't holding .	this shoe might remember that those toys who this fork heard are n't holding .
this book learned who those plates who lie have confused .	this book learned that those plates who lie have confused .
those dishes could n't forget what those windows who would n't lift those guys took .	those dishes could n't forget that those windows who would n't lift those guys took .
the bowls realize what this bag who that bed has n't heard did n't fix .	the bowls realize that this bag who that bed has n't heard did n't fix .
this glass noticed what this mirror who should n't know that shirt keeps .	this glass noticed that this mirror who should n't know that shirt keeps .
that bed realized what the boats who exercise keep .	that bed realized that the boats who exercise keep .
these books can n't learn what these bottles who did n't hear those schools make .	these books can n't learn that these bottles who did n't hear those schools make .
this door sees who those windows who know those windows were n't bothering .	this door sees that those windows who know those windows were n't bothering .
the bags would know what the park who is painting found .	the bags would know that the park who is painting found .
this plane can n't learn who those chairs who these dolls can hear bothered .	this plane can n't learn that those chairs who these dolls can hear bothered .
the candles see what the buttons who were n't bringing the ladies had brought .	the candles see that the buttons who were n't bringing the ladies had brought .
the cars had n't seen what that plane who knew that library held .	the cars had n't seen that that plane who knew that library held .
those spoons had n't noticed who this box who is n't laughing does n't like .	those spoons had n't noticed that this box who is n't laughing does n't like .
these bowls knew who the kitchen who had talked should n't bother .	these bowls knew that the kitchen who had talked should n't bother .
the spoons can n't learn who the fork who has those people confused .	the spoons can n't learn that the fork who has those people confused .
these boats do n't notice who the dish who has n't thrown the patient does n't bother .	these boats do n't notice that the dish who has n't thrown the patient does n't bother .
these hats realize what the mirror who heard those hats was keeping .	these hats realize that the mirror who heard those hats was keeping .
these glasses learned what that restaurant who read should fix .	these glasses learned that that restaurant who read should fix .
those doors saw what those chairs who practice keep .	those doors saw that those chairs who practice keep .
these windows should learn what the boats who had n't heard the door are making .	these windows should learn that the boats who had n't heard the door are making .
the hat had seen what that bowl who did n't cough will sell .	the hat had seen that that bowl who did n't cough will sell .
the books do n't remember who the picture who talked confused .	the books do n't remember that the picture who talked confused .
the bed remembered what this bowl who these bags should hear has n't kept .	the bed remembered that this bowl who these bags should hear has n't kept .
these boats forgot what the ship who will talk made .	these boats forgot that the ship who will talk made .
this crayon must learn what the boat who waved had fixed .	this crayon must learn that the boat who waved had fixed .
these hats learned who the fork who the spoon has heard liked .	these hats learned that the fork who the spoon has heard liked .
the trucks know what that room who has n't heard the rooms might keep .	the trucks know that that room who has n't heard the rooms might keep .
those books wo n't realize what those bottles who the museum hears have kept .	those books wo n't realize that those bottles who the museum hears have kept .
these pictures learn who the mirror who the dolls would hear might praise .	these pictures learn that the mirror who the dolls would hear might praise .
the forks remembered what these rings who the shoes hear fix .	the forks remembered that these rings who the shoes hear fix .
the cups noticed what the bed who is keeping the boys found .	the cups noticed that the bed who is keeping the boys found .
this button had remembered who the shirt who this restaurant knows has n't bothered .	this button had remembered that the shirt who this restaurant knows has n't bothered .
this box can n't learn what the dishes who painted find .	this box can n't learn that the dishes who painted find .
the rings remember what that dish who has n't won was holding .	the rings remember that that dish who has n't won was holding .
the button knew what that boat who hears these schools will take .	the button knew that that boat who hears these schools will take .
the bowl has n't learned what the cups who those schools could know have kept .	the bowl has n't learned that the cups who those schools could know have kept .
that book noticed who that library who has waved does n't scare .	that book noticed that that library who has waved does n't scare .
those dolls have learned what that spoon who would n't move this patient had held .	those dolls have learned that that spoon who would n't move this patient had held .
the shirts can notice who the mirror who the museum has n't heard had confused .	the shirts can notice that the mirror who the museum has n't heard had confused .
these crayons could n't learn what this mirror who has dropped that driver has n't fixed .	these crayons could n't learn that this mirror who has dropped that driver has n't fixed .
these cups know who that hospital who talked is n't bothering .	these cups know that that hospital who talked is n't bothering .
that window forgot what the toys who stretch fixed .	that window forgot that the toys who stretch fixed .
the car might notice what those boats who know this bank have n't bought .	the car might notice that those boats who know this bank have n't bought .
the toys knew what that bank who might fix the women was n't buying .	the toys knew that that bank who might fix the women was n't buying .
those cars remembered who that chair who can n't lose those women might bother .	those cars remembered that that chair who can n't lose those women might bother .
this truck could forget what the chairs who this door hears sell .	this truck could forget that the chairs who this door hears sell .
this glass has n't learned what that candle who read had n't taken .	this glass has n't learned that that candle who read had n't taken .
the plane knows who the buttons who take the adult hate .	the plane knows that the buttons who take the adult hate .
these cars can remember what that kitchen who that kitchen had heard kept .	these cars can remember that that kitchen who that kitchen had heard kept .
this rug could n't know what this candle who this park knew is n't fixing .	this rug could n't know that this candle who this park knew is n't fixing .
these doors saw who this car who should hear that window liked .	these doors saw that this car who should hear that window liked .
this picture has noticed what these cars who heard this crayon buy .	this picture has noticed that these cars who heard this crayon buy .
that door remembered who the cups who are n't reading scared .	that door remembered that the cups who are n't reading scared .
this ring can forget who this fork who read has confused .	this ring can forget that this fork who read has confused .
that plate has learned what these windows who hear those schools will buy .	that plate has learned that these windows who hear those schools will buy .
the mirror sees what this door who read brings .	the mirror sees that this door who read brings .
the candle could see what this toy who knew the fork had taken .	the candle could see that this toy who knew the fork had taken .
those cars would forget who the schools who sang scare .	those cars would forget that the schools who sang scare .
the car knows what that candle who has n't waved took .	the car knows that that candle who has n't waved took .
this door could forget who those spoons who were holding the guy would praise .	this door could forget that those spoons who were holding the guy would praise .
those chairs would n't realize what these glasses who had n't bought this boy were n't taking .	those chairs would n't realize that these glasses who had n't bought this boy were n't taking .
these shirts learn who these bags who should n't know those crayons would like .	these shirts learn that these bags who should n't know those crayons would like .
that bicycle had n't noticed what that bowl who knew those doors keeps .	that bicycle had n't noticed that that bowl who knew those doors keeps .
those dolls realized who the box who waves had n't liked .	those dolls realized that the box who waves had n't liked .
those bottles remember what the bags who are n't bringing the people steal .	those bottles remember that the bags who are n't bringing the people steal .
the rug may remember what these shoes who are losing should find .	the rug may remember that these shoes who are losing should find .
this box had n't noticed what these bottles who have found that boy make .	this box had n't noticed that these bottles who have found that boy make .
these dolls had n't known what that library who had cleaned the teachers took .	these dolls had n't known that that library who had cleaned the teachers took .
the windows have n't noticed who this cup who knows that ring liked .	the windows have n't noticed that this cup who knows that ring liked .
those boats know what these cups who were n't talking should find .	those boats know that these cups who were n't talking should find .
these bowls noticed what the plate who would cry was n't keeping .	these bowls noticed that the plate who would cry was n't keeping .
the doors learn what this doll who brought the teachers was keeping .	the doors learn that this doll who brought the teachers was keeping .
these trucks realized what the ring who is n't waving kept .	these trucks realized that the ring who is n't waving kept .
this car noticed who those rings who talk hate .	this car noticed that those rings who talk hate .
the bag knows what that book who the books would n't know has taken .	the bag knows that that book who the books would n't know has taken .
this crayon had n't known who those cars who that ship has n't heard have n't bothered .	this crayon had n't known that those cars who that ship has n't heard have n't bothered .
the window saw what that rug who talks brought .	the window saw that that rug who talks brought .
these boats should n't forget what this ring who has the doctors is bringing .	these boats should n't forget that this ring who has the doctors is bringing .
the picture remembered who the restaurant who throws the man likes .	the picture remembered that the restaurant who throws the man likes .
these books remembered what that box who knew this rocket has fixed .	these books remembered that that box who knew this rocket has fixed .
that bottle remembered what that glass who lost the boys had n't bought .	that bottle remembered that that glass who lost the boys had n't bought .
that ring should remember who those books who those schools had heard hate .	that ring should remember that those books who those schools had heard hate .
this bag had learned what the toys who might cough find .	this bag had learned that the toys who might cough find .
the glass had n't noticed who this window who was reading liked .	the glass had n't noticed that this window who was reading liked .
the bicycle remembered who the dolls who heard the hat have n't liked .	the bicycle remembered that the dolls who heard the hat have n't liked .
the spoon had n't known what the window who was n't practicing will steal .	the spoon had n't known that the window who was n't practicing will steal .
those chairs have n't learned what the spoon who holds those people can buy .	those chairs have n't learned that the spoon who holds those people can buy .
these books have n't learned what this book who the chair hears made .	these books have n't learned that this book who the chair hears made .
this truck realized who that plane who knows that hat confused .	this truck realized that that plane who knows that hat confused .
this cup knew who that room who had n't heard this bottle should praise .	this cup knew that that room who had n't heard this bottle should praise .
this dish learned what these doors who had heard this room bring .	this dish learned that these doors who had heard this room bring .
these shoes have n't known who those forks who have n't yelled have confused .	these shoes have n't known that those forks who have n't yelled have confused .
the bowl sees what these toys who won fixed .	the bowl sees that these toys who won fixed .
those windows have noticed what the shirt who may yell had n't held .	those windows have noticed that the shirt who may yell had n't held .
the cars knew what the rings who have n't heard that window bought .	the cars knew that the rings who have n't heard that window bought .
those boxes have n't known what that toy who did n't talk was n't making .	those boxes have n't known that that toy who did n't talk was n't making .
the books can n't learn what the boxes who cry are n't buying .	the books can n't learn that the boxes who cry are n't buying .
this bottle noticed what those boxes who shake the teachers can n't hold .	this bottle noticed that those boxes who shake the teachers can n't hold .
the shoes forget what the museum who has n't lost the people made .	the shoes forget that the museum who has n't lost the people made .
that toy had seen who those candles who whisper had n't bothered .	that toy had seen that those candles who whisper had n't bothered .
these spoons notice what the room who those cups knew makes .	these spoons notice that the room who those cups knew makes .
this bowl knows what these toys who throw these women kept .	this bowl knows that these toys who throw these women kept .
those crayons wo n't know what that shoe who the plates hear could n't take .	those crayons wo n't know that that shoe who the plates hear could n't take .
that button may know who the bowls who that glass hears can n't praise .	that button may know that the bowls who that glass hears can n't praise .
this door had n't learned who the library who has heard that cup bothered .	this door had n't learned that the library who has heard that cup bothered .
those cars can forget what those dishes who wo n't sneeze bought .	those cars can forget that those dishes who wo n't sneeze bought .
the bottle learned what these dolls who would n't lie may bring .	the bottle learned that these dolls who would n't lie may bring .
that glass would n't notice who the bicycle who may cough scares .	that glass would n't notice that the bicycle who may cough scares .
that box had known who those trucks who could n't buy these boys like .	that box had known that those trucks who could n't buy these boys like .
the bed has known who these hats who sang have n't confused .	the bed has known that these hats who sang have n't confused .
the beds must realize what those candles who bring this customer were fixing .	the beds must realize that those candles who bring this customer were fixing .
that bag forgot what those bottles who have n't laughed kept .	that bag forgot that those bottles who have n't laughed kept .
the candles forget what that bank who had n't heard this button would fix .	the candles forget that that bank who had n't heard this button would fix .
those cars had learned what that crayon who does n't fix the queen held .	those cars had learned that that crayon who does n't fix the queen held .
this truck had n't remembered who the fork who knows the kitchen can like .	this truck had n't remembered that the fork who knows the kitchen can like .
the shoes forgot what those buttons who would n't hear this mall keep .	the shoes forgot that those buttons who would n't hear this mall keep .
the boats would forget what those shoes who had lost could steal .	the boats would forget that those shoes who had lost could steal .
these trucks had n't learned what these doors who had n't fixed that patient have brought .	these trucks had n't learned that these doors who had n't fixed that patient have brought .
the cars forget what those windows who found the man keep .	the cars forget that those windows who found the man keep .
the plate has n't seen what those crayons who would n't hear this mirror would n't steal .	the plate has n't seen that those crayons who would n't hear this mirror would n't steal .
the plates forget who this dish who should smile can n't praise .	the plates forget that this dish who should smile can n't praise .
these dolls noticed what that spoon who won brought .	these dolls noticed that that spoon who won brought .
the candles might forget what the hospital who had heard those schools was keeping .	the candles might forget that the hospital who had heard those schools was keeping .
those cars realize who this truck who must throw that teacher would n't hate .	those cars realize that this truck who must throw that teacher would n't hate .
those plates have noticed what this fork who the library knew is finding .	those plates have noticed that this fork who the library knew is finding .
these bowls did n't see what those cars who would know these dishes have n't made .	these bowls did n't see that those cars who would know these dishes have n't made .
the doors could know who this doll who hears that mirror scares .	the doors could know that this doll who hears that mirror scares .
those beds do n't notice what these forks who won steal .	those beds do n't notice that these forks who won steal .
these books have n't realized what the truck who was n't crying is n't finding .	these books have n't realized that the truck who was n't crying is n't finding .
that book had n't known what those boxes who knew those rooms were holding .	that book had n't known that those boxes who knew those rooms were holding .
that ring had n't seen who this cup who must keep the king can scare .	that ring had n't seen that this cup who must keep the king can scare .
these hats remember what the cups who are yelling are making .	these hats remember that the cups who are yelling are making .
those chairs can learn who the windows who that school hears hate .	those chairs can learn that the windows who that school hears hate .
that hat might realize what those cars who the glasses know have found .	that hat might realize that those cars who the glasses know have found .
that bed learned what that car who is n't making that customer would n't steal .	that bed learned that that car who is n't making that customer would n't steal .
the window can realize who those crayons who are n't painting liked .	the window can realize that those crayons who are n't painting liked .
those pictures noticed what the dish who had n't talked takes .	those pictures noticed that the dish who had n't talked takes .
this bag remembered what that kitchen who brought these children was n't holding .	this bag remembered that that kitchen who brought these children was n't holding .
these doors realized what the bottles who had n't made the teachers could n't fix .	these doors realized that the bottles who had n't made the teachers could n't fix .
that book had n't remembered who those cups who had n't heard those cups scare .	that book had n't remembered that those cups who had n't heard those cups scare .
the trucks would n't remember who that rocket who this box hears scared .	the trucks would n't remember that that rocket who this box hears scared .
this bicycle has n't noticed who the shoe who is losing does n't scare .	this bicycle has n't noticed that the shoe who is losing does n't scare .
the toys had noticed who those buttons who have heard that window praise .	the toys had noticed that those buttons who have heard that window praise .
this bottle knows what the dish who this book had n't heard held .	this bottle knows that the dish who this book had n't heard held .
the shirts can n't remember what those hats who sell the person have n't bought .	the shirts can n't remember that those hats who sell the person have n't bought .
these boats could remember what this bicycle who was buying these women takes .	these boats could remember that this bicycle who was buying these women takes .
this spoon had seen who the cars who have painted had bothered .	this spoon had seen that the cars who have painted had bothered .
this bowl has realized what the doll who stole the men had bought .	this bowl has realized that the doll who stole the men had bought .
that boat might learn who that bank who talks had bothered .	that boat might learn that that bank who talks had bothered .
those shoes wo n't see what the bottle who is n't smiling found .	those shoes wo n't see that the bottle who is n't smiling found .
the glasses could see who that chair who will sell that doctor scared .	the glasses could see that that chair who will sell that doctor scared .
those shoes forgot what those toys who knew that spoon kept .	those shoes forgot that those toys who knew that spoon kept .
this shirt noticed what those spoons who kept the ladies are fixing .	this shirt noticed that those spoons who kept the ladies are fixing .
the candle had seen what these beds who hear this picture took .	the candle had seen that these beds who hear this picture took .
this truck realized what this button who those shirts knew took .	this truck realized that this button who those shirts knew took .
the beds remember what that shoe who that truck knows took .	the beds remember that that shoe who that truck knows took .
these bottles know who the couch who knew this button would appreciate .	these bottles know that the couch who knew this button would appreciate .
that truck noticed what that crayon who can n't know the chair has taken .	that truck noticed that that crayon who can n't know the chair has taken .
the boats remembered what this truck who cried has n't brought .	the boats remembered that this truck who cried has n't brought .
these shirts had n't realized what those bottles who this school heard bring .	these shirts had n't realized that those bottles who this school heard bring .
the plane forgot who that bank who has n't read may hate .	the plane forgot that that bank who has n't read may hate .
the candle knows what this ship who did n't read holds .	the candle knows that this ship who did n't read holds .
that chair had known who the candle who has cleaned that child confused .	that chair had known that the candle who has cleaned that child confused .
those boats could n't see what the door who that rocket knew had held .	those boats could n't see that the door who that rocket knew had held .
these buttons remembered what this rocket who is reading takes .	these buttons remembered that this rocket who is reading takes .
those buttons see who these trucks who were screaming scare .	those buttons see that these trucks who were screaming scare .
that bed wo n't know what those shirts who had n't talked would take .	that bed wo n't know that those shirts who had n't talked would take .
the glasses have learned what these dolls who knew that room had n't taken .	the glasses have learned that these dolls who knew that room had n't taken .
the cup had n't realized what the room who sang will sell .	the cup had n't realized that the room who sang will sell .
those forks forgot who those books who laughed scare .	those forks forgot that those books who laughed scare .
the buttons wo n't notice who those glasses who had laughed do n't praise .	the buttons wo n't notice that those glasses who had laughed do n't praise .
this doll did n't learn what the toys who have n't heard these dishes sell .	this doll did n't learn that the toys who have n't heard these dishes sell .
that dish has known who the toys who that spoon heard like .	that dish has known that the toys who that spoon heard like .
the toy saw what those bottles who were losing fix .	the toy saw that those bottles who were losing fix .
this cup has n't noticed who the crayons who hear those cars have n't liked .	this cup has n't noticed that the crayons who hear those cars have n't liked .
the shoes have n't known what the button who has kept the boy must find .	the shoes have n't known that the button who has kept the boy must find .
this door saw what that room who those schools knew has found .	this door saw that that room who those schools knew has found .
the ship did n't realize who this book who the rocket knows would n't appreciate .	the ship did n't realize that this book who the rocket knows would n't appreciate .
those doors knew what these rooms who this chair would know should bring .	those doors knew that these rooms who this chair would know should bring .
the fork does n't learn what these trucks who are n't painting are n't holding .	the fork does n't learn that these trucks who are n't painting are n't holding .
those beds remembered who that car who is cleaning these ladies bothered .	those beds remembered that that car who is cleaning these ladies bothered .
these boxes saw what the dolls who could n't know these hats buy .	these boxes saw that the dolls who could n't know these hats buy .
the books do n't learn what the toys who have heard that school sell .	the books do n't learn that the toys who have heard that school sell .
the picture forgot what these boxes who may exercise take .	the picture forgot that these boxes who may exercise take .
this button might learn what this school who will know the doll kept .	this button might learn that this school who will know the doll kept .
that ship remembered what those chairs who should steal that patient may take .	that ship remembered that those chairs who should steal that patient may take .
that bed has seen who the doors who were bringing the dentist have n't liked .	that bed has seen that the doors who were bringing the dentist have n't liked .
that couch will learn what that bowl who took these girls was fixing .	that couch will learn that that bowl who took these girls was fixing .
that mirror had n't noticed what those shirts who can smile had made .	that mirror had n't noticed that those shirts who can smile had made .
the bottle should n't notice what the boats who can scream had n't taken .	the bottle should n't notice that the boats who can scream had n't taken .
these pictures had learned who this button who is taking the patient scared .	these pictures had learned that this button who is taking the patient scared .
the rings remember what this hospital who the bicycle heard has held .	the rings remember that this hospital who the bicycle heard has held .
these bowls remembered who that truck who can n't fix the teachers had n't scared .	these bowls remembered that that truck who can n't fix the teachers had n't scared .
these spoons have learned who the button who is n't finding that child does n't bother .	these spoons have learned that the button who is n't finding that child does n't bother .
those glasses should know what this window who this couch hears brings .	those glasses should know that this window who this couch hears brings .
the doll sees who these forks who painted confused .	the doll sees that these forks who painted confused .
that window forgot what that book who these chairs knew brings .	that window forgot that that book who these chairs knew brings .
this window has n't known what the museum who was n't crying held .	this window has n't known that the museum who was n't crying held .
the chair saw who those windows who this shoe knows had n't liked .	the chair saw that those windows who this shoe knows had n't liked .
these crayons have realized who the boats who these bowls hear scare .	these crayons have realized that the boats who these bowls hear scare .
those glasses remember what the doors who were n't finding the dancer bring .	those glasses remember that the doors who were n't finding the dancer bring .
these hats do n't remember what that room who wo n't laugh was n't holding .	these hats do n't remember that that room who wo n't laugh was n't holding .
those cars see who the toy who knew this bed was n't bothering .	those cars see that the toy who knew this bed was n't bothering .
those rings should notice who the candles who must hold the dentist did n't bother .	those rings should notice that the candles who must hold the dentist did n't bother .
the candles noticed who that dish who these books have n't heard must scare .	the candles noticed that that dish who these books have n't heard must scare .
this cup realized who that kitchen who is screaming does n't hate .	this cup realized that that kitchen who is screaming does n't hate .
this cup sees who those spoons who could hear the toys do n't hate .	this cup sees that those spoons who could hear the toys do n't hate .
these chairs know what that plate who the ship knows had held .	these chairs know that that plate who the ship knows had held .
the plane forgot who that car who waved had confused .	the plane forgot that that car who waved had confused .
those books should n't notice what the spoon who may hear that couch makes .	those books should n't notice that the spoon who may hear that couch makes .
this boat remembered who this box who knew this car likes .	this boat remembered that this box who knew this car likes .
the car could n't notice what that picture who had read was holding .	the car could n't notice that that picture who had read was holding .
this spoon has n't remembered what that couch who moved these men can take .	this spoon has n't remembered that that couch who moved these men can take .
the doll could n't notice who these toys who the boat knew liked .	the doll could n't notice that these toys who the boat knew liked .
these bowls saw who these schools who are reading bothered .	these bowls saw that these schools who are reading bothered .
this bowl may notice what that school who sings is taking .	this bowl may notice that that school who sings is taking .
that book must forget who those books who wo n't read have scared .	that book must forget that those books who wo n't read have scared .
the button should n't notice what this hat who can n't smile holds .	the button should n't notice that this hat who can n't smile holds .
these hats did n't see what this glass who was talking was finding .	these hats did n't see that this glass who was talking was finding .
these windows remembered what those windows who will clean this queen were n't making .	these windows remembered that those windows who will clean this queen were n't making .
the rings forgot what those bags who paint steal .	the rings forgot that those bags who paint steal .
this glass realized what those doors who could take the doctors could n't take .	this glass realized that those doors who could take the doctors could n't take .
this plate forgot what this door who has bought the guy was n't holding .	this plate forgot that this door who has bought the guy was n't holding .
the chairs have learned what that ship who can smile stole .	the chairs have learned that that ship who can smile stole .
these windows realize what that bed who the rings had heard must take .	these windows realize that that bed who the rings had heard must take .
the books had noticed what those bags who this kitchen knows make .	the books had noticed that those bags who this kitchen knows make .
the bowls remembered what the school who was losing must buy .	the bowls remembered that the school who was losing must buy .
these forks could n't forget who this school who that park could hear liked .	these forks could n't forget that this school who that park could hear liked .
this boat knew what those shirts who had n't taken the women might bring .	this boat knew that those shirts who had n't taken the women might bring .
this car realized who the plate who was fixing those doctors liked .	this car realized that the plate who was fixing those doctors liked .
this ring had remembered what the toy who can cough has kept .	this ring had remembered that the toy who can cough has kept .
the car had seen what these buttons who lost held .	the car had seen that these buttons who lost held .
this book has n't realized what the dishes who yelled steal .	this book has n't realized that the dishes who yelled steal .
that rocket might notice who the restaurant who was losing these guys can like .	that rocket might notice that the restaurant who was losing these guys can like .
the shoes do n't forget who these bottles who should win liked .	the shoes do n't forget that these bottles who should win liked .
that doll had known who those boxes who were singing bothered .	that doll had known that those boxes who were singing bothered .
this ring has n't realized what the pictures who the rooms know can n't fix .	this ring has n't realized that the pictures who the rooms know can n't fix .
this dish could n't remember what this bed who brought that lady was n't taking .	this dish could n't remember that this bed who brought that lady was n't taking .
the door could n't see what these trucks who that button hears may keep .	the door could n't see that these trucks who that button hears may keep .
this bicycle has learned what these crayons who did n't whisper have n't found .	this bicycle has learned that these crayons who did n't whisper have n't found .
the cars know who these windows who bought that king have n't scared .	the cars know that these windows who bought that king have n't scared .
this bottle knows what these pictures who had fixed these women were n't fixing .	this bottle knows that these pictures who had fixed these women were n't fixing .
these bowls realized what the school who is n't waving holds .	these bowls realized that the school who is n't waving holds .
these candles have remembered who these trucks who could steal those women would n't praise .	these candles have remembered that these trucks who could steal those women would n't praise .
the dish can n't realize who those glasses who those doors could hear had n't liked .	the dish can n't realize that those glasses who those doors could hear had n't liked .
the book must forget what that book who that couch knows brought .	the book must forget that that book who that couch knows brought .
that rug had n't learned what the doors who hear these boxes could take .	that rug had n't learned that the doors who hear these boxes could take .
that shirt can n't know what this candle who this crayon can know kept .	that shirt can n't know that this candle who this crayon can know kept .
this candle would n't notice who these bottles who could hold the customer bothered .	this candle would n't notice that these bottles who could hold the customer bothered .
the candles see who the candle who might know that cup did n't praise .	the candles see that the candle who might know that cup did n't praise .
the bed sees what that boat who has bought the men should n't make .	the bed sees that that boat who has bought the men should n't make .
the rings had realized who the crayons who read should n't bother .	the rings had realized that the crayons who read should n't bother .
this boat could remember who this hat who has n't lost bothered .	this boat could remember that this hat who has n't lost bothered .
those cups can learn what that book who made the girl is making .	those cups can learn that that book who made the girl is making .
this book wo n't forget what that doll who was waving wo n't buy .	this book wo n't forget that that doll who was waving wo n't buy .
these cups wo n't see who that spoon who moves these people would n't like .	these cups wo n't see that that spoon who moves these people would n't like .
the ship may remember what these books who won would n't make .	the ship may remember that these books who won would n't make .
the doors learned what the door who will sneeze has n't kept .	the doors learned that the door who will sneeze has n't kept .
these forks had n't known what the rooms who might have those girls have made .	these forks had n't known that the rooms who might have those girls have made .
that ship learned what these shirts who laughed have bought .	that ship learned that these shirts who laughed have bought .
the truck could notice who that window who these schools have heard bothered .	the truck could notice that that window who these schools have heard bothered .
the cars know who those hats who practice liked .	the cars know that those hats who practice liked .
these bags learn what this cup who must talk must find .	these bags learn that this cup who must talk must find .
these crayons did n't remember what these beds who the car heard can n't hold .	these crayons did n't remember that these beds who the car heard can n't hold .
the dolls saw who that window who must hear this bed does n't praise .	the dolls saw that that window who must hear this bed does n't praise .
these cups have n't seen what that car who wo n't keep this adult is n't making .	these cups have n't seen that that car who wo n't keep this adult is n't making .
this shoe can n't notice what the rooms who knew these dolls stole .	this shoe can n't notice that the rooms who knew these dolls stole .
this box forgot who those cups who lose have confused .	this box forgot that those cups who lose have confused .
that chair might remember what these chairs who can n't hear the book have n't bought .	that chair might remember that these chairs who can n't hear the book have n't bought .
