what does that person keep while dropping those hats ?	what does that person keep those hats while dropping ?
where would that dentist return to before leaving the bank ?	where would that dentist return to the bank before leaving ?
what had that customer held before holding these cars ?	what had that customer held these cars before holding ?
what are the ladies throwing after buying the rocket ?	what are the ladies throwing the rocket after buying ?
what could these people make after bringing those plates ?	what could these people make those plates after bringing ?
what has the patient held without dropping the book ?	what has the patient held the book without dropping ?
who has the patient visited after working with that boy ?	who has the patient visited that boy after working with ?
what are those girls breaking before breaking the toy ?	what are those girls breaking the toy before breaking ?
what have these children found while holding that bicycle ?	what have these children found that bicycle while holding ?
what have those doors broken without breaking the books ?	what have those doors broken the books without breaking ?
who will the dentist appreciate while listening to the lady ?	who will the dentist appreciate the lady while listening to ?
where were the boys walking through while leaving that school ?	where were the boys walking through that school while leaving ?
what is this teacher cleaning before shaking these trucks ?	what is this teacher cleaning these trucks before shaking ?
what could that book break without breaking the crayons ?	what could that book break the crayons without breaking ?
who has this man scared while teaching this dentist ?	who has this man scared this dentist while teaching ?
what would these guys fix before fixing these bottles ?	what would these guys fix these bottles before fixing ?
what has that person taken while finding those beds ?	what has that person taken those beds while finding ?
what had this girl talked about without talking about this customer ?	what had this girl talked about this customer without talking about ?
what have these women lost while moving those chairs ?	what have these women lost those chairs while moving ?
who has the dentist worked with without talking to those teachers ?	who has the dentist worked with those teachers without talking to ?
what do these men take after cleaning the candles ?	what do these men take the candles after cleaning ?
what can this crayon break without breaking the dishes ?	what can this crayon break the dishes without breaking ?
what could this dish break before breaking these cars ?	what could this dish break these cars before breaking ?
who have those people found before working with the boys ?	who have those people found the boys before working with ?
what could the guys take while dropping this car ?	what could the guys take this car while dropping ?
what have these doctors lost while finding the cars ?	what have these doctors lost the cars while finding ?
what is the teacher breaking without breaking that box ?	what is the teacher breaking that box without breaking ?
where were those doctors walking through while running around this kitchen ?	where were those doctors walking through this kitchen while running around ?
what have the children seen before thinking about these bowls ?	what have the children seen these bowls before thinking about ?
who was this teacher listening to before teaching that person ?	who was this teacher listening to that person before teaching ?
who did the woman answer after teaching these people ?	who did the woman answer these people after teaching ?
what did the dentist shake after bringing the buttons ?	what did the dentist shake the buttons after bringing ?
where will the patient drive to while going to that kitchen ?	where will the patient drive to that kitchen while going to ?
who is that person helping while visiting the patient ?	who is that person helping the patient while visiting ?
who does that king teach before bothering that girl ?	who does that king teach that girl before bothering ?
what were those horses breaking without breaking the plate ?	what were those horses breaking the plate without breaking ?
what would this doctor move without shaking these boxes ?	what would this doctor move these boxes without shaking ?
what has the king found before losing these dishes ?	what has the king found these dishes before losing ?
what should these plates break without breaking this mirror ?	what should these plates break this mirror without breaking ?
what could this boy love before thinking about that ring ?	what could this boy love that ring before thinking about ?
who will the women care for while helping the dentist ?	who will the women care for the dentist while helping ?
what can this adult hold before buying those bags ?	what can this adult hold those bags before buying ?
what did that queen see before thinking about this cat ?	what did that queen see this cat before thinking about ?
what is this guy dropping while bringing this fork ?	what is this guy dropping this fork while bringing ?
who will this dentist praise after bothering the girl ?	who will this dentist praise the girl after bothering ?
who has this queen confused without talking to this dentist ?	who has this queen confused this dentist without talking to ?
what had this teacher remembered while thinking about that window ?	what had this teacher remembered that window while thinking about ?
what is this person breaking after breaking this boat ?	what is this person breaking this boat after breaking ?
who can this queen visit without helping those girls ?	who can this queen visit those girls without helping ?
what will the woman make without taking those cars ?	what will the woman make those cars without taking ?
who should the lady worry before visiting the queen ?	who should the lady worry the queen before visiting ?
who has this guy helped after teaching these ladies ?	who has this guy helped these ladies after teaching ?
what are those cars breaking while breaking these buttons ?	what are those cars breaking these buttons while breaking ?
what did that man throw without fixing those rings ?	what did that man throw those rings without fixing ?
what was the boy holding without bringing this book ?	what was the boy holding this book without bringing ?
what should that boy hold after taking those trucks ?	what should that boy hold those trucks after taking ?
what does the driver keep without making the buttons ?	what does the driver keep the buttons without making ?
what have the boys taken while fixing these boxes ?	what have the boys taken these boxes while fixing ?
what has that button broken without breaking this shirt ?	what has that button broken this shirt without breaking ?
what are the birds thinking about after thinking about this bed ?	what are the birds thinking about this bed after thinking about ?
what should this man break while breaking that chair ?	what should this man break that chair while breaking ?
what could those teachers fix after dropping these plates ?	what could those teachers fix these plates after dropping ?
what are these children finding while taking the spoon ?	what are these children finding the spoon while taking ?
what had these girls kept without losing those buttons ?	what had these girls kept those buttons without losing ?
what would these people like while thinking about that picture ?	what would these people like that picture while thinking about ?
what will this customer have after bringing that picture ?	what will this customer have that picture after bringing ?
what should these girls fix while fixing the shirts ?	what should these girls fix the shirts while fixing ?
what did this candle break after breaking this glass ?	what did this candle break this glass after breaking ?
who will this adult visit before working with the girl ?	who will this adult visit the girl before working with ?
what had this patient thrown while making these dishes ?	what had this patient thrown these dishes while making ?
what were those doctors finding without taking this rocket ?	what were those doctors finding this rocket without taking ?
what do the ladies talk about without talking about that boat ?	what do the ladies talk about that boat without talking about ?
what will that toy break while breaking the trucks ?	what will that toy break the trucks while breaking ?
what could the picture break without breaking this glass ?	what could the picture break this glass without breaking ?
who are the doctors bothering while talking to those guys ?	who are the doctors bothering those guys while talking to ?
what does that cat break after breaking this doll ?	what does that cat break this doll after breaking ?
what can those mice break without breaking the bottle ?	what can those mice break the bottle without breaking ?
who does the queen visit before working with this patient ?	who does the queen visit this patient before working with ?
what was this girl breaking before breaking this car ?	what was this girl breaking this car before breaking ?
what was this man holding without dropping these books ?	what was this man holding these books without dropping ?
what will the people steal before holding the books ?	what will the people steal the books before holding ?
what had these children brought after shaking this couch ?	what had these children brought this couch after shaking ?
where had this doctor walked through before running around this kitchen ?	where had this doctor walked through this kitchen before running around ?
what has this doctor held before dropping the book ?	what has this doctor held the book before dropping ?
what do the cups break after breaking those pictures ?	what do the cups break those pictures after breaking ?
who could the lady work with while working with the king ?	who could the lady work with the king while working with ?
where will this woman run around without leaving this mall ?	where will this woman run around this mall without leaving ?
what did those guys hate after thinking about the girls ?	what did those guys hate the girls after thinking about ?
what were the snakes breaking while breaking that fork ?	what were the snakes breaking that fork while breaking ?
who would those women work with after visiting these guys ?	who would those women work with these guys after visiting ?
what can the birds hate without thinking about that truck ?	what can the birds hate that truck without thinking about ?
what was this girl dropping before making the cup ?	what was this girl dropping the cup before making ?
what was that adult shaking while buying these bottles ?	what was that adult shaking these bottles while buying ?
what was the queen making after finding the glasses ?	what was the queen making the glasses after finding ?
what does the dancer clean after cleaning the hat ?	what does the dancer clean the hat after cleaning ?
what do these horses see before thinking about those glasses ?	what do these horses see those glasses before thinking about ?
what will this king fix before shaking these cars ?	what will this king fix these cars before shaking ?
who could the ladies help after bothering the boy ?	who could the ladies help the boy after bothering ?
what had that dentist made before dropping those books ?	what had that dentist made those books before dropping ?
what is the dancer holding while finding these windows ?	what is the dancer holding these windows while finding ?
what could these women take before keeping that mirror ?	what could these women take that mirror before keeping ?
what are these girls shaking while shaking this bicycle ?	what are these girls shaking this bicycle while shaking ?
who could that teacher answer without helping these women ?	who could that teacher answer these women without helping ?
who was the queen visiting while working with those guys ?	who was the queen visiting those guys while working with ?
where is that queen leaving after leaving these rooms ?	where is that queen leaving these rooms after leaving ?
what had those hats broken before breaking the window ?	what had those hats broken the window before breaking ?
what had this dentist moved after moving the plane ?	what had this dentist moved the plane after moving ?
who should these ladies listen to after helping the child ?	who should these ladies listen to the child after helping ?
what had these doctors held before moving the mirror ?	what had these doctors held the mirror before moving ?
what does that glass break while breaking the car ?	what does that glass break the car while breaking ?
who will those girls talk to after working with this woman ?	who will those girls talk to this woman after working with ?
what can the doctors break without breaking those crayons ?	what can the doctors break those crayons without breaking ?
what would these men hold before bringing that candle ?	what would these men hold that candle before bringing ?
who was the man working with after bothering that person ?	who was the man working with that person after bothering ?
who is the driver listening to before listening to the customer ?	who is the driver listening to the customer before listening to ?
what was that customer dropping after fixing this picture ?	what was that customer dropping this picture after fixing ?
what could this rabbit like after thinking about that door ?	what could this rabbit like that door after thinking about ?
what were those guys cleaning before losing the toy ?	what were those guys cleaning the toy before losing ?
what did these women bring while finding this bottle ?	what did these women bring this bottle while finding ?
what will this bowl break before breaking this crayon ?	what will this bowl break this crayon before breaking ?
where can those girls pass after leaving that restaurant ?	where can those girls pass that restaurant after leaving ?
what has the ship broken while breaking the dishes ?	what has the ship broken the dishes while breaking ?
what can these people hate before thinking about this boat ?	what can these people hate this boat before thinking about ?
what had this plane broken without breaking this toy ?	what had this plane broken this toy without breaking ?
where do the teachers go to while walking through that museum ?	where do the teachers go to that museum while walking through ?
where do the men walk through without driving to that library ?	where do the men walk through that library without driving to ?
what should the adult shake after finding that spoon ?	what should the adult shake that spoon after finding ?
what should the customer steal after throwing that ship ?	what should the customer steal that ship after throwing ?
what had the cups broken after breaking the door ?	what had the cups broken the door after breaking ?
who had those ladies helped without visiting the ladies ?	who had those ladies helped the ladies without visiting ?
what have these teachers thrown while keeping this bed ?	what have these teachers thrown this bed while keeping ?
who was the driver talking to without visiting the doctors ?	who was the driver talking to the doctors without visiting ?
what is that child fixing while dropping that car ?	what is that child fixing that car while dropping ?
what had those ladies remembered before thinking about this horse ?	what had those ladies remembered this horse before thinking about ?
what was the rocket breaking before breaking those spoons ?	what was the rocket breaking those spoons before breaking ?
what would this customer shake without throwing the plates ?	what would this customer shake the plates without throwing ?
who would that patient teach while helping this boy ?	who would that patient teach this boy while helping ?
what did this dentist make before taking the buttons ?	what did this dentist make the buttons before taking ?
what had the customer broken before breaking the dish ?	what had the customer broken the dish before breaking ?
what had that button broken without breaking these dolls ?	what had that button broken these dolls without breaking ?
what is that guy holding after keeping those bags ?	what is that guy holding those bags after keeping ?
what had the doctors noticed before thinking about this spoon ?	what had the doctors noticed this spoon before thinking about ?
what had this queen brought before holding those books ?	what had this queen brought those books before holding ?
where has that king passed while driving to that bank ?	where has that king passed that bank while driving to ?
what had the driver talked about before talking about the hat ?	what had the driver talked about the hat before talking about ?
who were those ladies teaching without visiting the customer ?	who were those ladies teaching the customer without visiting ?
what can this rocket break without breaking those pictures ?	what can this rocket break those pictures without breaking ?
who should the women work with before teaching the teachers ?	who should the women work with the teachers before teaching ?
what are those guys cleaning without moving the toys ?	what are those guys cleaning the toys without moving ?
what has the toy broken before breaking that rug ?	what has the toy broken that rug before breaking ?
what is this bag breaking after breaking these boats ?	what is this bag breaking these boats after breaking ?
what are the girls shaking after dropping the plate ?	what are the girls shaking the plate after dropping ?
what had the woman made after losing this spoon ?	what had the woman made this spoon after losing ?
what will the rug break while breaking the plate ?	what will the rug break the plate while breaking ?
what can that boy break before breaking that cup ?	what can that boy break that cup before breaking ?
where do these boys run around while running around the museum ?	where do these boys run around the museum while running around ?
what had that man broken after breaking those hats ?	what had that man broken those hats after breaking ?
what had that guy kept before bringing this doll ?	what had that guy kept this doll before bringing ?
what had that man kept without dropping the crayons ?	what had that man kept the crayons without dropping ?
what had those shirts broken after breaking these crayons ?	what had those shirts broken these crayons after breaking ?
what was that guy keeping after shaking these doors ?	what was that guy keeping these doors after shaking ?
what were those children breaking without breaking the crayons ?	what were those children breaking the crayons without breaking ?
who has the customer worried while visiting this customer ?	who has the customer worried this customer while visiting ?
who are those girls teaching without talking to this dancer ?	who are those girls teaching this dancer without talking to ?
what had this lady talked about while talking about the person ?	what had this lady talked about the person while talking about ?
where will this king drive to without walking through that restaurant ?	where will this king drive to that restaurant without walking through ?
what were those children taking while making the ship ?	what were those children taking the ship while making ?
what were these turtles breaking while breaking those boats ?	what were these turtles breaking those boats while breaking ?
what had the patient taken without making the toys ?	what had the patient taken the toys without making ?
what had this cat broken after breaking that ship ?	what had this cat broken that ship after breaking ?
what was this king fixing without fixing the dolls ?	what was this king fixing the dolls without fixing ?
what can the boy fix without losing the shoe ?	what can the boy fix the shoe without losing ?
what were these women buying without cleaning the spoon ?	what were these women buying the spoon without cleaning ?
what was the fork breaking without breaking this ship ?	what was the fork breaking this ship without breaking ?
what can the child hate after thinking about this dog ?	what can the child hate this dog after thinking about ?
what would this child break while breaking those crayons ?	what would this child break those crayons while breaking ?
what could the women keep while moving the books ?	what could the women keep the books while moving ?
who did that man scare while talking to this doctor ?	who did that man scare this doctor while talking to ?
what has this person broken after breaking these boats ?	what has this person broken these boats after breaking ?
what have those girls held after bringing the rug ?	what have those girls held the rug after bringing ?
what were those women breaking before breaking this plane ?	what were those women breaking this plane before breaking ?
what is this boy losing without losing those forks ?	what is this boy losing those forks without losing ?
what will the women throw without dropping these cups ?	what will the women throw these cups without dropping ?
what have the women brought while cleaning the spoon ?	what have the women brought the spoon while cleaning ?
what was this king moving while moving that crayon ?	what was this king moving that crayon while moving ?
what could that rug break without breaking the ship ?	what could that rug break the ship without breaking ?
where is that driver running around without running around that mall ?	where is that driver running around that mall without running around ?
who can the guy appreciate before bothering this adult ?	who can the guy appreciate this adult before bothering ?
who are those ladies working with while listening to the teachers ?	who are those ladies working with the teachers while listening to ?
who could these people worry without teaching these teachers ?	who could these people worry these teachers without teaching ?
what had that customer brought without throwing this truck ?	what had that customer brought this truck without throwing ?
what can these women think about without thinking about the shirt ?	what can these women think about the shirt without thinking about ?
what were those women making before cleaning the plates ?	what were those women making the plates before cleaning ?
what have these dishes broken without breaking that picture ?	what have these dishes broken that picture without breaking ?
who will these guys bother before teaching the king ?	who will these guys bother the king before teaching ?
what has that rug broken while breaking those toys ?	what has that rug broken those toys while breaking ?
who will these men help before visiting the patient ?	who will these men help the patient before visiting ?
what are those women breaking before breaking the shirt ?	what are those women breaking the shirt before breaking ?
where should this lady drive to without running around that mall ?	where should this lady drive to that mall without running around ?
where did that dentist pass without driving to the kitchen ?	where did that dentist pass the kitchen without driving to ?
what can these women fix without cleaning this couch ?	what can these women fix this couch without cleaning ?
what was this king keeping without dropping the beds ?	what was this king keeping the beds without dropping ?
what is that child dropping after taking those candles ?	what is that child dropping those candles after taking ?
what should that bag break without breaking the toy ?	what should that bag break the toy without breaking ?
what had the children held after throwing these bowls ?	what had the children held these bowls after throwing ?
what were these people buying after throwing those shirts ?	what were these people buying those shirts after throwing ?
what has that chair broken while breaking those dishes ?	what has that chair broken those dishes while breaking ?
what will that queen take while finding the candles ?	what will that queen take the candles while finding ?
what has the man thrown without taking this car ?	what has the man thrown this car without taking ?
what have the bowls broken without breaking the chairs ?	what have the bowls broken the chairs without breaking ?
what had the trucks broken while breaking those candles ?	what had the trucks broken those candles while breaking ?
what are those girls fixing before throwing that door ?	what are those girls fixing that door before throwing ?
what do those guys clean while buying the forks ?	what do those guys clean the forks while buying ?
what was the dentist cleaning while taking the glasses ?	what was the dentist cleaning the glasses while taking ?
what was that couch breaking after breaking the plate ?	what was that couch breaking the plate after breaking ?
where can those girls go to before leaving those rooms ?	where can those girls go to those rooms before leaving ?
where were these boys running around after leaving this museum ?	where were these boys running around this museum after leaving ?
what will this guy hate while thinking about the window ?	what will this guy hate the window while thinking about ?
who did that child answer while teaching that driver ?	who did that child answer that driver while teaching ?
what does the driver hate without thinking about that book ?	what does the driver hate that book without thinking about ?
what would these turtles like after thinking about the cars ?	what would these turtles like the cars after thinking about ?
what did the rings break while breaking the spoon ?	what did the rings break the spoon while breaking ?
who would that woman help while visiting this customer ?	who would that woman help this customer while visiting ?
who is that driver listening to without bothering this doctor ?	who is that driver listening to this doctor without bothering ?
where had the boys passed without leaving the room ?	where had the boys passed the room without leaving ?
what have the guys held while keeping this bed ?	what have the guys held this bed while keeping ?
what did these boys lift while finding those cars ?	what did these boys lift those cars while finding ?
what do the people drop after moving that toy ?	what do the people drop that toy after moving ?
where is that boy going to after running around the school ?	where is that boy going to the school after running around ?
what could this customer clean while bringing that book ?	what could this customer clean that book while bringing ?
what was the lady moving while buying those windows ?	what was the lady moving those windows while buying ?
where were those men running around while leaving that kitchen ?	where were those men running around that kitchen while leaving ?
what had this adult bought after buying these spoons ?	what had this adult bought these spoons after buying ?
what does this box break without breaking the spoon ?	what does this box break the spoon without breaking ?
what did this guy clean while cleaning these doors ?	what did this guy clean these doors while cleaning ?
who can these men teach while visiting this doctor ?	who can these men teach this doctor while visiting ?
what did the dancer think about before thinking about the ladies ?	what did the dancer think about the ladies before thinking about ?
what could those people drop while losing the doors ?	what could those people drop the doors while losing ?
what should the windows break before breaking this shirt ?	what should the windows break this shirt before breaking ?
who could this patient talk to without bothering the men ?	who could this patient talk to the men without bothering ?
what has this teacher held before buying those trucks ?	what has this teacher held those trucks before buying ?
who are the boys working with after helping that man ?	who are the boys working with that man after helping ?
what has this dentist bought after buying that cup ?	what has this dentist bought that cup after buying ?
what is this doctor buying without shaking this glass ?	what is this doctor buying this glass without shaking ?
what was the bowl breaking without breaking the chair ?	what was the bowl breaking the chair without breaking ?
what could those cars break without breaking the buttons ?	what could those cars break the buttons without breaking ?
what was the bed breaking while breaking the bottles ?	what was the bed breaking the bottles while breaking ?
who were those women listening to after helping that lady ?	who were those women listening to that lady after helping ?
what did the driver lose after taking those dishes ?	what did the driver lose those dishes after taking ?
what could this rocket break without breaking this mirror ?	what could this rocket break this mirror without breaking ?
who do these women talk to before helping the lady ?	who do these women talk to the lady before helping ?
who were the children helping after talking to that king ?	who were the children helping that king after talking to ?
what did the books break without breaking these candles ?	what did the books break these candles without breaking ?
what are the people cleaning before making those boats ?	what are the people cleaning those boats before making ?
what are these buttons breaking without breaking that glass ?	what are these buttons breaking that glass without breaking ?
what had those doctors made after keeping the bottles ?	what had those doctors made the bottles after keeping ?
who were those men talking to after teaching these women ?	who were those men talking to these women after teaching ?
what are these doctors keeping before fixing the crayons ?	what are these doctors keeping the crayons before fixing ?
what do these children notice after thinking about that dentist ?	what do these children notice that dentist after thinking about ?
what is this spoon breaking after breaking those hats ?	what is this spoon breaking those hats after breaking ?
what would these pictures break while breaking that rug ?	what would these pictures break that rug while breaking ?
where is this child walking through while walking through this mall ?	where is this child walking through this mall while walking through ?
what had the women dropped before making the shoes ?	what had the women dropped the shoes before making ?
what is that lady thinking about before thinking about the children ?	what is that lady thinking about the children before thinking about ?
who were those ladies working with after helping the dancer ?	who were those ladies working with the dancer after helping ?
what would that teacher throw while shaking these books ?	what would that teacher throw these books while shaking ?
what had that toy broken before breaking the hat ?	what had that toy broken the hat before breaking ?
what were these mice breaking after breaking the ring ?	what were these mice breaking the ring after breaking ?
what had this teacher talked about after talking about these mice ?	what had this teacher talked about these mice after talking about ?
what have those men held while fixing these dishes ?	what have those men held these dishes while fixing ?
what should this teacher clean after cleaning this window ?	what should this teacher clean this window after cleaning ?
what can this glass break before breaking those books ?	what can this glass break those books before breaking ?
what has this plane broken after breaking that hat ?	what has this plane broken that hat after breaking ?
who have these doctors scared after bothering this boy ?	who have these doctors scared this boy after bothering ?
what should the adult lose while finding that spoon ?	what should the adult lose that spoon while finding ?
what did that plate break without breaking the chairs ?	what did that plate break the chairs without breaking ?
what were the children keeping after throwing these glasses ?	what were the children keeping these glasses after throwing ?
who should the doctor answer before teaching these doctors ?	who should the doctor answer these doctors before teaching ?
who could this customer talk to before working with this driver ?	who could this customer talk to this driver before working with ?
what did those cats notice after thinking about the books ?	what did those cats notice the books after thinking about ?
what had the doors broken before breaking those boats ?	what had the doors broken those boats before breaking ?
what had this lady remembered without thinking about these glasses ?	what had this lady remembered these glasses without thinking about ?
who would that dancer bother after listening to the customer ?	who would that dancer bother the customer after listening to ?
what had that glass broken after breaking that plate ?	what had that glass broken that plate after breaking ?
what would the women have without holding the shoe ?	what would the women have the shoe without holding ?
what would this driver drop before cleaning the book ?	what would this driver drop the book before cleaning ?
what will that doctor throw after bringing those bottles ?	what will that doctor throw those bottles after bringing ?
what are these children dropping before throwing that shirt ?	what are these children dropping that shirt before throwing ?
where was the child running around without walking through the museum ?	where was the child running around the museum without walking through ?
what did that driver think about while thinking about these children ?	what did that driver think about these children while thinking about ?
what should the woman break before breaking that button ?	what should the woman break that button before breaking ?
who would this customer listen to without working with these boys ?	who would this customer listen to these boys without working with ?
what is that lady losing after fixing those rings ?	what is that lady losing those rings after fixing ?
what would these rabbits break after breaking this glass ?	what would these rabbits break this glass after breaking ?
where are the men walking through after driving to those rooms ?	where are the men walking through those rooms after driving to ?
what had this mouse seen after thinking about these forks ?	what had this mouse seen these forks after thinking about ?
what is the woman bringing without buying that boat ?	what is the woman bringing that boat without buying ?
who do these women understand without listening to this patient ?	who do these women understand this patient without listening to ?
what was the driver buying while dropping these cars ?	what was the driver buying these cars while dropping ?
what could this doctor make after dropping this bicycle ?	what could this doctor make this bicycle after dropping ?
what can those chairs break after breaking these forks ?	what can those chairs break these forks after breaking ?
where are the doctors going to before running around this school ?	where are the doctors going to this school before running around ?
what has that boy seen without thinking about this book ?	what has that boy seen this book without thinking about ?
who have these women bothered without working with that queen ?	who have these women bothered that queen without working with ?
who has the man confused after talking to that dentist ?	who has the man confused that dentist after talking to ?
what had those women talked about after talking about these cars ?	what had those women talked about these cars after talking about ?
what had the woman lost while dropping the bottles ?	what had the woman lost the bottles while dropping ?
who can these doctors praise without listening to the lady ?	who can these doctors praise the lady without listening to ?
what has that child held after buying this chair ?	what has that child held this chair after buying ?
what will that crayon break before breaking the door ?	what will that crayon break the door before breaking ?
who could that dentist care for before helping these ladies ?	who could that dentist care for these ladies before helping ?
what were the hats breaking while breaking this button ?	what were the hats breaking this button while breaking ?
where has the teacher run around while walking through that mall ?	where has the teacher run around that mall while walking through ?
what has this queen taken after losing that window ?	what has this queen taken that window after losing ?
what have these boys bought after holding this box ?	what have these boys bought this box after holding ?
what do these girls have while taking these beds ?	what do these girls have these beds while taking ?
who had the queen confused while teaching the boys ?	who had the queen confused the boys while teaching ?
what was that dancer dropping after taking those forks ?	what was that dancer dropping those forks after taking ?
what are the ladies talking about while talking about that rug ?	what are the ladies talking about that rug while talking about ?
what had that queen seen after thinking about those bowls ?	what had that queen seen those bowls after thinking about ?
what should these women notice before thinking about the books ?	what should these women notice the books before thinking about ?
what had the women taken while taking that bicycle ?	what had the women taken that bicycle while taking ?
what is that dancer buying before throwing those hats ?	what is that dancer buying those hats before throwing ?
what had that doctor dropped without cleaning that shoe ?	what had that doctor dropped that shoe without cleaning ?
who should these men understand after bothering this teacher ?	who should these men understand this teacher after bothering ?
who did these boys appreciate without bothering that driver ?	who did these boys appreciate that driver without bothering ?
what had those chairs broken while breaking those forks ?	what had those chairs broken those forks while breaking ?
who were those children bothering while helping this adult ?	who were those children bothering this adult while helping ?
what would the men break after breaking this cup ?	what would the men break this cup after breaking ?
what would this bird break before breaking those plates ?	what would this bird break those plates before breaking ?
what have those forks broken while breaking that couch ?	what have those forks broken that couch while breaking ?
who would these men visit after visiting these teachers ?	who would these men visit these teachers after visiting ?
what have these boys talked about after talking about the bird ?	what have these boys talked about the bird after talking about ?
what had the plate broken after breaking this fork ?	what had the plate broken this fork after breaking ?
what has the lady made before buying that shirt ?	what has the lady made that shirt before buying ?
what has that person noticed before thinking about the snakes ?	what has that person noticed the snakes before thinking about ?
what will that child drop before losing the cups ?	what will that child drop the cups before losing ?
where had those teachers run around before going to the library ?	where had those teachers run around the library before going to ?
what have the cars broken after breaking that toy ?	what have the cars broken that toy after breaking ?
what had this dog broken while breaking this shirt ?	what had this dog broken this shirt while breaking ?
who has the patient scared before bothering that man ?	who has the patient scared that man before bothering ?
what are these guys finding after taking the car ?	what are these guys finding the car after taking ?
where does the queen walk through before going to that hospital ?	where does the queen walk through that hospital before going to ?
what should the teachers lift while holding these books ?	what should the teachers lift these books while holding ?
what would the boys remember without thinking about this box ?	what would the boys remember this box without thinking about ?
where does the girl go to while walking through that park ?	where does the girl go to that park while walking through ?
what can those crayons break while breaking this fork ?	what can those crayons break this fork while breaking ?
what have the men held before making this bowl ?	what have the men held this bowl before making ?
who had the people scared while visiting the teacher ?	who had the people scared the teacher while visiting ?
what did the queen shake without holding that cup ?	what did the queen shake that cup without holding ?
what are these men fixing before shaking the picture ?	what are these men fixing the picture before shaking ?
who have those people confused while working with the ladies ?	who have those people confused the ladies while working with ?
who will that patient scare while teaching this dancer ?	who will that patient scare this dancer while teaching ?
who had the guys taught while helping this patient ?	who had the guys taught this patient while helping ?
where is that queen running around while walking through that park ?	where is that queen running around that park while walking through ?
where has that teacher gone to after running around this hospital ?	where has that teacher gone to this hospital after running around ?
who are these children talking to while talking to this woman ?	who are these children talking to this woman while talking to ?
who can the adult listen to without listening to the teachers ?	who can the adult listen to the teachers without listening to ?
what has the queen noticed after thinking about the door ?	what has the queen noticed the door after thinking about ?
what can this king lift after holding those plates ?	what can this king lift those plates after holding ?
what is the bicycle breaking while breaking the boats ?	what is the bicycle breaking the boats while breaking ?
what have the men moved without fixing this car ?	what have the men moved this car without fixing ?
where was this person going to after going to that museum ?	where was this person going to that museum after going to ?
what should the woman steal before bringing that bicycle ?	what should the woman steal that bicycle before bringing ?
what can that adult lift while taking the beds ?	what can that adult lift the beds while taking ?
what were the girls buying after cleaning the bowl ?	what were the girls buying the bowl after cleaning ?
where is this girl walking through while leaving that restaurant ?	where is this girl walking through that restaurant while leaving ?
what is the customer taking while taking that picture ?	what is the customer taking that picture while taking ?
who did the people help without visiting these girls ?	who did the people help these girls without visiting ?
what does the lady break without breaking that plane ?	what does the lady break that plane without breaking ?
what had that couch broken before breaking this chair ?	what had that couch broken this chair before breaking ?
what would those turtles break without breaking those toys ?	what would those turtles break those toys without breaking ?
what should this man steal without shaking that spoon ?	what should this man steal that spoon without shaking ?
where will the guys drive to before walking through that park ?	where will the guys drive to that park before walking through ?
what does this queen shake while losing this door ?	what does this queen shake this door while losing ?
what had those doctors found without shaking this toy ?	what had those doctors found this toy without shaking ?
where does the patient drive to while going to that park ?	where does the patient drive to that park while going to ?
what is that bottle breaking without breaking these crayons ?	what is that bottle breaking these crayons without breaking ?
where are the doctors going to while driving to the museum ?	where are the doctors going to the museum while driving to ?
what does this boy clean while cleaning those cups ?	what does this boy clean those cups while cleaning ?
where was the teacher going to before driving to this kitchen ?	where was the teacher going to this kitchen before driving to ?
who do the women scare before talking to that person ?	who do the women scare that person before talking to ?
what have the guys lost after losing these doors ?	what have the guys lost these doors after losing ?
who is this person talking to before talking to that queen ?	who is this person talking to that queen before talking to ?
what are the trucks breaking before breaking these chairs ?	what are the trucks breaking these chairs before breaking ?
what are those people cleaning without losing these dishes ?	what are those people cleaning these dishes without losing ?
who can that queen scare after talking to the boys ?	who can that queen scare the boys after talking to ?
what was that child talking about without talking about that mirror ?	what was that child talking about that mirror without talking about ?
what does the driver break without breaking the bowl ?	what does the driver break the bowl without breaking ?
what has that doctor bought without cleaning this bowl ?	what has that doctor bought this bowl without cleaning ?
what would this truck break while breaking those cups ?	what would this truck break those cups while breaking ?
what are those windows breaking after breaking the car ?	what are those windows breaking the car after breaking ?
what did the dancer break after breaking the car ?	what did the dancer break the car after breaking ?
what is this dentist talking about while talking about these dolls ?	what is this dentist talking about these dolls while talking about ?
what was this customer talking about without talking about those men ?	what was this customer talking about those men without talking about ?
what does the woman take before cleaning those boats ?	what does the woman take those boats before cleaning ?
what is the hamster breaking before breaking the book ?	what is the hamster breaking the book before breaking ?
what are the ladies breaking while breaking this glass ?	what are the ladies breaking this glass while breaking ?
what had those children bought after taking that truck ?	what had those children bought that truck after taking ?
who has that customer found without helping that king ?	who has that customer found that king without helping ?
what had this dancer talked about without talking about the doctors ?	what had this dancer talked about the doctors without talking about ?
what could that person find while finding those rings ?	what could that person find those rings while finding ?
who can those men scare before helping this patient ?	who can those men scare this patient before helping ?
what is the driver keeping while throwing the bag ?	what is the driver keeping the bag while throwing ?
what have these girls moved while cleaning the chair ?	what have these girls moved the chair while cleaning ?
what should this patient lose after dropping the rug ?	what should this patient lose the rug after dropping ?
what can these birds see after thinking about the bowls ?	what can these birds see the bowls after thinking about ?
what have the guys seen after thinking about this driver ?	what have the guys seen this driver after thinking about ?
what were the birds breaking without breaking the windows ?	what were the birds breaking the windows without breaking ?
where is the teacher running around while walking through these schools ?	where is the teacher running around these schools while walking through ?
what is this button breaking before breaking the ship ?	what is this button breaking the ship before breaking ?
what is this box breaking after breaking those glasses ?	what is this box breaking those glasses after breaking ?
what could the children like while thinking about the mouse ?	what could the children like the mouse while thinking about ?
what are those spoons breaking after breaking these buttons ?	what are those spoons breaking these buttons after breaking ?
where did the dentist drive to without running around this restaurant ?	where did the dentist drive to this restaurant without running around ?
what would the mice remember before thinking about the women ?	what would the mice remember the women before thinking about ?
what did the customer lose while shaking this hat ?	what did the customer lose this hat while shaking ?
what should the teachers shake without keeping that rocket ?	what should the teachers shake that rocket without keeping ?
what had the dentist dropped without finding the toy ?	what had the dentist dropped the toy without finding ?
what should these people steal without cleaning the window ?	what should these people steal the window without cleaning ?
what had that lady thought about before thinking about the dentist ?	what had that lady thought about the dentist before thinking about ?
what had the bottle broken while breaking those dishes ?	what had the bottle broken those dishes while breaking ?
where will these people run around before leaving the library ?	where will these people run around the library before leaving ?
what could the king lift without keeping these cars ?	what could the king lift these cars without keeping ?
what did these turtles like before thinking about these plates ?	what did these turtles like these plates before thinking about ?
what should this boy fix before cleaning that plane ?	what should this boy fix that plane before cleaning ?
who could the dancer worry after talking to this queen ?	who could the dancer worry this queen after talking to ?
what would that dentist break after breaking this book ?	what would that dentist break this book after breaking ?
what can this teacher break before breaking that car ?	what can this teacher break that car before breaking ?
what does that bowl break after breaking those cars ?	what does that bowl break those cars after breaking ?
what were those men making while keeping those candles ?	what were those men making those candles while keeping ?
what should the toys break while breaking that shirt ?	what should the toys break that shirt while breaking ?
what should those doctors drop while keeping the boats ?	what should those doctors drop the boats while keeping ?
who can the driver scare without teaching these boys ?	who can the driver scare these boys without teaching ?
what is this door breaking while breaking this bed ?	what is this door breaking this bed while breaking ?
what was the queen making while buying the boxes ?	what was the queen making the boxes while buying ?
what was the doctor moving while dropping these pictures ?	what was the doctor moving these pictures while dropping ?
what can this king break after breaking the glasses ?	what can this king break the glasses after breaking ?
where are those ladies running around before going to the rooms ?	where are those ladies running around the rooms before going to ?
what will this dancer buy while keeping the dishes ?	what will this dancer buy the dishes while keeping ?
what will that bird break after breaking the boats ?	what will that bird break the boats after breaking ?
who was this king talking to without bothering the woman ?	who was this king talking to the woman without bothering ?
what had those cars broken without breaking this mirror ?	what had those cars broken this mirror without breaking ?
what did that girl break before breaking this cup ?	what did that girl break this cup before breaking ?
what has this doctor found while keeping these spoons ?	what has this doctor found these spoons while keeping ?
what had this ring broken while breaking the crayon ?	what had this ring broken the crayon while breaking ?
what are these dogs thinking about without thinking about those bags ?	what are these dogs thinking about those bags without thinking about ?
what could this king find before finding that bicycle ?	what could this king find that bicycle before finding ?
what will those hats break before breaking those crayons ?	what will those hats break those crayons before breaking ?
what were the books breaking while breaking these shoes ?	what were the books breaking these shoes while breaking ?
what have these children taken while dropping the doors ?	what have these children taken the doors while dropping ?
what had the box broken after breaking the cups ?	what had the box broken the cups after breaking ?
what had the king remembered after thinking about the bed ?	what had the king remembered the bed after thinking about ?
what is that woman finding while dropping this fork ?	what is that woman finding this fork while dropping ?
who could those men bother without bothering that guy ?	who could those men bother that guy without bothering ?
what could the man fix after taking these bottles ?	what could the man fix these bottles after taking ?
what will this man clean before losing those dolls ?	what will this man clean those dolls before losing ?
what had this doctor fixed before fixing this cup ?	what had this doctor fixed this cup before fixing ?
what is the hamster breaking while breaking these toys ?	what is the hamster breaking these toys while breaking ?
what should the doctor bring after shaking that doll ?	what should the doctor bring that doll after shaking ?
what was this woman bringing before dropping the doors ?	what was this woman bringing the doors before dropping ?
what has this person held before finding that bed ?	what has this person held that bed before finding ?
what does the couch break while breaking the truck ?	what does the couch break the truck while breaking ?
who had the man helped while listening to the dancer ?	who had the man helped the dancer while listening to ?
who had the boy visited while visiting this king ?	who had the boy visited this king while visiting ?
what does this driver keep before throwing these buttons ?	what does this driver keep these buttons before throwing ?
what was that patient breaking while breaking the boat ?	what was that patient breaking the boat while breaking ?
what will these women buy while moving that crayon ?	what will these women buy that crayon while moving ?
where was that customer driving to after leaving the schools ?	where was that customer driving to the schools after leaving ?
what has the king broken while breaking those doors ?	what has the king broken those doors while breaking ?
what had these boats broken before breaking those shirts ?	what had these boats broken those shirts before breaking ?
what was this queen taking before fixing these shirts ?	what was this queen taking these shirts before fixing ?
who should these doctors talk to before listening to these girls ?	who should these doctors talk to these girls before listening to ?
what can the dishes break while breaking this ship ?	what can the dishes break this ship while breaking ?
what has that king thought about while thinking about that window ?	what has that king thought about that window while thinking about ?
who were these girls working with after listening to this teacher ?	who were these girls working with this teacher after listening to ?
who has the adult visited after bothering these guys ?	who has the adult visited these guys after bothering ?
who is that driver visiting without teaching that dentist ?	who is that driver visiting that dentist without teaching ?
what had that customer made before taking these rings ?	what had that customer made these rings before taking ?
who would the doctor care for while working with those men ?	who would the doctor care for those men while working with ?
what can those men throw while bringing those crayons ?	what can those men throw those crayons while bringing ?
where would that guy drive to after driving to the restaurant ?	where would that guy drive to the restaurant after driving to ?
who has the boy answered while talking to the people ?	who has the boy answered the people while talking to ?
what has the man remembered without thinking about the cups ?	what has the man remembered the cups without thinking about ?
what do the girls buy without making the books ?	what do the girls buy the books without making ?
what was the child losing without buying these doors ?	what was the child losing these doors without buying ?
what had the bird broken without breaking that glass ?	what had the bird broken that glass without breaking ?
where can that dentist drive to before running around the park ?	where can that dentist drive to the park before running around ?
what could the snakes break without breaking this car ?	what could the snakes break this car without breaking ?
what has this doctor bought before finding that book ?	what has this doctor bought that book before finding ?
what is that adult finding before buying the bowl ?	what is that adult finding the bowl before buying ?
what was this man keeping after buying this ring ?	what was this man keeping this ring after buying ?
who did these women scare after teaching this person ?	who did these women scare this person after teaching ?
where is that person leaving while walking through these schools ?	where is that person leaving these schools while walking through ?
what had this child broken before breaking that spoon ?	what had this child broken that spoon before breaking ?
what could that guy move before shaking that mirror ?	what could that guy move that mirror before shaking ?
what was that teacher breaking without breaking those beds ?	what was that teacher breaking those beds without breaking ?
who will those ladies teach while teaching that king ?	who will those ladies teach that king while teaching ?
what will that teacher lose without making the bottle ?	what will that teacher lose the bottle without making ?
what has that queen found after holding these candles ?	what has that queen found these candles after holding ?
what was this hat breaking before breaking the cars ?	what was this hat breaking the cars before breaking ?
what should the bicycle break while breaking that fork ?	what should the bicycle break that fork while breaking ?
what does the girl drop without throwing those dolls ?	what does the girl drop those dolls without throwing ?
what can this adult see before thinking about this plane ?	what can this adult see this plane before thinking about ?
what is that dancer dropping without fixing the spoon ?	what is that dancer dropping the spoon without fixing ?
what were these teachers fixing before fixing these plates ?	what were these teachers fixing these plates before fixing ?
where does the patient go to after going to this school ?	where does the patient go to this school after going to ?
who did the dancer bother without helping the children ?	who did the dancer bother the children without helping ?
who had that lady talked to without working with the children ?	who had that lady talked to the children without working with ?
where has this doctor gone to after driving to that room ?	where has this doctor gone to that room after driving to ?
what had these children broken while breaking the glasses ?	what had these children broken the glasses while breaking ?
what is this fork breaking while breaking those books ?	what is this fork breaking those books while breaking ?
what are the doctors making without moving that glass ?	what are the doctors making that glass without moving ?
who have these men scared before bothering these children ?	who have these men scared these children before bothering ?
where will this customer leave while running around the restaurant ?	where will this customer leave the restaurant while running around ?
where could the child run around before going to that school ?	where could the child run around that school before going to ?
what was that person losing after taking these shoes ?	what was that person losing these shoes after taking ?
what was this person bringing while holding that window ?	what was this person bringing that window while holding ?
what had the picture broken without breaking this book ?	what had the picture broken this book without breaking ?
what had those birds noticed after thinking about the rocket ?	what had those birds noticed the rocket after thinking about ?
what had the driver seen before thinking about those doors ?	what had the driver seen those doors before thinking about ?
what was that bird breaking while breaking that door ?	what was that bird breaking that door while breaking ?
what had the children kept without moving those books ?	what had the children kept those books without moving ?
what was the dentist breaking without breaking those books ?	what was the dentist breaking those books without breaking ?
what were those cars breaking after breaking these shoes ?	what were those cars breaking these shoes after breaking ?
what was the boy making while moving these beds ?	what was the boy making these beds while moving ?
what had this adult remembered before thinking about the doors ?	what had this adult remembered the doors before thinking about ?
what will this child take while keeping those dolls ?	what will this child take those dolls while keeping ?
what were those shirts breaking while breaking these plates ?	what were those shirts breaking these plates while breaking ?
what has that queen brought while shaking the box ?	what has that queen brought the box while shaking ?
where could that man pass while walking through the mall ?	where could that man pass the mall while walking through ?
what is that box breaking after breaking that window ?	what is that box breaking that window after breaking ?
who should the women appreciate without working with these people ?	who should the women appreciate these people without working with ?
who would the boy answer after listening to those doctors ?	who would the boy answer those doctors after listening to ?
what was the woman breaking before breaking the boat ?	what was the woman breaking the boat before breaking ?
what could that door break without breaking these hats ?	what could that door break these hats without breaking ?
who does this patient praise without working with the man ?	who does this patient praise the man without working with ?
who were those children bothering before visiting the women ?	who were those children bothering the women before visiting ?
who has the man taught after teaching the person ?	who has the man taught the person after teaching ?
who have those women answered after bothering the driver ?	who have those women answered the driver after bothering ?
where is this lady driving to without going to the schools ?	where is this lady driving to the schools without going to ?
where will that lady leave after going to the library ?	where will that lady leave the library after going to ?
what were those dishes breaking without breaking this truck ?	what were those dishes breaking this truck without breaking ?
what will those women move before bringing the cars ?	what will those women move the cars before bringing ?
who can this patient teach before bothering the teachers ?	who can this patient teach the teachers before bothering ?
what would these boys lift without fixing this bottle ?	what would these boys lift this bottle without fixing ?
what were the men holding after holding the fork ?	what were the men holding the fork after holding ?
what can this driver fix without moving these bowls ?	what can this driver fix these bowls without moving ?
who was that teacher talking to while bothering the children ?	who was that teacher talking to the children while bothering ?
what is that teacher breaking after breaking this couch ?	what is that teacher breaking this couch after breaking ?
where does that adult pass while walking through that hospital ?	where does that adult pass that hospital while walking through ?
what will these children lift without holding those shoes ?	what will these children lift those shoes without holding ?
what can that doctor steal before making those beds ?	what can that doctor steal those beds before making ?
what would this dentist fix before buying the ring ?	what would this dentist fix the ring before buying ?
what was the bed breaking after breaking this candle ?	what was the bed breaking this candle after breaking ?
what should the book break before breaking the chairs ?	what should the book break the chairs before breaking ?
where did that dentist drive to before walking through the rooms ?	where did that dentist drive to the rooms before walking through ?
what had the child broken while breaking these bowls ?	what had the child broken these bowls while breaking ?
what would those cars break while breaking this bicycle ?	what would those cars break this bicycle while breaking ?
where have those teachers run around before running around that hospital ?	where have those teachers run around that hospital before running around ?
who has that girl lost while helping the adult ?	who has that girl lost the adult while helping ?
what were the teachers losing while making this picture ?	what were the teachers losing this picture while making ?
who was that girl helping while visiting that lady ?	who was that girl helping that lady while visiting ?
what had these men broken without breaking the buttons ?	what had these men broken the buttons without breaking ?
what was the boy holding without throwing the pictures ?	what was the boy holding the pictures without throwing ?
who can that customer teach after working with those children ?	who can that customer teach those children after working with ?
what can that boy break without breaking this book ?	what can that boy break this book without breaking ?
what is that person finding without dropping that box ?	what is that person finding that box without dropping ?
who had the adult confused before listening to these guys ?	who had the adult confused these guys before listening to ?
what does the boat break while breaking the fork ?	what does the boat break the fork while breaking ?
where is the queen running around without driving to this room ?	where is the queen running around this room without driving to ?
what should that boy steal after moving this fork ?	what should that boy steal this fork after moving ?
who does this guy appreciate without helping this king ?	who does this guy appreciate this king without helping ?
what could these boys steal after bringing that dish ?	what could these boys steal that dish after bringing ?
what has this woman lost while dropping that fork ?	what has this woman lost that fork while dropping ?
who do these men understand after visiting the person ?	who do these men understand the person after visiting ?
what have the men brought after fixing these doors ?	what have the men brought these doors after fixing ?
what were those people breaking before breaking this rug ?	what were those people breaking this rug before breaking ?
what had the teacher made while taking those bowls ?	what had the teacher made those bowls while taking ?
who would the king teach after talking to that dentist ?	who would the king teach that dentist after talking to ?
what will this button break without breaking these boxes ?	what will this button break these boxes without breaking ?
what did these glasses break after breaking those toys ?	what did these glasses break those toys after breaking ?
what had these books broken without breaking the fork ?	what had these books broken the fork without breaking ?
what can that customer shake before shaking these plates ?	what can that customer shake these plates before shaking ?
who should this king appreciate after working with that guy ?	who should this king appreciate that guy after working with ?
what were these women bringing while keeping the boat ?	what were these women bringing the boat while keeping ?
where is the king walking through before leaving that bank ?	where is the king walking through that bank before leaving ?
what had that boy thrown before moving these buttons ?	what had that boy thrown these buttons before moving ?
what are these rabbits breaking while breaking the mirror ?	what are these rabbits breaking the mirror while breaking ?
what was that customer breaking before breaking the spoon ?	what was that customer breaking the spoon before breaking ?
what were the shoes breaking while breaking that spoon ?	what were the shoes breaking that spoon while breaking ?
what should these people throw while dropping these glasses ?	what should these people throw these glasses while dropping ?
what were these women fixing without bringing that boat ?	what were these women fixing that boat without bringing ?
who had this adult bothered after working with these people ?	who had this adult bothered these people after working with ?
what have those teachers thrown without shaking the cars ?	what have those teachers thrown the cars without shaking ?
what did these books break after breaking the glasses ?	what did these books break the glasses after breaking ?
what had the patient thrown without dropping that bed ?	what had the patient thrown that bed without dropping ?
who will these teachers answer while helping that person ?	who will these teachers answer that person while helping ?
what are those forks breaking while breaking the books ?	what are those forks breaking the books while breaking ?
what did those children make before shaking that shoe ?	what did those children make that shoe before shaking ?
what is the lady moving before throwing that boat ?	what is the lady moving that boat before throwing ?
who could the queen teach after teaching that man ?	who could the queen teach that man after teaching ?
who can the doctors worry without bothering the girl ?	who can the doctors worry the girl without bothering ?
who could this woman bother without working with the boy ?	who could this woman bother the boy without working with ?
what has that adult talked about before talking about those shirts ?	what has that adult talked about those shirts before talking about ?
who have those doctors visited while bothering that boy ?	who have those doctors visited that boy while bothering ?
who would these people scare after talking to that man ?	who would these people scare that man after talking to ?
what are the people taking while holding this dish ?	what are the people taking this dish while holding ?
who was this teacher visiting without teaching these men ?	who was this teacher visiting these men without teaching ?
what had these mice thought about without thinking about the teachers ?	what had these mice thought about the teachers without thinking about ?
where can these men go to while running around the school ?	where can these men go to the school while running around ?
who did that woman visit before talking to this woman ?	who did that woman visit this woman before talking to ?
who had that king bothered while bothering the patient ?	who had that king bothered the patient while bothering ?
what does this woman break without breaking this crayon ?	what does this woman break this crayon without breaking ?
where could the customer run around without walking through that room ?	where could the customer run around that room without walking through ?
where do the boys walk through after walking through this library ?	where do the boys walk through this library after walking through ?
what is the child taking after fixing the cars ?	what is the child taking the cars after fixing ?
what does the horse notice while thinking about those crayons ?	what does the horse notice those crayons while thinking about ?
what are the shirts breaking after breaking that bed ?	what are the shirts breaking that bed after breaking ?
what will these children break before breaking those glasses ?	what will these children break those glasses before breaking ?
who has the man talked to before visiting the guy ?	who has the man talked to the guy before visiting ?
what will that guy break before breaking those trucks ?	what will that guy break those trucks before breaking ?
what is that dentist taking after shaking those windows ?	what is that dentist taking those windows after shaking ?
who are the women helping after talking to the person ?	who are the women helping the person after talking to ?
what does this dentist notice after thinking about the horse ?	what does this dentist notice the horse after thinking about ?
what had those women thrown after keeping the chair ?	what had those women thrown the chair after keeping ?
who would those doctors help without talking to the girl ?	who would those doctors help the girl without talking to ?
what had these beds broken before breaking the chair ?	what had these beds broken the chair before breaking ?
what is that plate breaking after breaking the shirt ?	what is that plate breaking the shirt after breaking ?
what had this rug broken while breaking that cup ?	what had this rug broken that cup while breaking ?
what had the doctor brought while losing that bowl ?	what had the doctor brought that bowl while losing ?
who was that child talking to while listening to this child ?	who was that child talking to this child while listening to ?
what should the doctors throw before moving the couch ?	what should the doctors throw the couch before moving ?
who has the child bothered while working with the women ?	who has the child bothered the women while working with ?
who had these doctors worked with before visiting this doctor ?	who had these doctors worked with this doctor before visiting ?
who can the queen answer after helping these doctors ?	who can the queen answer these doctors after helping ?
what should this lady move after finding the hats ?	what should this lady move the hats after finding ?
who had the children bothered without bothering this man ?	who had the children bothered this man without bothering ?
who has the person helped after teaching that child ?	who has the person helped that child after teaching ?
what was this teacher bringing while taking these plates ?	what was this teacher bringing these plates while taking ?
where will the boys leave after driving to the library ?	where will the boys leave the library after driving to ?
who can this customer care for while talking to that adult ?	who can this customer care for that adult while talking to ?
who has this dancer answered while listening to that lady ?	who has this dancer answered that lady while listening to ?
what was the dancer talking about before talking about that hamster ?	what was the dancer talking about that hamster before talking about ?
who can these people work with after listening to that adult ?	who can these people work with that adult after listening to ?
what were those boxes breaking without breaking those chairs ?	what were those boxes breaking those chairs without breaking ?
what was that dancer throwing while dropping the dolls ?	what was that dancer throwing the dolls while dropping ?
what were those people taking without keeping the shirts ?	what were those people taking the shirts without keeping ?
what had these bottles broken before breaking that crayon ?	what had these bottles broken that crayon before breaking ?
who is this adult helping while visiting those ladies ?	who is this adult helping those ladies while visiting ?
what have those dolls broken before breaking the books ?	what have those dolls broken the books before breaking ?
who have those boys bothered after working with this boy ?	who have those boys bothered this boy after working with ?
who is that lady talking to while helping this customer ?	who is that lady talking to this customer while helping ?
what did the patient buy while finding those bottles ?	what did the patient buy those bottles while finding ?
who can that driver praise while talking to the teachers ?	who can that driver praise the teachers while talking to ?
who had this guy bothered while helping that teacher ?	who had this guy bothered that teacher while helping ?
what does that driver notice after thinking about these glasses ?	what does that driver notice these glasses after thinking about ?
what is the man making while bringing that button ?	what is the man making that button while bringing ?
what have these guys found without throwing that bowl ?	what have these guys found that bowl without throwing ?
what is the child breaking without breaking that bed ?	what is the child breaking that bed without breaking ?
what can those shoes break without breaking those cars ?	what can those shoes break those cars without breaking ?
who had the men helped while working with the ladies ?	who had the men helped the ladies while working with ?
who were those men listening to after visiting this dancer ?	who were those men listening to this dancer after visiting ?
who can that customer listen to after bothering the lady ?	who can that customer listen to the lady after bothering ?
what were the girls bringing before shaking the crayon ?	what were the girls bringing the crayon before shaking ?
who could that man help before teaching that dancer ?	who could that man help that dancer before teaching ?
what will this woman throw without fixing the shirt ?	what will this woman throw the shirt without fixing ?
what had this child moved before losing the candle ?	what had this child moved the candle before losing ?
what is that lady shaking after finding those cars ?	what is that lady shaking those cars after finding ?
what has this dentist taken while losing this chair ?	what has this dentist taken this chair while losing ?
what has the king brought after shaking these forks ?	what has the king brought these forks after shaking ?
who can these guys visit while listening to that driver ?	who can these guys visit that driver while listening to ?
where was the doctor running around while leaving this school ?	where was the doctor running around this school while leaving ?
what had the teachers noticed after thinking about those rings ?	what had the teachers noticed those rings after thinking about ?
what was the queen breaking without breaking the boxes ?	what was the queen breaking the boxes without breaking ?
who had the dentist worked with without talking to the girls ?	who had the dentist worked with the girls without talking to ?
what had the dentist thought about after thinking about the adult ?	what had the dentist thought about the adult after thinking about ?
what was the lady breaking while breaking this ring ?	what was the lady breaking this ring while breaking ?
what will these men steal while buying the picture ?	what will these men steal the picture while buying ?
what did the king steal before holding the bag ?	what did the king steal the bag before holding ?
what could those guys shake after taking the cars ?	what could those guys shake the cars after taking ?
what is the turtle breaking without breaking the trucks ?	what is the turtle breaking the trucks without breaking ?
what is this rabbit breaking without breaking this chair ?	what is this rabbit breaking this chair without breaking ?
who could that dentist visit before visiting this teacher ?	who could that dentist visit this teacher before visiting ?
who could the guy care for without visiting that woman ?	who could the guy care for that woman without visiting ?
where is the woman running around without running around that museum ?	where is the woman running around that museum without running around ?
who does the child care for before working with this adult ?	who does the child care for this adult before working with ?
what had the people bought while throwing that rocket ?	what had the people bought that rocket while throwing ?
what have the cars broken without breaking that cup ?	what have the cars broken that cup without breaking ?
what had that boy made while shaking this rocket ?	what had that boy made this rocket while shaking ?
what does this guy break before breaking those glasses ?	what does this guy break those glasses before breaking ?
what would this cat break without breaking those bowls ?	what would this cat break those bowls without breaking ?
what is this queen taking while keeping the shirt ?	what is this queen taking the shirt while keeping ?
what would that adult keep while throwing the bowls ?	what would that adult keep the bowls while throwing ?
what has this doctor made while holding this chair ?	what has this doctor made this chair while holding ?
what has the dentist dropped before keeping this bag ?	what has the dentist dropped this bag before keeping ?
who do those women appreciate while helping that woman ?	who do those women appreciate that woman while helping ?
what would the king clean while fixing these spoons ?	what would the king clean these spoons while fixing ?
what could this queen keep before taking this button ?	what could this queen keep this button before taking ?
what is the boy buying without holding those trucks ?	what is the boy buying those trucks without holding ?
what have those doctors kept without throwing this doll ?	what have those doctors kept this doll without throwing ?
who are those women bothering after listening to those boys ?	who are those women bothering those boys after listening to ?
who would this doctor understand while teaching the man ?	who would this doctor understand the man while teaching ?
what should that guy find without fixing those windows ?	what should that guy find those windows without fixing ?
who will the driver listen to after teaching the people ?	who will the driver listen to the people after teaching ?
what will the guys sell before dropping the ring ?	what will the guys sell the ring before dropping ?
what has this shirt broken without breaking that fork ?	what has this shirt broken that fork without breaking ?
what are those teachers making after throwing the plate ?	what are those teachers making the plate after throwing ?
what has this girl seen before thinking about the books ?	what has this girl seen the books before thinking about ?
what would this snake notice after thinking about that cup ?	what would this snake notice that cup after thinking about ?
who had that guy found while teaching that guy ?	who had that guy found that guy while teaching ?
what did the woman fix without keeping the forks ?	what did the woman fix the forks without keeping ?
where had the dancer gone to without going to that library ?	where had the dancer gone to that library without going to ?
what is the girl fixing before taking those windows ?	what is the girl fixing those windows before taking ?
what were these pictures breaking without breaking those trucks ?	what were these pictures breaking those trucks without breaking ?
what had those teachers bought after fixing those buttons ?	what had those teachers bought those buttons after fixing ?
what is the bed breaking without breaking this car ?	what is the bed breaking this car without breaking ?
who had that queen bothered after visiting these women ?	who had that queen bothered these women after visiting ?
what could that adult have before dropping this bottle ?	what could that adult have this bottle before dropping ?
who should this lady bother before working with that person ?	who should this lady bother that person before working with ?
what should that couch break after breaking those crayons ?	what should that couch break those crayons after breaking ?
what do those girls love while thinking about these mice ?	what do those girls love these mice while thinking about ?
what would the dancer buy before shaking that shoe ?	what would the dancer buy that shoe before shaking ?
what had those guys cleaned while cleaning this car ?	what had those guys cleaned this car while cleaning ?
what does this dancer break while breaking this plane ?	what does this dancer break this plane while breaking ?
what can these doctors lose without cleaning those spoons ?	what can these doctors lose those spoons without cleaning ?
what had that adult cleaned after bringing that candle ?	what had that adult cleaned that candle after bringing ?
what could that girl steal before shaking that crayon ?	what could that girl steal that crayon before shaking ?
what was the doctor dropping after losing the shirts ?	what was the doctor dropping the shirts after losing ?
what are those pictures breaking before breaking the dishes ?	what are those pictures breaking the dishes before breaking ?
what should that glass break after breaking the dishes ?	what should that glass break the dishes after breaking ?
what had this hat broken without breaking those beds ?	what had this hat broken those beds without breaking ?
where could this adult leave after running around the rooms ?	where could this adult leave the rooms after running around ?
what did these women bring before moving those chairs ?	what did these women bring those chairs before moving ?
what has that man seen after thinking about this chair ?	what has that man seen this chair after thinking about ?
what have these forks broken while breaking this candle ?	what have these forks broken this candle while breaking ?
who was the dancer teaching while listening to this doctor ?	who was the dancer teaching this doctor while listening to ?
who did those guys talk to without bothering that customer ?	who did those guys talk to that customer without bothering ?
what have those turtles broken after breaking the bowl ?	what have those turtles broken the bowl after breaking ?
what had the doctor fixed before cleaning the windows ?	what had the doctor fixed the windows before cleaning ?
what will these ladies shake without making this bag ?	what will these ladies shake this bag without making ?
what is the box breaking before breaking that ship ?	what is the box breaking that ship before breaking ?
what did these women fix after holding that crayon ?	what did these women fix that crayon after holding ?
where are these teachers walking through after going to the hospital ?	where are these teachers walking through the hospital after going to ?
what is the snake breaking without breaking the toys ?	what is the snake breaking the toys without breaking ?
what have the children held without buying those books ?	what have the children held those books without buying ?
what was the rocket breaking before breaking these boxes ?	what was the rocket breaking these boxes before breaking ?
what can this woman hold without throwing that window ?	what can this woman hold that window without throwing ?
what had the driver broken without breaking that cup ?	what had the driver broken that cup without breaking ?
who had that lady worried without teaching the king ?	who had that lady worried the king without teaching ?
who are the teachers visiting before working with this king ?	who are the teachers visiting this king before working with ?
what was the girl finding without taking those windows ?	what was the girl finding those windows without taking ?
what were those dolls breaking without breaking this bicycle ?	what were those dolls breaking this bicycle without breaking ?
what can these girls make while losing these doors ?	what can these girls make these doors while losing ?
who has the guy answered after working with these doctors ?	who has the guy answered these doctors after working with ?
what is that king thinking about before thinking about those ladies ?	what is that king thinking about those ladies before thinking about ?
what had those doctors held without dropping these spoons ?	what had those doctors held these spoons without dropping ?
who is that teacher listening to without visiting the teacher ?	who is that teacher listening to the teacher without visiting ?
what will the king hate after thinking about these forks ?	what will the king hate these forks after thinking about ?
what could those girls find after buying these bags ?	what could those girls find these bags after buying ?
what had the driver lost before making the buttons ?	what had the driver lost the buttons before making ?
what has this spoon broken after breaking these books ?	what has this spoon broken these books after breaking ?
what did this queen have before keeping the glasses ?	what did this queen have the glasses before keeping ?
what did that guy love after thinking about that book ?	what did that guy love that book after thinking about ?
what could that dancer break before breaking the doors ?	what could that dancer break the doors before breaking ?
what did that plate break before breaking the forks ?	what did that plate break the forks before breaking ?
what had this dentist kept without shaking those plates ?	what had this dentist kept those plates without shaking ?
what were the hats breaking after breaking the bags ?	what were the hats breaking the bags after breaking ?
what is the lady bringing without finding these bowls ?	what is the lady bringing these bowls without finding ?
what will that man drop before taking these dolls ?	what will that man drop these dolls before taking ?
what did the ship break before breaking this picture ?	what did the ship break this picture before breaking ?
what is that customer finding before keeping this book ?	what is that customer finding this book before keeping ?
what have the people noticed while thinking about these bowls ?	what have the people noticed these bowls while thinking about ?
who would the lady help while listening to the doctors ?	who would the lady help the doctors while listening to ?
who will that dancer teach before bothering the teachers ?	who will that dancer teach the teachers before bothering ?
what was the customer taking without making the shirts ?	what was the customer taking the shirts without making ?
what had the turtles broken while breaking the dishes ?	what had the turtles broken the dishes while breaking ?
what will this doctor have without holding that spoon ?	what will this doctor have that spoon without holding ?
who could the doctor scare after talking to this driver ?	who could the doctor scare this driver after talking to ?
who has the boy bothered without working with the children ?	who has the boy bothered the children without working with ?
who is the man talking to while helping that dancer ?	who is the man talking to that dancer while helping ?
where can the guy go to after leaving the rooms ?	where can the guy go to the rooms after leaving ?
what were the doctors losing without moving those dishes ?	what were the doctors losing those dishes without moving ?
what could the person throw while cleaning the chair ?	what could the person throw the chair while cleaning ?
what will this boy sell before throwing those toys ?	what will this boy sell those toys before throwing ?
what has the guy dropped after moving the plates ?	what has the guy dropped the plates after moving ?
what was that plane breaking while breaking that window ?	what was that plane breaking that window while breaking ?
what has this king taken before losing these dishes ?	what has this king taken these dishes before losing ?
what are these men cleaning without losing these buttons ?	what are these men cleaning these buttons without losing ?
where had this doctor gone to without driving to that school ?	where had this doctor gone to that school without driving to ?
what will the ladies clean without holding these buttons ?	what will the ladies clean these buttons without holding ?
what were these boats breaking after breaking that button ?	what were these boats breaking that button after breaking ?
what can the driver shake after finding these cars ?	what can the driver shake these cars after finding ?
where is that king walking through before going to the museum ?	where is that king walking through the museum before going to ?
what are the boats breaking without breaking this bowl ?	what are the boats breaking this bowl without breaking ?
who had the people found before visiting this lady ?	who had the people found this lady before visiting ?
what are these people buying after fixing those buttons ?	what are these people buying those buttons after fixing ?
what will the person hold before bringing the book ?	what will the person hold the book before bringing ?
what did this dentist find while fixing these buttons ?	what did this dentist find these buttons while fixing ?
what is this fork breaking after breaking those spoons ?	what is this fork breaking those spoons after breaking ?
where will those women leave while driving to those schools ?	where will those women leave those schools while driving to ?
what was the customer bringing after shaking those cups ?	what was the customer bringing those cups after shaking ?
what have those books broken before breaking those bowls ?	what have those books broken those bowls before breaking ?
where has that driver passed without running around these schools ?	where has that driver passed these schools without running around ?
what should these guys talk about while talking about these crayons ?	what should these guys talk about these crayons while talking about ?
who had the guys scared without teaching the queen ?	who had the guys scared the queen without teaching ?
what had the patient dropped while bringing this plane ?	what had the patient dropped this plane while bringing ?
where can the boy leave while driving to this mall ?	where can the boy leave this mall while driving to ?
what is that king thinking about while thinking about the shirt ?	what is that king thinking about the shirt while thinking about ?
what are the women taking while bringing these cars ?	what are the women taking these cars while bringing ?
what was this boy talking about without talking about these bowls ?	what was this boy talking about these bowls without talking about ?
what is this man cleaning before throwing the forks ?	what is this man cleaning the forks before throwing ?
what were the bags breaking without breaking this shoe ?	what were the bags breaking this shoe without breaking ?
what did these girls sell while throwing this picture ?	what did these girls sell this picture while throwing ?
who are these boys bothering before talking to the girls ?	who are these boys bothering the girls before talking to ?
where had this dancer left while running around these rooms ?	where had this dancer left these rooms while running around ?
what was this lady finding while throwing those crayons ?	what was this lady finding those crayons while throwing ?
what had those turtles broken before breaking this ship ?	what had those turtles broken this ship before breaking ?
what were these rabbits thinking about while thinking about this rocket ?	what were these rabbits thinking about this rocket while thinking about ?
what could the men steal after losing the spoon ?	what could the men steal the spoon after losing ?
what are those girls shaking while losing that hat ?	what are those girls shaking that hat while losing ?
who can the boys listen to before helping that teacher ?	who can the boys listen to that teacher before helping ?
what could that dancer steal while moving that door ?	what could that dancer steal that door while moving ?
where were the children leaving before walking through that school ?	where were the children leaving that school before walking through ?
what will the guys see without thinking about the person ?	what will the guys see the person without thinking about ?
what will this guy bring while making this candle ?	what will this guy bring this candle while making ?
what were those doctors moving before finding this window ?	what were those doctors moving this window before finding ?
what could the doctor break while breaking the toys ?	what could the doctor break the toys while breaking ?
what are the ladies finding while moving these beds ?	what are the ladies finding these beds while moving ?
who had the children taught after listening to these teachers ?	who had the children taught these teachers after listening to ?
where was this customer walking through before leaving the restaurant ?	where was this customer walking through the restaurant before leaving ?
what would that patient break before breaking the bed ?	what would that patient break the bed before breaking ?
what were those mice breaking before breaking that glass ?	what were those mice breaking that glass before breaking ?
who had the queen confused before helping the doctor ?	who had the queen confused the doctor before helping ?
what had this guy broken after breaking the bottles ?	what had this guy broken the bottles after breaking ?
what could the cars break while breaking these rings ?	what could the cars break these rings while breaking ?
what did those men fix before throwing this bicycle ?	what did those men fix this bicycle before throwing ?
what was the adult losing after bringing this bottle ?	what was the adult losing this bottle after bringing ?
what was the child shaking while taking those toys ?	what was the child shaking those toys while taking ?
what had these trucks broken after breaking this cup ?	what had these trucks broken this cup after breaking ?
what would this guy steal before fixing this door ?	what would this guy steal this door before fixing ?
what is that lady shaking before holding the fork ?	what is that lady shaking the fork before holding ?
what had the dancer found before shaking the candle ?	what had the dancer found the candle before shaking ?
what should that guy lose while shaking this shirt ?	what should that guy lose this shirt while shaking ?
what had this king seen after thinking about these books ?	what had this king seen these books after thinking about ?
who did the children work with before talking to the patient ?	who did the children work with the patient before talking to ?
who had these women talked to after talking to this guy ?	who had these women talked to this guy after talking to ?
what does that person buy before dropping that door ?	what does that person buy that door before dropping ?
what does that customer clean before keeping the mirror ?	what does that customer clean the mirror before keeping ?
what was that doctor keeping while throwing those trucks ?	what was that doctor keeping those trucks while throwing ?
what is that adult cleaning before holding that truck ?	what is that adult cleaning that truck before holding ?
who did this girl appreciate without teaching that dentist ?	who did this girl appreciate that dentist without teaching ?
what have these toys broken without breaking that door ?	what have these toys broken that door without breaking ?
what had this lady lost without taking this toy ?	what had this lady lost this toy without taking ?
what has that queen found after making the cars ?	what has that queen found the cars after making ?
what had this customer taken while shaking this ring ?	what had this customer taken this ring while shaking ?
what was that queen losing without moving this doll ?	what was that queen losing this doll without moving ?
what does this driver make while throwing the picture ?	what does this driver make the picture while throwing ?
what has the driver thrown after cleaning these spoons ?	what has the driver thrown these spoons after cleaning ?
what have these forks broken while breaking those forks ?	what have these forks broken those forks while breaking ?
what are the women breaking after breaking that picture ?	what are the women breaking that picture after breaking ?
who had the guy helped while visiting those ladies ?	who had the guy helped those ladies while visiting ?
what can this rocket break after breaking the plates ?	what can this rocket break the plates after breaking ?
what had the boys moved without bringing that toy ?	what had the boys moved that toy without bringing ?
what is this king throwing without finding the couch ?	what is this king throwing the couch without finding ?
who have these boys talked to while helping this child ?	who have these boys talked to this child while helping ?
what has this dentist noticed without thinking about those women ?	what has this dentist noticed those women without thinking about ?
what were these doors breaking while breaking this hat ?	what were these doors breaking this hat while breaking ?
who will the ladies teach without teaching that patient ?	who will the ladies teach that patient without teaching ?
what will this queen break without breaking this shoe ?	what will this queen break this shoe without breaking ?
who had the patient worried before working with that dancer ?	who had the patient worried that dancer before working with ?
what have the people held while bringing the book ?	what have the people held the book while bringing ?
what had those ladies found after finding the door ?	what had those ladies found the door after finding ?
what have the women moved while finding this shirt ?	what have the women moved this shirt while finding ?
what has that patient seen before thinking about this child ?	what has that patient seen this child before thinking about ?
what could that adult take while bringing the doors ?	what could that adult take the doors while bringing ?
what has that adult taken while holding that hat ?	what has that adult taken that hat while holding ?
what are these ladies bringing while finding the bicycle ?	what are these ladies bringing the bicycle while finding ?
who was the patient working with before listening to this lady ?	who was the patient working with this lady before listening to ?
what did these guys buy while finding the hats ?	what did these guys buy the hats while finding ?
what would this turtle think about without thinking about this picture ?	what would this turtle think about this picture without thinking about ?
what could the doctors break without breaking this car ?	what could the doctors break this car without breaking ?
what has this dentist remembered before thinking about that shoe ?	what has this dentist remembered that shoe before thinking about ?
what had this spoon broken before breaking that shoe ?	what had this spoon broken that shoe before breaking ?
what had that teacher held without taking this fork ?	what had that teacher held this fork without taking ?
who did the dancer understand before bothering the guys ?	who did the dancer understand the guys before bothering ?
what was this boy keeping before keeping these bottles ?	what was this boy keeping these bottles before keeping ?
what will the customer break while breaking this shoe ?	what will the customer break this shoe while breaking ?
what were these cars breaking before breaking this bag ?	what were these cars breaking this bag before breaking ?
what were these glasses breaking without breaking the dolls ?	what were these glasses breaking the dolls without breaking ?
what had this button broken after breaking the ring ?	what had this button broken the ring after breaking ?
what have the men brought without bringing the ring ?	what have the men brought the ring without bringing ?
what has that child noticed before thinking about the rocket ?	what has that child noticed the rocket before thinking about ?
what is that dentist buying before moving the buttons ?	what is that dentist buying the buttons before moving ?
where could this lady go to while going to those schools ?	where could this lady go to those schools while going to ?
who is this boy working with without helping that girl ?	who is this boy working with that girl without helping ?
who should that driver work with before bothering the boy ?	who should that driver work with the boy before bothering ?
what is the teacher thinking about after thinking about the windows ?	what is the teacher thinking about the windows after thinking about ?
what had this cup broken before breaking that plate ?	what had this cup broken that plate before breaking ?
what was the king taking after making the dishes ?	what was the king taking the dishes after making ?
who can the girls visit after listening to that king ?	who can the girls visit that king after listening to ?
what had that lady taken before shaking this boat ?	what had that lady taken this boat before shaking ?
what are these women making before taking this ship ?	what are these women making this ship before taking ?
who is the patient bothering without teaching this dancer ?	who is the patient bothering this dancer without teaching ?
what is the driver dropping while cleaning the mirror ?	what is the driver dropping the mirror while cleaning ?
what has the bag broken after breaking the bicycle ?	what has the bag broken the bicycle after breaking ?
where would that boy return to before running around that kitchen ?	where would that boy return to that kitchen before running around ?
what can that king sell while dropping the book ?	what can that king sell the book while dropping ?
what are the snakes breaking before breaking this bottle ?	what are the snakes breaking this bottle before breaking ?
what is this hamster breaking without breaking these windows ?	what is this hamster breaking these windows without breaking ?
what were the crayons breaking while breaking this crayon ?	what were the crayons breaking this crayon while breaking ?
where had that man passed before walking through the school ?	where had that man passed the school before walking through ?
what did those guys lift while buying that picture ?	what did those guys lift that picture while buying ?
where has that king passed before going to that school ?	where has that king passed that school before going to ?
where is the king running around without going to the rooms ?	where is the king running around the rooms without going to ?
what has that queen talked about without talking about these trucks ?	what has that queen talked about these trucks without talking about ?
what is this boat breaking without breaking these shoes ?	what is this boat breaking these shoes without breaking ?
what does this patient bring after fixing these toys ?	what does this patient bring these toys after fixing ?
what has this patient lost after throwing that shirt ?	what has this patient lost that shirt after throwing ?
what was this mirror breaking while breaking the cups ?	what was this mirror breaking the cups while breaking ?
who would the lady teach before bothering the patient ?	who would the lady teach the patient before bothering ?
what did the guy make without cleaning these buttons ?	what did the guy make these buttons without cleaning ?
what will that bed break after breaking that truck ?	what will that bed break that truck after breaking ?
what were those doors breaking without breaking this car ?	what were those doors breaking this car without breaking ?
what should the king have after fixing the boats ?	what should the king have the boats after fixing ?
what should these turtles break without breaking the bed ?	what should these turtles break the bed without breaking ?
what is the customer finding before bringing these windows ?	what is the customer finding these windows before bringing ?
what were these children shaking after fixing this boat ?	what were these children shaking this boat after fixing ?
who will that lady teach while talking to the patient ?	who will that lady teach the patient while talking to ?
what will that king think about without thinking about these mice ?	what will that king think about these mice without thinking about ?
what had that lady taken without taking those boxes ?	what had that lady taken those boxes without taking ?
what would the person fix while losing the cups ?	what would the person fix the cups while losing ?
what can the shoe break before breaking this door ?	what can the shoe break this door before breaking ?
what has the doctor held without buying these boxes ?	what has the doctor held these boxes without buying ?
what can that person throw before holding that fork ?	what can that person throw that fork before holding ?
what do these cars break without breaking these shirts ?	what do these cars break these shirts without breaking ?
what is the woman shaking without fixing the books ?	what is the woman shaking the books without fixing ?
what is this driver bringing without shaking that boat ?	what is this driver bringing that boat without shaking ?
what is that doctor making before keeping that glass ?	what is that doctor making that glass before keeping ?
what was the child buying after making that boat ?	what was the child buying that boat after making ?
what is that doctor losing before taking these glasses ?	what is that doctor losing these glasses before taking ?
what have the rabbits seen without thinking about that turtle ?	what have the rabbits seen that turtle without thinking about ?
what had this hamster broken before breaking that hat ?	what had this hamster broken that hat before breaking ?
who have the guys helped while bothering those boys ?	who have the guys helped those boys while bothering ?
what do these children steal before bringing those dolls ?	what do these children steal those dolls before bringing ?
what has this boy taken while shaking these trucks ?	what has this boy taken these trucks while shaking ?
what would the doctor take while dropping the beds ?	what would the doctor take the beds while dropping ?
where can those boys leave after leaving the schools ?	where can those boys leave the schools after leaving ?
who should that adult visit without bothering that customer ?	who should that adult visit that customer without bothering ?
who could the boys bother without working with that adult ?	who could the boys bother that adult without working with ?
where were those guys driving to without going to these rooms ?	where were those guys driving to these rooms without going to ?
what could this mouse love while thinking about this cup ?	what could this mouse love this cup while thinking about ?
what will those girls talk about after talking about this bed ?	what will those girls talk about this bed after talking about ?
what did that guy talk about before talking about that guy ?	what did that guy talk about that guy before talking about ?
who would the queen scare without teaching the child ?	who would the queen scare the child without teaching ?
who was this driver working with without teaching this dancer ?	who was this driver working with this dancer without teaching ?
what would the women take without moving the shirt ?	what would the women take the shirt without moving ?
what would the patient clean before dropping these shirts ?	what would the patient clean these shirts before dropping ?
what is that patient finding before holding these boats ?	what is that patient finding these boats before holding ?
where could that queen run around before leaving this library ?	where could that queen run around this library before leaving ?
what had the door broken while breaking the door ?	what had the door broken the door while breaking ?
what had those girls dropped before losing this bowl ?	what had those girls dropped this bowl before losing ?
what was that patient moving without moving that truck ?	what was that patient moving that truck without moving ?
who did that girl appreciate before teaching these guys ?	who did that girl appreciate these guys before teaching ?
what should that glass break after breaking the car ?	what should that glass break the car after breaking ?
who would the teacher worry without bothering the boys ?	who would the teacher worry the boys without bothering ?
what should this dentist take before buying the books ?	what should this dentist take the books before buying ?
who have these teachers visited after talking to the adult ?	who have these teachers visited the adult after talking to ?
what are those teachers breaking while breaking this rug ?	what are those teachers breaking this rug while breaking ?
what can these teachers break while breaking that couch ?	what can these teachers break that couch while breaking ?
who is that child visiting after listening to the people ?	who is that child visiting the people after listening to ?
what is that queen fixing after holding the windows ?	what is that queen fixing the windows after holding ?
what have these doctors brought before making that doll ?	what have these doctors brought that doll before making ?
who will that dancer work with while helping this lady ?	who will that dancer work with this lady while helping ?
where could those women drive to after going to the hospital ?	where could those women drive to the hospital after going to ?
what did these boxes break while breaking this candle ?	what did these boxes break this candle while breaking ?
who had that child worked with while teaching these men ?	who had that child worked with these men while teaching ?
where can the girls run around without walking through those schools ?	where can the girls run around those schools without walking through ?
what was this bottle breaking after breaking this hat ?	what was this bottle breaking this hat after breaking ?
what could those men take without fixing that hat ?	what could those men take that hat without fixing ?
what had that plane broken before breaking this plane ?	what had that plane broken this plane before breaking ?
what were those women shaking while making the plate ?	what were those women shaking the plate while making ?
what is this dog thinking about without thinking about the trucks ?	what is this dog thinking about the trucks without thinking about ?
what was this doctor bringing without cleaning these rings ?	what was this doctor bringing these rings without cleaning ?
who did these ladies bother after working with the child ?	who did these ladies bother the child after working with ?
what does this boy have while dropping the cup ?	what does this boy have the cup while dropping ?
who do these ladies answer after teaching these men ?	who do these ladies answer these men after teaching ?
what is that man throwing before taking this door ?	what is that man throwing this door before taking ?
who was this boy bothering without bothering those girls ?	who was this boy bothering those girls without bothering ?
what did the rings break without breaking these doors ?	what did the rings break these doors without breaking ?
what has the lady found before taking the ring ?	what has the lady found the ring before taking ?
what were the teachers throwing after making those cups ?	what were the teachers throwing those cups after making ?
who can these doctors answer without bothering the man ?	who can these doctors answer the man without bothering ?
what do the ladies clean before dropping this box ?	what do the ladies clean this box before dropping ?
where does the queen return to before walking through that school ?	where does the queen return to that school before walking through ?
what is that king dropping after bringing the plates ?	what is that king dropping the plates after bringing ?
what had the ladies found without making those rings ?	what had the ladies found those rings without making ?
who will these boys appreciate while visiting the queen ?	who will these boys appreciate the queen while visiting ?
what were these doctors talking about without talking about that driver ?	what were these doctors talking about that driver without talking about ?
what is this chair breaking without breaking the spoon ?	what is this chair breaking the spoon without breaking ?
