my cousins the dancer understands cough .	my cousins the dancer understands sings cough .
that dentist those children listen to reads .	that dentist those children listen to cough reads .
your doctor your friends work with paints .	your doctor your friends work with lie paints .
the person these doctors care for cries .	the person these doctors care for wave cries .
this dancer the people bother waves .	this dancer the people bother paint waves .
the child my friends understand talks .	the child my friends understand talk talks .
that driver your teachers visit exercises .	that driver your teachers visit smile exercises .
the driver the teachers visit reads .	the driver the teachers visit lose reads .
those people this child talks to paint .	those people this child talks to exercises paint .
your doctor your friends worry waves .	your doctor your friends worry stretch waves .
your cousin the doctors worry waves .	your cousin the doctors worry laugh waves .
my teachers the child works with paint .	my teachers the child works with cries paint .
my doctors that person scares read .	my doctors that person scares talks read .
my cousin these people listen to paints .	my cousin these people listen to sing paints .
these doctors your teacher works with whisper .	these doctors your teacher works with exercises whisper .
those teachers this driver works with win .	those teachers this driver works with exercises win .
this dancer those people listen to exercises .	this dancer those people listen to win exercises .
my teacher the teachers listen to reads .	my teacher the teachers listen to sneeze reads .
my doctor those children understand cries .	my doctor those children understand smile cries .
my friend these teachers bother sings .	my friend these teachers bother paint sings .
that dancer these people care for talks .	that dancer these people care for read talks .
this driver your doctors care for paints .	this driver your doctors care for win paints .
that customer those children answer cries .	that customer those children answer sneeze cries .
your teacher my friends teach waves .	your teacher my friends teach whisper waves .
my cousins that dentist works with exercise .	my cousins that dentist works with paints exercise .
my dentist your cousins care for cries .	my dentist your cousins care for exercise cries .
these people this dentist helps cry .	these people this dentist helps paints cry .
your doctor the doctors care for talks .	your doctor the doctors care for win talks .
that person your teachers visit sings .	that person your teachers visit stretch sings .
those children my dentist scares paint .	those children my dentist scares sings paint .
this adult my cousins talk to sings .	this adult my cousins talk to smile sings .
your cousins my friend works with exercise .	your cousins my friend works with waves exercise .
my friend those children work with reads .	my friend those children work with sneeze reads .
my teacher your doctors appreciate paints .	my teacher your doctors appreciate whisper paints .
that dentist my teachers understand waves .	that dentist my teachers understand talk waves .
the person your cousins understand reads .	the person your cousins understand cough reads .
your doctors my boss talks to talk .	your doctors my boss talks to paints talk .
your cousins my friend scares lose .	your cousins my friend scares waves lose .
your doctor your doctors listen to cries .	your doctor your doctors listen to sneeze cries .
your friend the people help waves .	your friend the people help cry waves .
your cousins the adult understands scream .	your cousins the adult understands waves scream .
the doctors my teacher helps wave .	the doctors my teacher helps sings wave .
those teachers the doctor works with lose .	those teachers the doctor works with reads lose .
that driver my doctors scare exercises .	that driver my doctors scare read exercises .
the teachers this person understands yell .	the teachers this person understands sings yell .
these teachers this patient understands yell .	these teachers this patient understands waves yell .
your teachers that person talks to laugh .	your teachers that person talks to paints laugh .
the doctor your teachers understand exercises .	the doctor your teachers understand yell exercises .
my doctor those children care for exercises .	my doctor those children care for read exercises .
that adult your teachers scare paints .	that adult your teachers scare cry paints .
my teachers my friend helps laugh .	my teachers my friend helps talks laugh .
this doctor your friends appreciate waves .	this doctor your friends appreciate laugh waves .
my teacher the doctors help reads .	my teacher the doctors help yell reads .
the adult the children work with cries .	the adult the children work with lose cries .
my dentist my doctors appreciate cries .	my dentist my doctors appreciate practice cries .
the driver the teachers help waves .	the driver the teachers help yell waves .
this dentist these children work with paints .	this dentist these children work with lose paints .
that teacher your cousins understand cries .	that teacher your cousins understand exercise cries .
the people your cousin understands sing .	the people your cousin understands talks sing .
that dentist my friends praise waves .	that dentist my friends praise lie waves .
the person my doctors care for reads .	the person my doctors care for sing reads .
my friend these people teach exercises .	my friend these people teach read exercises .
my cousin these doctors praise exercises .	my cousin these doctors praise exercise exercises .
my friend those people understand paints .	my friend those people understand laugh paints .
my doctor the children bother reads .	my doctor the children bother wave reads .
the child the teachers answer exercises .	the child the teachers answer read exercises .
my boss these teachers visit cries .	my boss these teachers visit practice cries .
the people my dentist talks to whisper .	the people my dentist talks to talks whisper .
my teacher your friends appreciate cries .	my teacher your friends appreciate yell cries .
my cousins your dentist scares laugh .	my cousins your dentist scares reads laugh .
my doctor those teachers visit talks .	my doctor those teachers visit laugh talks .
your friends my friend talks to smile .	your friends my friend talks to reads smile .
your teacher my cousins answer talks .	your teacher my cousins answer scream talks .
those people that doctor helps whisper .	those people that doctor helps paints whisper .
my cousins the doctor works with cry .	my cousins the doctor works with reads cry .
your cousin the teachers listen to cries .	your cousin the teachers listen to sing cries .
my teacher these children scare exercises .	my teacher these children scare talk exercises .
your friend those children help cries .	your friend those children help lose cries .
this teacher the teachers help cries .	this teacher the teachers help cry cries .
those people your friend understands cry .	those people your friend understands exercises cry .
your friend those children appreciate waves .	your friend those children appreciate smile waves .
this teacher your teachers worry sings .	this teacher your teachers worry cry sings .
my teacher my friends bother paints .	my teacher my friends bother laugh paints .
my teacher your doctors bother reads .	my teacher your doctors bother practice reads .
your friend my teachers teach talks .	your friend my teachers teach win talks .
my dentist my teachers visit paints .	my dentist my teachers visit sneeze paints .
my doctors this child helps whisper .	my doctors this child helps reads whisper .
my teacher those children appreciate exercises .	my teacher those children appreciate whisper exercises .
this teacher your doctors care for waves .	this teacher your doctors care for paint waves .
my friends my boss works with win .	my friends my boss works with reads win .
those doctors my boss scares cry .	those doctors my boss scares sings cry .
those children your dentist helps wave .	those children your dentist helps reads wave .
this dentist the children listen to sings .	this dentist the children listen to scream sings .
the adult my cousins scare paints .	the adult my cousins scare yell paints .
your teachers this driver works with cry .	your teachers this driver works with paints cry .
my teacher the people listen to sings .	my teacher the people listen to wave sings .
your boss your doctors praise talks .	your boss your doctors praise talk talks .
your dentist your teachers teach waves .	your dentist your teachers teach paint waves .
my teacher your friends understand talks .	my teacher your friends understand cough talks .
my dentist your teachers listen to waves .	my dentist your teachers listen to cough waves .
my friends your cousin helps sneeze .	my friends your cousin helps waves sneeze .
those children my friend understands smile .	those children my friend understands exercises smile .
my friend these doctors understand cries .	my friend these doctors understand sing cries .
your cousins my doctor talks to paint .	your cousins my doctor talks to paints paint .
my dentist these doctors listen to talks .	my dentist these doctors listen to whisper talks .
that doctor those people appreciate exercises .	that doctor those people appreciate stretch exercises .
this driver the doctors care for reads .	this driver the doctors care for cough reads .
your doctor the children care for sings .	your doctor the children care for smile sings .
this adult my teachers appreciate exercises .	this adult my teachers appreciate cough exercises .
this teacher the people listen to talks .	this teacher the people listen to paint talks .
your dentist those teachers listen to exercises .	your dentist those teachers listen to read exercises .
my friend your doctors visit sings .	my friend your doctors visit lie sings .
the person your friends understand talks .	the person your friends understand wave talks .
that adult your teachers work with cries .	that adult your teachers work with stretch cries .
the person your friends answer reads .	the person your friends answer sneeze reads .
your friend the doctors scare waves .	your friend the doctors scare paint waves .
those children your teacher works with read .	those children your teacher works with sings read .
my teacher your friends scare waves .	my teacher your friends scare cough waves .
your teacher these children bother exercises .	your teacher these children bother sneeze exercises .
my cousin my friends worry sings .	my cousin my friends worry smile sings .
that adult these doctors understand talks .	that adult these doctors understand lie talks .
my friend your teachers teach sings .	my friend your teachers teach laugh sings .
my friends my cousin helps lie .	my friends my cousin helps waves lie .
that patient my cousins praise talks .	that patient my cousins praise stretch talks .
the teachers this driver understands smile .	the teachers this driver understands talks smile .
that doctor your cousins answer reads .	that doctor your cousins answer smile reads .
my cousin your teachers teach talks .	my cousin your teachers teach cry talks .
my friend these people understand reads .	my friend these people understand wave reads .
this customer my teachers care for sings .	this customer my teachers care for paint sings .
your doctor those teachers talk to exercises .	your doctor those teachers talk to smile exercises .
this doctor your teachers praise cries .	this doctor your teachers praise sing cries .
this person your doctors listen to paints .	this person your doctors listen to sing paints .
this adult my teachers help cries .	this adult my teachers help wave cries .
the customer my teachers care for cries .	the customer my teachers care for read cries .
your boss those children bother talks .	your boss those children bother read talks .
those people this dentist talks to yell .	those people this dentist talks to reads yell .
my doctors my boss scares whisper .	my doctors my boss scares talks whisper .
your friends your cousin scares whisper .	your friends your cousin scares paints whisper .
my teachers the dancer talks to talk .	my teachers the dancer talks to cries talk .
this patient these doctors bother paints .	this patient these doctors bother scream paints .
my boss my cousins answer sings .	my boss my cousins answer smile sings .
the teacher the children worry paints .	the teacher the children worry cough paints .
my doctors that patient understands read .	my doctors that patient understands paints read .
your boss your doctors care for cries .	your boss your doctors care for stretch cries .
my boss these children answer paints .	my boss these children answer paint paints .
this driver these children care for waves .	this driver these children care for lose waves .
your boss these doctors care for exercises .	your boss these doctors care for win exercises .
your doctors that dentist understands yell .	your doctors that dentist understands waves yell .
the dancer these doctors worry reads .	the dancer these doctors worry smile reads .
your cousin my cousins care for cries .	your cousin my cousins care for lie cries .
your friends the customer talks to wave .	your friends the customer talks to cries wave .
that patient the children scare sings .	that patient the children scare yell sings .
my teachers my cousin works with cough .	my teachers my cousin works with paints cough .
your cousins this patient works with scream .	your cousins this patient works with cries scream .
your doctors the driver works with wave .	your doctors the driver works with cries wave .
the doctors that adult helps cough .	the doctors that adult helps exercises cough .
these doctors the driver helps sneeze .	these doctors the driver helps waves sneeze .
the teacher those children listen to exercises .	the teacher those children listen to yell exercises .
my cousins my friend scares wave .	my cousins my friend scares paints wave .
this patient those people talk to sings .	this patient those people talk to wave sings .
the dentist your friends help paints .	the dentist your friends help practice paints .
this dentist those teachers visit cries .	this dentist those teachers visit yell cries .
your doctors your boss works with yell .	your doctors your boss works with reads yell .
this dentist my doctors care for waves .	this dentist my doctors care for yell waves .
my dentist the children understand waves .	my dentist the children understand sing waves .
those teachers this patient works with cough .	those teachers this patient works with talks cough .
my cousins that teacher talks to laugh .	my cousins that teacher talks to reads laugh .
this patient these people scare paints .	this patient these people scare win paints .
this doctor my teachers praise reads .	this doctor my teachers praise whisper reads .
that doctor your doctors praise talks .	that doctor your doctors praise lose talks .
my cousins my cousin scares stretch .	my cousins my cousin scares exercises stretch .
those people this dancer talks to wave .	those people this dancer talks to exercises wave .
that dentist your teachers appreciate waves .	that dentist your teachers appreciate lose waves .
my doctor your teachers understand exercises .	my doctor your teachers understand sing exercises .
my friend my friends talk to sings .	my friend my friends talk to whisper sings .
my boss your doctors care for cries .	my boss your doctors care for talk cries .
these teachers your friend scares sing .	these teachers your friend scares talks sing .
that customer those children bother reads .	that customer those children bother lie reads .
these people your doctor scares win .	these people your doctor scares talks win .
your dentist the people listen to waves .	your dentist the people listen to lose waves .
that doctor those children bother cries .	that doctor those children bother wave cries .
my dentist those children visit exercises .	my dentist those children visit cry exercises .
the people that driver understands win .	the people that driver understands talks win .
my cousins my teacher works with practice .	my cousins my teacher works with sings practice .
the child those teachers worry paints .	the child those teachers worry yell paints .
your dentist these children work with paints .	your dentist these children work with cry paints .
those people the customer works with talk .	those people the customer works with waves talk .
the patient my doctors listen to exercises .	the patient my doctors listen to talk exercises .
my doctor those people scare waves .	my doctor those people scare scream waves .
this customer your teachers answer waves .	this customer your teachers answer win waves .
my dentist those children teach exercises .	my dentist those children teach laugh exercises .
your friend my friends listen to reads .	your friend my friends listen to talk reads .
your doctors this customer helps sing .	your doctors this customer helps sings sing .
my dentist those children praise talks .	my dentist those children praise wave talks .
my cousins this dentist talks to laugh .	my cousins this dentist talks to paints laugh .
my cousin my cousins care for exercises .	my cousin my cousins care for laugh exercises .
my teacher my friends scare sings .	my teacher my friends scare sing sings .
my dentist your cousins care for talks .	my dentist your cousins care for paint talks .
the customer those children understand sings .	the customer those children understand smile sings .
that customer your cousins talk to exercises .	that customer your cousins talk to win exercises .
the people your boss talks to talk .	the people your boss talks to waves talk .
your friend your teachers worry exercises .	your friend your teachers worry sneeze exercises .
your teachers my teacher talks to smile .	your teachers my teacher talks to sings smile .
your cousin these people praise exercises .	your cousin these people praise win exercises .
the teacher your cousins praise sings .	the teacher your cousins praise scream sings .
that doctor those teachers worry waves .	that doctor those teachers worry sneeze waves .
these people my doctor helps yell .	these people my doctor helps reads yell .
this patient your teachers answer cries .	this patient your teachers answer talk cries .
the doctor the doctors answer reads .	the doctor the doctors answer lose reads .
those children your dentist works with stretch .	those children your dentist works with cries stretch .
my cousin my friends praise sings .	my cousin my friends praise smile sings .
the person my doctors answer talks .	the person my doctors answer lose talks .
my friend those teachers listen to waves .	my friend those teachers listen to yell waves .
this child these doctors work with exercises .	this child these doctors work with lose exercises .
my friend my teachers worry cries .	my friend my teachers worry paint cries .
that teacher these teachers work with reads .	that teacher these teachers work with paint reads .
the dancer these people help exercises .	the dancer these people help cough exercises .
the customer these people understand exercises .	the customer these people understand lose exercises .
my doctor my teachers help waves .	my doctor my teachers help exercise waves .
your dentist the children understand sings .	your dentist the children understand cough sings .
the customer your teachers teach reads .	the customer your teachers teach sneeze reads .
this person your teachers worry waves .	this person your teachers worry sing waves .
this teacher your doctors teach talks .	this teacher your doctors teach win talks .
my dentist your doctors work with sings .	my dentist your doctors work with wave sings .
your teacher these doctors scare waves .	your teacher these doctors scare sing waves .
the dancer the teachers care for cries .	the dancer the teachers care for talk cries .
your friend your doctors appreciate exercises .	your friend your doctors appreciate laugh exercises .
my teacher the teachers help waves .	my teacher the teachers help smile waves .
my cousins your boss scares read .	my cousins your boss scares waves read .
your teachers the dancer scares yell .	your teachers the dancer scares reads yell .
your boss those children listen to reads .	your boss those children listen to yell reads .
the doctor these doctors care for talks .	the doctor these doctors care for talk talks .
my doctors your cousin helps lie .	my doctors your cousin helps exercises lie .
my teachers that customer talks to cough .	my teachers that customer talks to waves cough .
your teachers that customer talks to cough .	your teachers that customer talks to reads cough .
my cousins your friend talks to paint .	my cousins your friend talks to sings paint .
my boss these people scare talks .	my boss these people scare lie talks .
your cousins your teacher understands wave .	your cousins your teacher understands sings wave .
that driver those doctors worry exercises .	that driver those doctors worry read exercises .
my friend these doctors talk to waves .	my friend these doctors talk to sneeze waves .
my teacher my friends talk to exercises .	my teacher my friends talk to cry exercises .
your cousin my cousins understand reads .	your cousin my cousins understand cry reads .
my teacher these doctors scare waves .	my teacher these doctors scare talk waves .
the person these doctors answer talks .	the person these doctors answer cry talks .
the driver my friends worry exercises .	the driver my friends worry cough exercises .
the adult the children praise paints .	the adult the children praise sneeze paints .
those people my teacher talks to stretch .	those people my teacher talks to talks stretch .
those doctors your boss understands yell .	those doctors your boss understands paints yell .
your teacher the children worry cries .	your teacher the children worry whisper cries .
your boss these people answer sings .	your boss these people answer sneeze sings .
that dentist the people help cries .	that dentist the people help talk cries .
my teachers my teacher scares exercise .	my teachers my teacher scares cries exercise .
that person the children care for paints .	that person the children care for lie paints .
your boss these people work with paints .	your boss these people work with cry paints .
that adult my cousins appreciate cries .	that adult my cousins appreciate smile cries .
the teachers this doctor works with lie .	the teachers this doctor works with exercises lie .
that customer these children care for exercises .	that customer these children care for laugh exercises .
the customer my doctors listen to waves .	the customer my doctors listen to read waves .
your boss your friends praise sings .	your boss your friends praise cry sings .
your teacher your cousins teach reads .	your teacher your cousins teach cry reads .
my friends my friend works with laugh .	my friends my friend works with talks laugh .
my doctor your doctors scare talks .	my doctor your doctors scare scream talks .
your boss your friends listen to sings .	your boss your friends listen to scream sings .
your doctor those teachers praise waves .	your doctor those teachers praise paint waves .
my dentist your teachers visit cries .	my dentist your teachers visit sneeze cries .
my boss my friends teach talks .	my boss my friends teach laugh talks .
my friends my doctor helps cough .	my friends my doctor helps cries cough .
that dentist my teachers care for sings .	that dentist my teachers care for whisper sings .
my boss those children help sings .	my boss those children help cough sings .
this patient your cousins talk to waves .	this patient your cousins talk to cry waves .
my teachers the child helps wave .	my teachers the child helps waves wave .
your boss those doctors understand exercises .	your boss those doctors understand yell exercises .
my friends that customer works with read .	my friends that customer works with waves read .
the person those children understand cries .	the person those children understand yell cries .
those teachers that dancer scares sing .	those teachers that dancer scares reads sing .
my doctor your doctors teach paints .	my doctor your doctors teach win paints .
this teacher your cousins help reads .	this teacher your cousins help whisper reads .
your cousin those people help sings .	your cousin those people help practice sings .
your cousin those people scare exercises .	your cousin those people scare exercise exercises .
my doctors my teacher works with sing .	my doctors my teacher works with talks sing .
your dentist your friends praise reads .	your dentist your friends praise practice reads .
this adult my friends answer cries .	this adult my friends answer practice cries .
my dentist your teachers work with paints .	my dentist your teachers work with whisper paints .
your friends my friend helps paint .	your friends my friend helps cries paint .
your friend your cousins talk to exercises .	your friend your cousins talk to yell exercises .
your friend these doctors scare exercises .	your friend these doctors scare yell exercises .
this doctor your cousins care for paints .	this doctor your cousins care for sing paints .
my teachers that person works with win .	my teachers that person works with paints win .
this dentist those doctors work with waves .	this dentist those doctors work with yell waves .
this driver your doctors scare talks .	this driver your doctors scare lie talks .
this person the doctors bother sings .	this person the doctors bother practice sings .
your doctor my doctors work with talks .	your doctor my doctors work with exercise talks .
my doctor my cousins care for waves .	my doctor my cousins care for cough waves .
your teacher my doctors teach reads .	your teacher my doctors teach win reads .
your teachers that dentist talks to paint .	your teachers that dentist talks to talks paint .
your doctors my boss scares cough .	your doctors my boss scares paints cough .
those teachers your teacher understands cough .	those teachers your teacher understands sings cough .
your doctors my boss scares lie .	your doctors my boss scares talks lie .
your doctors this dancer talks to wave .	your doctors this dancer talks to paints wave .
that driver your teachers appreciate cries .	that driver your teachers appreciate lie cries .
that adult your doctors talk to talks .	that adult your doctors talk to lie talks .
the adult my friends appreciate cries .	the adult my friends appreciate smile cries .
that dancer your doctors worry reads .	that dancer your doctors worry smile reads .
that doctor my friends bother reads .	that doctor my friends bother sing reads .
your teacher your friends worry exercises .	your teacher your friends worry lose exercises .
this dancer my teachers work with paints .	this dancer my teachers work with talk paints .
my doctor these people work with reads .	my doctor these people work with practice reads .
your friend my friends bother exercises .	your friend my friends bother stretch exercises .
your cousin these children work with paints .	your cousin these children work with laugh paints .
my doctors that customer scares lose .	my doctors that customer scares exercises lose .
the customer those teachers understand reads .	the customer those teachers understand paint reads .
that person the doctors teach paints .	that person the doctors teach wave paints .
my cousin my teachers teach reads .	my cousin my teachers teach wave reads .
the teacher the doctors understand reads .	the teacher the doctors understand cough reads .
that teacher the doctors understand talks .	that teacher the doctors understand sneeze talks .
the person those people answer cries .	the person those people answer lose cries .
my friends my cousin works with scream .	my friends my cousin works with exercises scream .
your cousin your friends work with exercises .	your cousin your friends work with whisper exercises .
your friend the children praise exercises .	your friend the children praise whisper exercises .
your teacher the children worry cries .	your teacher the children worry lose cries .
your cousin my cousins care for reads .	your cousin my cousins care for exercise reads .
this dancer my friends care for waves .	this dancer my friends care for practice waves .
this child the doctors appreciate waves .	this child the doctors appreciate scream waves .
the dancer the doctors care for paints .	the dancer the doctors care for exercise paints .
my teachers that dancer understands sneeze .	my teachers that dancer understands sings sneeze .
those children the doctor understands whisper .	those children the doctor understands sings whisper .
my doctor the people worry exercises .	my doctor the people worry stretch exercises .
the child those children talk to talks .	the child those children talk to smile talks .
your teacher my friends visit waves .	your teacher my friends visit yell waves .
this teacher your doctors scare sings .	this teacher your doctors scare cry sings .
the people my cousin talks to win .	the people my cousin talks to reads win .
this patient my cousins bother exercises .	this patient my cousins bother cough exercises .
your teacher the people visit sings .	your teacher the people visit win sings .
your cousins your teacher scares yell .	your cousins your teacher scares paints yell .
that doctor these doctors understand reads .	that doctor these doctors understand win reads .
my friend my cousins praise cries .	my friend my cousins praise talk cries .
my cousin your friends worry exercises .	my cousin your friends worry read exercises .
my doctor your doctors teach cries .	my doctor your doctors teach whisper cries .
my friend your cousins help waves .	my friend your cousins help lose waves .
the dancer the doctors appreciate waves .	the dancer the doctors appreciate lose waves .
my doctor those children talk to paints .	my doctor those children talk to stretch paints .
my boss those people listen to paints .	my boss those people listen to cry paints .
my boss these teachers understand exercises .	my boss these teachers understand cry exercises .
my friends this driver talks to stretch .	my friends this driver talks to paints stretch .
your friend your friends care for cries .	your friend your friends care for smile cries .
your friend those people worry paints .	your friend those people worry cough paints .
that child your friends teach exercises .	that child your friends teach lose exercises .
the customer my teachers care for exercises .	the customer my teachers care for win exercises .
that person these doctors work with talks .	that person these doctors work with lie talks .
these doctors my teacher talks to win .	these doctors my teacher talks to waves win .
my dentist those people praise exercises .	my dentist those people praise stretch exercises .
your teachers my cousin scares smile .	your teachers my cousin scares talks smile .
my cousin your doctors answer cries .	my cousin your doctors answer scream cries .
your doctor my cousins bother paints .	your doctor my cousins bother stretch paints .
that patient my doctors understand exercises .	that patient my doctors understand lose exercises .
the person my teachers teach exercises .	the person my teachers teach cry exercises .
my teacher these people answer paints .	my teacher these people answer smile paints .
your friend those doctors listen to exercises .	your friend those doctors listen to scream exercises .
my cousins my cousin talks to laugh .	my cousins my cousin talks to exercises laugh .
your teacher those children bother reads .	your teacher those children bother stretch reads .
the doctor my friends appreciate exercises .	the doctor my friends appreciate smile exercises .
your teacher my teachers teach talks .	your teacher my teachers teach cough talks .
your cousin these children praise exercises .	your cousin these children praise scream exercises .
my friend these teachers visit cries .	my friend these teachers visit smile cries .
this adult the teachers work with cries .	this adult the teachers work with sneeze cries .
the dancer the teachers scare waves .	the dancer the teachers scare paint waves .
this dentist your friends scare waves .	this dentist your friends scare laugh waves .
my friend my cousins appreciate sings .	my friend my cousins appreciate talk sings .
your friends my friend works with stretch .	your friends my friend works with reads stretch .
your dentist your teachers bother talks .	your dentist your teachers bother wave talks .
your teacher the teachers scare talks .	your teacher the teachers scare exercise talks .
that adult the children bother exercises .	that adult the children bother stretch exercises .
my cousins your teacher helps cry .	my cousins your teacher helps paints cry .
this dancer your doctors understand sings .	this dancer your doctors understand sing sings .
the teacher the teachers bother waves .	the teacher the teachers bother practice waves .
your friends the person scares sing .	your friends the person scares exercises sing .
this dancer the doctors answer talks .	this dancer the doctors answer whisper talks .
these teachers this teacher talks to practice .	these teachers this teacher talks to talks practice .
these doctors the driver understands sneeze .	these doctors the driver understands waves sneeze .
this adult those teachers work with talks .	this adult those teachers work with win talks .
the customer those children understand reads .	the customer those children understand yell reads .
this dentist these teachers work with paints .	this dentist these teachers work with sneeze paints .
your dentist the children care for waves .	your dentist the children care for cry waves .
this dentist those people teach talks .	this dentist those people teach cough talks .
my dentist these people listen to sings .	my dentist these people listen to wave sings .
that patient these teachers bother reads .	that patient these teachers bother stretch reads .
this teacher my teachers bother cries .	this teacher my teachers bother cough cries .
my doctor those doctors answer talks .	my doctor those doctors answer lie talks .
your doctor my friends teach sings .	your doctor my friends teach win sings .
this driver those children talk to reads .	this driver those children talk to yell reads .
the doctor your friends work with reads .	the doctor your friends work with talk reads .
this dentist your doctors visit sings .	this dentist your doctors visit paint sings .
this patient your friends visit sings .	this patient your friends visit win sings .
the teachers your boss works with whisper .	the teachers your boss works with reads whisper .
your doctor those people help waves .	your doctor those people help exercise waves .
this patient your teachers praise talks .	this patient your teachers praise scream talks .
that dancer those teachers talk to reads .	that dancer those teachers talk to read reads .
that patient these teachers talk to exercises .	that patient these teachers talk to laugh exercises .
the child those children scare talks .	the child those children scare laugh talks .
your cousin your doctors teach talks .	your cousin your doctors teach lose talks .
your teachers your dentist understands exercise .	your teachers your dentist understands reads exercise .
that driver these people worry reads .	that driver these people worry stretch reads .
the customer these teachers worry sings .	the customer these teachers worry scream sings .
that dentist those teachers worry talks .	that dentist those teachers worry smile talks .
the doctors the adult helps scream .	the doctors the adult helps paints scream .
the child my teachers help reads .	the child my teachers help paint reads .
your doctor your friends worry sings .	your doctor your friends worry lie sings .
the children the person talks to yell .	the children the person talks to paints yell .
the teacher these teachers listen to waves .	the teacher these teachers listen to win waves .
those teachers the person understands talk .	those teachers the person understands waves talk .
my friend my doctors listen to talks .	my friend my doctors listen to scream talks .
my cousin these children care for exercises .	my cousin these children care for wave exercises .
that dentist your teachers bother sings .	that dentist your teachers bother paint sings .
my cousin your doctors visit sings .	my cousin your doctors visit wave sings .
the dancer your friends teach paints .	the dancer your friends teach scream paints .
these children your doctor helps whisper .	these children your doctor helps exercises whisper .
my teacher your teachers care for exercises .	my teacher your teachers care for wave exercises .
that child your cousins praise waves .	that child your cousins praise smile waves .
your boss your teachers work with talks .	your boss your teachers work with scream talks .
my doctor my cousins talk to paints .	my doctor my cousins talk to sneeze paints .
this person the doctors understand sings .	this person the doctors understand sing sings .
the teacher those people work with reads .	the teacher those people work with lose reads .
your friend my cousins scare reads .	your friend my cousins scare win reads .
my friend those doctors appreciate reads .	my friend those doctors appreciate wave reads .
your doctor these teachers bother reads .	your doctor these teachers bother paint reads .
the patient those people visit sings .	the patient those people visit paint sings .
that dentist the children teach paints .	that dentist the children teach yell paints .
my friend my doctors appreciate cries .	my friend my doctors appreciate paint cries .
that dancer my teachers answer reads .	that dancer my teachers answer scream reads .
this driver my cousins listen to reads .	this driver my cousins listen to practice reads .
your doctor my teachers listen to talks .	your doctor my teachers listen to read talks .
the child my teachers scare paints .	the child my teachers scare smile paints .
my dentist these children appreciate cries .	my dentist these children appreciate win cries .
these children my friend understands sing .	these children my friend understands sings sing .
the people this person scares lie .	the people this person scares exercises lie .
your friend the doctors teach talks .	your friend the doctors teach practice talks .
my cousin the teachers praise reads .	my cousin the teachers praise paint reads .
your friends that dentist works with sneeze .	your friends that dentist works with cries sneeze .
your friend these people talk to sings .	your friend these people talk to sneeze sings .
your teacher my doctors talk to talks .	your teacher my doctors talk to sneeze talks .
your friends that doctor works with cough .	your friends that doctor works with cries cough .
the teacher the doctors talk to paints .	the teacher the doctors talk to cough paints .
my friends your cousin works with talk .	my friends your cousin works with reads talk .
your teacher the teachers scare waves .	your teacher the teachers scare lie waves .
your friend my doctors bother sings .	your friend my doctors bother cry sings .
your friend your teachers visit cries .	your friend your teachers visit sing cries .
my friend my doctors teach talks .	my friend my doctors teach exercise talks .
these doctors this teacher works with stretch .	these doctors this teacher works with reads stretch .
my cousin your teachers visit reads .	my cousin your teachers visit cough reads .
my friends the person understands cry .	my friends the person understands talks cry .
the person these teachers care for waves .	the person these teachers care for scream waves .
those people my boss understands wave .	those people my boss understands exercises wave .
my doctor my doctors praise paints .	my doctor my doctors praise sing paints .
your boss these children visit talks .	your boss these children visit read talks .
this adult these people worry waves .	this adult these people worry talk waves .
this dancer these people teach waves .	this dancer these people teach whisper waves .
your doctors this dancer works with cry .	your doctors this dancer works with reads cry .
this child the teachers appreciate cries .	this child the teachers appreciate laugh cries .
that child the doctors praise talks .	that child the doctors praise lose talks .
this adult the teachers bother waves .	this adult the teachers bother wave waves .
your teacher my teachers answer paints .	your teacher my teachers answer sneeze paints .
my doctor these people worry cries .	my doctor these people worry laugh cries .
your doctor the doctors worry talks .	your doctor the doctors worry scream talks .
that child my friends understand sings .	that child my friends understand paint sings .
the child those people visit sings .	the child those people visit cry sings .
my cousins the driver talks to stretch .	my cousins the driver talks to exercises stretch .
the patient those children appreciate talks .	the patient those children appreciate exercise talks .
my teacher the people teach waves .	my teacher the people teach stretch waves .
my cousin your teachers answer cries .	my cousin your teachers answer read cries .
this teacher my doctors listen to sings .	this teacher my doctors listen to lie sings .
your friend my friends understand talks .	your friend my friends understand lie talks .
this dancer the people worry talks .	this dancer the people worry cry talks .
that dentist these teachers bother cries .	that dentist these teachers bother paint cries .
the dancer your cousins care for waves .	the dancer your cousins care for cough waves .
your doctor those doctors bother reads .	your doctor those doctors bother stretch reads .
this patient these doctors bother reads .	this patient these doctors bother sneeze reads .
the children my friend works with smile .	the children my friend works with waves smile .
this teacher your friends scare waves .	this teacher your friends scare read waves .
your boss my teachers visit waves .	your boss my teachers visit smile waves .
the teacher these teachers worry reads .	the teacher these teachers worry sneeze reads .
this patient these people help exercises .	this patient these people help practice exercises .
my friend these doctors care for paints .	my friend these doctors care for wave paints .
my teachers my friend helps stretch .	my teachers my friend helps exercises stretch .
this customer my friends work with sings .	this customer my friends work with talk sings .
this dentist my cousins praise sings .	this dentist my cousins praise laugh sings .
those doctors the dancer understands cry .	those doctors the dancer understands sings cry .
these doctors your dentist understands stretch .	these doctors your dentist understands waves stretch .
those children my friend talks to lie .	those children my friend talks to exercises lie .
my doctors that dentist talks to sing .	my doctors that dentist talks to paints sing .
your friends your doctor helps paint .	your friends your doctor helps reads paint .
my friend these doctors bother exercises .	my friend these doctors bother smile exercises .
the person those children help sings .	the person those children help wave sings .
my cousins my friend helps yell .	my cousins my friend helps exercises yell .
this person these teachers work with waves .	this person these teachers work with cough waves .
the doctor your friends talk to exercises .	the doctor your friends talk to sneeze exercises .
your cousin my teachers answer exercises .	your cousin my teachers answer laugh exercises .
the patient my cousins care for paints .	the patient my cousins care for sing paints .
my friend those children praise waves .	my friend those children praise lose waves .
that dentist my teachers talk to waves .	that dentist my teachers talk to scream waves .
those doctors this person talks to stretch .	those doctors this person talks to waves stretch .
the children your teacher talks to paint .	the children your teacher talks to exercises paint .
my cousins the teacher helps laugh .	my cousins the teacher helps reads laugh .
my dentist the teachers bother sings .	my dentist the teachers bother practice sings .
your dentist your doctors listen to cries .	your dentist your doctors listen to yell cries .
your cousin the teachers understand exercises .	your cousin the teachers understand talk exercises .
that doctor my friends listen to exercises .	that doctor my friends listen to practice exercises .
this customer your doctors talk to reads .	this customer your doctors talk to win reads .
my doctors your cousin helps scream .	my doctors your cousin helps paints scream .
your teacher those children answer talks .	your teacher those children answer read talks .
my dentist those teachers listen to exercises .	my dentist those teachers listen to lose exercises .
the doctors my doctor understands read .	the doctors my doctor understands waves read .
the people this teacher works with practice .	the people this teacher works with paints practice .
the dentist your doctors worry cries .	the dentist your doctors worry practice cries .
that teacher your doctors bother paints .	that teacher your doctors bother laugh paints .
my teachers your teacher works with scream .	my teachers your teacher works with talks scream .
your doctors your friend scares read .	your doctors your friend scares exercises read .
these doctors my teacher talks to talk .	these doctors my teacher talks to sings talk .
the patient the doctors visit paints .	the patient the doctors visit practice paints .
the adult my teachers teach reads .	the adult my teachers teach exercise reads .
my doctor my cousins visit cries .	my doctor my cousins visit sneeze cries .
that dancer my doctors answer sings .	that dancer my doctors answer lie sings .
the patient those people visit paints .	the patient those people visit stretch paints .
that patient these teachers scare sings .	that patient these teachers scare cry sings .
the doctor those doctors bother sings .	the doctor those doctors bother scream sings .
your cousin your cousins praise talks .	your cousin your cousins praise paint talks .
your teachers this teacher talks to practice .	your teachers this teacher talks to cries practice .
your doctor these children answer paints .	your doctor these children answer yell paints .
this doctor these children help reads .	this doctor these children help stretch reads .
your teacher your teachers praise talks .	your teacher your teachers praise lose talks .
those teachers my dentist understands wave .	those teachers my dentist understands cries wave .
my dentist your friends teach waves .	my dentist your friends teach sing waves .
your friends the dancer helps paint .	your friends the dancer helps exercises paint .
my friend your teachers worry waves .	my friend your teachers worry wave waves .
the dancer those children bother waves .	the dancer those children bother lose waves .
your doctor your doctors teach waves .	your doctor your doctors teach cough waves .
the driver your teachers answer talks .	the driver your teachers answer stretch talks .
my doctor the teachers answer reads .	my doctor the teachers answer laugh reads .
my doctor those people worry exercises .	my doctor those people worry exercise exercises .
your doctors this doctor understands stretch .	your doctors this doctor understands exercises stretch .
my doctor your cousins help waves .	my doctor your cousins help talk waves .
the people my dentist understands cough .	the people my dentist understands cries cough .
the teachers your teacher helps sneeze .	the teachers your teacher helps talks sneeze .
this patient these doctors appreciate cries .	this patient these doctors appreciate lose cries .
your cousin your cousins care for cries .	your cousin your cousins care for yell cries .
your cousins your doctor talks to laugh .	your cousins your doctor talks to exercises laugh .
this dancer my doctors work with waves .	this dancer my doctors work with practice waves .
your dentist my teachers help cries .	your dentist my teachers help sing cries .
that driver my friends listen to talks .	that driver my friends listen to lose talks .
my doctor your doctors worry cries .	my doctor your doctors worry win cries .
that person your teachers talk to reads .	that person your teachers talk to win reads .
these people my dentist talks to yell .	these people my dentist talks to cries yell .
your teachers this child scares lie .	your teachers this child scares sings lie .
this dentist those children care for sings .	this dentist those children care for lie sings .
my doctors my dentist scares exercise .	my doctors my dentist scares waves exercise .
this dentist your friends understand reads .	this dentist your friends understand win reads .
your cousin those teachers help waves .	your cousin those teachers help exercise waves .
the customer those people visit reads .	the customer those people visit win reads .
those people your teacher works with stretch .	those people your teacher works with talks stretch .
my boss the people visit exercises .	my boss the people visit exercise exercises .
these children your teacher talks to talk .	these children your teacher talks to waves talk .
your doctors your cousin talks to whisper .	your doctors your cousin talks to cries whisper .
this customer these doctors work with cries .	this customer these doctors work with cough cries .
those people your boss scares talk .	those people your boss scares paints talk .
these children this driver talks to sneeze .	these children this driver talks to reads sneeze .
the doctor your teachers help paints .	the doctor your teachers help wave paints .
this dancer your teachers scare cries .	this dancer your teachers scare stretch cries .
your doctors your dentist helps practice .	your doctors your dentist helps talks practice .
your cousin my friends scare sings .	your cousin my friends scare sing sings .
my doctor these children care for exercises .	my doctor these children care for smile exercises .
this dentist my cousins worry paints .	this dentist my cousins worry smile paints .
this adult these people scare sings .	this adult these people scare exercise sings .
those children that adult understands sing .	those children that adult understands sings sing .
your teachers my doctor works with laugh .	your teachers my doctor works with reads laugh .
those children your dentist works with win .	those children your dentist works with paints win .
your boss your teachers worry reads .	your boss your teachers worry stretch reads .
your teacher the teachers bother cries .	your teacher the teachers bother scream cries .
the teacher these people appreciate paints .	the teacher these people appreciate yell paints .
that teacher my teachers worry cries .	that teacher my teachers worry talk cries .
my teacher your friends understand cries .	my teacher your friends understand lie cries .
that driver your friends talk to reads .	that driver your friends talk to stretch reads .
my friends the patient works with paint .	my friends the patient works with cries paint .
my doctors your doctor talks to exercise .	my doctors your doctor talks to sings exercise .
the teacher your doctors visit cries .	the teacher your doctors visit win cries .
my friends the dentist helps smile .	my friends the dentist helps paints smile .
this child my friends answer sings .	this child my friends answer read sings .
your doctor the children care for paints .	your doctor the children care for yell paints .
this child these people appreciate waves .	this child these people appreciate stretch waves .
the person my cousins appreciate exercises .	the person my cousins appreciate cry exercises .
your cousin these children bother talks .	your cousin these children bother lose talks .
your doctors the dentist talks to wave .	your doctors the dentist talks to sings wave .
my cousin the doctors praise waves .	my cousin the doctors praise stretch waves .
your doctor my teachers teach cries .	your doctor my teachers teach practice cries .
your boss the teachers praise cries .	your boss the teachers praise smile cries .
your cousins your doctor scares lose .	your cousins your doctor scares exercises lose .
your boss these children answer exercises .	your boss these children answer yell exercises .
this person my teachers care for paints .	this person my teachers care for lose paints .
your cousin your cousins understand sings .	your cousin your cousins understand read sings .
the patient those children teach exercises .	the patient those children teach cough exercises .
your teacher these children help cries .	your teacher these children help cough cries .
my friend your cousins understand paints .	my friend your cousins understand cry paints .
the children that doctor talks to win .	the children that doctor talks to exercises win .
the doctor the teachers help reads .	the doctor the teachers help wave reads .
my friend these people praise exercises .	my friend these people praise sing exercises .
the adult the teachers work with sings .	the adult the teachers work with cry sings .
your friends this dentist talks to stretch .	your friends this dentist talks to paints stretch .
the dentist those teachers visit waves .	the dentist those teachers visit read waves .
my boss my cousins visit sings .	my boss my cousins visit wave sings .
those doctors your cousin scares wave .	those doctors your cousin scares paints wave .
these doctors that patient helps sneeze .	these doctors that patient helps exercises sneeze .
my cousin those doctors listen to sings .	my cousin those doctors listen to win sings .
that doctor these people care for sings .	that doctor these people care for smile sings .
the patient your doctors bother sings .	the patient your doctors bother stretch sings .
that teacher the people work with sings .	that teacher the people work with scream sings .
that patient my friends worry talks .	that patient my friends worry cough talks .
your cousin my friends visit sings .	your cousin my friends visit paint sings .
that patient the teachers praise reads .	that patient the teachers praise lose reads .
my friend those teachers worry waves .	my friend those teachers worry win waves .
your teachers my dentist understands cry .	your teachers my dentist understands sings cry .
your cousin your doctors scare paints .	your cousin your doctors scare laugh paints .
the person the teachers talk to sings .	the person the teachers talk to cry sings .
this patient the children care for talks .	this patient the children care for smile talks .
my friend these teachers bother sings .	my friend these teachers bother read sings .
the people my dentist talks to practice .	the people my dentist talks to waves practice .
this child the children visit exercises .	this child the children visit exercise exercises .
your cousin these people appreciate sings .	your cousin these people appreciate paint sings .
the person your cousins bother exercises .	the person your cousins bother stretch exercises .
my friend these children bother sings .	my friend these children bother lose sings .
my teachers this adult helps whisper .	my teachers this adult helps sings whisper .
that child my friends listen to reads .	that child my friends listen to paint reads .
that patient your friends listen to reads .	that patient your friends listen to sneeze reads .
that driver my friends bother cries .	that driver my friends bother lose cries .
those people your boss talks to cry .	those people your boss talks to talks cry .
my cousin these children praise cries .	my cousin these children praise cry cries .
the driver your friends worry waves .	the driver your friends worry exercise waves .
those children my doctor helps whisper .	those children my doctor helps sings whisper .
your doctor my friends help sings .	your doctor my friends help stretch sings .
the people your teacher scares sing .	the people your teacher scares waves sing .
this doctor those teachers bother paints .	this doctor those teachers bother stretch paints .
my dentist your teachers praise reads .	my dentist your teachers praise lie reads .
your friend your cousins visit sings .	your friend your cousins visit yell sings .
your friends my boss works with yell .	your friends my boss works with waves yell .
your cousin those people answer talks .	your cousin those people answer laugh talks .
this driver these children teach paints .	this driver these children teach lose paints .
that dancer the children teach cries .	that dancer the children teach win cries .
my cousins this child scares whisper .	my cousins this child scares exercises whisper .
this person those doctors visit sings .	this person those doctors visit practice sings .
my doctor the people praise reads .	my doctor the people praise talk reads .
the doctors that patient helps smile .	the doctors that patient helps waves smile .
this child your doctors answer talks .	this child your doctors answer stretch talks .
your teacher my cousins praise sings .	your teacher my cousins praise cry sings .
this teacher the children appreciate cries .	this teacher the children appreciate practice cries .
the adult these people worry paints .	the adult these people worry cry paints .
your cousin these children talk to waves .	your cousin these children talk to paint waves .
my teacher those doctors care for talks .	my teacher those doctors care for yell talks .
the child my teachers appreciate talks .	the child my teachers appreciate cough talks .
my friends my doctor scares scream .	my friends my doctor scares sings scream .
this patient my friends visit exercises .	this patient my friends visit exercise exercises .
those children your teacher understands whisper .	those children your teacher understands sings whisper .
my boss those doctors teach paints .	my boss those doctors teach sing paints .
these children my dentist helps scream .	these children my dentist helps paints scream .
the adult the people praise waves .	the adult the people praise talk waves .
this teacher my doctors appreciate sings .	this teacher my doctors appreciate win sings .
the doctors your dentist works with sneeze .	the doctors your dentist works with exercises sneeze .
the driver those doctors listen to paints .	the driver those doctors listen to laugh paints .
the dancer the children talk to reads .	the dancer the children talk to exercise reads .
my dentist your doctors help paints .	my dentist your doctors help win paints .
those doctors my dentist understands sing .	those doctors my dentist understands talks sing .
those people your doctor understands talk .	those people your doctor understands exercises talk .
that driver my teachers talk to sings .	that driver my teachers talk to cry sings .
this person your friends appreciate reads .	this person your friends appreciate smile reads .
your friends this customer scares wave .	your friends this customer scares talks wave .
that patient those children help exercises .	that patient those children help win exercises .
that child your doctors scare waves .	that child your doctors scare lose waves .
your cousin my teachers listen to reads .	your cousin my teachers listen to wave reads .
the driver those people scare talks .	the driver those people scare cry talks .
my cousin my friends answer exercises .	my cousin my friends answer read exercises .
the person these doctors help cries .	the person these doctors help lose cries .
your doctor my friends understand exercises .	your doctor my friends understand cry exercises .
these people my teacher helps cough .	these people my teacher helps reads cough .
the child these teachers help reads .	the child these teachers help sneeze reads .
your friends my friend scares sing .	your friends my friend scares sings sing .
your teacher my doctors listen to paints .	your teacher my doctors listen to practice paints .
this patient those doctors help sings .	this patient those doctors help sing sings .
my dentist those children bother sings .	my dentist those children bother paint sings .
that dancer your teachers bother paints .	that dancer your teachers bother sneeze paints .
this teacher my doctors talk to cries .	this teacher my doctors talk to sneeze cries .
your doctor your doctors talk to reads .	your doctor your doctors talk to exercise reads .
the teachers the doctor talks to read .	the teachers the doctor talks to waves read .
my teacher these people appreciate waves .	my teacher these people appreciate whisper waves .
those people your dentist scares practice .	those people your dentist scares cries practice .
the dentist the teachers scare cries .	the dentist the teachers scare sing cries .
your friends your teacher scares lose .	your friends your teacher scares talks lose .
my dentist these teachers work with talks .	my dentist these teachers work with talk talks .
this patient my doctors care for exercises .	this patient my doctors care for cough exercises .
those teachers my friend works with wave .	those teachers my friend works with cries wave .
your dentist your cousins praise talks .	your dentist your cousins praise lose talks .
this customer my teachers scare paints .	this customer my teachers scare win paints .
the adult your teachers bother sings .	the adult your teachers bother cough sings .
this teacher the teachers care for cries .	this teacher the teachers care for laugh cries .
your friend the teachers praise reads .	your friend the teachers praise whisper reads .
your friend your teachers worry reads .	your friend your teachers worry read reads .
that child my friends praise waves .	that child my friends praise sing waves .
that patient my doctors help talks .	that patient my doctors help exercise talks .
your dentist my teachers help paints .	your dentist my teachers help cry paints .
the person my doctors worry paints .	the person my doctors worry scream paints .
your teachers your cousin works with scream .	your teachers your cousin works with cries scream .
that adult my teachers help exercises .	that adult my teachers help sneeze exercises .
the person your teachers understand reads .	the person your teachers understand paint reads .
your friend those teachers understand exercises .	your friend those teachers understand wave exercises .
these children that doctor helps sneeze .	these children that doctor helps waves sneeze .
this person those people answer exercises .	this person those people answer wave exercises .
my doctors my dentist understands sneeze .	my doctors my dentist understands reads sneeze .
the customer my friends answer exercises .	the customer my friends answer cough exercises .
that adult your friends praise talks .	that adult your friends praise sneeze talks .
the patient those teachers praise talks .	the patient those teachers praise win talks .
my teacher these children scare cries .	my teacher these children scare yell cries .
your teachers my cousin helps wave .	your teachers my cousin helps sings wave .
those children this customer scares cough .	those children this customer scares exercises cough .
the doctor your friends work with paints .	the doctor your friends work with talk paints .
that person these doctors teach reads .	that person these doctors teach yell reads .
your cousin your teachers answer sings .	your cousin your teachers answer cry sings .
these people my friend understands scream .	these people my friend understands reads scream .
this dentist your doctors visit paints .	this dentist your doctors visit read paints .
your doctor your cousins understand paints .	your doctor your cousins understand scream paints .
these doctors that patient understands paint .	these doctors that patient understands talks paint .
this customer the teachers visit paints .	this customer the teachers visit yell paints .
my cousin those children talk to reads .	my cousin those children talk to win reads .
the teacher those children work with paints .	the teacher those children work with paint paints .
that patient the teachers work with exercises .	that patient the teachers work with wave exercises .
this customer these children understand reads .	this customer these children understand laugh reads .
your doctor your teachers visit exercises .	your doctor your teachers visit lie exercises .
my cousin those doctors talk to paints .	my cousin those doctors talk to smile paints .
that driver those doctors help cries .	that driver those doctors help yell cries .
your teacher my teachers answer waves .	your teacher my teachers answer laugh waves .
the patient those people worry reads .	the patient those people worry lose reads .
this doctor my doctors work with reads .	this doctor my doctors work with sneeze reads .
your teacher my cousins work with exercises .	your teacher my cousins work with stretch exercises .
this teacher your cousins praise exercises .	this teacher your cousins praise laugh exercises .
that teacher these doctors work with waves .	that teacher these doctors work with yell waves .
my dentist your friends teach reads .	my dentist your friends teach lie reads .
that dentist my friends listen to talks .	that dentist my friends listen to cry talks .
those children your doctor understands yell .	those children your doctor understands paints yell .
your doctor these teachers work with reads .	your doctor these teachers work with whisper reads .
the teachers your boss understands yell .	the teachers your boss understands cries yell .
that patient your cousins answer sings .	that patient your cousins answer practice sings .
your boss the children appreciate sings .	your boss the children appreciate sneeze sings .
these teachers the customer scares exercise .	these teachers the customer scares cries exercise .
my dentist my friends listen to waves .	my dentist my friends listen to sneeze waves .
that child my friends scare paints .	that child my friends scare laugh paints .
my cousin your teachers talk to reads .	my cousin your teachers talk to laugh reads .
my boss your doctors listen to reads .	my boss your doctors listen to lose reads .
my dentist my teachers work with cries .	my dentist my teachers work with cough cries .
the doctor your teachers bother waves .	the doctor your teachers bother wave waves .
the dancer those children appreciate sings .	the dancer those children appreciate talk sings .
those people the dancer helps lose .	those people the dancer helps talks lose .
the teacher my friends visit exercises .	the teacher my friends visit scream exercises .
my cousin these doctors bother talks .	my cousin these doctors bother sing talks .
my boss your cousins appreciate paints .	my boss your cousins appreciate cough paints .
that child these doctors worry talks .	that child these doctors worry read talks .
that teacher these people teach talks .	that teacher these people teach smile talks .
your friend your friends appreciate sings .	your friend your friends appreciate scream sings .
your dentist these doctors scare paints .	your dentist these doctors scare win paints .
your teacher your doctors answer sings .	your teacher your doctors answer cry sings .
this driver your teachers bother reads .	this driver your teachers bother cry reads .
the adult these teachers appreciate sings .	the adult these teachers appreciate wave sings .
your teacher the doctors understand waves .	your teacher the doctors understand lose waves .
this teacher these doctors care for waves .	this teacher these doctors care for exercise waves .
that person my teachers teach cries .	that person my teachers teach yell cries .
your doctor your teachers care for sings .	your doctor your teachers care for paint sings .
my friend my doctors praise cries .	my friend my doctors praise yell cries .
that teacher my doctors worry waves .	that teacher my doctors worry wave waves .
these teachers your cousin talks to cry .	these teachers your cousin talks to reads cry .
your friends this dancer scares exercise .	your friends this dancer scares talks exercise .
your boss those teachers listen to waves .	your boss those teachers listen to paint waves .
the driver my friends work with talks .	the driver my friends work with smile talks .
that customer your teachers appreciate talks .	that customer your teachers appreciate smile talks .
the doctors this patient understands sneeze .	the doctors this patient understands exercises sneeze .
my doctor these children appreciate exercises .	my doctor these children appreciate wave exercises .
that dentist those people care for talks .	that dentist those people care for sing talks .
the dentist those teachers answer waves .	the dentist those teachers answer lie waves .
your friend these teachers work with cries .	your friend these teachers work with win cries .
the adult my doctors scare waves .	the adult my doctors scare win waves .
this person my teachers appreciate reads .	this person my teachers appreciate exercise reads .
your teacher my teachers answer waves .	your teacher my teachers answer yell waves .
your teacher those doctors praise talks .	your teacher those doctors praise win talks .
this teacher my cousins help paints .	this teacher my cousins help cry paints .
my doctor those doctors care for talks .	my doctor those doctors care for stretch talks .
this child those people teach reads .	this child those people teach cough reads .
your doctor those children talk to exercises .	your doctor those children talk to cough exercises .
the patient those people work with paints .	the patient those people work with stretch paints .
the dancer my doctors teach cries .	the dancer my doctors teach smile cries .
your boss my cousins talk to paints .	your boss my cousins talk to lie paints .
the child my friends scare talks .	the child my friends scare sing talks .
my friend your teachers answer exercises .	my friend your teachers answer cry exercises .
that teacher my doctors appreciate exercises .	that teacher my doctors appreciate paint exercises .
the customer my teachers worry sings .	the customer my teachers worry wave sings .
the people my friend helps exercise .	the people my friend helps paints exercise .
this doctor your doctors worry reads .	this doctor your doctors worry yell reads .
my cousin your friends bother talks .	my cousin your friends bother scream talks .
the person these doctors answer waves .	the person these doctors answer stretch waves .
these children this driver talks to talk .	these children this driver talks to waves talk .
your cousin my friends understand exercises .	your cousin my friends understand lose exercises .
my friend these people talk to exercises .	my friend these people talk to read exercises .
the person the people care for waves .	the person the people care for exercise waves .
your doctors the dentist talks to win .	your doctors the dentist talks to talks win .
my doctors your dentist talks to wave .	my doctors your dentist talks to exercises wave .
those teachers my teacher understands paint .	those teachers my teacher understands sings paint .
the driver those doctors praise waves .	the driver those doctors praise exercise waves .
my friend these people care for exercises .	my friend these people care for cry exercises .
your doctor those people understand waves .	your doctor those people understand sneeze waves .
my friends this teacher works with paint .	my friends this teacher works with reads paint .
your teachers the dentist scares lie .	your teachers the dentist scares talks lie .
the dancer your doctors answer talks .	the dancer your doctors answer cry talks .
the driver your cousins appreciate exercises .	the driver your cousins appreciate cough exercises .
my cousins the driver understands win .	my cousins the driver understands reads win .
my teachers my doctor scares cry .	my teachers my doctor scares cries cry .
the dentist these children appreciate waves .	the dentist these children appreciate lie waves .
my doctor those teachers talk to waves .	my doctor those teachers talk to wave waves .
your friend these people worry waves .	your friend these people worry read waves .
those doctors your boss understands practice .	those doctors your boss understands cries practice .
this dentist my teachers care for talks .	this dentist my teachers care for cough talks .
your friend my friends scare waves .	your friend my friends scare talk waves .
your friends my boss understands lie .	your friends my boss understands exercises lie .
your doctor these teachers help reads .	your doctor these teachers help smile reads .
your boss my doctors visit waves .	your boss my doctors visit win waves .
this dancer these doctors visit paints .	this dancer these doctors visit smile paints .
my doctors your boss helps laugh .	my doctors your boss helps exercises laugh .
this driver those doctors appreciate reads .	this driver those doctors appreciate lie reads .
my cousin the doctors talk to exercises .	my cousin the doctors talk to cry exercises .
your cousin your friends teach waves .	your cousin your friends teach read waves .
those children your friend talks to sneeze .	those children your friend talks to talks sneeze .
the patient those teachers scare exercises .	the patient those teachers scare practice exercises .
the child those teachers bother exercises .	the child those teachers bother whisper exercises .
this customer my doctors praise exercises .	this customer my doctors praise lose exercises .
the teacher my cousins praise talks .	the teacher my cousins praise lose talks .
your teacher these doctors teach exercises .	your teacher these doctors teach lie exercises .
my friends my teacher works with win .	my friends my teacher works with exercises win .
those children your friend scares cough .	those children your friend scares reads cough .
that teacher those doctors answer talks .	that teacher those doctors answer practice talks .
your friends this child understands paint .	your friends this child understands cries paint .
the children this child works with wave .	the children this child works with paints wave .
the adult the teachers work with paints .	the adult the teachers work with cough paints .
your teachers this person talks to sing .	your teachers this person talks to cries sing .
this adult these doctors help sings .	this adult these doctors help wave sings .
my cousin my doctors talk to cries .	my cousin my doctors talk to practice cries .
the adult these children appreciate exercises .	the adult these children appreciate exercise exercises .
this driver these doctors scare waves .	this driver these doctors scare sing waves .
my dentist my cousins visit waves .	my dentist my cousins visit laugh waves .
my friend your friends listen to exercises .	my friend your friends listen to smile exercises .
the child those doctors listen to talks .	the child those doctors listen to smile talks .
the dancer your friends help reads .	the dancer your friends help laugh reads .
the patient your cousins help cries .	the patient your cousins help yell cries .
the patient my friends worry cries .	the patient my friends worry sing cries .
my dentist those people answer reads .	my dentist those people answer talk reads .
your boss these children answer waves .	your boss these children answer scream waves .
this adult these children work with waves .	this adult these children work with cry waves .
my cousin those children care for exercises .	my cousin those children care for sneeze exercises .
your doctor my cousins bother paints .	your doctor my cousins bother lie paints .
that adult my teachers praise reads .	that adult my teachers praise yell reads .
my friend your teachers care for reads .	my friend your teachers care for lose reads .
that person these teachers visit waves .	that person these teachers visit stretch waves .
your dentist your doctors work with waves .	your dentist your doctors work with sneeze waves .
these doctors this patient understands sneeze .	these doctors this patient understands talks sneeze .
the adult my doctors answer waves .	the adult my doctors answer sneeze waves .
the driver the children care for cries .	the driver the children care for practice cries .
your cousin your friends visit exercises .	your cousin your friends visit sing exercises .
your boss those doctors praise reads .	your boss those doctors praise whisper reads .
my doctor these people understand exercises .	my doctor these people understand cough exercises .
this doctor those children help sings .	this doctor those children help smile sings .
your friend my cousins listen to reads .	your friend my cousins listen to sneeze reads .
this patient my cousins scare paints .	this patient my cousins scare smile paints .
my boss those teachers worry exercises .	my boss those teachers worry stretch exercises .
those teachers your cousin helps lie .	those teachers your cousin helps talks lie .
your cousin your friends worry exercises .	your cousin your friends worry smile exercises .
that doctor my cousins work with exercises .	that doctor my cousins work with talk exercises .
these children that driver works with sneeze .	these children that driver works with waves sneeze .
your cousins your cousin helps paint .	your cousins your cousin helps waves paint .
the child your cousins teach exercises .	the child your cousins teach smile exercises .
my doctor the children visit waves .	my doctor the children visit win waves .
this customer your friends praise sings .	this customer your friends praise laugh sings .
this driver those doctors talk to sings .	this driver those doctors talk to cry sings .
your teacher your doctors visit waves .	your teacher your doctors visit smile waves .
those people that teacher understands exercise .	those people that teacher understands waves exercise .
the dancer those children scare talks .	the dancer those children scare sing talks .
my cousins this doctor helps sing .	my cousins this doctor helps paints sing .
my boss my cousins talk to paints .	my boss my cousins talk to lie paints .
my teachers your doctor helps exercise .	my teachers your doctor helps sings exercise .
your cousins this customer helps cough .	your cousins this customer helps talks cough .
the doctors that customer understands read .	the doctors that customer understands cries read .
your teacher these children care for cries .	your teacher these children care for practice cries .
the children your teacher helps cry .	the children your teacher helps exercises cry .
your friend the doctors help exercises .	your friend the doctors help lose exercises .
my dentist your friends work with talks .	my dentist your friends work with lie talks .
the teachers that dancer helps whisper .	the teachers that dancer helps exercises whisper .
this child these children worry cries .	this child these children worry whisper cries .
my dentist those people worry exercises .	my dentist those people worry read exercises .
my friend these teachers praise paints .	my friend these teachers praise lose paints .
your teachers my doctor helps scream .	your teachers my doctor helps talks scream .
my teacher those children bother sings .	my teacher those children bother paint sings .
your doctors your boss helps talk .	your doctors your boss helps cries talk .
my teacher my doctors praise sings .	my teacher my doctors praise exercise sings .
your boss my teachers praise waves .	your boss my teachers praise sneeze waves .
the patient these teachers praise waves .	the patient these teachers praise lose waves .
your teacher those doctors care for exercises .	your teacher those doctors care for cough exercises .
my doctor those children listen to exercises .	my doctor those children listen to read exercises .
my friends your friend works with yell .	my friends your friend works with exercises yell .
the child your friends listen to sings .	the child your friends listen to wave sings .
my teacher my teachers worry exercises .	my teacher my teachers worry talk exercises .
that driver those children visit talks .	that driver those children visit paint talks .
this child these doctors bother paints .	this child these doctors bother sing paints .
my cousin these teachers talk to reads .	my cousin these teachers talk to exercise reads .
your dentist those children scare cries .	your dentist those children scare read cries .
that child those people scare waves .	that child those people scare whisper waves .
this driver those people work with cries .	this driver those people work with talk cries .
this dentist your teachers answer cries .	this dentist your teachers answer sneeze cries .
my doctors your teacher understands sing .	my doctors your teacher understands cries sing .
this driver my teachers scare cries .	this driver my teachers scare cough cries .
the dentist your doctors talk to paints .	the dentist your doctors talk to cry paints .
your teacher your teachers talk to cries .	your teacher your teachers talk to scream cries .
that child the children talk to cries .	that child the children talk to cry cries .
my teacher my cousins appreciate exercises .	my teacher my cousins appreciate talk exercises .
your teacher my friends talk to sings .	your teacher my friends talk to sneeze sings .
this driver your cousins worry cries .	this driver your cousins worry cough cries .
my cousins my dentist talks to practice .	my cousins my dentist talks to waves practice .
this patient these people understand talks .	this patient these people understand scream talks .
the doctor my doctors work with sings .	the doctor my doctors work with paint sings .
the child my cousins work with cries .	the child my cousins work with read cries .
this customer these children worry cries .	this customer these children worry lie cries .
this person my cousins visit reads .	this person my cousins visit read reads .
these children my boss works with yell .	these children my boss works with waves yell .
that child your cousins work with exercises .	that child your cousins work with paint exercises .
your cousins my teacher works with sing .	your cousins my teacher works with paints sing .
the teacher my doctors scare exercises .	the teacher my doctors scare practice exercises .
these doctors my boss understands scream .	these doctors my boss understands sings scream .
this patient the people worry exercises .	this patient the people worry exercise exercises .
the children your teacher helps paint .	the children your teacher helps exercises paint .
the teacher my doctors appreciate sings .	the teacher my doctors appreciate cough sings .
the children that adult helps sneeze .	the children that adult helps reads sneeze .
your cousin my cousins appreciate reads .	your cousin my cousins appreciate lose reads .
those doctors your friend helps read .	those doctors your friend helps exercises read .
my dentist these people bother paints .	my dentist these people bother stretch paints .
the children my doctor understands talk .	the children my doctor understands sings talk .
this customer those doctors teach paints .	this customer those doctors teach yell paints .
your dentist my cousins care for reads .	your dentist my cousins care for laugh reads .
my dentist your doctors praise talks .	my dentist your doctors praise yell talks .
the patient your teachers teach reads .	the patient your teachers teach smile reads .
my dentist your friends visit paints .	my dentist your friends visit practice paints .
my boss the children help sings .	my boss the children help exercise sings .
my teachers my teacher scares read .	my teachers my teacher scares waves read .
my doctor my teachers listen to talks .	my doctor my teachers listen to lose talks .
these teachers my boss understands read .	these teachers my boss understands talks read .
the customer my teachers listen to paints .	the customer my teachers listen to stretch paints .
this adult the children scare cries .	this adult the children scare scream cries .
that driver these doctors work with reads .	that driver these doctors work with lie reads .
your friends your teacher works with lie .	your friends your teacher works with talks lie .
these children that patient understands scream .	these children that patient understands exercises scream .
my teacher my teachers worry reads .	my teacher my teachers worry practice reads .
your friends this doctor helps laugh .	your friends this doctor helps exercises laugh .
the teachers my teacher talks to scream .	the teachers my teacher talks to paints scream .
that child my friends work with exercises .	that child my friends work with sneeze exercises .
that patient these teachers worry sings .	that patient these teachers worry sing sings .
your teachers your doctor talks to sing .	your teachers your doctor talks to waves sing .
the people your cousin helps yell .	the people your cousin helps waves yell .
your doctors that dancer helps scream .	your doctors that dancer helps paints scream .
that driver my doctors work with reads .	that driver my doctors work with read reads .
my cousins this driver helps paint .	my cousins this driver helps reads paint .
the dentist my doctors help exercises .	the dentist my doctors help read exercises .
that doctor these people appreciate talks .	that doctor these people appreciate sneeze talks .
my teacher these people visit reads .	my teacher these people visit sing reads .
that dentist my cousins help paints .	that dentist my cousins help sneeze paints .
that teacher your cousins understand paints .	that teacher your cousins understand wave paints .
this driver these children listen to cries .	this driver these children listen to practice cries .
your friend these doctors understand exercises .	your friend these doctors understand cough exercises .
the dentist your teachers talk to sings .	the dentist your teachers talk to whisper sings .
this dentist your friends help waves .	this dentist your friends help talk waves .
the child those teachers work with sings .	the child those teachers work with practice sings .
those doctors the doctor understands sing .	those doctors the doctor understands paints sing .
your dentist those children understand sings .	your dentist those children understand laugh sings .
your boss your teachers worry reads .	your boss your teachers worry smile reads .
my teachers your cousin works with wave .	my teachers your cousin works with reads wave .
my teachers your friend scares whisper .	my teachers your friend scares talks whisper .
these doctors the patient understands cough .	these doctors the patient understands reads cough .
your boss those doctors help talks .	your boss those doctors help stretch talks .
your cousins this dentist works with whisper .	your cousins this dentist works with exercises whisper .
those children your teacher talks to wave .	those children your teacher talks to waves wave .
my boss your friends visit exercises .	my boss your friends visit sing exercises .
the doctor those people visit reads .	the doctor those people visit scream reads .
that adult my friends praise exercises .	that adult my friends praise smile exercises .
the child your doctors bother talks .	the child your doctors bother talk talks .
my doctor your cousins work with reads .	my doctor your cousins work with sneeze reads .
that dentist your friends talk to exercises .	that dentist your friends talk to laugh exercises .
your teacher your friends help cries .	your teacher your friends help cry cries .
my teacher my teachers teach talks .	my teacher my teachers teach stretch talks .
the teachers the dancer talks to cry .	the teachers the dancer talks to exercises cry .
my doctor my cousins understand exercises .	my doctor my cousins understand read exercises .
my friend my friends talk to talks .	my friend my friends talk to scream talks .
my cousin your doctors worry reads .	my cousin your doctors worry exercise reads .
your doctor the children praise paints .	your doctor the children praise sing paints .
those people that customer works with wave .	those people that customer works with reads wave .
the doctor those doctors worry cries .	the doctor those doctors worry laugh cries .
