my boss your cousins these teachers care for scare sings .	my boss your cousins these teachers care for sings .
the dentist these doctors those people visit scare paints .	the dentist these doctors those people visit paints .
the dancer your teachers the teachers care for worry reads .	the dancer your teachers the teachers care for reads .
the child those people those doctors praise teach paints .	the child those people those doctors praise paints .
my doctors my teacher your teacher scares talks to laugh .	my doctors my teacher your teacher scares laugh .
my teacher the doctors those children talk to visit talks .	my teacher the doctors those children talk to talks .
the teacher my doctors these teachers care for understand paints .	the teacher my doctors these teachers care for paints .
my doctor these people your teachers care for teach sings .	my doctor these people your teachers care for sings .
the doctor the people the teachers work with teach paints .	the doctor the people the teachers work with paints .
your cousin my doctors my teachers answer talk to cries .	your cousin my doctors my teachers answer cries .
your dentist my teachers my friends appreciate appreciate cries .	your dentist my teachers my friends appreciate cries .
my friend your doctors the doctors help talk to talks .	my friend your doctors the doctors help talks .
your cousin your teachers those teachers praise talk to sings .	your cousin your teachers those teachers praise sings .
that person these children those teachers appreciate care for waves .	that person these children those teachers appreciate waves .
my teacher my friends your cousins worry praise cries .	my teacher my friends your cousins worry cries .
your cousin those children your teachers help visit waves .	your cousin those children your teachers help waves .
that dentist these people my friends praise listen to paints .	that dentist these people my friends praise paints .
this adult your friends those people understand visit sings .	this adult your friends those people understand sings .
that person your teachers my cousins work with appreciate cries .	that person your teachers my cousins work with cries .
my cousins your boss that customer helps helps cough .	my cousins your boss that customer helps cough .
this customer my cousins my cousins scare care for talks .	this customer my cousins my cousins scare talks .
the driver these people these people worry praise paints .	the driver these people these people worry paints .
my friends that child your boss understands understands stretch .	my friends that child your boss understands stretch .
those doctors your boss my cousin scares talks to talk .	those doctors your boss my cousin scares talk .
this adult your cousins my teachers worry appreciate talks .	this adult your cousins my teachers worry talks .
the dentist the teachers these people talk to answer reads .	the dentist the teachers these people talk to reads .
these people the customer this adult understands understands lose .	these people the customer this adult understands lose .
that dentist your cousins these children care for teach exercises .	that dentist your cousins these children care for exercises .
my teachers your cousin that dancer talks to scares lose .	my teachers your cousin that dancer talks to lose .
your doctor the children these teachers appreciate care for talks .	your doctor the children these teachers appreciate talks .
this dancer the children these teachers worry appreciate reads .	this dancer the children these teachers worry reads .
this dancer those teachers these people listen to care for waves .	this dancer those teachers these people listen to waves .
my doctors my dentist your friend helps talks to read .	my doctors my dentist your friend helps read .
that dentist my teachers these teachers care for scare sings .	that dentist my teachers these teachers care for sings .
my cousin those people your teachers bother scare talks .	my cousin those people your teachers bother talks .
my cousin these people your friends scare work with exercises .	my cousin these people your friends scare exercises .
my dentist my cousins these children listen to visit cries .	my dentist my cousins these children listen to cries .
that person the children my teachers help care for reads .	that person the children my teachers help reads .
my teachers your friend your doctor understands works with scream .	my teachers your friend your doctor understands scream .
your cousins that customer the doctor helps works with yell .	your cousins that customer the doctor helps yell .
my cousin my teachers these children appreciate praise talks .	my cousin my teachers these children appreciate talks .
your cousin your teachers my friends work with worry waves .	your cousin your teachers my friends work with waves .
the dancer these children these children scare scare talks .	the dancer these children these children scare talks .
your dentist your friends these doctors bother appreciate cries .	your dentist your friends these doctors bother cries .
my dentist your cousins these teachers help praise talks .	my dentist your cousins these teachers help talks .
the customer these teachers these children help talk to sings .	the customer these teachers these children help sings .
this dancer these teachers the doctors visit worry cries .	this dancer these teachers the doctors visit cries .
your boss your friends your friends listen to appreciate talks .	your boss your friends your friends listen to talks .
my boss my teachers the people praise talk to talks .	my boss my teachers the people praise talks .
those teachers your boss this teacher helps talks to read .	those teachers your boss this teacher helps read .
this teacher my friends your friends care for appreciate reads .	this teacher my friends your friends care for reads .
my boss your friends these doctors answer care for waves .	my boss your friends these doctors answer waves .
your dentist those children your cousins worry worry cries .	your dentist those children your cousins worry cries .
these doctors this patient your dentist understands talks to laugh .	these doctors this patient your dentist understands laugh .
my teacher your friends my doctors visit understand talks .	my teacher your friends my doctors visit talks .
that dancer those people the people teach teach talks .	that dancer those people the people teach talks .
my boss these teachers these people work with understand talks .	my boss these teachers these people work with talks .
this dancer those children my doctors work with praise waves .	this dancer those children my doctors work with waves .
your teacher these teachers your doctors help help exercises .	your teacher these teachers your doctors help exercises .
these teachers my friend your teacher understands helps lose .	these teachers my friend your teacher understands lose .
the teachers your cousin your doctor scares scares lose .	the teachers your cousin your doctor scares lose .
your friend my doctors your teachers worry visit exercises .	your friend my doctors your teachers worry exercises .
your teacher the doctors your teachers work with work with paints .	your teacher the doctors your teachers work with paints .
that teacher those doctors the teachers listen to scare sings .	that teacher those doctors the teachers listen to sings .
my cousin those teachers my friends praise praise paints .	my cousin those teachers my friends praise paints .
your dentist the doctors these children talk to bother sings .	your dentist the doctors these children talk to sings .
this dentist my teachers the doctors care for visit cries .	this dentist my teachers the doctors care for cries .
this teacher my doctors the people teach visit cries .	this teacher my doctors the people teach cries .
your friend my cousins the people scare care for cries .	your friend my cousins the people scare cries .
this customer your cousins these doctors help appreciate cries .	this customer your cousins these doctors help cries .
my friends your boss my teacher understands scares practice .	my friends your boss my teacher understands practice .
the driver the people your teachers listen to bother paints .	the driver the people your teachers listen to paints .
my doctor your teachers those doctors care for listen to exercises .	my doctor your teachers those doctors care for exercises .
that person my friends these children care for listen to paints .	that person my friends these children care for paints .
that teacher your doctors these children praise listen to paints .	that teacher your doctors these children praise paints .
your dentist your friends those doctors listen to appreciate reads .	your dentist your friends those doctors listen to reads .
the people that teacher your teacher works with understands smile .	the people that teacher your teacher works with smile .
my cousin my teachers these teachers teach listen to talks .	my cousin my teachers these teachers teach talks .
that dentist my teachers my cousins scare help reads .	that dentist my teachers my cousins scare reads .
the teacher these teachers your cousins work with talk to sings .	the teacher these teachers your cousins work with sings .
my friend my friends your friends answer answer reads .	my friend my friends your friends answer reads .
that driver the children my friends teach understand talks .	that driver the children my friends teach talks .
your cousin these people my cousins bother talk to exercises .	your cousin these people my cousins bother exercises .
those people my boss the person works with scares lose .	those people my boss the person works with lose .
the driver these people those teachers scare care for reads .	the driver these people those teachers scare reads .
that dancer my cousins these children visit scare reads .	that dancer my cousins these children visit reads .
that customer my teachers the teachers visit understand sings .	that customer my teachers the teachers visit sings .
your cousins this customer this dancer works with talks to stretch .	your cousins this customer this dancer works with stretch .
the driver these doctors these doctors bother worry reads .	the driver these doctors these doctors bother reads .
the child your cousins my friends praise scare talks .	the child your cousins my friends praise talks .
this child your friends my teachers answer care for reads .	this child your friends my teachers answer reads .
my teachers your boss that customer understands understands scream .	my teachers your boss that customer understands scream .
the customer my doctors my teachers work with bother cries .	the customer my doctors my teachers work with cries .
my doctor my cousins my cousins bother appreciate reads .	my doctor my cousins my cousins bother reads .
the person my doctors your friends teach care for cries .	the person my doctors your friends teach cries .
your dentist these people those people talk to care for exercises .	your dentist these people those people talk to exercises .
my doctors the person my doctor understands talks to wave .	my doctors the person my doctor understands wave .
your doctors your dentist my doctor works with understands stretch .	your doctors your dentist my doctor works with stretch .
my doctors my boss the customer understands works with stretch .	my doctors my boss the customer understands stretch .
your boss those people my doctors visit worry talks .	your boss those people my doctors visit talks .
my cousin those teachers your doctors care for understand cries .	my cousin those teachers your doctors care for cries .
my boss your cousins my teachers teach help cries .	my boss your cousins my teachers teach cries .
the doctor those doctors my doctors listen to listen to sings .	the doctor those doctors my doctors listen to sings .
the dancer these teachers the people care for visit exercises .	the dancer these teachers the people care for exercises .
the child your friends my friends care for worry waves .	the child your friends my friends care for waves .
your friends this patient the person understands talks to read .	your friends this patient the person understands read .
your doctor those children your cousins help care for waves .	your doctor those children your cousins help waves .
the person the teachers my doctors teach help cries .	the person the teachers my doctors teach cries .
that dancer my friends those children work with talk to paints .	that dancer my friends those children work with paints .
my teachers that doctor your dentist understands works with wave .	my teachers that doctor your dentist understands wave .
my doctors my teacher that dentist works with scares scream .	my doctors my teacher that dentist works with scream .
your doctor those doctors those doctors visit answer exercises .	your doctor those doctors those doctors visit exercises .
my friend your doctors my friends worry worry cries .	my friend your doctors my friends worry cries .
this teacher my cousins these children teach teach cries .	this teacher my cousins these children teach cries .
your dentist these teachers your cousins work with talk to talks .	your dentist these teachers your cousins work with talks .
your doctor my doctors my cousins answer visit waves .	your doctor my doctors my cousins answer waves .
your friend these people your cousins appreciate help paints .	your friend these people your cousins appreciate paints .
your teacher the children these children help understand talks .	your teacher the children these children help talks .
my doctor my doctors those people appreciate worry cries .	my doctor my doctors those people appreciate cries .
the children this adult my teacher helps works with scream .	the children this adult my teacher helps scream .
this patient my doctors my teachers praise care for paints .	this patient my doctors my teachers praise paints .
your boss the teachers my cousins answer talk to reads .	your boss the teachers my cousins answer reads .
the people this doctor that person helps talks to whisper .	the people this doctor that person helps whisper .
your teacher the people these children understand scare cries .	your teacher the people these children understand cries .
the people my friend the dentist scares helps lose .	the people my friend the dentist scares lose .
your dentist these doctors your cousins talk to work with paints .	your dentist these doctors your cousins talk to paints .
my cousin your cousins my teachers appreciate bother waves .	my cousin your cousins my teachers appreciate waves .
your friends that dancer this dentist understands works with lose .	your friends that dancer this dentist understands lose .
my boss my friends these doctors teach bother paints .	my boss my friends these doctors teach paints .
the customer my teachers my teachers help scare waves .	the customer my teachers my teachers help waves .
your friend your teachers my friends listen to teach talks .	your friend your teachers my friends listen to talks .
your teachers the child the teacher talks to scares scream .	your teachers the child the teacher talks to scream .
this dancer the children those doctors appreciate understand waves .	this dancer the children those doctors appreciate waves .
this driver those children my friends visit care for talks .	this driver those children my friends visit talks .
my cousins the driver this patient talks to scares yell .	my cousins the driver this patient talks to yell .
this dancer those doctors my doctors praise visit sings .	this dancer those doctors my doctors praise sings .
your teachers the doctor your teacher works with understands exercise .	your teachers the doctor your teacher works with exercise .
those people that dentist your boss understands helps cry .	those people that dentist your boss understands cry .
that adult your friends your cousins work with work with exercises .	that adult your friends your cousins work with exercises .
these people your friend this patient works with scares laugh .	these people your friend this patient works with laugh .
my dentist my cousins your cousins worry bother cries .	my dentist my cousins your cousins worry cries .
your teacher these people my friends listen to listen to cries .	your teacher these people my friends listen to cries .
your doctor your cousins those people work with worry talks .	your doctor your cousins those people work with talks .
my cousins that teacher my doctor understands helps exercise .	my cousins that teacher my doctor understands exercise .
the adult my friends your doctors care for scare exercises .	the adult my friends your doctors care for exercises .
my doctor these children the teachers visit praise exercises .	my doctor these children the teachers visit exercises .
your teachers the child my cousin scares helps cry .	your teachers the child my cousin scares cry .
these teachers your doctor your friend scares helps win .	these teachers your doctor your friend scares win .
my cousin the teachers my cousins help scare cries .	my cousin the teachers my cousins help cries .
your teacher these doctors my teachers appreciate worry cries .	your teacher these doctors my teachers appreciate cries .
this dancer those people your cousins worry scare exercises .	this dancer those people your cousins worry exercises .
your boss those teachers your doctors praise bother reads .	your boss those teachers your doctors praise reads .
the teacher these teachers your teachers bother appreciate talks .	the teacher these teachers your teachers bother talks .
your friends this dentist this patient talks to helps sing .	your friends this dentist this patient talks to sing .
your doctor these people these doctors understand appreciate talks .	your doctor these people these doctors understand talks .
the doctor your friends your friends visit worry paints .	the doctor your friends your friends visit paints .
your doctor my doctors my cousins scare visit cries .	your doctor my doctors my cousins scare cries .
your dentist my friends these people scare help cries .	your dentist my friends these people scare cries .
my dentist the doctors your cousins scare listen to talks .	my dentist the doctors your cousins scare talks .
this adult your doctors your teachers help bother reads .	this adult your doctors your teachers help reads .
the child these children your friends help worry talks .	the child these children your friends help talks .
that doctor these doctors these teachers appreciate care for waves .	that doctor these doctors these teachers appreciate waves .
your cousin the teachers these teachers scare understand paints .	your cousin the teachers these teachers scare paints .
the driver my friends the children scare care for paints .	the driver my friends the children scare paints .
that person your doctors your doctors appreciate appreciate waves .	that person your doctors your doctors appreciate waves .
that teacher those people these doctors visit understand cries .	that teacher those people these doctors visit cries .
that dancer your doctors your teachers help help exercises .	that dancer your doctors your teachers help exercises .
these people my boss my dentist helps understands paint .	these people my boss my dentist helps paint .
my dentist my teachers the doctors scare care for exercises .	my dentist my teachers the doctors scare exercises .
the teacher these doctors those people worry teach paints .	the teacher these doctors those people worry paints .
the customer these teachers the people listen to worry exercises .	the customer these teachers the people listen to exercises .
the teacher your teachers those children praise talk to reads .	the teacher your teachers those children praise reads .
your boss your friends those children understand bother exercises .	your boss your friends those children understand exercises .
your teachers that child my doctor helps talks to scream .	your teachers that child my doctor helps scream .
your teacher the children the children worry appreciate waves .	your teacher the children the children worry waves .
that doctor these teachers your friends talk to listen to cries .	that doctor these teachers your friends talk to cries .
that patient the people those teachers scare talk to paints .	that patient the people those teachers scare paints .
my friends my boss the dancer scares talks to yell .	my friends my boss the dancer scares yell .
your doctor your cousins my doctors visit worry waves .	your doctor your cousins my doctors visit waves .
the dentist these teachers your friends listen to work with waves .	the dentist these teachers your friends listen to waves .
my boss these children my doctors praise visit waves .	my boss these children my doctors praise waves .
my doctors the patient your doctor helps scares stretch .	my doctors the patient your doctor helps stretch .
those people that child that person understands understands lie .	those people that child that person understands lie .
my dentist those teachers these people visit bother sings .	my dentist those teachers these people visit sings .
this patient the people those doctors understand help reads .	this patient the people those doctors understand reads .
my boss those teachers your cousins answer talk to paints .	my boss those teachers your cousins answer paints .
your boss these teachers these children worry worry waves .	your boss these teachers these children worry waves .
your doctor your teachers those doctors scare scare sings .	your doctor your teachers those doctors scare sings .
my teachers that dentist this customer understands scares whisper .	my teachers that dentist this customer understands whisper .
your friend my cousins your teachers answer talk to waves .	your friend my cousins your teachers answer waves .
the customer these doctors my teachers teach visit sings .	the customer these doctors my teachers teach sings .
this dentist my doctors these teachers answer help reads .	this dentist my doctors these teachers answer reads .
the teachers my teacher the patient helps talks to talk .	the teachers my teacher the patient helps talk .
that customer those teachers your friends care for praise exercises .	that customer those teachers your friends care for exercises .
my boss your friends my cousins help understand sings .	my boss your friends my cousins help sings .
your cousin your friends those children listen to worry reads .	your cousin your friends those children listen to reads .
my cousin your friends my friends scare bother sings .	my cousin your friends my friends scare sings .
your friend the children those teachers visit appreciate sings .	your friend the children those teachers visit sings .
the adult these teachers my friends worry appreciate cries .	the adult these teachers my friends worry cries .
those children my dentist this dancer helps talks to talk .	those children my dentist this dancer helps talk .
your teacher the teachers my doctors scare scare reads .	your teacher the teachers my doctors scare reads .
my doctor my friends your doctors praise understand cries .	my doctor my friends your doctors praise cries .
the dentist your cousins these children answer teach reads .	the dentist your cousins these children answer reads .
the doctors the teacher my teacher helps talks to exercise .	the doctors the teacher my teacher helps exercise .
these children the driver the patient talks to understands read .	these children the driver the patient talks to read .
this teacher my friends my cousins scare bother exercises .	this teacher my friends my cousins scare exercises .
my dentist my teachers the doctors scare praise talks .	my dentist my teachers the doctors scare talks .
this teacher those people my cousins care for visit talks .	this teacher those people my cousins care for talks .
your cousin the teachers your cousins appreciate help sings .	your cousin the teachers your cousins appreciate sings .
that doctor your cousins my doctors work with understand talks .	that doctor your cousins my doctors work with talks .
this dentist your cousins these teachers talk to help paints .	this dentist your cousins these teachers talk to paints .
my doctors that doctor that child helps works with laugh .	my doctors that doctor that child helps laugh .
your cousins the customer this adult works with talks to sing .	your cousins the customer this adult works with sing .
your dentist those doctors the doctors understand understand sings .	your dentist those doctors the doctors understand sings .
this doctor the doctors those children scare visit paints .	this doctor the doctors those children scare paints .
your boss my cousins those doctors teach talk to cries .	your boss my cousins those doctors teach cries .
these people the patient the dentist understands works with yell .	these people the patient the dentist understands yell .
your friend the children these people visit visit talks .	your friend the children these people visit talks .
my doctors that child this doctor helps understands scream .	my doctors that child this doctor helps scream .
your teacher these doctors these teachers praise help cries .	your teacher these doctors these teachers praise cries .
your cousin these children these people scare bother reads .	your cousin these children these people scare reads .
your friend my teachers these doctors visit appreciate talks .	your friend my teachers these doctors visit talks .
my cousin my cousins your cousins listen to bother reads .	my cousin my cousins your cousins listen to reads .
your cousin these doctors your teachers work with worry reads .	your cousin these doctors your teachers work with reads .
the child the doctors my cousins scare help cries .	the child the doctors my cousins scare cries .
the dancer your doctors these children bother teach talks .	the dancer your doctors these children bother talks .
your boss my doctors your doctors work with visit waves .	your boss my doctors your doctors work with waves .
my doctors this customer your doctor helps helps read .	my doctors this customer your doctor helps read .
your cousin my teachers these children understand help paints .	your cousin my teachers these children understand paints .
the customer these people my friends bother care for waves .	the customer these people my friends bother waves .
the person your friends those children visit answer paints .	the person your friends those children visit paints .
your boss these doctors your friends bother understand waves .	your boss these doctors your friends bother waves .
your dentist these people those doctors care for listen to reads .	your dentist these people those doctors care for reads .
the doctor the children my teachers talk to appreciate talks .	the doctor the children my teachers talk to talks .
these children the adult my doctor scares talks to cry .	these children the adult my doctor scares cry .
those teachers my cousin your friend scares talks to laugh .	those teachers my cousin your friend scares laugh .
my teacher my cousins your cousins help talk to waves .	my teacher my cousins your cousins help waves .
the doctors my teacher this adult understands understands laugh .	the doctors my teacher this adult understands laugh .
your teacher your friends my teachers care for appreciate talks .	your teacher your friends my teachers care for talks .
your boss these teachers my teachers praise talk to paints .	your boss these teachers my teachers praise paints .
your cousins this driver the dentist talks to scares stretch .	your cousins this driver the dentist talks to stretch .
your friend those teachers those people help work with cries .	your friend those teachers those people help cries .
my doctor my doctors my cousins visit help cries .	my doctor my doctors my cousins visit cries .
your cousin my cousins those children answer visit paints .	your cousin my cousins those children answer paints .
this patient those children these teachers bother answer reads .	this patient those children these teachers bother reads .
that customer my friends my cousins bother work with reads .	that customer my friends my cousins bother reads .
my cousins my boss my cousin scares works with paint .	my cousins my boss my cousin scares paint .
the teacher my cousins the teachers listen to scare paints .	the teacher my cousins the teachers listen to paints .
the patient my cousins my friends work with talk to exercises .	the patient my cousins my friends work with exercises .
my cousin the children your teachers care for scare waves .	my cousin the children your teachers care for waves .
the driver your teachers these children appreciate work with sings .	the driver your teachers these children appreciate sings .
your doctor my doctors those teachers understand bother exercises .	your doctor my doctors those teachers understand exercises .
these children your doctor your dentist helps understands scream .	these children your doctor your dentist helps scream .
that doctor my cousins my cousins listen to worry sings .	that doctor my cousins my cousins listen to sings .
that doctor my cousins these people worry worry waves .	that doctor my cousins these people worry waves .
the patient your friends your cousins listen to care for waves .	the patient your friends your cousins listen to waves .
this patient your cousins your doctors praise talk to waves .	this patient your cousins your doctors praise waves .
your friends my friend my teacher talks to scares laugh .	your friends my friend my teacher talks to laugh .
your boss your friends my teachers scare scare waves .	your boss your friends my teachers scare waves .
the customer these teachers the teachers talk to worry talks .	the customer these teachers the teachers talk to talks .
this driver my teachers the people praise bother exercises .	this driver my teachers the people praise exercises .
my cousin those doctors the people appreciate worry exercises .	my cousin those doctors the people appreciate exercises .
my cousin these doctors those doctors help worry sings .	my cousin these doctors those doctors help sings .
your boss the doctors my doctors appreciate teach paints .	your boss the doctors my doctors appreciate paints .
your teacher your friends these teachers listen to visit talks .	your teacher your friends these teachers listen to talks .
that adult my friends those teachers teach teach sings .	that adult my friends those teachers teach sings .
the dentist the teachers those doctors teach worry sings .	the dentist the teachers those doctors teach sings .
my dentist those teachers the children visit praise talks .	my dentist those teachers the children visit talks .
my teacher your doctors these doctors care for answer talks .	my teacher your doctors these doctors care for talks .
my cousin those teachers my cousins listen to listen to exercises .	my cousin those teachers my cousins listen to exercises .
your doctor my cousins those teachers listen to appreciate talks .	your doctor my cousins those teachers listen to talks .
this driver these teachers those teachers understand praise waves .	this driver these teachers those teachers understand waves .
your teacher these children your teachers help help paints .	your teacher these children your teachers help paints .
my cousin your friends my doctors appreciate scare sings .	my cousin your friends my doctors appreciate sings .
your dentist your doctors your friends teach help paints .	your dentist your doctors your friends teach paints .
my cousin your doctors the doctors talk to listen to sings .	my cousin your doctors the doctors talk to sings .
this adult your friends your doctors teach understand cries .	this adult your friends your doctors teach cries .
your doctor your teachers these teachers appreciate worry exercises .	your doctor your teachers these teachers appreciate exercises .
your cousin those doctors those people praise talk to reads .	your cousin those doctors those people praise reads .
my boss your doctors those teachers teach answer talks .	my boss your doctors those teachers teach talks .
these children that doctor my boss works with understands lose .	these children that doctor my boss works with lose .
my cousin my doctors your cousins understand teach exercises .	my cousin my doctors your cousins understand exercises .
your boss those doctors your teachers work with understand waves .	your boss those doctors your teachers work with waves .
your boss the children my cousins help listen to exercises .	your boss the children my cousins help exercises .
the child the people the teachers teach care for talks .	the child the people the teachers teach talks .
this driver your cousins your cousins talk to praise sings .	this driver your cousins your cousins talk to sings .
my dentist the teachers your cousins worry understand paints .	my dentist the teachers your cousins worry paints .
my boss my doctors my friends praise visit reads .	my boss my doctors my friends praise reads .
your friends your friend the dentist scares talks to sing .	your friends your friend the dentist scares sing .
my cousin those doctors my teachers care for appreciate paints .	my cousin those doctors my teachers care for paints .
this adult my doctors your teachers help visit talks .	this adult my doctors your teachers help talks .
the people my doctor the child helps scares cry .	the people my doctor the child helps cry .
this doctor your teachers those teachers care for care for waves .	this doctor your teachers those teachers care for waves .
my cousin your doctors your doctors visit bother talks .	my cousin your doctors your doctors visit talks .
your cousin those doctors those children help worry cries .	your cousin those doctors those children help cries .
this driver these teachers your teachers scare scare exercises .	this driver these teachers your teachers scare exercises .
this driver these teachers the teachers praise listen to talks .	this driver these teachers the teachers praise talks .
that adult the doctors those teachers understand understand paints .	that adult the doctors those teachers understand paints .
the people this dentist this doctor works with understands smile .	the people this dentist this doctor works with smile .
your friend the doctors those teachers scare talk to cries .	your friend the doctors those teachers scare cries .
that doctor your teachers those teachers care for help talks .	that doctor your teachers those teachers care for talks .
that dancer the people your cousins work with worry sings .	that dancer the people your cousins work with sings .
that dancer these children those children listen to understand waves .	that dancer these children those children listen to waves .
that teacher your doctors my friends work with praise exercises .	that teacher your doctors my friends work with exercises .
the driver my cousins those children visit talk to paints .	the driver my cousins those children visit paints .
your dentist my friends these teachers teach listen to talks .	your dentist my friends these teachers teach talks .
the person my cousins the teachers listen to appreciate paints .	the person my cousins the teachers listen to paints .
my friend your friends your friends bother answer sings .	my friend your friends your friends bother sings .
that person the doctors your friends scare worry paints .	that person the doctors your friends scare paints .
your friends that teacher my teacher works with scares wave .	your friends that teacher my teacher works with wave .
the doctors the patient my dentist helps understands whisper .	the doctors the patient my dentist helps whisper .
these teachers that person the driver helps works with practice .	these teachers that person the driver helps practice .
the teacher those people these children appreciate scare cries .	the teacher those people these children appreciate cries .
your boss my doctors your doctors care for answer reads .	your boss my doctors your doctors care for reads .
those doctors my boss the driver works with understands cry .	those doctors my boss the driver works with cry .
my friends your cousin my friend works with helps read .	my friends your cousin my friend works with read .
your cousins this patient your cousin scares understands talk .	your cousins this patient your cousin scares talk .
the driver the children your teachers appreciate understand paints .	the driver the children your teachers appreciate paints .
your cousins your friend your doctor works with scares yell .	your cousins your friend your doctor works with yell .
my doctors this child my dentist helps scares whisper .	my doctors this child my dentist helps whisper .
my doctor my friends the people help scare waves .	my doctor my friends the people help waves .
this driver those people these doctors appreciate help exercises .	this driver those people these doctors appreciate exercises .
the teachers your doctor your boss scares talks to stretch .	the teachers your doctor your boss scares stretch .
this person my friends my teachers praise bother reads .	this person my friends my teachers praise reads .
that patient these doctors the children care for care for cries .	that patient these doctors the children care for cries .
that person these children the children listen to help paints .	that person these children the children listen to paints .
these people this customer my cousin scares understands scream .	these people this customer my cousin scares scream .
your doctor my friends those people praise listen to cries .	your doctor my friends those people praise cries .
my boss the doctors these people scare talk to exercises .	my boss the doctors these people scare exercises .
your cousin the people your friends listen to listen to sings .	your cousin the people your friends listen to sings .
my boss my doctors the people understand scare reads .	my boss my doctors the people understand reads .
my friend these people my doctors scare talk to talks .	my friend these people my doctors scare talks .
your cousin those people your doctors care for work with cries .	your cousin those people your doctors care for cries .
these teachers this person your friend works with scares yell .	these teachers this person your friend works with yell .
my cousins that doctor that person understands scares whisper .	my cousins that doctor that person understands whisper .
that child your friends your friends understand answer cries .	that child your friends your friends understand cries .
your friend my doctors my teachers worry visit reads .	your friend my doctors my teachers worry reads .
your boss my cousins these people praise work with paints .	your boss my cousins these people praise paints .
this person your teachers my cousins praise visit paints .	this person your teachers my cousins praise paints .
my doctor my teachers those teachers work with appreciate cries .	my doctor my teachers those teachers work with cries .
the doctors my boss the adult works with understands sneeze .	the doctors my boss the adult works with sneeze .
your teacher your cousins these teachers appreciate work with waves .	your teacher your cousins these teachers appreciate waves .
the person those children your friends answer help paints .	the person those children your friends answer paints .
your teacher my teachers the children appreciate teach paints .	your teacher my teachers the children appreciate paints .
my cousin your cousins those teachers help teach reads .	my cousin your cousins those teachers help reads .
this dancer those teachers these teachers talk to visit exercises .	this dancer those teachers these teachers talk to exercises .
the driver your doctors these children care for help exercises .	the driver your doctors these children care for exercises .
your friend my teachers these people understand bother reads .	your friend my teachers these people understand reads .
this teacher those people the people listen to praise cries .	this teacher those people the people listen to cries .
the doctor my teachers your friends visit appreciate sings .	the doctor my teachers your friends visit sings .
this dancer your friends these teachers worry work with reads .	this dancer your friends these teachers worry reads .
this teacher my friends your friends bother listen to reads .	this teacher my friends your friends bother reads .
my doctor the doctors the doctors work with teach paints .	my doctor the doctors the doctors work with paints .
the child the people these doctors help understand exercises .	the child the people these doctors help exercises .
that adult the children your teachers worry work with sings .	that adult the children your teachers worry sings .
this child the doctors those teachers appreciate understand waves .	this child the doctors those teachers appreciate waves .
my friend your doctors your friends scare visit cries .	my friend your doctors your friends scare cries .
those children my friend my teacher helps works with practice .	those children my friend my teacher helps practice .
this doctor my doctors these teachers visit talk to paints .	this doctor my doctors these teachers visit paints .
your cousin these people the doctors teach talk to paints .	your cousin these people the doctors teach paints .
my dentist those people your teachers work with visit exercises .	my dentist those people your teachers work with exercises .
your dentist these doctors my teachers talk to care for reads .	your dentist these doctors my teachers talk to reads .
that dentist the people these people bother worry exercises .	that dentist the people these people bother exercises .
these doctors my teacher that dancer works with works with talk .	these doctors my teacher that dancer works with talk .
that dancer the children my teachers care for praise reads .	that dancer the children my teachers care for reads .
your doctor these children my teachers talk to talk to talks .	your doctor these children my teachers talk to talks .
that driver your cousins the people scare visit paints .	that driver your cousins the people scare paints .
those children my boss that person works with talks to wave .	those children my boss that person works with wave .
your dentist my friends the teachers appreciate understand exercises .	your dentist my friends the teachers appreciate exercises .
the doctors this dentist my teacher understands helps laugh .	the doctors this dentist my teacher understands laugh .
the customer those doctors your friends appreciate scare sings .	the customer those doctors your friends appreciate sings .
these teachers my cousin the teacher talks to talks to whisper .	these teachers my cousin the teacher talks to whisper .
my boss my doctors my teachers visit worry reads .	my boss my doctors my teachers visit reads .
my teacher these teachers those children work with worry talks .	my teacher these teachers those children work with talks .
the child your teachers your teachers help teach cries .	the child your teachers your teachers help cries .
this driver my teachers these teachers understand listen to reads .	this driver my teachers these teachers understand reads .
the doctor my doctors the people listen to answer waves .	the doctor my doctors the people listen to waves .
my boss your doctors your teachers answer work with cries .	my boss your doctors your teachers answer cries .
your dentist your cousins my teachers teach help sings .	your dentist your cousins my teachers teach sings .
my cousin the people your friends help talk to sings .	my cousin the people your friends help sings .
my doctor the people those people answer listen to reads .	my doctor the people those people answer reads .
my cousin these people those children teach worry waves .	my cousin these people those children teach waves .
my dentist those people these doctors care for help talks .	my dentist those people these doctors care for talks .
the children my doctor that person works with scares practice .	the children my doctor that person works with practice .
this child your friends these children care for scare reads .	this child your friends these children care for reads .
my boss these children my doctors understand teach reads .	my boss these children my doctors understand reads .
that patient these children these doctors work with work with talks .	that patient these children these doctors work with talks .
this adult your doctors the people talk to answer waves .	this adult your doctors the people talk to waves .
that dentist those doctors those doctors answer worry talks .	that dentist those doctors those doctors answer talks .
your dentist these children these teachers listen to answer sings .	your dentist these children these teachers listen to sings .
my boss the children these doctors work with teach waves .	my boss the children these doctors work with waves .
your dentist those doctors my cousins answer listen to talks .	your dentist those doctors my cousins answer talks .
your cousin those children your teachers praise understand reads .	your cousin those children your teachers praise reads .
those teachers this teacher the doctor works with scares cry .	those teachers this teacher the doctor works with cry .
my boss these people these teachers listen to visit cries .	my boss these people these teachers listen to cries .
my teacher your friends those doctors praise answer cries .	my teacher your friends those doctors praise cries .
my dentist my teachers my teachers praise worry sings .	my dentist my teachers my teachers praise sings .
these doctors that child your boss helps scares smile .	these doctors that child your boss helps smile .
that adult the people your teachers work with care for waves .	that adult the people your teachers work with waves .
my cousin these people the children answer scare paints .	my cousin these people the children answer paints .
this child these doctors my teachers teach teach sings .	this child these doctors my teachers teach sings .
the patient my doctors my teachers talk to care for reads .	the patient my doctors my teachers talk to reads .
the teachers my dentist the adult helps talks to yell .	the teachers my dentist the adult helps yell .
that patient the people your friends care for answer sings .	that patient the people your friends care for sings .
the dentist my doctors my teachers help scare waves .	the dentist my doctors my teachers help waves .
this dancer your friends these doctors answer answer reads .	this dancer your friends these doctors answer reads .
my cousin your teachers my doctors answer work with cries .	my cousin your teachers my doctors answer cries .
your doctor my teachers the teachers visit help cries .	your doctor my teachers the teachers visit cries .
my dentist these teachers the doctors visit understand talks .	my dentist these teachers the doctors visit talks .
my doctor these people these teachers listen to bother sings .	my doctor these people these teachers listen to sings .
the teachers this dentist that teacher works with talks to read .	the teachers this dentist that teacher works with read .
the people that patient that patient helps scares talk .	the people that patient that patient helps talk .
your cousin your teachers these people bother visit reads .	your cousin your teachers these people bother reads .
this dancer your teachers these teachers teach worry exercises .	this dancer your teachers these teachers teach exercises .
my teachers the patient my boss helps scares win .	my teachers the patient my boss helps win .
that doctor these people your teachers praise praise waves .	that doctor these people your teachers praise waves .
the driver your cousins your teachers appreciate talk to exercises .	the driver your cousins your teachers appreciate exercises .
that person those children my doctors scare help talks .	that person those children my doctors scare talks .
these teachers that dentist this driver scares works with lose .	these teachers that dentist this driver scares lose .
that doctor my doctors the children talk to appreciate reads .	that doctor my doctors the children talk to reads .
the adult my cousins the teachers understand understand sings .	the adult my cousins the teachers understand sings .
this dancer the children my friends scare appreciate cries .	this dancer the children my friends scare cries .
the teacher my doctors the doctors answer scare cries .	the teacher my doctors the doctors answer cries .
this child my cousins these people teach answer reads .	this child my cousins these people teach reads .
the person your cousins those people care for appreciate cries .	the person your cousins those people care for cries .
your cousin my teachers your friends bother answer cries .	your cousin my teachers your friends bother cries .
this dancer my teachers my doctors listen to help exercises .	this dancer my teachers my doctors listen to exercises .
this child the doctors my cousins talk to answer sings .	this child the doctors my cousins talk to sings .
the doctor the doctors those teachers help work with cries .	the doctor the doctors those teachers help cries .
this driver these teachers the people worry bother cries .	this driver these teachers the people worry cries .
my boss the children my teachers visit scare paints .	my boss the children my teachers visit paints .
this adult your teachers the people teach teach sings .	this adult your teachers the people teach sings .
my teacher my doctors these teachers listen to worry sings .	my teacher my doctors these teachers listen to sings .
your doctor the children these children bother bother cries .	your doctor the children these children bother cries .
the patient my friends your doctors listen to visit reads .	the patient my friends your doctors listen to reads .
my doctors your boss that teacher understands helps sneeze .	my doctors your boss that teacher understands sneeze .
my boss these children the children teach praise cries .	my boss these children the children teach cries .
these children my dentist this dancer scares works with laugh .	these children my dentist this dancer scares laugh .
your boss my friends your cousins work with listen to talks .	your boss my friends your cousins work with talks .
that child your doctors my friends work with understand waves .	that child your doctors my friends work with waves .
my teachers the person your dentist helps helps read .	my teachers the person your dentist helps read .
my boss these people your doctors praise understand cries .	my boss these people your doctors praise cries .
my cousin the people these teachers care for talk to waves .	my cousin the people these teachers care for waves .
my friend my teachers your doctors scare praise sings .	my friend my teachers your doctors scare sings .
this child your cousins my cousins worry talk to cries .	this child your cousins my cousins worry cries .
these children this customer your boss helps understands win .	these children this customer your boss helps win .
my dentist the children my doctors worry teach sings .	my dentist the children my doctors worry sings .
the doctors the adult your teacher works with works with read .	the doctors the adult your teacher works with read .
your cousin my teachers those doctors work with bother cries .	your cousin my teachers those doctors work with cries .
the children your dentist my doctor talks to helps laugh .	the children your dentist my doctor talks to laugh .
the teacher those doctors my doctors understand bother reads .	the teacher those doctors my doctors understand reads .
this person the children your doctors visit bother reads .	this person the children your doctors visit reads .
my doctor your cousins those children bother listen to cries .	my doctor your cousins those children bother cries .
your teacher those children these people praise appreciate sings .	your teacher those children these people praise sings .
my friend my cousins the doctors work with worry paints .	my friend my cousins the doctors work with paints .
your doctor these doctors the children talk to help talks .	your doctor these doctors the children talk to talks .
the adult my friends those children answer work with exercises .	the adult my friends those children answer exercises .
your teacher those teachers the teachers praise scare cries .	your teacher those teachers the teachers praise cries .
that teacher my teachers the doctors answer scare talks .	that teacher my teachers the doctors answer talks .
my teachers your cousin your cousin talks to works with scream .	my teachers your cousin your cousin talks to scream .
your doctors this person your teacher understands helps whisper .	your doctors this person your teacher understands whisper .
my cousin my cousins these teachers talk to help cries .	my cousin my cousins these teachers talk to cries .
these people my doctor the person helps works with whisper .	these people my doctor the person helps whisper .
those people my cousin this doctor talks to works with lie .	those people my cousin this doctor talks to lie .
your teacher the doctors my friends listen to talk to sings .	your teacher the doctors my friends listen to sings .
your doctor the teachers your teachers bother visit talks .	your doctor the teachers your teachers bother talks .
my cousin these people the people care for visit waves .	my cousin these people the people care for waves .
those teachers my boss that teacher works with helps exercise .	those teachers my boss that teacher works with exercise .
your cousin your friends your teachers answer work with reads .	your cousin your friends your teachers answer reads .
my boss the teachers these doctors scare talk to reads .	my boss the teachers these doctors scare reads .
this doctor those teachers my friends teach worry cries .	this doctor those teachers my friends teach cries .
your friends my dentist the adult helps understands paint .	your friends my dentist the adult helps paint .
my cousin your doctors these teachers talk to help cries .	my cousin your doctors these teachers talk to cries .
that adult those teachers these teachers worry visit talks .	that adult those teachers these teachers worry talks .
that child your friends my friends work with work with reads .	that child your friends my friends work with reads .
the teacher those doctors your friends care for help waves .	the teacher those doctors your friends care for waves .
that person your cousins these teachers appreciate praise waves .	that person your cousins these teachers appreciate waves .
that dancer these children your cousins appreciate talk to exercises .	that dancer these children your cousins appreciate exercises .
that patient these teachers the people teach talk to reads .	that patient these teachers the people teach reads .
that customer these children your doctors work with praise exercises .	that customer these children your doctors work with exercises .
your cousin the people those doctors listen to talk to talks .	your cousin the people those doctors listen to talks .
your boss these doctors my friends answer help sings .	your boss these doctors my friends answer sings .
my doctor your friends my friends praise talk to exercises .	my doctor your friends my friends praise exercises .
this doctor your doctors those doctors listen to talk to waves .	this doctor your doctors those doctors listen to waves .
my cousin the teachers these doctors worry answer cries .	my cousin the teachers these doctors worry cries .
your boss my doctors your teachers talk to help paints .	your boss my doctors your teachers talk to paints .
my dentist your teachers my cousins listen to understand exercises .	my dentist your teachers my cousins listen to exercises .
that patient those teachers these doctors scare care for cries .	that patient those teachers these doctors scare cries .
my teacher those people your doctors help worry talks .	my teacher those people your doctors help talks .
my friends your teacher my friend works with talks to scream .	my friends your teacher my friend works with scream .
my teacher my doctors my doctors work with care for talks .	my teacher my doctors my doctors work with talks .
my teachers this driver this dentist helps works with cry .	my teachers this driver this dentist helps cry .
the driver those children your teachers help answer waves .	the driver those children your teachers help waves .
that teacher your teachers these children care for teach paints .	that teacher your teachers these children care for paints .
the dentist the children my teachers talk to talk to cries .	the dentist the children my teachers talk to cries .
this dentist your doctors these people appreciate teach waves .	this dentist your doctors these people appreciate waves .
your friend my doctors those children visit work with waves .	your friend my doctors those children visit waves .
my doctor your doctors your friends help teach paints .	my doctor your doctors your friends help paints .
this teacher those doctors those doctors teach answer talks .	this teacher those doctors those doctors teach talks .
those doctors that dancer this child helps understands laugh .	those doctors that dancer this child helps laugh .
my teachers your friend the patient scares talks to stretch .	my teachers your friend the patient scares stretch .
my teacher my doctors my cousins work with understand talks .	my teacher my doctors my cousins work with talks .
that patient these people these people answer talk to reads .	that patient these people these people answer reads .
my teacher your cousins those doctors work with bother talks .	my teacher your cousins those doctors work with talks .
your friends my cousin your boss understands talks to win .	your friends my cousin your boss understands win .
that dancer your friends my teachers scare bother cries .	that dancer your friends my teachers scare cries .
my cousin the teachers the children visit care for exercises .	my cousin the teachers the children visit exercises .
these teachers my doctor this dentist talks to scares cough .	these teachers my doctor this dentist talks to cough .
the doctor your teachers your cousins appreciate visit cries .	the doctor your teachers your cousins appreciate cries .
those people your doctor my boss works with helps exercise .	those people your doctor my boss works with exercise .
the teacher my doctors the teachers care for visit cries .	the teacher my doctors the teachers care for cries .
my doctors my boss your teacher understands helps win .	my doctors my boss your teacher understands win .
your teacher these doctors these people care for answer talks .	your teacher these doctors these people care for talks .
your teacher the people your cousins scare visit paints .	your teacher the people your cousins scare paints .
your cousin my friends those children praise listen to talks .	your cousin my friends those children praise talks .
your teachers the adult that dentist works with helps smile .	your teachers the adult that dentist works with smile .
your cousins that dancer the patient understands scares whisper .	your cousins that dancer the patient understands whisper .
your boss your friends your doctors answer bother exercises .	your boss your friends your doctors answer exercises .
your friend these people those teachers worry understand exercises .	your friend these people those teachers worry exercises .
the dentist your teachers my doctors scare appreciate talks .	the dentist your teachers my doctors scare talks .
my friend these teachers those teachers talk to talk to reads .	my friend these teachers those teachers talk to reads .
my doctor my cousins your doctors worry visit reads .	my doctor my cousins your doctors worry reads .
these people my doctor my doctor talks to talks to yell .	these people my doctor my doctor talks to yell .
my cousins your teacher the dancer works with understands read .	my cousins your teacher the dancer works with read .
your teachers your cousin that driver talks to understands wave .	your teachers your cousin that driver talks to wave .
the teachers my friend this patient talks to talks to smile .	the teachers my friend this patient talks to smile .
my boss my doctors my teachers worry appreciate cries .	my boss my doctors my teachers worry cries .
the doctors your boss my boss understands works with laugh .	the doctors your boss my boss understands laugh .
this child your doctors these doctors scare care for sings .	this child your doctors these doctors scare sings .
your friend your doctors my teachers care for visit talks .	your friend your doctors my teachers care for talks .
your teacher these teachers my doctors teach scare exercises .	your teacher these teachers my doctors teach exercises .
that doctor my friends my cousins visit talk to waves .	that doctor my friends my cousins visit waves .
your teacher those teachers these doctors talk to scare waves .	your teacher those teachers these doctors talk to waves .
my cousin the children those teachers appreciate praise talks .	my cousin the children those teachers appreciate talks .
my teacher the children those teachers praise appreciate sings .	my teacher the children those teachers praise sings .
my boss these doctors your doctors work with bother cries .	my boss these doctors your doctors work with cries .
those people that teacher the child scares talks to stretch .	those people that teacher the child scares stretch .
these doctors the driver your dentist scares works with read .	these doctors the driver your dentist scares read .
your friend these children your cousins appreciate scare talks .	your friend these children your cousins appreciate talks .
that child my cousins those doctors bother bother waves .	that child my cousins those doctors bother waves .
my teachers the person that teacher works with scares wave .	my teachers the person that teacher works with wave .
your teacher those teachers these teachers help help sings .	your teacher those teachers these teachers help sings .
your boss your cousins these doctors care for bother paints .	your boss your cousins these doctors care for paints .
your teachers the adult your teacher understands understands talk .	your teachers the adult your teacher understands talk .
my cousin the doctors my cousins answer talk to waves .	my cousin the doctors my cousins answer waves .
my teacher my cousins those teachers visit bother sings .	my teacher my cousins those teachers visit sings .
these doctors your teacher that dancer scares understands whisper .	these doctors your teacher that dancer scares whisper .
the doctors my cousin your doctor understands understands paint .	the doctors my cousin your doctor understands paint .
that adult these doctors your friends talk to listen to paints .	that adult these doctors your friends talk to paints .
my cousins your teacher the dentist works with works with laugh .	my cousins your teacher the dentist works with laugh .
your teacher those children my doctors talk to talk to waves .	your teacher those children my doctors talk to waves .
your friends my cousin that person works with talks to lose .	your friends my cousin that person works with lose .
your cousins that dancer my boss works with scares sneeze .	your cousins that dancer my boss works with sneeze .
that dentist my doctors these people care for listen to paints .	that dentist my doctors these people care for paints .
this doctor your teachers your doctors teach bother paints .	this doctor your teachers your doctors teach paints .
your doctor the children those children praise visit paints .	your doctor the children those children praise paints .
those children your boss my cousin talks to talks to scream .	those children your boss my cousin talks to scream .
these teachers my boss the driver works with helps stretch .	these teachers my boss the driver works with stretch .
your doctor the teachers your cousins bother understand cries .	your doctor the teachers your cousins bother cries .
this adult my doctors these teachers worry listen to reads .	this adult my doctors these teachers worry reads .
the dancer these teachers your doctors understand scare sings .	the dancer these teachers your doctors understand sings .
that patient these people the teachers bother scare paints .	that patient these people the teachers bother paints .
your cousin your teachers these people teach answer cries .	your cousin your teachers these people teach cries .
my boss those children those doctors listen to visit sings .	my boss those children those doctors listen to sings .
your boss my teachers the children praise work with reads .	your boss my teachers the children praise reads .
the person the teachers your teachers bother work with reads .	the person the teachers your teachers bother reads .
your teacher your doctors the teachers help listen to waves .	your teacher your doctors the teachers help waves .
your doctor the children my cousins teach answer exercises .	your doctor the children my cousins teach exercises .
my friends your doctor my dentist understands talks to lie .	my friends your doctor my dentist understands lie .
my boss these doctors your teachers talk to teach talks .	my boss these doctors your teachers talk to talks .
my dentist these doctors my cousins visit talk to sings .	my dentist these doctors my cousins visit sings .
this driver my cousins your cousins scare understand waves .	this driver my cousins your cousins scare waves .
your cousin these teachers these teachers understand care for reads .	your cousin these teachers these teachers understand reads .
my friends my doctor my doctor scares scares scream .	my friends my doctor my doctor scares scream .
your teacher my teachers the doctors worry appreciate cries .	your teacher my teachers the doctors worry cries .
this customer those people your cousins scare worry reads .	this customer those people your cousins scare reads .
the doctors that dancer the customer understands works with yell .	the doctors that dancer the customer understands yell .
my friend your doctors those doctors praise praise waves .	my friend your doctors those doctors praise waves .
the children my boss that patient helps helps lie .	the children my boss that patient helps lie .
your dentist those doctors my teachers bother talk to waves .	your dentist those doctors my teachers bother waves .
your cousin your teachers your friends scare worry talks .	your cousin your teachers your friends scare talks .
my teachers that teacher my boss helps helps wave .	my teachers that teacher my boss helps wave .
this driver your teachers these doctors understand praise cries .	this driver your teachers these doctors understand cries .
the doctors my boss your boss understands works with lose .	the doctors my boss your boss understands lose .
your friends my cousin this customer talks to helps exercise .	your friends my cousin this customer talks to exercise .
my teachers the adult my doctor helps talks to lie .	my teachers the adult my doctor helps lie .
my teachers that child that dancer talks to talks to laugh .	my teachers that child that dancer talks to laugh .
your teachers that patient this doctor helps helps win .	your teachers that patient this doctor helps win .
that customer your doctors those children help praise talks .	that customer your doctors those children help talks .
your doctor the doctors my friends care for visit sings .	your doctor the doctors my friends care for sings .
your teacher your friends my friends understand understand talks .	your teacher your friends my friends understand talks .
that dancer my cousins your friends listen to listen to exercises .	that dancer my cousins your friends listen to exercises .
my friend your doctors these doctors bother teach paints .	my friend your doctors these doctors bother paints .
my teachers the child your boss talks to talks to laugh .	my teachers the child your boss talks to laugh .
this teacher the children those doctors work with worry reads .	this teacher the children those doctors work with reads .
this patient these teachers the teachers answer work with waves .	this patient these teachers the teachers answer waves .
the teacher your teachers my friends care for worry exercises .	the teacher your teachers my friends care for exercises .
those children your dentist the teacher works with talks to win .	those children your dentist the teacher works with win .
your cousin my cousins the doctors answer work with waves .	your cousin my cousins the doctors answer waves .
this adult my friends my teachers talk to teach reads .	this adult my friends my teachers talk to reads .
my doctor these children your cousins praise bother waves .	my doctor these children your cousins praise waves .
this adult those doctors the children work with talk to waves .	this adult those doctors the children work with waves .
this patient your doctors my friends bother answer talks .	this patient your doctors my friends bother talks .
those people my boss your boss works with scares paint .	those people my boss your boss works with paint .
this adult the doctors these teachers understand talk to paints .	this adult the doctors these teachers understand paints .
my teacher these doctors my doctors understand praise talks .	my teacher these doctors my doctors understand talks .
your doctor your friends these teachers listen to scare sings .	your doctor your friends these teachers listen to sings .
my cousin your cousins my teachers care for work with cries .	my cousin your cousins my teachers care for cries .
your teachers my dentist your teacher understands understands win .	your teachers my dentist your teacher understands win .
my boss your cousins these doctors teach praise exercises .	my boss your cousins these doctors teach exercises .
my boss my doctors your cousins listen to teach cries .	my boss my doctors your cousins listen to cries .
your boss those doctors my cousins talk to answer waves .	your boss those doctors my cousins talk to waves .
my friend my doctors your teachers praise scare waves .	my friend my doctors your teachers praise waves .
the dancer my cousins those people understand teach reads .	the dancer my cousins those people understand reads .
my cousin your cousins my cousins talk to care for sings .	my cousin your cousins my cousins talk to sings .
the teacher your cousins these teachers worry worry talks .	the teacher your cousins these teachers worry talks .
this customer the doctors these doctors understand work with cries .	this customer the doctors these doctors understand cries .
your friends this patient this patient helps talks to paint .	your friends this patient this patient helps paint .
your dentist your friends these doctors listen to scare paints .	your dentist your friends these doctors listen to paints .
your boss your friends your friends teach help talks .	your boss your friends your friends teach talks .
the teachers the customer your doctor scares works with whisper .	the teachers the customer your doctor scares whisper .
those children that dentist your friend talks to understands win .	those children that dentist your friend talks to win .
your cousin the teachers my teachers understand appreciate reads .	your cousin the teachers my teachers understand reads .
that dentist the teachers my doctors appreciate talk to cries .	that dentist the teachers my doctors appreciate cries .
the children this driver your cousin talks to understands whisper .	the children this driver your cousin talks to whisper .
this doctor these doctors those doctors scare teach exercises .	this doctor these doctors those doctors scare exercises .
your cousin my teachers my friends help care for talks .	your cousin my teachers my friends help talks .
the driver my teachers those people scare understand reads .	the driver my teachers those people scare reads .
my boss your friends the children understand teach paints .	my boss your friends the children understand paints .
my boss your cousins these children scare talk to exercises .	my boss your cousins these children scare exercises .
that dentist your teachers my cousins teach bother sings .	that dentist your teachers my cousins teach sings .
my doctor those children the doctors work with scare reads .	my doctor those children the doctors work with reads .
my teachers my boss the dancer helps understands paint .	my teachers my boss the dancer helps paint .
this customer those teachers my cousins care for scare reads .	this customer those teachers my cousins care for reads .
your dentist your doctors your teachers worry appreciate sings .	your dentist your doctors your teachers worry sings .
your cousin the children these children appreciate scare talks .	your cousin the children these children appreciate talks .
this patient your cousins these children listen to praise cries .	this patient your cousins these children listen to cries .
my boss these people the doctors listen to praise talks .	my boss these people the doctors listen to talks .
this dentist these teachers your friends talk to appreciate paints .	this dentist these teachers your friends talk to paints .
my cousin the doctors my teachers answer scare reads .	my cousin the doctors my teachers answer reads .
these people the driver your boss scares helps laugh .	these people the driver your boss scares laugh .
your cousin my friends those doctors listen to teach paints .	your cousin my friends those doctors listen to paints .
my friend my teachers your teachers answer care for waves .	my friend my teachers your teachers answer waves .
your dentist your teachers your teachers appreciate visit waves .	your dentist your teachers your teachers appreciate waves .
these doctors your cousin this doctor scares works with paint .	these doctors your cousin this doctor scares paint .
my teacher my cousins your doctors understand bother talks .	my teacher my cousins your doctors understand talks .
this dancer my doctors these teachers appreciate praise waves .	this dancer my doctors these teachers appreciate waves .
my cousins that dancer this customer understands talks to sneeze .	my cousins that dancer this customer understands sneeze .
this patient these teachers your doctors work with understand exercises .	this patient these teachers your doctors work with exercises .
that teacher those teachers these teachers talk to teach paints .	that teacher those teachers these teachers talk to paints .
your cousin my cousins your cousins listen to work with waves .	your cousin my cousins your cousins listen to waves .
your friends this patient the dancer talks to helps win .	your friends this patient the dancer talks to win .
your friend those people my doctors talk to appreciate paints .	your friend those people my doctors talk to paints .
the child those teachers those teachers help teach exercises .	the child those teachers those teachers help exercises .
the child the people my cousins understand scare reads .	the child the people my cousins understand reads .
your doctor the teachers these doctors care for understand waves .	your doctor the teachers these doctors care for waves .
that adult these people your teachers understand work with waves .	that adult these people your teachers understand waves .
your dentist my doctors the children care for answer exercises .	your dentist my doctors the children care for exercises .
my teacher the children these teachers bother appreciate talks .	my teacher the children these teachers bother talks .
this child my doctors the people praise praise talks .	this child my doctors the people praise talks .
my doctor your cousins the doctors worry talk to sings .	my doctor your cousins the doctors worry sings .
my cousins your doctor your teacher helps talks to lie .	my cousins your doctor your teacher helps lie .
the children that doctor your doctor scares understands whisper .	the children that doctor your doctor scares whisper .
this driver the doctors the people talk to scare talks .	this driver the doctors the people talk to talks .
my teachers my cousin your cousin understands works with sneeze .	my teachers my cousin your cousin understands sneeze .
this person your friends my friends visit praise sings .	this person your friends my friends visit sings .
your doctors that dancer my dentist helps helps paint .	your doctors that dancer my dentist helps paint .
your cousins that dancer my doctor helps scares talk .	your cousins that dancer my doctor helps talk .
your dentist those people my friends scare understand sings .	your dentist those people my friends scare sings .
the dentist my cousins your teachers appreciate visit talks .	the dentist my cousins your teachers appreciate talks .
your dentist my teachers those people worry worry talks .	your dentist my teachers those people worry talks .
your doctors that person the patient scares helps exercise .	your doctors that person the patient scares exercise .
your teachers my cousin my teacher scares scares cry .	your teachers my cousin my teacher scares cry .
my teachers my cousin the dentist works with understands lose .	my teachers my cousin the dentist works with lose .
that driver my friends the people care for talk to paints .	that driver my friends the people care for paints .
your boss your doctors my friends bother teach waves .	your boss your doctors my friends bother waves .
the customer your friends those teachers understand talk to sings .	the customer your friends those teachers understand sings .
the doctors the teacher that person works with talks to read .	the doctors the teacher that person works with read .
this dentist my doctors these people answer appreciate cries .	this dentist my doctors these people answer cries .
that patient my cousins these doctors bother understand paints .	that patient my cousins these doctors bother paints .
the dentist the doctors these people listen to worry sings .	the dentist the doctors these people listen to sings .
your friend your cousins the children teach listen to talks .	your friend your cousins the children teach talks .
that customer these children the teachers teach listen to exercises .	that customer these children the teachers teach exercises .
the patient these people your cousins care for scare waves .	the patient these people your cousins care for waves .
your boss those children those doctors bother praise exercises .	your boss those children those doctors bother exercises .
this person your cousins your friends listen to help cries .	this person your cousins your friends listen to cries .
my friend my cousins your teachers listen to scare waves .	my friend my cousins your teachers listen to waves .
my boss the people your doctors listen to scare waves .	my boss the people your doctors listen to waves .
your teachers this person your boss understands works with paint .	your teachers this person your boss understands paint .
the people my teacher my dentist scares understands talk .	the people my teacher my dentist scares talk .
these children this child my cousin works with talks to cough .	these children this child my cousin works with cough .
your friend these doctors the children care for visit cries .	your friend these doctors the children care for cries .
the customer your cousins those people care for work with paints .	the customer your cousins those people care for paints .
this doctor those doctors the children appreciate listen to sings .	this doctor those doctors the children appreciate sings .
that customer those children my cousins bother appreciate talks .	that customer those children my cousins bother talks .
the adult the people your friends understand talk to waves .	the adult the people your friends understand waves .
that teacher those people my doctors praise visit reads .	that teacher those people my doctors praise reads .
your doctors your doctor my friend talks to works with wave .	your doctors your doctor my friend talks to wave .
my boss your doctors your cousins bother praise exercises .	my boss your doctors your cousins bother exercises .
the doctor my teachers my doctors care for understand sings .	the doctor my teachers my doctors care for sings .
those people the dancer that adult talks to helps exercise .	those people the dancer that adult talks to exercise .
my cousin your cousins your cousins bother care for reads .	my cousin your cousins your cousins bother reads .
the dentist my friends the teachers teach care for talks .	the dentist my friends the teachers teach talks .
my dentist my doctors those doctors praise bother sings .	my dentist my doctors those doctors praise sings .
those teachers your friend my doctor helps understands whisper .	those teachers your friend my doctor helps whisper .
your boss your teachers these doctors talk to talk to paints .	your boss your teachers these doctors talk to paints .
your teacher those doctors these people worry work with cries .	your teacher those doctors these people worry cries .
these doctors your doctor this adult helps scares whisper .	these doctors your doctor this adult helps whisper .
your friends my doctor this doctor works with scares lie .	your friends my doctor this doctor works with lie .
this driver your friends the children teach visit exercises .	this driver your friends the children teach exercises .
that dentist my cousins my cousins listen to talk to exercises .	that dentist my cousins my cousins listen to exercises .
my doctor these people these children listen to work with reads .	my doctor these people these children listen to reads .
your dentist my teachers those doctors listen to understand paints .	your dentist my teachers those doctors listen to paints .
this adult these doctors your teachers work with bother exercises .	this adult these doctors your teachers work with exercises .
that child my doctors your friends understand bother paints .	that child my doctors your friends understand paints .
my cousin your cousins these people scare answer sings .	my cousin your cousins these people scare sings .
your dentist these children your teachers worry praise reads .	your dentist these children your teachers worry reads .
the customer your cousins these teachers scare scare cries .	the customer your cousins these teachers scare cries .
that patient my cousins your friends appreciate understand talks .	that patient my cousins your friends appreciate talks .
your dentist your teachers my cousins help worry waves .	your dentist your teachers my cousins help waves .
your friend those teachers these children teach help waves .	your friend those teachers these children teach waves .
this adult your teachers those teachers worry listen to exercises .	this adult your teachers those teachers worry exercises .
your doctors that doctor the driver works with scares whisper .	your doctors that doctor the driver works with whisper .
my teachers this adult my friend scares scares lie .	my teachers this adult my friend scares lie .
your friend my doctors my cousins worry care for sings .	your friend my doctors my cousins worry sings .
your cousins the person your boss works with scares yell .	your cousins the person your boss works with yell .
the dancer your cousins my friends talk to praise sings .	the dancer your cousins my friends talk to sings .
my teacher these people those doctors praise talk to talks .	my teacher these people those doctors praise talks .
the customer these doctors the teachers talk to appreciate paints .	the customer these doctors the teachers talk to paints .
my cousin my doctors those children visit understand reads .	my cousin my doctors those children visit reads .
your friend your doctors the teachers appreciate answer waves .	your friend your doctors the teachers appreciate waves .
this teacher the children your friends visit help sings .	this teacher the children your friends visit sings .
the doctors your dentist that driver helps scares read .	the doctors your dentist that driver helps read .
my doctors the patient this child scares scares stretch .	my doctors the patient this child scares stretch .
this driver my friends my cousins visit appreciate exercises .	this driver my friends my cousins visit exercises .
my friend your teachers the children teach care for exercises .	my friend your teachers the children teach exercises .
that teacher these teachers my friends bother praise talks .	that teacher these teachers my friends bother talks .
my boss the people my friends praise appreciate exercises .	my boss the people my friends praise exercises .
my doctor my doctors the teachers understand scare paints .	my doctor my doctors the teachers understand paints .
the dentist your cousins these teachers help listen to talks .	the dentist your cousins these teachers help talks .
my teacher your friends your doctors work with talk to reads .	my teacher your friends your doctors work with reads .
that child your cousins my teachers talk to care for paints .	that child your cousins my teachers talk to paints .
your friend the children those people listen to bother talks .	your friend the children those people listen to talks .
my dentist my cousins my doctors bother care for waves .	my dentist my cousins my doctors bother waves .
my boss my cousins your friends work with scare reads .	my boss my cousins your friends work with reads .
your friends the child the doctor scares helps whisper .	your friends the child the doctor scares whisper .
this dancer my doctors these children help listen to reads .	this dancer my doctors these children help reads .
my teacher your teachers those people work with talk to cries .	my teacher your teachers those people work with cries .
that doctor your teachers those children praise care for talks .	that doctor your teachers those children praise talks .
the dentist your doctors my friends worry praise talks .	the dentist your doctors my friends worry talks .
my doctors that adult this patient understands helps smile .	my doctors that adult this patient understands smile .
the teacher my doctors your cousins listen to scare cries .	the teacher my doctors your cousins listen to cries .
my teacher my teachers these people praise listen to paints .	my teacher my teachers these people praise paints .
this driver the people those people bother listen to reads .	this driver the people those people bother reads .
your cousin your teachers my teachers worry help sings .	your cousin your teachers my teachers worry sings .
the doctors my friend that driver understands understands sneeze .	the doctors my friend that driver understands sneeze .
those children this driver that teacher works with helps laugh .	those children this driver that teacher works with laugh .
your friend those people those teachers bother visit sings .	your friend those people those teachers bother sings .
my cousin your doctors the children care for understand sings .	my cousin your doctors the children care for sings .
your doctors my teacher my teacher talks to scares smile .	your doctors my teacher my teacher talks to smile .
your teacher these teachers my doctors bother worry sings .	your teacher these teachers my doctors bother sings .
this patient your cousins my cousins care for scare talks .	this patient your cousins my cousins care for talks .
the child my doctors these doctors worry praise exercises .	the child my doctors these doctors worry exercises .
the teacher these people my cousins care for care for sings .	the teacher these people my cousins care for sings .
that adult my friends my teachers talk to teach reads .	that adult my friends my teachers talk to reads .
my doctor the people my doctors appreciate answer paints .	my doctor the people my doctors appreciate paints .
your doctors your dentist that child talks to helps lie .	your doctors your dentist that child talks to lie .
this child your friends the children bother worry exercises .	this child your friends the children bother exercises .
the dentist my teachers your friends talk to work with sings .	the dentist my teachers your friends talk to sings .
your doctor the teachers your cousins bother worry paints .	your doctor the teachers your cousins bother paints .
those teachers the patient your boss understands helps sneeze .	those teachers the patient your boss understands sneeze .
the teacher my cousins my friends visit talk to paints .	the teacher my cousins my friends visit paints .
your teachers my doctor my doctor works with understands paint .	your teachers my doctor my doctor works with paint .
my friend these teachers your teachers care for care for waves .	my friend these teachers your teachers care for waves .
that driver your teachers your friends listen to bother cries .	that driver your teachers your friends listen to cries .
your doctor my doctors these doctors help appreciate waves .	your doctor my doctors these doctors help waves .
my cousins that person the adult understands scares lose .	my cousins that person the adult understands lose .
that doctor my cousins your cousins appreciate scare reads .	that doctor my cousins your cousins appreciate reads .
your doctor these teachers my cousins talk to listen to waves .	your doctor these teachers my cousins talk to waves .
this teacher my friends your friends visit bother cries .	this teacher my friends your friends visit cries .
this dancer my friends these doctors answer understand paints .	this dancer my friends these doctors answer paints .
my doctors that patient the customer works with scares lie .	my doctors that patient the customer works with lie .
the patient my cousins your cousins answer bother exercises .	the patient my cousins your cousins answer exercises .
those teachers the patient your boss scares talks to win .	those teachers the patient your boss scares win .
those doctors my doctor my dentist helps helps smile .	those doctors my doctor my dentist helps smile .
my boss my doctors my friends talk to care for cries .	my boss my doctors my friends talk to cries .
your cousin my doctors your doctors worry teach reads .	your cousin my doctors your doctors worry reads .
your doctor those doctors the teachers talk to visit cries .	your doctor those doctors the teachers talk to cries .
the patient those doctors my friends work with talk to cries .	the patient those doctors my friends work with cries .
my dentist my doctors those people visit care for sings .	my dentist my doctors those people visit sings .
my boss your friends these children appreciate praise waves .	my boss your friends these children appreciate waves .
your doctor these people my doctors worry talk to exercises .	your doctor these people my doctors worry exercises .
the doctor those teachers those children care for listen to exercises .	the doctor those teachers those children care for exercises .
your friend those doctors your doctors scare teach reads .	your friend those doctors your doctors scare reads .
my doctors this driver this doctor scares understands win .	my doctors this driver this doctor scares win .
my cousins my doctor the adult works with talks to cough .	my cousins my doctor the adult works with cough .
your cousin your cousins your cousins understand scare exercises .	your cousin your cousins your cousins understand exercises .
the doctor my cousins my teachers answer answer sings .	the doctor my cousins my teachers answer sings .
these doctors my friend your friend scares helps whisper .	these doctors my friend your friend scares whisper .
my cousin my cousins these doctors bother scare exercises .	my cousin my cousins these doctors bother exercises .
that dentist those people these people praise bother waves .	that dentist those people these people praise waves .
my friend these doctors your teachers work with listen to cries .	my friend these doctors your teachers work with cries .
the dentist your doctors my doctors understand praise reads .	the dentist your doctors my doctors understand reads .
my doctor those people those doctors understand talk to cries .	my doctor those people those doctors understand cries .
the adult my teachers your friends praise talk to sings .	the adult my teachers your friends praise sings .
this driver the children the children worry praise cries .	this driver the children the children worry cries .
the dentist the teachers your teachers bother work with waves .	the dentist the teachers your teachers bother waves .
the teacher these children the doctors talk to scare cries .	the teacher these children the doctors talk to cries .
my friend these children my doctors care for talk to talks .	my friend these children my doctors care for talks .
your friends that dentist your cousin helps helps win .	your friends that dentist your cousin helps win .
that dentist those teachers my friends care for scare exercises .	that dentist those teachers my friends care for exercises .
my boss your doctors my doctors answer teach waves .	my boss your doctors my doctors answer waves .
this driver your friends those children appreciate bother paints .	this driver your friends those children appreciate paints .
that dentist your cousins those children understand work with waves .	that dentist your cousins those children understand waves .
my friend your teachers my doctors care for help talks .	my friend your teachers my doctors care for talks .
your cousin my teachers your doctors understand teach waves .	your cousin my teachers your doctors understand waves .
my teacher those teachers my teachers work with understand waves .	my teacher those teachers my teachers work with waves .
my friend your friends my friends talk to answer cries .	my friend your friends my friends talk to cries .
my friends your boss my dentist works with talks to yell .	my friends your boss my dentist works with yell .
my dentist my cousins those doctors visit praise sings .	my dentist my cousins those doctors visit sings .
this driver these children those doctors talk to talk to talks .	this driver these children those doctors talk to talks .
my doctor these children my friends talk to teach talks .	my doctor these children my friends talk to talks .
your friends your doctor your friend understands talks to sneeze .	your friends your doctor your friend understands sneeze .
my boss my cousins your cousins appreciate listen to reads .	my boss my cousins your cousins appreciate reads .
this customer those children those people appreciate listen to sings .	this customer those children those people appreciate sings .
that adult the doctors those doctors teach teach exercises .	that adult the doctors those doctors teach exercises .
that driver those people my teachers understand listen to cries .	that driver those people my teachers understand cries .
that dancer my doctors my doctors understand care for waves .	that dancer my doctors my doctors understand waves .
that patient these people my friends teach praise talks .	that patient these people my friends teach talks .
your teachers my friend the patient scares scares talk .	your teachers my friend the patient scares talk .
your friends this doctor your doctor scares understands whisper .	your friends this doctor your doctor scares whisper .
your boss my doctors the doctors understand praise exercises .	your boss my doctors the doctors understand exercises .
your teachers the driver that doctor helps scares sneeze .	your teachers the driver that doctor helps sneeze .
your cousin those children my doctors appreciate talk to talks .	your cousin those children my doctors appreciate talks .
that doctor these doctors my teachers care for teach paints .	that doctor these doctors my teachers care for paints .
these teachers your cousin this doctor understands understands read .	these teachers your cousin this doctor understands read .
that customer my teachers the doctors understand teach talks .	that customer my teachers the doctors understand talks .
your friends this person the dancer works with understands talk .	your friends this person the dancer works with talk .
this dentist my cousins your doctors care for answer waves .	this dentist my cousins your doctors care for waves .
this child my cousins the people bother work with sings .	this child my cousins the people bother sings .
your friends my cousin this patient understands scares lie .	your friends my cousin this patient understands lie .
the customer my teachers your friends praise listen to talks .	the customer my teachers your friends praise talks .
the dancer these doctors the children visit listen to talks .	the dancer these doctors the children visit talks .
this teacher your cousins these children listen to work with waves .	this teacher your cousins these children listen to waves .
my boss the teachers your cousins work with care for reads .	my boss the teachers your cousins work with reads .
this person the children your cousins praise appreciate reads .	this person the children your cousins praise reads .
my dentist those teachers your friends care for talk to exercises .	my dentist those teachers your friends care for exercises .
the people your teacher my boss understands works with exercise .	the people your teacher my boss understands exercise .
the driver my friends the children help understand talks .	the driver my friends the children help talks .
the person my cousins my doctors praise appreciate talks .	the person my cousins my doctors praise talks .
this child the doctors my cousins care for help paints .	this child the doctors my cousins care for paints .
the dancer your teachers these children talk to scare cries .	the dancer your teachers these children talk to cries .
this teacher your doctors those teachers worry appreciate cries .	this teacher your doctors those teachers worry cries .
my doctor your doctors my cousins appreciate talk to sings .	my doctor your doctors my cousins appreciate sings .
the doctor your doctors my doctors bother answer talks .	the doctor your doctors my doctors bother talks .
my teacher my teachers your teachers care for scare cries .	my teacher my teachers your teachers care for cries .
my dentist my teachers those doctors visit bother reads .	my dentist my teachers those doctors visit reads .
this patient these doctors your teachers appreciate work with waves .	this patient these doctors your teachers appreciate waves .
this teacher these children the teachers worry visit paints .	this teacher these children the teachers worry paints .
my boss my cousins the people talk to talk to exercises .	my boss my cousins the people talk to exercises .
the customer those people my cousins talk to bother waves .	the customer those people my cousins talk to waves .
that teacher those people my cousins listen to appreciate reads .	that teacher those people my cousins listen to reads .
that adult the teachers these doctors answer scare exercises .	that adult the teachers these doctors answer exercises .
that patient my cousins those doctors talk to worry reads .	that patient my cousins those doctors talk to reads .
my teachers the teacher your cousin understands understands exercise .	my teachers the teacher your cousin understands exercise .
the doctor the teachers my doctors bother worry cries .	the doctor the teachers my doctors bother cries .
my teacher your cousins my friends appreciate scare waves .	my teacher your cousins my friends appreciate waves .
that person these teachers my friends work with help exercises .	that person these teachers my friends work with exercises .
those people my dentist my doctor scares helps read .	those people my dentist my doctor scares read .
my friends the driver the person helps talks to whisper .	my friends the driver the person helps whisper .
that patient your friends those children visit understand waves .	that patient your friends those children visit waves .
this child your cousins the teachers work with listen to reads .	this child your cousins the teachers work with reads .
your boss my friends my cousins visit worry paints .	your boss my friends my cousins visit paints .
this dentist your doctors my doctors work with answer talks .	this dentist your doctors my doctors work with talks .
my teachers the person the teacher scares scares exercise .	my teachers the person the teacher scares exercise .
the customer the children your friends bother answer sings .	the customer the children your friends bother sings .
your boss your cousins your teachers worry help cries .	your boss your cousins your teachers worry cries .
my dentist the doctors my cousins worry work with paints .	my dentist the doctors my cousins worry paints .
the doctors my friend my cousin scares understands exercise .	the doctors my friend my cousin scares exercise .
my teacher those people your teachers teach care for exercises .	my teacher those people your teachers teach exercises .
the driver your teachers my cousins worry work with cries .	the driver your teachers my cousins worry cries .
my doctors your doctor my teacher understands understands read .	my doctors your doctor my teacher understands read .
this dentist these people my friends answer talk to paints .	this dentist these people my friends answer paints .
my teacher my doctors your doctors bother answer sings .	my teacher my doctors your doctors bother sings .
your dentist your cousins those children visit listen to cries .	your dentist your cousins those children visit cries .
your cousin those people those teachers appreciate scare cries .	your cousin those people those teachers appreciate cries .
your friend my doctors your doctors help praise reads .	your friend my doctors your doctors help reads .
my friends my dentist my doctor understands works with scream .	my friends my dentist my doctor understands scream .
my friends my doctor that dancer talks to talks to laugh .	my friends my doctor that dancer talks to laugh .
your doctor your friends your doctors teach talk to waves .	your doctor your friends your doctors teach waves .
my teacher these children my doctors talk to understand waves .	my teacher these children my doctors talk to waves .
my doctor the doctors my doctors talk to bother cries .	my doctor the doctors my doctors talk to cries .
my doctor my teachers those people praise care for exercises .	my doctor my teachers those people praise exercises .
the dancer the people your teachers work with understand sings .	the dancer the people your teachers work with sings .
those doctors your teacher the adult talks to understands yell .	those doctors your teacher the adult talks to yell .
this dentist my friends my friends answer understand sings .	this dentist my friends my friends answer sings .
your teacher my teachers my teachers care for praise paints .	your teacher my teachers my teachers care for paints .
your cousin the doctors your teachers worry bother exercises .	your cousin the doctors your teachers worry exercises .
the adult my teachers your doctors praise teach talks .	the adult my teachers your doctors praise talks .
my boss the people these teachers appreciate help reads .	my boss the people these teachers appreciate reads .
your cousin the children those people scare help reads .	your cousin the children those people scare reads .
the dancer these teachers your friends scare answer reads .	the dancer these teachers your friends scare reads .
the customer the teachers your doctors visit talk to talks .	the customer the teachers your doctors visit talks .
my cousin the people the doctors worry appreciate cries .	my cousin the people the doctors worry cries .
the dentist the doctors the teachers appreciate understand sings .	the dentist the doctors the teachers appreciate sings .
my dentist your cousins your cousins scare answer cries .	my dentist your cousins your cousins scare cries .
that adult those children these children bother visit cries .	that adult those children these children bother cries .
your boss your doctors my cousins care for bother cries .	your boss your doctors my cousins care for cries .
the adult my cousins your doctors care for work with paints .	the adult my cousins your doctors care for paints .
your friend my doctors these doctors talk to teach waves .	your friend my doctors these doctors talk to waves .
your cousin these people your cousins visit talk to sings .	your cousin these people your cousins visit sings .
your friend my teachers these teachers listen to help cries .	your friend my teachers these teachers listen to cries .
my friend my doctors these doctors visit work with cries .	my friend my doctors these doctors visit cries .
that customer the people your friends answer understand talks .	that customer the people your friends answer talks .
your cousins that teacher that dentist scares talks to smile .	your cousins that teacher that dentist scares smile .
my friends your teacher that driver scares understands paint .	my friends your teacher that driver scares paint .
the dancer these children my friends worry praise cries .	the dancer these children my friends worry cries .
the dancer these doctors the children listen to care for reads .	the dancer these doctors the children listen to reads .
that dentist the children these children visit bother cries .	that dentist the children these children visit cries .
your doctor those doctors your friends listen to bother waves .	your doctor those doctors your friends listen to waves .
my teachers that person the person scares works with sing .	my teachers that person the person scares sing .
your boss those children those children praise understand paints .	your boss those children those children praise paints .
the driver these teachers these children bother care for paints .	the driver these teachers these children bother paints .
these people my boss your friend talks to talks to cough .	these people my boss your friend talks to cough .
the dentist the people those children bother answer exercises .	the dentist the people those children bother exercises .
these teachers your friend my boss works with works with stretch .	these teachers your friend my boss works with stretch .
my doctors the person my cousin works with scares laugh .	my doctors the person my cousin works with laugh .
this dentist those people your cousins visit listen to reads .	this dentist those people your cousins visit reads .
this person those children these people teach appreciate waves .	this person those children these people teach waves .
those people your cousin that person helps understands read .	those people your cousin that person helps read .
your cousin those doctors my friends understand bother cries .	your cousin those doctors my friends understand cries .
my doctor your doctors those people answer praise cries .	my doctor your doctors those people answer cries .
this dentist your doctors those children talk to care for cries .	this dentist your doctors those children talk to cries .
these teachers your cousin this child talks to helps paint .	these teachers your cousin this child talks to paint .
my friend those doctors those children appreciate understand waves .	my friend those doctors those children appreciate waves .
the child my doctors your cousins worry answer reads .	the child my doctors your cousins worry reads .
this patient my doctors those doctors understand understand reads .	this patient my doctors those doctors understand reads .
my boss your doctors your cousins answer bother reads .	my boss your doctors your cousins answer reads .
the teacher your doctors my friends scare visit exercises .	the teacher your doctors my friends scare exercises .
this child these doctors these doctors understand answer reads .	this child these doctors these doctors understand reads .
this customer the doctors the children care for help waves .	this customer the doctors the children care for waves .
this teacher these doctors my friends praise scare talks .	this teacher these doctors my friends praise talks .
your doctor your teachers these doctors praise scare paints .	your doctor your teachers these doctors praise paints .
your doctors that teacher that adult understands helps smile .	your doctors that teacher that adult understands smile .
my cousins my dentist the adult understands scares stretch .	my cousins my dentist the adult understands stretch .
the children your doctor my friend talks to helps scream .	the children your doctor my friend talks to scream .
your teacher those people your cousins help understand sings .	your teacher those people your cousins help sings .
that dancer these teachers your doctors appreciate work with waves .	that dancer these teachers your doctors appreciate waves .
that child my doctors the teachers answer listen to exercises .	that child my doctors the teachers answer exercises .
your friend my doctors the people praise praise sings .	your friend my doctors the people praise sings .
the dentist your doctors your doctors appreciate visit paints .	the dentist your doctors your doctors appreciate paints .
the children this dentist your doctor works with understands sing .	the children this dentist your doctor works with sing .
these people this adult my boss talks to scares sing .	these people this adult my boss talks to sing .
your boss the people the doctors understand bother exercises .	your boss the people the doctors understand exercises .
your boss your teachers your doctors talk to talk to reads .	your boss your teachers your doctors talk to reads .
this customer my cousins the teachers teach teach sings .	this customer my cousins the teachers teach sings .
my friend these children your doctors visit talk to exercises .	my friend these children your doctors visit exercises .
your cousin these children my teachers worry help paints .	your cousin these children my teachers worry paints .
my teacher these children these people talk to bother exercises .	my teacher these children these people talk to exercises .
the dancer the people these teachers help visit exercises .	the dancer the people these teachers help exercises .
the child your teachers my friends listen to work with talks .	the child your teachers my friends listen to talks .
this customer those people these teachers answer appreciate exercises .	this customer those people these teachers answer exercises .
the doctors this patient the driver works with scares paint .	the doctors this patient the driver works with paint .
my doctors my cousin your doctor helps talks to read .	my doctors my cousin your doctor helps read .
the customer my doctors your friends worry understand waves .	the customer my doctors your friends worry waves .
my cousins my doctor that child understands helps practice .	my cousins my doctor that child understands practice .
your teacher those doctors my teachers scare bother cries .	your teacher those doctors my teachers scare cries .
my doctor my doctors my friends care for help cries .	my doctor my doctors my friends care for cries .
this dancer the teachers your teachers understand appreciate talks .	this dancer the teachers your teachers understand talks .
those children your doctor your teacher understands talks to scream .	those children your doctor your teacher understands scream .
my boss my teachers the doctors work with work with paints .	my boss my teachers the doctors work with paints .
that teacher the doctors the teachers praise care for talks .	that teacher the doctors the teachers praise talks .
my boss my doctors your cousins scare answer cries .	my boss my doctors your cousins scare cries .
your teacher these people my friends answer scare sings .	your teacher these people my friends answer sings .
my friend my doctors your cousins talk to help reads .	my friend my doctors your cousins talk to reads .
this patient these people those doctors listen to talk to cries .	this patient these people those doctors listen to cries .
my boss my cousins my doctors care for worry talks .	my boss my cousins my doctors care for talks .
these doctors that patient this dancer helps works with lose .	these doctors that patient this dancer helps lose .
your cousin the doctors my doctors answer talk to sings .	your cousin the doctors my doctors answer sings .
this dentist my cousins these doctors worry answer exercises .	this dentist my cousins these doctors worry exercises .
my cousin these children your doctors help appreciate cries .	my cousin these children your doctors help cries .
my friends your doctor my cousin understands talks to practice .	my friends your doctor my cousin understands practice .
this person your teachers your friends visit praise waves .	this person your teachers your friends visit waves .
my dentist those teachers your doctors appreciate visit sings .	my dentist those teachers your doctors appreciate sings .
the person my doctors your friends listen to listen to talks .	the person my doctors your friends listen to talks .
that doctor these people those teachers worry work with waves .	that doctor these people those teachers worry waves .
my dentist your friends your teachers teach understand exercises .	my dentist your friends your teachers teach exercises .
your teachers the adult your friend works with helps lie .	your teachers the adult your friend works with lie .
my teacher my teachers these teachers care for understand paints .	my teacher my teachers these teachers care for paints .
this customer these teachers my doctors bother listen to cries .	this customer these teachers my doctors bother cries .
my boss my teachers these teachers bother visit sings .	my boss my teachers these teachers bother sings .
that teacher your doctors my doctors talk to answer talks .	that teacher your doctors my doctors talk to talks .
your cousin those children these children visit care for sings .	your cousin those children these children visit sings .
the doctors your friend this child talks to scares cry .	the doctors your friend this child talks to cry .
these teachers your doctor my doctor works with understands laugh .	these teachers your doctor my doctor works with laugh .
your doctors my teacher your dentist talks to talks to sing .	your doctors my teacher your dentist talks to sing .
my cousin my friends your doctors visit visit sings .	my cousin my friends your doctors visit sings .
the customer the doctors your cousins appreciate worry talks .	the customer the doctors your cousins appreciate talks .
the doctors this doctor that customer understands helps sneeze .	the doctors this doctor that customer understands sneeze .
this customer those teachers these doctors visit care for waves .	this customer those teachers these doctors visit waves .
