the women worked with this child .	the women worked with this children .
the ladies were breaking that truck .	the ladies were breaking that trucks .
the customer would talk about those turtles .	the customer would talk about those turtle .
the customer does n't look like these mice .	the customer does n't look like these mouse .
the guy has n't broken these spoons .	the guy has n't broken these spoon .
the men do n't shake these glasses .	the men do n't shake these glass .
the people talk about this woman .	the people talk about this women .
the lady threw this crayon .	the lady threw this crayons .
the mice notice those cars .	the mice notice those car .
the ladies hear that snake .	the ladies hear that snakes .
the patient can n't scare those guys .	the patient can n't scare those guy .
the people could take those boxes .	the people could take those box .
the girls were n't thinking about this child .	the girls were n't thinking about this children .
the cat has seen these buttons .	the cat has seen these button .
the girl will talk about this bird .	the girl will talk about this birds .
the children had found these boats .	the children had found these boat .
the driver worried this person .	the driver worried this people .
the forks broke those windows .	the forks broke those window .
the child talked to these girls .	the child talked to these girl .
the lady is visiting those children .	the lady is visiting those child .
the dog noticed these cars .	the dog noticed these car .
the man would move these boxes .	the man would move these box .
the boys bothered that girl .	the boys bothered that girls .
the boys hold those toys .	the boys hold those toy .
the teacher has n't brought these glasses .	the teacher has n't brought these glass .
the dentist likes this crayon .	the dentist likes this crayons .
the men have talked about that child .	the men have talked about that children .
the boys had thrown that car .	the boys had thrown that cars .
the women were n't throwing this fork .	the women were n't throwing this forks .
the dancer has n't fixed that shoe .	the dancer has n't fixed that shoes .
the guy talked about that door .	the guy talked about that doors .
the man brought those shoes .	the man brought those shoe .
the horses were n't thinking about those people .	the horses were n't thinking about those person .
the rabbit should hate those boys .	the rabbit should hate those boy .
the girls hear these horses .	the girls hear these horse .
the guy talks about that rabbit .	the guy talks about that rabbits .
the man can hear that horse .	the man can hear that horses .
the girl can n't keep this picture .	the girl can n't keep this pictures .
the guys had bought those forks .	the guys had bought those fork .
the dentist must keep this chair .	the dentist must keep this chairs .
the birds had noticed this shoe .	the birds had noticed this shoes .
the children must like this hat .	the children must like this hats .
the girls might lift these trucks .	the girls might lift these truck .
the people had heard those people .	the people had heard those person .
the ladies work with this person .	the ladies work with this people .
the guy bought those books .	the guy bought those book .
the lady is n't making this bottle .	the lady is n't making this bottles .
the horses have n't remembered those ladies .	the horses have n't remembered those lady .
the children had n't cleaned this ring .	the children had n't cleaned this rings .
the children have n't held this car .	the children have n't held this cars .
the toys were breaking this truck .	the toys were breaking this trucks .
the queen is n't moving these forks .	the queen is n't moving these fork .
the boys are breaking that window .	the boys are breaking that windows .
the guys went to this room .	the guys went to this rooms .
the horse can hate these snakes .	the horse can hate these snake .
the driver had n't worried those children .	the driver had n't worried those child .
the teachers have n't broken these hats .	the teachers have n't broken these hat .
the doctor had n't lost those glasses .	the doctor had n't lost those glass .
the doctors could n't clean those bottles .	the doctors could n't clean those bottle .
the lady is n't walking through this school .	the lady is n't walking through this schools .
the hamster breaks that button .	the hamster breaks that buttons .
the men have heard these teachers .	the men have heard these teacher .
the child is n't working with those teachers .	the child is n't working with those teacher .
the crayon broke this glass .	the crayon broke this glasses .
the driver had n't taught those doctors .	the driver had n't taught those doctor .
the queen helped these doctors .	the queen helped these doctor .
the person found those candles .	the person found those candle .
the people left these schools .	the people left these school .
the patient has n't broken these buttons .	the patient has n't broken these button .
the snakes think about that shoe .	the snakes think about that shoes .
the horse will forget these women .	the horse will forget these woman .
the cat forgot this shoe .	the cat forgot this shoes .
the teacher should hear these birds .	the teacher should hear these bird .
the men had answered that child .	the men had answered that children .
the guys walked through those schools .	the guys walked through those school .
the mirror wo n't break those bottles .	the mirror wo n't break those bottle .
the adult might take that book .	the adult might take that books .
the queen held those dishes .	the queen held those dish .
the ladies may fix those boxes .	the ladies may fix those box .
the guy was n't bringing that candle .	the guy was n't bringing that candles .
the girls made these bottles .	the girls made these bottle .
the driver held this picture .	the driver held this pictures .
the boy saw those glasses .	the boy saw those glass .
the birds loved that crayon .	the birds loved that crayons .
the king is losing that candle .	the king is losing that candles .
the men are moving this glass .	the men are moving this glasses .
the dentist broke those boxes .	the dentist broke those box .
the queen had heard those dogs .	the queen had heard those dog .
the men had moved those bottles .	the men had moved those bottle .
the doctors sounded like these dogs .	the doctors sounded like these dog .
the bird is n't breaking these crayons .	the bird is n't breaking these crayon .
the boy has n't talked to those people .	the boy has n't talked to those person .
the patient wo n't remember this woman .	the patient wo n't remember this women .
the people had brought this hat .	the people had brought this hats .
the teacher did n't listen to those boys .	the teacher did n't listen to those boy .
the doctors could n't remember that child .	the doctors could n't remember that children .
the horse could remember these shoes .	the horse could remember these shoe .
the dentist sounded like those boys .	the dentist sounded like those boy .
the ladies work with those children .	the ladies work with those child .
the driver talks about those books .	the driver talks about those book .
the men found those buttons .	the men found those button .
the driver has n't thought about this glass .	the driver has n't thought about this glasses .
the girls have n't cleaned these books .	the girls have n't cleaned these book .
the girls should n't bother those girls .	the girls should n't bother those girl .
the driver had n't taught this girl .	the driver had n't taught this girls .
the teachers saw that box .	the teachers saw that boxes .
the picture should break these beds .	the picture should break these bed .
the teacher would look like those children .	the teacher would look like those child .
the guys understand those children .	the guys understand those child .
the teachers do n't fix that shoe .	the teachers do n't fix that shoes .
the children broke those shoes .	the children broke those shoe .
the dancer sounds like those cats .	the dancer sounds like those cat .
the lady is n't driving to those rooms .	the lady is n't driving to those room .
the guys take those bottles .	the guys take those bottle .
the teachers have n't thrown this shoe .	the teachers have n't thrown this shoes .
the child talked about this person .	the child talked about this people .
the cat thought about this crayon .	the cat thought about this crayons .
the teacher visited that boy .	the teacher visited that boys .
the cup broke those books .	the cup broke those book .
the turtles may love these boys .	the turtles may love these boy .
the dentist noticed this snake .	the dentist noticed this snakes .
the women sell these pictures .	the women sell these picture .
the teachers dropped these pictures .	the teachers dropped these picture .
the doctor scares these children .	the doctor scares these child .
the boy would drop this car .	the boy would drop this cars .
the patient did n't see that shirt .	the patient did n't see that shirts .
the doctor has n't heard this cat .	the doctor has n't heard this cats .
the girls can n't find this bag .	the girls can n't find this bags .
the teachers lost that guy .	the teachers lost that guys .
the cars may break those shirts .	the cars may break those shirt .
the cat loved this car .	the cat loved this cars .
the teacher talked about these rings .	the teacher talked about these ring .
the teacher answered those girls .	the teacher answered those girl .
the bed has broken these plates .	the bed has broken these plate .
the doctors could notice these turtles .	the doctors could notice these turtle .
the patient had n't visited these ladies .	the patient had n't visited these lady .
the doctor breaks that box .	the doctor breaks that boxes .
the woman lost these guys .	the woman lost these guy .
the dancer hears these children .	the dancer hears these child .
the ladies were losing these trucks .	the ladies were losing these truck .
the people have dropped these books .	the people have dropped these book .
the rabbit thinks about those bowls .	the rabbit thinks about those bowl .
the person had talked to that teacher .	the person had talked to that teachers .
the customer is throwing those shoes .	the customer is throwing those shoe .
the car had broken these books .	the car had broken these book .
the driver should drive to these schools .	the driver should drive to these school .
the doctors shook these buttons .	the doctors shook these button .
the people had noticed these forks .	the people had noticed these fork .
the people do n't notice these buttons .	the people do n't notice these button .
the boys were bringing this plate .	the boys were bringing this plates .
the dancer had n't helped this man .	the dancer had n't helped this men .
the children have kept those glasses .	the children have kept those glass .
the adult is visiting those teachers .	the adult is visiting those teacher .
the children remembered this fork .	the children remembered this forks .
the doctors have seen those turtles .	the doctors have seen those turtle .
the people were n't finding these doors .	the people were n't finding these door .
the girls should n't drive to this school .	the girls should n't drive to this schools .
the forks were breaking that candle .	the forks were breaking that candles .
the boy has answered those ladies .	the boy has answered those lady .
the books would break this fork .	the books would break this forks .
the queen threw those windows .	the queen threw those window .
the birds liked that man .	the birds liked that men .
the child must love those birds .	the child must love those bird .
the girl drove to this room .	the girl drove to this rooms .
the queen was n't thinking about that fork .	the queen was n't thinking about that forks .
the cup has broken those chairs .	the cup has broken those chair .
the dancer was n't thinking about those dolls .	the dancer was n't thinking about those doll .
the man is teaching this lady .	the man is teaching this ladies .
the teacher forgot those guys .	the teacher forgot those guy .
the women lose these toys .	the women lose these toy .
the forks would n't break these shirts .	the forks would n't break these shirt .
the lady loves those boys .	the lady loves those boy .
the man liked those doors .	the man liked those door .
the fork is n't breaking these cars .	the fork is n't breaking these car .
the ladies talked to these men .	the ladies talked to these man .
the man noticed that snake .	the man noticed that snakes .
the children have n't remembered this chair .	the children have n't remembered this chairs .
the teacher would n't shake those bottles .	the teacher would n't shake those bottle .
the ladies were finding this button .	the ladies were finding this buttons .
the adult was n't teaching this teacher .	the adult was n't teaching this teachers .
the doctors would n't walk through that school .	the doctors would n't walk through that schools .
the queen remembered those plates .	the queen remembered those plate .
the person had passed this school .	the person had passed this schools .
the bicycle broke these buttons .	the bicycle broke these button .
the bottles break that picture .	the bottles break that pictures .
the doctors have heard this child .	the doctors have heard this children .
the child does n't scare that boy .	the child does n't scare that boys .
the children have n't bothered those guys .	the children have n't bothered those guy .
the doctor broke these hats .	the doctor broke these hat .
the ladies had lost those shoes .	the ladies had lost those shoe .
the teacher had talked about those men .	the teacher had talked about those man .
the patient would talk about this ring .	the patient would talk about this rings .
the doctor has n't taught that boy .	the doctor has n't taught that boys .
the woman works with these ladies .	the woman works with these lady .
the driver hears this snake .	the driver hears this snakes .
the person visited these children .	the person visited these child .
the boys help this child .	the boys help this children .
the rabbit was n't thinking about that car .	the rabbit was n't thinking about that cars .
the customer does n't buy these windows .	the customer does n't buy these window .
the teachers help these boys .	the teachers help these boy .
the button broke this candle .	the button broke this candles .
the girl noticed these dishes .	the girl noticed these dish .
the teachers have n't bought those plates .	the teachers have n't bought those plate .
the girl is bothering that child .	the girl is bothering that children .
the hat has broken those rings .	the hat has broken those ring .
the boys see those cars .	the boys see those car .
the driver was n't fixing this bowl .	the driver was n't fixing this bowls .
the children are n't taking that fork .	the children are n't taking that forks .
the rabbits hate that mouse .	the rabbits hate that mice .
the boy had n't talked about these hats .	the boy had n't talked about these hat .
the driver is n't walking through these schools .	the driver is n't walking through these school .
the customer may forget these cars .	the customer may forget these car .
the driver has n't noticed this horse .	the driver has n't noticed this horses .
the girl cleaned these books .	the girl cleaned these book .
the patient is throwing these spoons .	the patient is throwing these spoon .
the children have dropped this spoon .	the children have dropped this spoons .
the girl had noticed these snakes .	the girl had noticed these snake .
the girls held that candle .	the girls held that candles .
the turtles were thinking about that window .	the turtles were thinking about that windows .
the woman had talked about these bottles .	the woman had talked about these bottle .
the women heard those women .	the women heard those woman .
the dogs will remember that child .	the dogs will remember that children .
the dentist can n't take that book .	the dentist can n't take that books .
the lady has n't lost these doctors .	the lady has n't lost these doctor .
the adult had talked about this man .	the adult had talked about this men .
the guys had n't thought about those forks .	the guys had n't thought about those fork .
the button might break those crayons .	the button might break those crayon .
the crayons break this box .	the crayons break this boxes .
the guy drove to this room .	the guy drove to this rooms .
the adult kept this dish .	the adult kept this dishes .
the men leave those schools .	the men leave those school .
the guys have run around that school .	the guys have run around that schools .
the doctor could hold those boxes .	the doctor could hold those box .
the turtle sees this bed .	the turtle sees this beds .
the guys had n't heard those mice .	the guys had n't heard those mouse .
the dancer would n't return to those schools .	the dancer would n't return to those school .
the adult is buying these dishes .	the adult is buying these dish .
the patient keeps those cups .	the patient keeps those cup .
the horses thought about those windows .	the horses thought about those window .
the women go to these schools .	the women go to these school .
the boys might move these bottles .	the boys might move these bottle .
the doctor lost that truck .	the doctor lost that trucks .
the child had n't bought these candles .	the child had n't bought these candle .
the man wo n't fix those cars .	the man wo n't fix those car .
the snake forgot that horse .	the snake forgot that horses .
the guys were visiting this guy .	the guys were visiting this guys .
the children throw this crayon .	the children throw this crayons .
the patient cleaned these bowls .	the patient cleaned these bowl .
the dancer holds these dolls .	the dancer holds these doll .
the guys had this door .	the guys had this doors .
the guy dropped these cars .	the guy dropped these car .
the girls were n't throwing those bags .	the girls were n't throwing those bag .
the men knew those horses .	the men knew those horse .
the girls will buy those candles .	the girls will buy those candle .
the teacher does n't listen to these doctors .	the teacher does n't listen to these doctor .
the king taught that child .	the king taught that children .
the man throws this window .	the man throws this windows .
the lady is driving to these schools .	the lady is driving to these school .
the boy does n't hear that person .	the boy does n't hear that people .
the fork broke those crayons .	the fork broke those crayon .
the boys shook those cars .	the boys shook those car .
the customer may bring this car .	the customer may bring this cars .
the dentist heard that man .	the dentist heard that men .
the guy does n't talk about that cat .	the guy does n't talk about that cats .
the mouse saw this bottle .	the mouse saw this bottles .
the women are taking those bags .	the women are taking those bag .
the girls have lost that bag .	the girls have lost that bags .
the people drive to that school .	the people drive to that schools .
the mirror did n't break these glasses .	the mirror did n't break these glass .
the girl fixed these cars .	the girl fixed these car .
the dentist had n't heard these birds .	the dentist had n't heard these bird .
the people have moved that cup .	the people have moved that cups .
the people had lost those girls .	the people had lost those girl .
the children wo n't love those bowls .	the children wo n't love those bowl .
the girl broke this toy .	the girl broke this toys .
the bed breaks that shoe .	the bed breaks that shoes .
the adult should bother those children .	the adult should bother those child .
the ladies looked like this snake .	the ladies looked like this snakes .
the guy should n't find this box .	the guy should n't find this boxes .
the teachers would n't hold that car .	the teachers would n't hold that cars .
the ladies return to that school .	the ladies return to that schools .
the boy wo n't shake this toy .	the boy wo n't shake this toys .
the dentist is throwing those bottles .	the dentist is throwing those bottle .
the cats loved this teacher .	the cats loved this teachers .
the guys found this boy .	the guys found this boys .
the plane had broken this car .	the plane had broken this cars .
the children have those boats .	the children have those boat .
the patient keeps those hats .	the patient keeps those hat .
the queen wo n't worry that woman .	the queen wo n't worry that women .
the patient had n't found these people .	the patient had n't found these person .
the doctor dropped that cup .	the doctor dropped that cups .
the person stole those boxes .	the person stole those box .
the king confused these ladies .	the king confused these lady .
the doctors are n't helping those teachers .	the doctors are n't helping those teacher .
the dishes broke this window .	the dishes broke this windows .
the child moves this ring .	the child moves this rings .
the people return to that school .	the people return to that schools .
the bird sees that hat .	the bird sees that hats .
the queen looks like that dog .	the queen looks like that dogs .
the guys could bring that book .	the guys could bring that books .
the ladies were n't talking about this fork .	the ladies were n't talking about this forks .
the king might see that picture .	the king might see that pictures .
the king made these books .	the king made these book .
the dog loves that lady .	the dog loves that ladies .
the queen lost those toys .	the queen lost those toy .
the adult has found those girls .	the adult has found those girl .
the adult will look like this horse .	the adult will look like this horses .
the shoe is n't breaking these beds .	the shoe is n't breaking these bed .
the dolls break these cups .	the dolls break these cup .
the dancer talks to this woman .	the dancer talks to this women .
the guys saw these pictures .	the guys saw these picture .
the driver may like this boat .	the driver may like this boats .
the child wo n't lose that door .	the child wo n't lose that doors .
the boys move these boats .	the boys move these boat .
the doctor kept those cars .	the doctor kept those car .
the woman is walking through that school .	the woman is walking through that schools .
the girl sounded like that rabbit .	the girl sounded like that rabbits .
the guys are n't bothering this woman .	the guys are n't bothering this women .
the dentist stole those dolls .	the dentist stole those doll .
the dentist must have these toys .	the dentist must have these toy .
the women have n't brought these toys .	the women have n't brought these toy .
the adult had held that picture .	the adult had held that pictures .
the children had remembered these bottles .	the children had remembered these bottle .
the bowls break this box .	the bowls break this boxes .
the lady talked about those crayons .	the lady talked about those crayon .
the ladies lost that lady .	the ladies lost that ladies .
the children looked like that doctor .	the children looked like that doctors .
the king is talking to this doctor .	the king is talking to this doctors .
the glasses have broken these hats .	the glasses have broken these hat .
the cat loves this mouse .	the cat loves this mice .
the man would break this boat .	the man would break this boats .
the children hear those birds .	the children hear those bird .
the patient had dropped those books .	the patient had dropped those book .
the chair breaks that bag .	the chair breaks that bags .
the spoons break those trucks .	the spoons break those truck .
the ladies buy that cup .	the ladies buy that cups .
the snakes had n't noticed those ladies .	the snakes had n't noticed those lady .
the doctors had seen these cars .	the doctors had seen these car .
the boys answer those doctors .	the boys answer those doctor .
the dancer is finding these candles .	the dancer is finding these candle .
the girl could move that bed .	the girl could move that beds .
the guys broke that ring .	the guys broke that rings .
the guys could n't sound like this person .	the guys could n't sound like this people .
the people must sound like these people .	the people must sound like these person .
the customer has that spoon .	the customer has that spoons .
the rings were breaking those boats .	the rings were breaking those boat .
the guys sell that doll .	the guys sell that dolls .
the customer found these people .	the customer found these person .
the men are n't throwing those cars .	the men are n't throwing those car .
the doctors thought about these bags .	the doctors thought about these bag .
the doctor is dropping those candles .	the doctor is dropping those candle .
the bed broke those bags .	the bed broke those bag .
the guys knew these snakes .	the guys knew these snake .
the snakes had n't noticed those boats .	the snakes had n't noticed those boat .
the people could bring this window .	the people could bring this windows .
the woman could n't listen to this person .	the woman could n't listen to this people .
the driver broke those windows .	the driver broke those window .
the dogs loved this candle .	the dogs loved this candles .
the driver can appreciate this child .	the driver can appreciate this children .
the ladies were bothering those people .	the ladies were bothering those person .
the woman is n't bringing these toys .	the woman is n't bringing these toy .
the teachers had n't heard those mice .	the teachers had n't heard those mouse .
the dentist could know this rabbit .	the dentist could know this rabbits .
the girls were n't moving that book .	the girls were n't moving that books .
the men work with that child .	the men work with that children .
the boys had n't held those beds .	the boys had n't held those bed .
the adult was breaking those doors .	the adult was breaking those door .
the women listen to these guys .	the women listen to these guy .
the guy drops this book .	the guy drops this books .
the lady works with those guys .	the lady works with those guy .
the women should talk about these glasses .	the women should talk about these glass .
the guy talks to these boys .	the guy talks to these boy .
the man heard these boys .	the man heard these boy .
the dentist has n't seen this hat .	the dentist has n't seen this hats .
the girls do n't move those beds .	the girls do n't move those bed .
the men are n't talking to these people .	the men are n't talking to these person .
the women lift this truck .	the women lift this trucks .
the ladies remembered this car .	the ladies remembered this cars .
the men would n't praise those people .	the men would n't praise those person .
the dancer could n't drop these forks .	the dancer could n't drop these fork .
the boats are n't breaking this ring .	the boats are n't breaking this rings .
the women found that lady .	the women found that ladies .
the dentist is n't breaking that door .	the dentist is n't breaking that doors .
the driver made those cups .	the driver made those cup .
the women knew these teachers .	the women knew these teacher .
the mirror had n't broken that book .	the mirror had n't broken that books .
the ladies are n't leaving those schools .	the ladies are n't leaving those school .
the lady was n't holding these shirts .	the lady was n't holding these shirt .
the people saw these girls .	the people saw these girl .
the girls did n't lose that plate .	the girls did n't lose that plates .
the customer must make that car .	the customer must make that cars .
the doctor can n't bring this button .	the doctor can n't bring this buttons .
the dentist moved that shirt .	the dentist moved that shirts .
the cats notice that bed .	the cats notice that beds .
the man cleaned those cars .	the man cleaned those car .
the children move these forks .	the children move these fork .
the woman should n't keep those plates .	the woman should n't keep those plate .
the man lost those glasses .	the man lost those glass .
the guy answered that teacher .	the guy answered that teachers .
the guy bothered these doctors .	the guy bothered these doctor .
the dancer had n't walked through these schools .	the dancer had n't walked through these school .
the doctor is losing that cup .	the doctor is losing that cups .
the snake breaks that boat .	the snake breaks that boats .
the patient looks like that teacher .	the patient looks like that teachers .
the driver did n't steal that door .	the driver did n't steal that doors .
the doctor had broken that bowl .	the doctor had broken that bowls .
the children did n't lift those beds .	the children did n't lift those bed .
the men were bringing that bowl .	the men were bringing that bowls .
the adult may like that person .	the adult may like that people .
the dancer has made these shirts .	the dancer has made these shirt .
the hamster wo n't see this book .	the hamster wo n't see this books .
the people will break that chair .	the people will break that chairs .
the teacher has bothered these teachers .	the teacher has bothered these teacher .
the queen was dropping these boxes .	the queen was dropping these box .
the dentist had heard this child .	the dentist had heard this children .
the door can n't break this crayon .	the door can n't break this crayons .
the man had those hats .	the man had those hat .
the women had gone to those schools .	the women had gone to those school .
the forks break that bottle .	the forks break that bottles .
the person has n't made this box .	the person has n't made this boxes .
the doctor was throwing this chair .	the doctor was throwing this chairs .
the man looks like this lady .	the man looks like this ladies .
the child walked through this room .	the child walked through this rooms .
the couch broke this shoe .	the couch broke this shoes .
the boys had cleaned those bags .	the boys had cleaned those bag .
the birds can break those glasses .	the birds can break those glass .
the girls must throw those shoes .	the girls must throw those shoe .
the bowls may break these boats .	the bowls may break these boat .
the king had n't cleaned those shoes .	the king had n't cleaned those shoe .
the girls have dropped that doll .	the girls have dropped that dolls .
the person is listening to those teachers .	the person is listening to those teacher .
the boat broke these pictures .	the boat broke these picture .
the boys love those dogs .	the boys love those dog .
the dancer would steal that bottle .	the dancer would steal that bottles .
the boy brought this car .	the boy brought this cars .
the patient sounded like these birds .	the patient sounded like these bird .
the boy was thinking about these birds .	the boy was thinking about these bird .
the patient could n't hate these cars .	the patient could n't hate these car .
the men worked with these ladies .	the men worked with these lady .
the driver had gone to that school .	the driver had gone to that schools .
the children should n't fix that bag .	the children should n't fix that bags .
the teacher has these plates .	the teacher has these plate .
the queen is talking about that woman .	the queen is talking about that women .
the woman had n't remembered this candle .	the woman had n't remembered this candles .
the queen scared those women .	the queen scared those woman .
the birds remembered these dolls .	the birds remembered these doll .
the people appreciate those boys .	the people appreciate those boy .
the person should n't remember this dish .	the person should n't remember this dishes .
the king had n't thought about this door .	the king had n't thought about this doors .
the customer is n't making this doll .	the customer is n't making this dolls .
the ladies look like that man .	the ladies look like that men .
the turtles could n't see these shoes .	the turtles could n't see these shoe .
the driver had thought about these cars .	the driver had thought about these car .
the customer noticed this bag .	the customer noticed this bags .
the patient thought about those teachers .	the patient thought about those teacher .
the men broke that picture .	the men broke that pictures .
the rabbits broke this candle .	the rabbits broke this candles .
the driver could buy those boats .	the driver could buy those boat .
the women forgot that dish .	the women forgot that dishes .
the dancer hears these people .	the dancer hears these person .
the guy saw that turtle .	the guy saw that turtles .
the dentist is making those spoons .	the dentist is making those spoon .
the boy talked about that book .	the boy talked about that books .
the patient might lift that plate .	the patient might lift that plates .
the ladies broke these forks .	the ladies broke these fork .
the children shook that button .	the children shook that buttons .
the child has n't answered this lady .	the child has n't answered this ladies .
the girl can n't look like that horse .	the girl can n't look like that horses .
the children brought those bags .	the children brought those bag .
the ladies were n't thinking about this doll .	the ladies were n't thinking about this dolls .
the men would throw that bowl .	the men would throw that bowls .
the adult sounds like those women .	the adult sounds like those woman .
the boys like these doors .	the boys like these door .
the adult had kept that book .	the adult had kept that books .
the men remember those crayons .	the men remember those crayon .
the cats broke that truck .	the cats broke that trucks .
the adult knows these women .	the adult knows these woman .
the man likes those bags .	the man likes those bag .
the guy is fixing those books .	the guy is fixing those book .
the bird breaks these cups .	the bird breaks these cup .
the customer dropped those hats .	the customer dropped those hat .
the ladies will care for those people .	the ladies will care for those person .
the person can n't hear these horses .	the person can n't hear these horse .
the dentist kept this dish .	the dentist kept this dishes .
the guy thought about this box .	the guy thought about this boxes .
the horse was n't thinking about those boxes .	the horse was n't thinking about those box .
the girls have talked to these teachers .	the girls have talked to these teacher .
the men clean these toys .	the men clean these toy .
the dancer kept these trucks .	the dancer kept these truck .
the rabbits hate that dog .	the rabbits hate that dogs .
the driver sounds like this horse .	the driver sounds like this horses .
the children talk to this lady .	the children talk to this ladies .
the lady had dropped those cars .	the lady had dropped those car .
the woman could hear those children .	the woman could hear those child .
the rabbit loves these teachers .	the rabbit loves these teacher .
the rug had broken that bottle .	the rug had broken that bottles .
the guys worked with that guy .	the guys worked with that guys .
the dancer is n't breaking these beds .	the dancer is n't breaking these bed .
the dentist is keeping that hat .	the dentist is keeping that hats .
the people lost that doll .	the people lost that dolls .
the women talked to that child .	the women talked to that children .
the guys had n't talked to this child .	the guys had n't talked to this children .
the ship might break these beds .	the ship might break these bed .
the teacher leaves those schools .	the teacher leaves those school .
the child does n't forget these hats .	the child does n't forget these hat .
the doctor should take those forks .	the doctor should take those fork .
the lady makes these pictures .	the lady makes these picture .
the men had dropped these toys .	the men had dropped these toy .
the doctors visited those guys .	the doctors visited those guy .
the rabbits love that bag .	the rabbits love that bags .
the customer remembered these doors .	the customer remembered these door .
the men could n't sell that window .	the men could n't sell that windows .
the girl may make these toys .	the girl may make these toy .
the man helped those women .	the man helped those woman .
the guy talks about that guy .	the guy talks about that guys .
the men fixed that car .	the men fixed that cars .
the children are n't finding this chair .	the children are n't finding this chairs .
the patient should praise those people .	the patient should praise those person .
the lady had lost that toy .	the lady had lost that toys .
the adult taught that girl .	the adult taught that girls .
the dancer can remember those cups .	the dancer can remember those cup .
the ladies talk about this boy .	the ladies talk about this boys .
the girls hear these children .	the girls hear these child .
the cat had noticed these dolls .	the cat had noticed these doll .
the bird has n't noticed these girls .	the bird has n't noticed these girl .
the turtle noticed that dish .	the turtle noticed that dishes .
the boys visit those teachers .	the boys visit those teacher .
the girls bring this shoe .	the girls bring this shoes .
the adult kept that shirt .	the adult kept that shirts .
the teacher should n't bring this shirt .	the teacher should n't bring this shirts .
the women could make those plates .	the women could make those plate .
the cats had n't remembered these cars .	the cats had n't remembered these car .
the child works with these guys .	the child works with these guy .
the woman would worry that man .	the woman would worry that men .
the crayons would n't break those shoes .	the crayons would n't break those shoe .
the women did n't look like this child .	the women did n't look like this children .
the guy forgot those guys .	the guy forgot those guy .
the boy may talk about these hats .	the boy may talk about these hat .
the men understand those girls .	the men understand those girl .
the customer hears that turtle .	the customer hears that turtles .
the guys might bother those ladies .	the guys might bother those lady .
the children must notice those people .	the children must notice those person .
the people had n't brought that window .	the people had n't brought that windows .
the box broke that boat .	the box broke that boats .
the guys are n't holding that crayon .	the guys are n't holding that crayons .
the child had those bowls .	the child had those bowl .
the ladies are n't thinking about this fork .	the ladies are n't thinking about this forks .
the man could hate that spoon .	the man could hate that spoons .
the dancer keeps that boat .	the dancer keeps that boats .
the boy has n't visited this man .	the boy has n't visited this men .
the man has n't thought about that dish .	the man has n't thought about that dishes .
the person will have those hats .	the person will have those hat .
the teacher understands that man .	the teacher understands that men .
the men loved these women .	the men loved these woman .
the person can n't lift that doll .	the person can n't lift that dolls .
the girl had n't thrown these glasses .	the girl had n't thrown these glass .
the shoes break those boxes .	the shoes break those box .
the teacher throws those chairs .	the teacher throws those chair .
the lady made this dish .	the lady made this dishes .
the doctors know these snakes .	the doctors know these snake .
the teacher can n't know this boy .	the teacher can n't know this boys .
the teachers had those cars .	the teachers had those car .
the teachers wo n't take that ring .	the teachers wo n't take that rings .
the bags break these beds .	the bags break these bed .
the boy could throw these chairs .	the boy could throw these chair .
the guy likes this button .	the guy likes this buttons .
the dentist scared those girls .	the dentist scared those girl .
the teachers bother this guy .	the teachers bother this guys .
the doctor might lose these books .	the doctor might lose these book .
the person found this truck .	the person found this trucks .
the guys may praise that man .	the guys may praise that men .
the teachers love this hat .	the teachers love this hats .
the books break this box .	the books break this boxes .
the guys had made these trucks .	the guys had made these truck .
the bottles are breaking that car .	the bottles are breaking that cars .
the ladies must steal these rings .	the ladies must steal these ring .
the children had n't talked about these doctors .	the children had n't talked about these doctor .
the dentist has fixed those bottles .	the dentist has fixed those bottle .
the dancer had n't taught this boy .	the dancer had n't taught this boys .
the teacher was moving this button .	the teacher was moving this buttons .
the doors do n't break these trucks .	the doors do n't break these truck .
the turtles loved that toy .	the turtles loved that toys .
the dancer should n't sound like this man .	the dancer should n't sound like this men .
the boy has n't thought about that bowl .	the boy has n't thought about that bowls .
the doctor was n't listening to this person .	the doctor was n't listening to this people .
the ladies have found this man .	the ladies have found this men .
the ladies had talked about these bowls .	the ladies had talked about these bowl .
the women were talking about those doors .	the women were talking about those door .
the person answered those girls .	the person answered those girl .
the boys may love that rabbit .	the boys may love that rabbits .
the mouse had n't thought about these forks .	the mouse had n't thought about these fork .
the dancer talked about these windows .	the dancer talked about these window .
the teacher was n't working with this doctor .	the teacher was n't working with this doctors .
the teachers might leave those schools .	the teachers might leave those school .
the person wo n't shake these buttons .	the person wo n't shake these button .
the lady looked like those snakes .	the lady looked like those snake .
the cats forgot those books .	the cats forgot those book .
the lady has n't scared these people .	the lady has n't scared these person .
the teachers taught these girls .	the teachers taught these girl .
the girls talked to those doctors .	the girls talked to those doctor .
the dentist knows these people .	the dentist knows these person .
the hamster may remember these cars .	the hamster may remember these car .
the dancer is n't cleaning this shirt .	the dancer is n't cleaning this shirts .
the girl does n't hear that lady .	the girl does n't hear that ladies .
the ladies might keep these boxes .	the ladies might keep these box .
the man threw those cars .	the man threw those car .
the queen could throw this toy .	the queen could throw this toys .
the dentist dropped this picture .	the dentist dropped this pictures .
the patient does n't go to that room .	the patient does n't go to that rooms .
the dentist sounded like those men .	the dentist sounded like those man .
the girl worried those guys .	the girl worried those guy .
the doctor sounded like those women .	the doctor sounded like those woman .
the women looked like those turtles .	the women looked like those turtle .
the customer thought about these rabbits .	the customer thought about these rabbit .
the queen found those cars .	the queen found those car .
the dentist could see that rabbit .	the dentist could see that rabbits .
the driver makes those cups .	the driver makes those cup .
the doctors should n't worry those guys .	the doctors should n't worry those guy .
the dogs notice this book .	the dogs notice this books .
the car may break this truck .	the car may break this trucks .
the bag had broken these glasses .	the bag had broken these glass .
the dentist was n't moving those crayons .	the dentist was n't moving those crayon .
the boys are helping that child .	the boys are helping that children .
the children have helped this woman .	the children have helped this women .
the girl may think about this ring .	the girl may think about this rings .
the adult had bought that hat .	the adult had bought that hats .
the boy is buying this truck .	the boy is buying this trucks .
the ladies had thought about that book .	the ladies had thought about that books .
the women scared that teacher .	the women scared that teachers .
the girls have that plate .	the girls have that plates .
the guys look like that woman .	the guys look like that women .
the turtle noticed this girl .	the turtle noticed this girls .
the customer was talking about that cat .	the customer was talking about that cats .
the patient moves this dish .	the patient moves this dishes .
the teachers lost those men .	the teachers lost those man .
the girls had n't noticed this teacher .	the girls had n't noticed this teachers .
the man was thinking about these boys .	the man was thinking about these boy .
the man has kept those forks .	the man has kept those fork .
the people sound like this person .	the people sound like this people .
the dentist loves that woman .	the dentist loves that women .
the man has thrown those boats .	the man has thrown those boat .
the king talks about these teachers .	the king talks about these teacher .
the rabbits have broken this cup .	the rabbits have broken this cups .
the boys find this spoon .	the boys find this spoons .
the doctors talked about this cup .	the doctors talked about this cups .
the child should n't remember that woman .	the child should n't remember that women .
the book breaks that fork .	the book breaks that forks .
the cats have noticed that rabbit .	the cats have noticed that rabbits .
the girls worked with these guys .	the girls worked with these guy .
the child would n't buy those shirts .	the child would n't buy those shirt .
the driver lost this lady .	the driver lost this ladies .
the cat breaks this box .	the cat breaks this boxes .
the lady had bothered those people .	the lady had bothered those person .
the guys can take that hat .	the guys can take that hats .
the boy does n't talk about these hats .	the boy does n't talk about these hat .
the fork had n't broken this car .	the fork had n't broken this cars .
the toy breaks that candle .	the toy breaks that candles .
the pictures should n't break that car .	the pictures should n't break that cars .
the driver has n't held those hats .	the driver has n't held those hat .
the men have moved this shoe .	the men have moved this shoes .
the boy is visiting these ladies .	the boy is visiting these lady .
the teacher brought this dish .	the teacher brought this dishes .
the dancer had n't talked to this child .	the dancer had n't talked to this children .
the driver is n't thinking about this box .	the driver is n't thinking about this boxes .
the person broke those beds .	the person broke those bed .
the doctors broke those toys .	the doctors broke those toy .
the girl had heard that guy .	the girl had heard that guys .
the rabbit forgot those trucks .	the rabbit forgot those truck .
the queen has n't worried this lady .	the queen has n't worried this ladies .
the doctor is n't holding those windows .	the doctor is n't holding those window .
the ladies had kept that car .	the ladies had kept that cars .
the woman has kept those dolls .	the woman has kept those doll .
the rabbits have n't noticed these horses .	the rabbits have n't noticed these horse .
the customer looks like this guy .	the customer looks like this guys .
the couch broke this ring .	the couch broke this rings .
the teachers can n't like this boy .	the teachers can n't like this boys .
the customer had n't taught this boy .	the customer had n't taught this boys .
the guy lost those women .	the guy lost those woman .
the children confused these boys .	the children confused these boy .
the children had taken these crayons .	the children had taken these crayon .
the car broke that book .	the car broke that books .
the women were throwing this button .	the women were throwing this buttons .
the customer talked about these boxes .	the customer talked about these box .
the doctors lift this cup .	the doctors lift this cups .
the man bought that boat .	the man bought that boats .
the cup would break these cars .	the cup would break these car .
the patient was n't talking to those ladies .	the patient was n't talking to those lady .
the driver was n't helping these teachers .	the driver was n't helping these teacher .
the king can n't sell these cups .	the king can n't sell these cup .
the teacher could lift those chairs .	the teacher could lift those chair .
the woman helps those women .	the woman helps those woman .
the person is n't making these books .	the person is n't making these book .
the bird was n't breaking those windows .	the bird was n't breaking those window .
the women were finding those bowls .	the women were finding those bowl .
the dolls broke this hat .	the dolls broke this hats .
the guys could n't find those crayons .	the guys could n't find those crayon .
the men should n't return to that room .	the men should n't return to that rooms .
the queen was n't keeping these hats .	the queen was n't keeping these hat .
the person went to those schools .	the person went to those school .
the mouse liked that ring .	the mouse liked that rings .
the turtle did n't like this car .	the turtle did n't like this cars .
the man thought about these cars .	the man thought about these car .
the boy takes this box .	the boy takes this boxes .
the girls had n't heard this dog .	the girls had n't heard this dogs .
the boy can bring this hat .	the boy can bring this hats .
the queen sounds like those guys .	the queen sounds like those guy .
the dancer found that bottle .	the dancer found that bottles .
the mouse thought about those boxes .	the mouse thought about those box .
the girl had n't passed those rooms .	the girl had n't passed those room .
the dog liked these bowls .	the dog liked these bowl .
the guys were n't dropping this chair .	the guys were n't dropping this chairs .
the doctor is talking about those mice .	the doctor is talking about those mouse .
the child loved those rings .	the child loved those ring .
the man has n't bought these bowls .	the man has n't bought these bowl .
the man had scared these guys .	the man had scared these guy .
the adult has n't passed that school .	the adult has n't passed that schools .
the lady had these doors .	the lady had these door .
the people see these mice .	the people see these mouse .
the boys heard that rabbit .	the boys heard that rabbits .
the men may like that car .	the men may like that cars .
the plate has broken these chairs .	the plate has broken these chair .
the driver had n't thrown these bottles .	the driver had n't thrown these bottle .
the boys found these shirts .	the boys found these shirt .
the men brought this shirt .	the men brought this shirts .
the woman makes those dolls .	the woman makes those doll .
the king moved those candles .	the king moved those candle .
the patient had those glasses .	the patient had those glass .
the people could n't leave those rooms .	the people could n't leave those room .
the lady can sound like those doctors .	the lady can sound like those doctor .
the women would n't look like those men .	the women would n't look like those man .
the women answer those guys .	the women answer those guy .
the doctors can find these books .	the doctors can find these book .
the person fixed those hats .	the person fixed those hat .
the women are bothering this boy .	the women are bothering this boys .
the boy found these women .	the boy found these woman .
the driver has that button .	the driver has that buttons .
the patient broke these beds .	the patient broke these bed .
the dancer was dropping this shoe .	the dancer was dropping this shoes .
the driver had n't talked about that button .	the driver had n't talked about that buttons .
the girl would n't steal those spoons .	the girl would n't steal those spoon .
the window is breaking these books .	the window is breaking these book .
the men found those cars .	the men found those car .
the teachers could worry these teachers .	the teachers could worry these teacher .
the doctors could n't hate this man .	the doctors could n't hate this men .
the guy shook those dolls .	the guy shook those doll .
the child did n't sound like these horses .	the child did n't sound like these horse .
the doctor understands those women .	the doctor understands those woman .
the teachers fixed that candle .	the teachers fixed that candles .
the adult has n't remembered those women .	the adult has n't remembered those woman .
the doctors should shake those glasses .	the doctors should shake those glass .
the doctor fixed these shirts .	the doctor fixed these shirt .
the doctors would n't look like that rabbit .	the doctors would n't look like that rabbits .
the queen makes this book .	the queen makes this books .
the men love those shirts .	the men love those shirt .
the girls answered those doctors .	the girls answered those doctor .
the girl makes these cups .	the girl makes these cup .
the guys sounded like that boy .	the guys sounded like that boys .
the ladies left these schools .	the ladies left these school .
the guys were n't taking these pictures .	the guys were n't taking these picture .
the boy made those hats .	the boy made those hat .
the guys bought those plates .	the guys bought those plate .
the customer did n't understand those doctors .	the customer did n't understand those doctor .
the bird has thought about that snake .	the bird has thought about that snakes .
the doctors were n't thinking about this button .	the doctors were n't thinking about this buttons .
the patient likes this shoe .	the patient likes this shoes .
the man can see this teacher .	the man can see this teachers .
the girls liked these men .	the girls liked these man .
the guys worry these guys .	the guys worry these guy .
the person might help that doctor .	the person might help that doctors .
the patient has n't heard this guy .	the patient has n't heard this guys .
the people wo n't help this person .	the people wo n't help this people .
the girl had moved those boxes .	the girl had moved those box .
the women are n't thinking about this rabbit .	the women are n't thinking about this rabbits .
the boys shake those candles .	the boys shake those candle .
the teachers should n't teach these men .	the teachers should n't teach these man .
the people would n't pass these schools .	the people would n't pass these school .
the customer holds this hat .	the customer holds this hats .
the boat breaks those crayons .	the boat breaks those crayon .
the doctor may forget these people .	the doctor may forget these person .
the mice could n't love these books .	the mice could n't love these book .
the girls could know that boy .	the girls could know that boys .
the women liked these cars .	the women liked these car .
the people will bother these doctors .	the people will bother these doctor .
the guy walked through those rooms .	the guy walked through those room .
the child can n't appreciate those men .	the child can n't appreciate those man .
the driver sounds like that horse .	the driver sounds like that horses .
the bed breaks that bottle .	the bed breaks that bottles .
the girl was shaking those bags .	the girl was shaking those bag .
the adult could n't praise that child .	the adult could n't praise that children .
the doctor will hold that box .	the doctor will hold that boxes .
the queen scared those guys .	the queen scared those guy .
the king could think about this bag .	the king could think about this bags .
the customer looked like these doctors .	the customer looked like these doctor .
the bed is n't breaking those dishes .	the bed is n't breaking those dish .
the lady moves those windows .	the lady moves those window .
the driver holds this dish .	the driver holds this dishes .
the ladies cleaned that chair .	the ladies cleaned that chairs .
the children have found those dolls .	the children have found those doll .
the boys have made those toys .	the boys have made those toy .
the box breaks those trucks .	the box breaks those truck .
the boys fix this truck .	the boys fix this trucks .
the person is n't keeping those spoons .	the person is n't keeping those spoon .
the boy was n't running around those rooms .	the boy was n't running around those room .
the child was teaching this person .	the child was teaching this people .
the men were fixing these shirts .	the men were fixing these shirt .
the boys made that plate .	the boys made that plates .
the child has talked about those bowls .	the child has talked about those bowl .
the patient was n't talking to this teacher .	the patient was n't talking to this teachers .
the cats have thought about this box .	the cats have thought about this boxes .
the turtles can break these windows .	the turtles can break these window .
the birds do n't forget this boy .	the birds do n't forget this boys .
the men should know this woman .	the men should know this women .
the glasses are breaking this box .	the glasses are breaking this boxes .
the adult stole these dolls .	the adult stole these doll .
the woman threw these rings .	the woman threw these ring .
the women drop this button .	the women drop this buttons .
the lady has n't talked about those chairs .	the lady has n't talked about those chair .
the cats liked this bag .	the cats liked this bags .
the dentist was n't holding those bags .	the dentist was n't holding those bag .
the teacher is n't shaking these pictures .	the teacher is n't shaking these picture .
the girl shakes those doors .	the girl shakes those door .
the cats are breaking this ring .	the cats are breaking this rings .
the rocket breaks those shirts .	the rocket breaks those shirt .
the person should forget this truck .	the person should forget this trucks .
the shoe breaks this dish .	the shoe breaks this dishes .
the guys have moved that truck .	the guys have moved that trucks .
the girls were n't driving to those rooms .	the girls were n't driving to those room .
the lady forgot this car .	the lady forgot this cars .
the boy has n't bought this picture .	the boy has n't bought this pictures .
the spoon broke this bottle .	the spoon broke this bottles .
the dog does n't remember those plates .	the dog does n't remember those plate .
the customer likes these hats .	the customer likes these hat .
the men should n't break that cup .	the men should n't break that cups .
the doctors must appreciate these children .	the doctors must appreciate these child .
the woman liked those birds .	the woman liked those bird .
the ladies had seen this spoon .	the ladies had seen this spoons .
the teachers throw these books .	the teachers throw these book .
the teacher visited those ladies .	the teacher visited those lady .
the men talked to this guy .	the men talked to this guys .
the turtles remembered those beds .	the turtles remembered those bed .
the king keeps those books .	the king keeps those book .
the queen thought about these candles .	the queen thought about these candle .
the girl drove to those schools .	the girl drove to those school .
the horses could n't think about this doctor .	the horses could n't think about this doctors .
the doctors had kept those books .	the doctors had kept those book .
the guys were breaking those bags .	the guys were breaking those bag .
the doctors hold that cup .	the doctors hold that cups .
the turtle may remember that bag .	the turtle may remember that bags .
the man was n't walking through those schools .	the man was n't walking through those school .
the rabbits remembered these forks .	the rabbits remembered these fork .
the cats would n't see these doctors .	the cats would n't see these doctor .
the couch breaks those bottles .	the couch breaks those bottle .
the child forgot those boxes .	the child forgot those box .
the snake has n't thought about this boat .	the snake has n't thought about this boats .
the child worked with this man .	the child worked with this men .
the lady breaks these cars .	the lady breaks these car .
the woman was dropping this bottle .	the woman was dropping this bottles .
the girls could n't go to that school .	the girls could n't go to that schools .
the girls understand that guy .	the girls understand that guys .
the shoes can break these boats .	the shoes can break these boat .
the patient keeps that car .	the patient keeps that cars .
the king makes these plates .	the king makes these plate .
the hamster sees this snake .	the hamster sees this snakes .
the dog should notice those bottles .	the dog should notice those bottle .
the women held this hat .	the women held this hats .
the people can drive to this school .	the people can drive to this schools .
the dentist might notice this ring .	the dentist might notice this rings .
the dentist would n't see those cats .	the dentist would n't see those cat .
the teachers drove to this school .	the teachers drove to this schools .
the person scared these children .	the person scared these child .
the doctor is n't throwing that bag .	the doctor is n't throwing that bags .
the boy is n't listening to those doctors .	the boy is n't listening to those doctor .
the children talk about this bowl .	the children talk about this bowls .
the people praise that man .	the people praise that men .
the man was walking through these schools .	the man was walking through these school .
the hats were n't breaking those crayons .	the hats were n't breaking those crayon .
the boy might talk about this box .	the boy might talk about this boxes .
the guys are making those shirts .	the guys are making those shirt .
the person is talking about those chairs .	the person is talking about those chair .
the boy made this picture .	the boy made this pictures .
the queen does n't bring those bags .	the queen does n't bring those bag .
the teachers would n't buy that fork .	the teachers would n't buy that forks .
the queen would buy this cup .	the queen would buy this cups .
the chair is n't breaking this truck .	the chair is n't breaking this trucks .
the adult should help this doctor .	the adult should help this doctors .
the dentist kept these cars .	the dentist kept these car .
the man was n't taking that boat .	the man was n't taking that boats .
the rings break these rings .	the rings break these ring .
the toys break these bowls .	the toys break these bowl .
the child knows that horse .	the child knows that horses .
the patient had worked with these people .	the patient had worked with these person .
the man can n't worry these teachers .	the man can n't worry these teacher .
the dancer wo n't talk about this girl .	the dancer wo n't talk about this girls .
the guy was working with this person .	the guy was working with this people .
the dancer was n't cleaning these boats .	the dancer was n't cleaning these boat .
the lady must like those people .	the lady must like those person .
the dentist must appreciate this child .	the dentist must appreciate this children .
the lady talks about that horse .	the lady talks about that horses .
the doctors have n't dropped that button .	the doctors have n't dropped that buttons .
the person has n't broken that car .	the person has n't broken that cars .
the person saw this shirt .	the person saw this shirts .
the woman remembered that ring .	the woman remembered that rings .
the teachers must praise that guy .	the teachers must praise that guys .
the teachers had that candle .	the teachers had that candles .
the rocket could n't break that spoon .	the rocket could n't break that spoons .
the queen would n't see this person .	the queen would n't see this people .
the child dropped this button .	the child dropped this buttons .
the fork was breaking those candles .	the fork was breaking those candle .
the ladies clean those beds .	the ladies clean those bed .
the patient was finding this shoe .	the patient was finding this shoes .
the forks broke that shirt .	the forks broke that shirts .
the adult is thinking about that woman .	the adult is thinking about that women .
the teachers heard that bird .	the teachers heard that birds .
the horse was breaking those dishes .	the horse was breaking those dish .
the teacher would talk to these men .	the teacher would talk to these man .
the child could scare this boy .	the child could scare this boys .
the turtles hate those dolls .	the turtles hate those doll .
the adult helped these guys .	the adult helped these guy .
the queen breaks this candle .	the queen breaks this candles .
the boy drove to this room .	the boy drove to this rooms .
the boys have n't dropped these buttons .	the boys have n't dropped these button .
the child lost those spoons .	the child lost those spoon .
the crayon had broken that car .	the crayon had broken that cars .
the boys were n't working with that girl .	the boys were n't working with that girls .
the children go to these schools .	the children go to these school .
the snake had n't noticed this candle .	the snake had n't noticed this candles .
the teachers keep those books .	the teachers keep those book .
the customer was n't throwing those books .	the customer was n't throwing those book .
the doctors talk about this fork .	the doctors talk about this forks .
the guys are n't listening to that boy .	the guys are n't listening to that boys .
the adult may buy this picture .	the adult may buy this pictures .
the boy is n't teaching these men .	the boy is n't teaching these man .
the cup wo n't break these spoons .	the cup wo n't break these spoon .
the rug had broken this fork .	the rug had broken this forks .
the girl understands those women .	the girl understands those woman .
the driver can n't find this shoe .	the driver can n't find this shoes .
the men go to those schools .	the men go to those school .
the boy brought this toy .	the boy brought this toys .
the doctor could visit those teachers .	the doctor could visit those teacher .
the guy should lift these chairs .	the guy should lift these chair .
the woman moves this candle .	the woman moves this candles .
the king was n't finding that toy .	the king was n't finding that toys .
the cat has remembered those guys .	the cat has remembered those guy .
the horses break this bowl .	the horses break this bowls .
the man worried that guy .	the man worried that guys .
the boys listen to that woman .	the boys listen to that women .
the doctor is losing those spoons .	the doctor is losing those spoon .
the plate has n't broken that button .	the plate has n't broken that buttons .
the lady had n't heard those people .	the lady had n't heard those person .
the people had n't cleaned this car .	the people had n't cleaned this cars .
the patient has thrown these spoons .	the patient has thrown these spoon .
the customer had talked about those men .	the customer had talked about those man .
the girl does n't see those girls .	the girl does n't see those girl .
the doctors liked these bags .	the doctors liked these bag .
the men heard those doctors .	the men heard those doctor .
the ladies kept this button .	the ladies kept this buttons .
the cars were breaking that dish .	the cars were breaking that dishes .
the dolls were n't breaking this candle .	the dolls were n't breaking this candles .
the customer saw those dogs .	the customer saw those dog .
the doctors were n't shaking those bags .	the doctors were n't shaking those bag .
the teachers are n't breaking these cups .	the teachers are n't breaking these cup .
the doctor is n't dropping that shirt .	the doctor is n't dropping that shirts .
the birds notice these snakes .	the birds notice these snake .
the men talked about that chair .	the men talked about that chairs .
the doctors noticed that window .	the doctors noticed that windows .
the birds have thought about that ring .	the birds have thought about that rings .
the dancer noticed that guy .	the dancer noticed that guys .
the girls were driving to those rooms .	the girls were driving to those room .
the dancer would see those cars .	the dancer would see those car .
the girls had thrown those rings .	the girls had thrown those ring .
the ladies have fixed this box .	the ladies have fixed this boxes .
the boys will shake this spoon .	the boys will shake this spoons .
the teachers taught this person .	the teachers taught this people .
the plane breaks that box .	the plane breaks that boxes .
the cup is breaking these dishes .	the cup is breaking these dish .
the dentist will answer those guys .	the dentist will answer those guy .
the girls were listening to this man .	the girls were listening to this men .
the guys talked about this boy .	the guys talked about this boys .
the teacher broke these chairs .	the teacher broke these chair .
the king passed that school .	the king passed that schools .
the boy breaks this plate .	the boy breaks this plates .
the cars have n't broken those beds .	the cars have n't broken those bed .
the cup broke this boat .	the cup broke this boats .
the girls are n't throwing this bottle .	the girls are n't throwing this bottles .
the dentist has n't lost that man .	the dentist has n't lost that men .
the boy was listening to that doctor .	the boy was listening to that doctors .
the hamster broke these windows .	the hamster broke these window .
the horse could n't notice those birds .	the horse could n't notice those bird .
the teacher has worked with those doctors .	the teacher has worked with those doctor .
the queen made that doll .	the queen made that dolls .
the queen is n't helping this guy .	the queen is n't helping this guys .
the girl was n't moving these pictures .	the girl was n't moving these picture .
the girl was n't teaching that girl .	the girl was n't teaching that girls .
the king stole these boats .	the king stole these boat .
the teachers did n't fix these hats .	the teachers did n't fix these hat .
the rings break this toy .	the rings break this toys .
the driver wo n't forget that ring .	the driver wo n't forget that rings .
the crayon had n't broken these pictures .	the crayon had n't broken these picture .
the men lose those shirts .	the men lose those shirt .
the customer lost those guys .	the customer lost those guy .
