confused doctors stretch quietly .	stretch quietly doctors confused .
upset teachers lose quietly .	teachers upset lose quietly .
tall children lose carefully .	tall lose children carefully .
clever teachers scream slowly .	teachers clever scream slowly .
young people smile quickly .	people smile young quickly .
happy teachers practice carefully .	carefully teachers practice happy .
hungry teachers cough perfectly .	perfectly hungry cough teachers .
hungry children yell perfectly .	yell perfectly hungry children .
upset teachers sneeze carefully .	carefully teachers upset sneeze .
confused doctors win slowly .	slowly confused win doctors .
smart teachers cry quietly .	cry teachers quietly smart .
friendly people cough perfectly .	cough perfectly friendly people .
boring teachers win quietly .	win quietly teachers boring .
strong people lose quickly .	quickly people strong lose .
lucky children win slowly .	win lucky slowly children .
healthy children practice slowly .	children healthy slowly practice .
kind children laugh quickly .	kind laugh children quickly .
clever people cough quietly .	people quietly clever cough .
hungry people smile slowly .	slowly smile hungry people .
upset teachers win quickly .	quickly teachers upset win .
clever doctors whisper perfectly .	clever whisper doctors perfectly .
smart children scream perfectly .	smart perfectly scream children .
curious people talk perfectly .	curious talk perfectly people .
careful children paint quickly .	children careful quickly paint .
bored doctors exercise perfectly .	doctors bored exercise perfectly .
boring people wave quickly .	people wave quickly boring .
curious children sing slowly .	children slowly sing curious .
important people laugh perfectly .	perfectly people important laugh .
upset children stretch quickly .	children upset stretch quickly .
careful children sing quietly .	children quietly sing careful .
clever doctors wave perfectly .	doctors clever wave perfectly .
friendly children sing carefully .	carefully sing children friendly .
confused teachers sing slowly .	teachers confused sing slowly .
quiet children yell perfectly .	yell quiet perfectly children .
surprised doctors win carefully .	win carefully doctors surprised .
bored doctors whisper slowly .	slowly doctors bored whisper .
kind children win quickly .	kind quickly children win .
curious people exercise quietly .	quietly curious exercise people .
important teachers lie carefully .	carefully lie teachers important .
young people sneeze perfectly .	people sneeze perfectly young .
kind teachers cough carefully .	kind cough teachers carefully .
smart children whisper slowly .	whisper slowly children smart .
important doctors cry quietly .	cry doctors quietly important .
quiet doctors paint quietly .	quiet paint quietly doctors .
excited children smile quickly .	smile quickly children excited .
sleepy children exercise quickly .	quickly sleepy exercise children .
kind doctors yell perfectly .	doctors perfectly kind yell .
young teachers practice slowly .	practice teachers young slowly .
young doctors wave quickly .	doctors wave quickly young .
bored people laugh slowly .	bored slowly laugh people .
important children scream quickly .	quickly children important scream .
tall people whisper carefully .	tall carefully people whisper .
sleepy people practice slowly .	people slowly sleepy practice .
healthy teachers win quickly .	teachers healthy win quickly .
helpful children smile quietly .	children helpful smile quietly .
hungry people exercise quickly .	people exercise quickly hungry .
curious people stretch carefully .	curious stretch people carefully .
gentle people sing slowly .	people sing slowly gentle .
kind doctors lose perfectly .	doctors lose perfectly kind .
smart doctors read quietly .	smart read quietly doctors .
bored teachers practice perfectly .	perfectly practice bored teachers .
confused people read quietly .	people read confused quietly .
friendly children sing carefully .	children sing friendly carefully .
happy doctors smile quickly .	smile happy doctors quickly .
strong people cry perfectly .	strong perfectly cry people .
sleepy children sneeze perfectly .	sleepy sneeze children perfectly .
curious children paint carefully .	paint children curious carefully .
kind children cry carefully .	children carefully cry kind .
tired doctors stretch perfectly .	stretch tired doctors perfectly .
upset doctors win carefully .	win upset doctors carefully .
careful people wave slowly .	wave careful slowly people .
friendly teachers yell carefully .	yell carefully teachers friendly .
wrong children whisper quickly .	children wrong quickly whisper .
angry people exercise carefully .	carefully people exercise angry .
quiet people cough carefully .	people cough quiet carefully .
clever teachers exercise quickly .	exercise teachers clever quickly .
busy teachers stretch carefully .	carefully teachers stretch busy .
surprised doctors sing carefully .	carefully sing doctors surprised .
young teachers exercise quietly .	teachers young exercise quietly .
helpful doctors smile perfectly .	perfectly helpful smile doctors .
kind teachers stretch carefully .	teachers kind carefully stretch .
young people win quietly .	people win young quietly .
curious children scream quietly .	children quietly curious scream .
boring doctors smile quietly .	quietly boring smile doctors .
happy people whisper slowly .	people slowly whisper happy .
nice doctors scream quickly .	doctors nice quickly scream .
kind doctors laugh quickly .	laugh quickly kind doctors .
wrong teachers read perfectly .	read teachers wrong perfectly .
strong teachers practice quickly .	practice strong quickly teachers .
tired children talk quickly .	talk tired quickly children .
upset children read perfectly .	read children perfectly upset .
young people cry quietly .	people cry young quietly .
lucky children cough quietly .	children cough quietly lucky .
excited people wave quietly .	quietly people wave excited .
healthy children exercise quietly .	quietly exercise healthy children .
tall children lose slowly .	lose children slowly tall .
busy children sneeze carefully .	sneeze busy children carefully .
helpful teachers win perfectly .	perfectly teachers win helpful .
strong people scream quietly .	people quietly scream strong .
nice doctors cough carefully .	nice carefully cough doctors .
smart doctors lose quietly .	doctors smart lose quietly .
sleepy people cough quickly .	people sleepy cough quickly .
kind children whisper quickly .	kind quickly whisper children .
friendly people exercise carefully .	exercise carefully friendly people .
clever people exercise perfectly .	clever exercise people perfectly .
surprised teachers sneeze quietly .	surprised quietly teachers sneeze .
young people win perfectly .	win young people perfectly .
tired teachers lie slowly .	slowly lie teachers tired .
important people whisper perfectly .	whisper people perfectly important .
boring people paint quickly .	quickly people paint boring .
busy doctors laugh slowly .	laugh slowly doctors busy .
surprised children talk quickly .	quickly talk children surprised .
careful people wave carefully .	people carefully careful wave .
tall doctors laugh carefully .	doctors carefully laugh tall .
wrong doctors talk quietly .	wrong talk quietly doctors .
lucky children exercise carefully .	exercise lucky carefully children .
lucky doctors cry carefully .	lucky cry carefully doctors .
tall teachers cough slowly .	tall slowly cough teachers .
smart people read carefully .	carefully people smart read .
upset people wave carefully .	upset wave carefully people .
surprised teachers whisper carefully .	surprised carefully teachers whisper .
busy people lose quietly .	quietly busy lose people .
upset teachers read slowly .	slowly read upset teachers .
clever people lie perfectly .	perfectly people lie clever .
kind doctors stretch slowly .	doctors slowly stretch kind .
happy people lie perfectly .	people lie perfectly happy .
clever children stretch carefully .	stretch carefully clever children .
gentle children read perfectly .	gentle perfectly read children .
tall people lose carefully .	people lose tall carefully .
upset doctors stretch quietly .	doctors stretch quietly upset .
wrong doctors talk quietly .	wrong quietly doctors talk .
upset teachers sing quickly .	sing teachers quickly upset .
excited people sing quickly .	people quickly sing excited .
smart people lose quietly .	lose smart people quietly .
young children lose perfectly .	children young perfectly lose .
friendly children win carefully .	children win friendly carefully .
strong doctors exercise slowly .	exercise strong slowly doctors .
quiet children win slowly .	quiet win children slowly .
healthy people whisper quietly .	whisper people quietly healthy .
confused children stretch quietly .	stretch quietly confused children .
busy doctors wave quickly .	wave quickly busy doctors .
healthy teachers read carefully .	carefully healthy read teachers .
smart children smile quickly .	smile children quickly smart .
healthy teachers exercise quietly .	quietly exercise healthy teachers .
lucky teachers lie carefully .	carefully lie teachers lucky .
important children whisper quietly .	children important whisper quietly .
helpful teachers scream quietly .	helpful quietly scream teachers .
nice teachers cry quietly .	quietly teachers cry nice .
clever doctors cough perfectly .	cough clever doctors perfectly .
gentle teachers sing perfectly .	sing perfectly gentle teachers .
healthy teachers practice quickly .	teachers healthy practice quickly .
angry teachers yell slowly .	teachers angry yell slowly .
healthy doctors lose carefully .	doctors healthy carefully lose .
happy teachers sneeze carefully .	teachers sneeze happy carefully .
upset doctors talk quietly .	upset talk doctors quietly .
gentle teachers cry carefully .	cry gentle carefully teachers .
angry doctors wave slowly .	slowly angry wave doctors .
angry doctors smile quickly .	smile doctors angry quickly .
excited people sneeze carefully .	carefully people excited sneeze .
surprised teachers win slowly .	win surprised slowly teachers .
curious people paint quietly .	quietly people curious paint .
surprised teachers read carefully .	teachers carefully read surprised .
friendly doctors scream perfectly .	perfectly friendly scream doctors .
quiet doctors paint quietly .	doctors paint quiet quietly .
curious doctors talk quietly .	doctors curious quietly talk .
healthy children read perfectly .	read perfectly healthy children .
boring doctors lie quickly .	lie doctors quickly boring .
angry teachers practice quickly .	teachers quickly angry practice .
clever teachers cough slowly .	teachers slowly cough clever .
boring teachers read quietly .	read boring quietly teachers .
surprised teachers lie perfectly .	surprised perfectly teachers lie .
bored doctors read quickly .	doctors quickly bored read .
tall people cry perfectly .	people tall perfectly cry .
nice doctors laugh perfectly .	laugh nice perfectly doctors .
friendly doctors laugh slowly .	slowly doctors laugh friendly .
gentle doctors wave slowly .	doctors slowly gentle wave .
kind doctors sing carefully .	sing kind carefully doctors .
lucky doctors paint carefully .	paint carefully lucky doctors .
helpful people cough slowly .	helpful cough slowly people .
important people read quietly .	quietly important read people .
angry people cough slowly .	cough angry slowly people .
nice people stretch perfectly .	people perfectly nice stretch .
careful teachers laugh perfectly .	laugh perfectly careful teachers .
tall people smile carefully .	carefully smile people tall .
young people sneeze perfectly .	perfectly young sneeze people .
angry doctors win carefully .	win angry carefully doctors .
bored people exercise quickly .	exercise bored quickly people .
boring people read perfectly .	perfectly people read boring .
clever teachers laugh quickly .	teachers quickly clever laugh .
surprised children cough quickly .	surprised cough quickly children .
angry doctors yell carefully .	doctors carefully angry yell .
quiet people stretch carefully .	quiet carefully people stretch .
upset children sing quietly .	children sing quietly upset .
wrong people lie perfectly .	people lie perfectly wrong .
sleepy children stretch carefully .	children sleepy carefully stretch .
busy children scream quietly .	busy scream children quietly .
surprised people whisper perfectly .	perfectly surprised whisper people .
important doctors sneeze slowly .	doctors important sneeze slowly .
curious doctors lose quietly .	doctors lose quietly curious .
boring teachers wave slowly .	boring slowly wave teachers .
tall doctors paint carefully .	tall paint carefully doctors .
excited children scream quietly .	quietly children scream excited .
angry children exercise slowly .	slowly children angry exercise .
helpful doctors wave slowly .	slowly wave helpful doctors .
quiet teachers cry perfectly .	cry perfectly quiet teachers .
tall teachers sneeze quickly .	tall quickly teachers sneeze .
hungry people exercise carefully .	carefully hungry exercise people .
upset teachers sing slowly .	teachers upset slowly sing .
gentle doctors read quickly .	doctors quickly gentle read .
healthy children smile slowly .	children smile slowly healthy .
important children exercise slowly .	slowly exercise important children .
friendly doctors exercise quietly .	quietly exercise friendly doctors .
smart people lose quietly .	smart quietly people lose .
wrong children whisper perfectly .	wrong perfectly children whisper .
happy people exercise carefully .	happy exercise people carefully .
busy children smile carefully .	smile busy children carefully .
clever children cough quietly .	quietly cough children clever .
healthy children lose slowly .	slowly healthy lose children .
excited doctors laugh perfectly .	laugh doctors perfectly excited .
kind teachers cough quickly .	cough teachers quickly kind .
smart children whisper carefully .	whisper children smart carefully .
curious children scream carefully .	scream carefully curious children .
angry children scream carefully .	scream angry carefully children .
lucky children talk quietly .	children quietly lucky talk .
quiet children lose quickly .	lose children quickly quiet .
angry people practice slowly .	slowly people practice angry .
healthy children exercise slowly .	healthy slowly children exercise .
friendly children smile slowly .	slowly friendly smile children .
angry teachers whisper slowly .	whisper teachers slowly angry .
tall people whisper perfectly .	tall perfectly people whisper .
kind people wave quickly .	wave people quickly kind .
gentle people sneeze carefully .	carefully sneeze gentle people .
sleepy doctors sing perfectly .	sing perfectly doctors sleepy .
happy teachers cry quickly .	teachers happy cry quickly .
sleepy teachers cry quietly .	sleepy cry teachers quietly .
confused people sing quietly .	confused quietly sing people .
helpful teachers lose quietly .	teachers helpful quietly lose .
upset children cry carefully .	cry carefully children upset .
happy people scream perfectly .	perfectly people scream happy .
healthy teachers scream perfectly .	healthy scream teachers perfectly .
lucky teachers read quickly .	teachers quickly lucky read .
upset teachers practice quietly .	practice upset teachers quietly .
young people scream carefully .	young carefully people scream .
bored teachers wave carefully .	bored carefully wave teachers .
bored teachers wave slowly .	teachers wave slowly bored .
gentle teachers win quietly .	teachers win quietly gentle .
busy doctors exercise quickly .	doctors exercise quickly busy .
sleepy doctors win perfectly .	sleepy perfectly doctors win .
bored teachers wave quickly .	teachers bored quickly wave .
tired doctors lose quickly .	quickly doctors lose tired .
bored doctors cough perfectly .	cough perfectly bored doctors .
lucky doctors talk carefully .	talk lucky doctors carefully .
gentle doctors sing quietly .	quietly doctors gentle sing .
quiet people read slowly .	people quiet read slowly .
smart children sing quietly .	children smart sing quietly .
confused doctors win quickly .	confused quickly win doctors .
hungry teachers cough quickly .	teachers cough quickly hungry .
wrong teachers talk slowly .	teachers wrong slowly talk .
busy children lose perfectly .	busy perfectly children lose .
busy doctors practice perfectly .	doctors perfectly practice busy .
lucky people read slowly .	lucky slowly read people .
bored children whisper perfectly .	children whisper perfectly bored .
angry doctors lie quietly .	lie quietly doctors angry .
helpful people stretch carefully .	helpful carefully people stretch .
tired people yell slowly .	yell slowly people tired .
young children win perfectly .	children young win perfectly .
boring people exercise slowly .	slowly people boring exercise .
wrong doctors read perfectly .	doctors read perfectly wrong .
important people lose quickly .	lose important quickly people .
helpful children sing perfectly .	sing children helpful perfectly .
friendly doctors lie quietly .	quietly lie doctors friendly .
hungry teachers read quickly .	read quickly hungry teachers .
friendly doctors practice quickly .	friendly quickly doctors practice .
young doctors exercise carefully .	young exercise doctors carefully .
kind doctors paint quietly .	doctors paint kind quietly .
curious teachers sneeze quickly .	teachers curious quickly sneeze .
important teachers whisper slowly .	whisper teachers slowly important .
angry people read quietly .	read people angry quietly .
gentle people smile quietly .	gentle smile quietly people .
quiet children read carefully .	carefully read children quiet .
helpful children sneeze slowly .	children sneeze slowly helpful .
important doctors lose quickly .	important lose doctors quickly .
lucky children sing perfectly .	perfectly children sing lucky .
kind teachers sneeze quickly .	teachers quickly sneeze kind .
lucky children cough quickly .	cough quickly lucky children .
quiet children sing quietly .	quietly children quiet sing .
curious people paint slowly .	paint slowly curious people .
sleepy children laugh slowly .	children slowly laugh sleepy .
surprised people paint slowly .	surprised paint slowly people .
boring people exercise quietly .	exercise people boring quietly .
quiet children talk slowly .	quiet slowly talk children .
important doctors lose quickly .	quickly doctors lose important .
smart children cough quickly .	quickly cough children smart .
busy doctors paint quietly .	quietly doctors paint busy .
careful teachers whisper perfectly .	careful whisper teachers perfectly .
smart doctors paint quickly .	doctors quickly smart paint .
young doctors paint slowly .	paint doctors slowly young .
gentle doctors cry slowly .	gentle slowly cry doctors .
young teachers lie quietly .	quietly young lie teachers .
bored doctors sing carefully .	doctors carefully bored sing .
surprised children exercise slowly .	children slowly exercise surprised .
excited people talk perfectly .	excited perfectly people talk .
strong doctors cry quickly .	doctors quickly cry strong .
hungry doctors exercise perfectly .	perfectly doctors exercise hungry .
hungry children wave quickly .	children wave quickly hungry .
smart children cough slowly .	smart cough children slowly .
bored teachers talk quickly .	bored talk teachers quickly .
tall doctors smile carefully .	smile doctors carefully tall .
important doctors win slowly .	important win doctors slowly .
upset people stretch quietly .	quietly people stretch upset .
sleepy people lie quietly .	lie quietly people sleepy .
friendly doctors scream perfectly .	friendly scream doctors perfectly .
surprised people exercise perfectly .	surprised exercise perfectly people .
excited people cry perfectly .	cry excited perfectly people .
clever doctors talk quietly .	doctors clever quietly talk .
upset teachers cough quietly .	teachers cough quietly upset .
healthy teachers whisper perfectly .	perfectly teachers whisper healthy .
lucky people read quietly .	quietly people lucky read .
confused people read quickly .	quickly people confused read .
confused people cough carefully .	people confused cough carefully .
curious teachers talk carefully .	carefully talk curious teachers .
lucky people smile quietly .	lucky quietly smile people .
smart doctors win quickly .	quickly smart win doctors .
bored children whisper quietly .	bored whisper quietly children .
nice teachers stretch quietly .	nice quietly stretch teachers .
healthy doctors lie perfectly .	perfectly doctors lie healthy .
upset teachers cough slowly .	teachers cough upset slowly .
healthy children read quickly .	children healthy quickly read .
excited people practice quickly .	quickly people excited practice .
confused doctors stretch quietly .	stretch doctors quietly confused .
gentle children cry slowly .	slowly cry children gentle .
young doctors lie slowly .	lie slowly young doctors .
tired people win slowly .	slowly tired win people .
sleepy teachers smile perfectly .	smile perfectly sleepy teachers .
nice children lie carefully .	lie carefully nice children .
curious people wave quietly .	wave people curious quietly .
curious doctors sneeze perfectly .	doctors curious sneeze perfectly .
strong people cry carefully .	people strong cry carefully .
nice people cry slowly .	cry slowly people nice .
angry teachers read carefully .	angry carefully read teachers .
helpful people smile carefully .	smile carefully people helpful .
hungry children laugh carefully .	children hungry carefully laugh .
healthy teachers sneeze perfectly .	sneeze perfectly teachers healthy .
wrong people practice perfectly .	practice wrong perfectly people .
lucky people sneeze quietly .	quietly lucky sneeze people .
friendly people read quickly .	people friendly quickly read .
kind teachers yell slowly .	kind yell slowly teachers .
kind people whisper carefully .	whisper carefully people kind .
young children laugh carefully .	carefully laugh young children .
wrong children scream quickly .	scream wrong quickly children .
helpful doctors cry carefully .	cry helpful carefully doctors .
gentle doctors stretch quietly .	gentle quietly doctors stretch .
excited teachers stretch quietly .	teachers excited quietly stretch .
clever people talk slowly .	talk slowly clever people .
tired teachers cry slowly .	tired slowly cry teachers .
angry children practice carefully .	carefully practice angry children .
friendly people practice quickly .	people quickly friendly practice .
confused teachers exercise slowly .	confused exercise slowly teachers .
smart teachers cry quickly .	teachers quickly cry smart .
friendly doctors wave slowly .	slowly doctors wave friendly .
happy doctors practice slowly .	practice slowly doctors happy .
nice people exercise carefully .	exercise nice carefully people .
tall doctors whisper quietly .	tall whisper doctors quietly .
wrong doctors smile quickly .	quickly smile doctors wrong .
healthy people lose quickly .	quickly healthy lose people .
bored people talk quietly .	people bored talk quietly .
surprised people cough perfectly .	surprised cough perfectly people .
surprised people read quietly .	surprised quietly people read .
strong children smile carefully .	strong smile carefully children .
angry children exercise perfectly .	perfectly angry exercise children .
sleepy people practice quickly .	practice quickly people sleepy .
clever children read carefully .	clever carefully read children .
tired doctors read quickly .	tired quickly doctors read .
upset teachers read quickly .	teachers quickly read upset .
important children scream quietly .	important scream children quietly .
smart children lie perfectly .	children smart lie perfectly .
kind doctors practice slowly .	slowly doctors kind practice .
sleepy doctors paint perfectly .	sleepy paint doctors perfectly .
clever teachers laugh carefully .	carefully laugh clever teachers .
busy doctors lose quietly .	lose quietly busy doctors .
friendly children lie slowly .	children lie friendly slowly .
kind children paint perfectly .	children perfectly paint kind .
wrong people lose slowly .	people wrong lose slowly .
helpful doctors win quickly .	helpful quickly doctors win .
young children yell carefully .	carefully yell children young .
excited teachers cough quietly .	quietly cough excited teachers .
upset children stretch perfectly .	stretch children perfectly upset .
quiet doctors lie quietly .	quietly quiet lie doctors .
young children whisper slowly .	whisper young slowly children .
tired children stretch quickly .	children quickly stretch tired .
kind children sing carefully .	children kind carefully sing .
important teachers practice quietly .	teachers important practice quietly .
important doctors win carefully .	important carefully win doctors .
smart people cry slowly .	people slowly smart cry .
curious children exercise perfectly .	exercise children perfectly curious .
young teachers cry quietly .	young quietly teachers cry .
happy doctors cough slowly .	slowly doctors happy cough .
busy teachers smile quietly .	smile quietly busy teachers .
healthy teachers sneeze quietly .	quietly sneeze healthy teachers .
tall teachers cry quietly .	quietly cry teachers tall .
upset teachers sneeze perfectly .	teachers sneeze perfectly upset .
surprised people whisper perfectly .	people surprised perfectly whisper .
curious people cough slowly .	curious cough people slowly .
careful teachers win perfectly .	teachers perfectly careful win .
tall doctors sing perfectly .	sing doctors perfectly tall .
helpful people wave slowly .	helpful slowly wave people .
surprised teachers paint quietly .	surprised paint quietly teachers .
curious doctors lie quickly .	lie doctors quickly curious .
careful children wave quickly .	quickly wave careful children .
busy teachers sing quickly .	busy quickly teachers sing .
upset teachers paint quickly .	paint quickly teachers upset .
boring teachers sing quickly .	quickly teachers boring sing .
quiet doctors lie carefully .	lie doctors quiet carefully .
quiet teachers lose perfectly .	quiet perfectly teachers lose .
clever teachers cry quickly .	cry quickly teachers clever .
strong doctors lose slowly .	doctors slowly strong lose .
friendly children practice quietly .	quietly practice children friendly .
bored doctors paint perfectly .	bored paint doctors perfectly .
angry children whisper carefully .	children whisper carefully angry .
excited people smile perfectly .	smile people perfectly excited .
clever children smile perfectly .	children clever perfectly smile .
healthy doctors wave quickly .	wave healthy quickly doctors .
sleepy people read carefully .	people carefully read sleepy .
confused people lie quickly .	people lie quickly confused .
hungry people laugh carefully .	laugh hungry people carefully .
tired teachers paint quickly .	paint quickly teachers tired .
young doctors cry quietly .	quietly young cry doctors .
strong children cry quickly .	children strong cry quickly .
nice children sing carefully .	carefully children sing nice .
upset teachers whisper quickly .	whisper upset quickly teachers .
boring children whisper perfectly .	whisper boring perfectly children .
lucky children win quickly .	quickly win children lucky .
excited children cry perfectly .	perfectly cry excited children .
tired people lie quietly .	lie quietly people tired .
happy doctors lose slowly .	doctors slowly happy lose .
tall teachers win perfectly .	win teachers perfectly tall .
sleepy people talk quickly .	talk quickly people sleepy .
wrong doctors sing perfectly .	doctors sing wrong perfectly .
healthy doctors lose quickly .	doctors quickly healthy lose .
angry children smile carefully .	smile angry carefully children .
strong children exercise carefully .	children carefully strong exercise .
friendly doctors smile quietly .	quietly friendly smile doctors .
upset doctors exercise slowly .	doctors slowly exercise upset .
happy children sneeze perfectly .	children happy perfectly sneeze .
healthy doctors paint quickly .	paint doctors healthy quickly .
gentle children cry quickly .	cry gentle quickly children .
wrong doctors whisper slowly .	whisper slowly wrong doctors .
lucky teachers whisper perfectly .	whisper lucky teachers perfectly .
healthy teachers laugh perfectly .	laugh healthy teachers perfectly .
friendly doctors lie carefully .	doctors lie carefully friendly .
clever people read quietly .	people quietly read clever .
tall people practice perfectly .	people practice tall perfectly .
gentle people scream carefully .	people gentle scream carefully .
sleepy people smile perfectly .	perfectly smile people sleepy .
sleepy children practice perfectly .	perfectly practice children sleepy .
healthy doctors smile carefully .	healthy smile carefully doctors .
sleepy children whisper quickly .	sleepy quickly children whisper .
wrong children practice quietly .	quietly children practice wrong .
happy people cough carefully .	cough carefully people happy .
bored doctors exercise perfectly .	doctors perfectly bored exercise .
important doctors lose carefully .	carefully doctors lose important .
angry doctors wave perfectly .	perfectly doctors wave angry .
smart people cry perfectly .	people smart perfectly cry .
friendly people sing slowly .	people sing slowly friendly .
angry people paint quickly .	paint people quickly angry .
excited teachers paint slowly .	excited paint slowly teachers .
upset children paint slowly .	upset paint slowly children .
angry teachers smile carefully .	teachers smile angry carefully .
angry doctors talk perfectly .	perfectly angry talk doctors .
nice people practice quickly .	nice practice quickly people .
upset doctors win quickly .	win upset quickly doctors .
angry children practice quickly .	practice children angry quickly .
healthy people paint quietly .	healthy quietly people paint .
tired children scream perfectly .	perfectly scream tired children .
friendly people win slowly .	win friendly slowly people .
tired teachers win quickly .	teachers win quickly tired .
bored children scream quietly .	scream children quietly bored .
excited teachers win carefully .	teachers carefully win excited .
tired children whisper perfectly .	whisper perfectly tired children .
curious people laugh carefully .	carefully laugh curious people .
helpful doctors cough carefully .	carefully cough helpful doctors .
kind teachers yell carefully .	teachers carefully yell kind .
confused teachers cry carefully .	confused carefully cry teachers .
young teachers read perfectly .	teachers perfectly read young .
kind people wave quietly .	wave quietly kind people .
hungry people stretch carefully .	stretch people hungry carefully .
upset doctors whisper perfectly .	doctors upset perfectly whisper .
clever children talk quietly .	talk clever quietly children .
excited doctors read carefully .	read carefully doctors excited .
tired doctors smile quickly .	smile tired quickly doctors .
wrong people paint slowly .	slowly people paint wrong .
surprised teachers scream quietly .	surprised scream quietly teachers .
surprised doctors exercise slowly .	slowly exercise surprised doctors .
tall doctors lose perfectly .	doctors lose tall perfectly .
excited doctors whisper slowly .	excited whisper doctors slowly .
lucky people read slowly .	read people slowly lucky .
smart doctors laugh slowly .	smart slowly doctors laugh .
quiet teachers sneeze quietly .	teachers quiet sneeze quietly .
boring children sing perfectly .	sing boring children perfectly .
smart teachers smile carefully .	teachers smart smile carefully .
surprised doctors lie slowly .	slowly lie doctors surprised .
tired teachers stretch carefully .	stretch carefully tired teachers .
excited people read perfectly .	perfectly people read excited .
clever teachers yell quietly .	teachers quietly clever yell .
happy children cough perfectly .	cough happy children perfectly .
confused doctors whisper slowly .	confused whisper slowly doctors .
helpful doctors sing slowly .	doctors helpful sing slowly .
happy children cough carefully .	happy carefully children cough .
tired people cough carefully .	people tired carefully cough .
young teachers sneeze carefully .	teachers young sneeze carefully .
careful people sneeze quietly .	quietly sneeze people careful .
careful people smile quietly .	smile quietly careful people .
angry doctors sing quietly .	sing doctors angry quietly .
quiet children laugh slowly .	children slowly laugh quiet .
wrong doctors sneeze perfectly .	doctors wrong sneeze perfectly .
careful doctors sneeze quickly .	careful sneeze quickly doctors .
friendly doctors yell slowly .	doctors friendly slowly yell .
friendly teachers smile perfectly .	teachers smile perfectly friendly .
kind doctors stretch quickly .	stretch kind doctors quickly .
friendly children scream quickly .	scream children friendly quickly .
tall doctors whisper perfectly .	perfectly whisper tall doctors .
young people cry perfectly .	young cry people perfectly .
busy teachers lose carefully .	carefully teachers busy lose .
upset doctors lose quickly .	lose doctors upset quickly .
angry children lose slowly .	angry lose slowly children .
confused people smile carefully .	smile carefully people confused .
hungry children exercise slowly .	exercise hungry slowly children .
tired teachers cough quietly .	quietly cough tired teachers .
busy people win perfectly .	win perfectly busy people .
surprised people cry slowly .	surprised slowly cry people .
careful people sneeze quietly .	people sneeze quietly careful .
upset children practice slowly .	upset practice children slowly .
curious doctors cry quietly .	quietly doctors curious cry .
healthy teachers read quickly .	teachers healthy quickly read .
upset teachers talk perfectly .	talk teachers upset perfectly .
tired doctors wave slowly .	wave tired slowly doctors .
wrong doctors exercise perfectly .	perfectly exercise wrong doctors .
confused doctors lie slowly .	confused lie slowly doctors .
excited teachers sneeze quietly .	teachers quietly excited sneeze .
nice teachers cry perfectly .	teachers nice perfectly cry .
smart people read quickly .	people smart quickly read .
strong doctors cough quickly .	strong quickly cough doctors .
careful children lose quietly .	quietly lose children careful .
clever doctors talk slowly .	doctors clever talk slowly .
quiet children scream quietly .	quiet quietly scream children .
smart people yell quietly .	quietly yell smart people .
gentle people win quietly .	gentle quietly win people .
strong children smile slowly .	slowly strong smile children .
friendly doctors sing perfectly .	sing friendly perfectly doctors .
nice people read quietly .	read quietly nice people .
bored teachers scream quickly .	quickly teachers scream bored .
gentle people wave carefully .	wave carefully people gentle .
confused teachers sneeze slowly .	sneeze confused teachers slowly .
confused doctors yell perfectly .	doctors perfectly yell confused .
clever teachers paint perfectly .	clever perfectly teachers paint .
tall teachers cry carefully .	carefully cry tall teachers .
lucky children smile slowly .	smile children slowly lucky .
important doctors whisper quietly .	important quietly doctors whisper .
confused children whisper quickly .	whisper quickly children confused .
confused doctors sneeze slowly .	doctors sneeze slowly confused .
hungry children read slowly .	children read slowly hungry .
curious people lie perfectly .	lie people curious perfectly .
friendly children cry slowly .	slowly children cry friendly .
busy doctors whisper quietly .	whisper busy quietly doctors .
gentle doctors win carefully .	gentle carefully win doctors .
wrong people cough slowly .	cough people wrong slowly .
confused people practice perfectly .	confused practice perfectly people .
gentle children smile quietly .	gentle quietly smile children .
careful people lie quickly .	quickly lie careful people .
angry teachers talk perfectly .	perfectly teachers talk angry .
boring doctors sing perfectly .	doctors boring sing perfectly .
sleepy people practice carefully .	carefully practice people sleepy .
excited doctors talk perfectly .	doctors talk perfectly excited .
confused people paint perfectly .	paint confused people perfectly .
wrong people paint quickly .	people wrong paint quickly .
confused doctors practice quietly .	practice doctors confused quietly .
important children win quietly .	win children quietly important .
happy doctors yell quickly .	quickly happy yell doctors .
young people laugh quickly .	people young quickly laugh .
young people read perfectly .	read young people perfectly .
upset teachers stretch carefully .	stretch upset carefully teachers .
friendly children lose perfectly .	lose children friendly perfectly .
wrong children exercise quickly .	children quickly wrong exercise .
angry teachers scream quietly .	teachers angry scream quietly .
clever doctors paint carefully .	doctors clever paint carefully .
boring doctors cry perfectly .	doctors boring perfectly cry .
lucky people win slowly .	lucky win people slowly .
upset people stretch quickly .	people stretch upset quickly .
happy doctors wave perfectly .	wave doctors perfectly happy .
quiet children practice carefully .	practice carefully quiet children .
wrong people scream quietly .	scream wrong quietly people .
busy people whisper quietly .	whisper busy people quietly .
bored doctors smile carefully .	carefully smile bored doctors .
young people smile quickly .	quickly smile young people .
upset doctors scream quietly .	doctors scream upset quietly .
boring doctors talk perfectly .	doctors perfectly talk boring .
tired people lose perfectly .	perfectly lose people tired .
clever children wave slowly .	clever slowly children wave .
tall people yell quickly .	yell tall people quickly .
upset doctors wave perfectly .	perfectly doctors upset wave .
tired doctors cry quickly .	tired cry doctors quickly .
angry doctors sneeze carefully .	doctors carefully angry sneeze .
boring children wave slowly .	children boring wave slowly .
boring teachers laugh quietly .	teachers boring quietly laugh .
kind children scream quietly .	scream children kind quietly .
curious children stretch carefully .	carefully children stretch curious .
busy teachers lose quietly .	teachers quietly lose busy .
friendly teachers read carefully .	teachers carefully friendly read .
busy teachers cry quickly .	teachers quickly busy cry .
strong doctors smile slowly .	smile doctors strong slowly .
healthy teachers read quietly .	healthy read quietly teachers .
clever children yell slowly .	children slowly clever yell .
hungry children sneeze quickly .	hungry quickly children sneeze .
healthy children laugh carefully .	laugh carefully healthy children .
kind doctors paint quietly .	quietly doctors paint kind .
quiet doctors talk slowly .	slowly talk quiet doctors .
hungry teachers practice quickly .	practice teachers quickly hungry .
important children cry quickly .	cry important quickly children .
curious teachers exercise quietly .	teachers curious quietly exercise .
bored doctors exercise carefully .	exercise carefully bored doctors .
careful people stretch slowly .	careful stretch slowly people .
smart doctors wave quickly .	wave quickly smart doctors .
young teachers talk perfectly .	young perfectly talk teachers .
helpful teachers stretch perfectly .	perfectly stretch teachers helpful .
hungry doctors wave perfectly .	hungry wave perfectly doctors .
tired people talk quietly .	quietly talk tired people .
bored doctors sing quickly .	doctors quickly sing bored .
excited people smile carefully .	people excited smile carefully .
lucky doctors laugh quickly .	lucky laugh quickly doctors .
young teachers yell carefully .	yell young carefully teachers .
happy teachers sing quietly .	teachers sing quietly happy .
excited doctors practice quickly .	practice doctors quickly excited .
tall children exercise perfectly .	children tall perfectly exercise .
important people wave perfectly .	perfectly people wave important .
gentle people whisper quickly .	whisper quickly people gentle .
young children wave quietly .	children wave quietly young .
kind children win quickly .	quickly win children kind .
careful doctors stretch quickly .	doctors careful stretch quickly .
healthy people whisper slowly .	healthy slowly whisper people .
kind children smile slowly .	kind smile slowly children .
helpful people sneeze perfectly .	people helpful sneeze perfectly .
confused children sing perfectly .	confused perfectly children sing .
clever doctors win quietly .	win clever doctors quietly .
boring doctors lose carefully .	lose doctors boring carefully .
young people cry perfectly .	young cry perfectly people .
boring teachers lie perfectly .	perfectly lie boring teachers .
quiet children smile quickly .	quiet quickly smile children .
boring people paint quietly .	boring paint quietly people .
surprised children cough quickly .	children cough quickly surprised .
tall teachers sing slowly .	tall sing slowly teachers .
careful children cough perfectly .	cough children perfectly careful .
lucky people paint quietly .	quietly people lucky paint .
lucky doctors scream quietly .	lucky scream quietly doctors .
nice people paint perfectly .	people nice perfectly paint .
gentle doctors practice quickly .	quickly practice gentle doctors .
angry doctors win slowly .	slowly doctors angry win .
important doctors talk slowly .	slowly doctors talk important .
clever children scream slowly .	clever scream slowly children .
gentle people scream quietly .	people quietly gentle scream .
confused people stretch quietly .	confused stretch quietly people .
clever doctors win carefully .	clever carefully win doctors .
clever children lie quietly .	lie clever quietly children .
excited doctors read quietly .	read excited doctors quietly .
tired children paint carefully .	children tired carefully paint .
helpful children paint carefully .	carefully paint helpful children .
happy doctors practice quickly .	happy quickly practice doctors .
boring children read quietly .	children boring read quietly .
surprised teachers scream carefully .	surprised carefully scream teachers .
smart teachers whisper slowly .	whisper slowly teachers smart .
bored children sneeze slowly .	bored slowly children sneeze .
sleepy teachers stretch perfectly .	stretch perfectly sleepy teachers .
clever teachers read quietly .	teachers quietly read clever .
important people paint slowly .	people important paint slowly .
busy doctors stretch quietly .	stretch busy quietly doctors .
lucky children lose perfectly .	perfectly lose lucky children .
angry children paint carefully .	paint angry carefully children .
happy people whisper quickly .	quickly whisper happy people .
friendly teachers practice perfectly .	teachers practice friendly perfectly .
confused teachers practice quickly .	teachers practice quickly confused .
boring teachers talk quietly .	boring talk teachers quietly .
surprised people laugh perfectly .	perfectly people laugh surprised .
boring people paint carefully .	people paint boring carefully .
happy children exercise perfectly .	happy perfectly children exercise .
curious children scream slowly .	scream curious slowly children .
gentle doctors paint carefully .	doctors gentle paint carefully .
lucky children lose slowly .	children lose lucky slowly .
bored teachers exercise quickly .	teachers exercise bored quickly .
excited doctors stretch quietly .	excited stretch doctors quietly .
lucky doctors laugh quietly .	laugh doctors quietly lucky .
gentle children wave quickly .	gentle wave children quickly .
surprised doctors smile quickly .	doctors quickly surprised smile .
quiet people read slowly .	people read slowly quiet .
busy people stretch perfectly .	perfectly people busy stretch .
bored teachers lie quickly .	teachers quickly bored lie .
young teachers cry quietly .	quietly cry young teachers .
friendly children sing slowly .	sing children slowly friendly .
friendly teachers wave perfectly .	wave friendly perfectly teachers .
smart children sneeze perfectly .	sneeze perfectly children smart .
wrong doctors sneeze perfectly .	sneeze wrong doctors perfectly .
kind people cough carefully .	carefully cough kind people .
careful doctors stretch carefully .	carefully careful stretch doctors .
nice children cough quietly .	quietly nice cough children .
bored children cough quietly .	quietly children bored cough .
confused doctors talk slowly .	confused talk slowly doctors .
lucky doctors wave quickly .	wave doctors quickly lucky .
healthy teachers wave perfectly .	perfectly wave healthy teachers .
helpful teachers win quietly .	win helpful quietly teachers .
upset people wave perfectly .	perfectly wave upset people .
boring doctors paint slowly .	slowly doctors paint boring .
tall people whisper quickly .	quickly tall whisper people .
smart doctors talk perfectly .	perfectly talk doctors smart .
surprised doctors laugh quickly .	doctors quickly laugh surprised .
lucky doctors whisper slowly .	slowly lucky whisper doctors .
kind teachers paint slowly .	slowly paint teachers kind .
happy doctors scream perfectly .	doctors happy scream perfectly .
tall teachers exercise quietly .	exercise quietly tall teachers .
important people scream carefully .	people important carefully scream .
confused teachers laugh slowly .	confused laugh slowly teachers .
nice doctors win quietly .	nice quietly win doctors .
happy teachers lose quietly .	teachers happy quietly lose .
busy children cry carefully .	cry children busy carefully .
clever doctors wave quickly .	quickly wave doctors clever .
healthy people wave slowly .	healthy wave people slowly .
boring people lose slowly .	lose people boring slowly .
helpful teachers stretch carefully .	stretch teachers helpful carefully .
careful people lie quickly .	people careful quickly lie .
surprised doctors practice carefully .	doctors surprised carefully practice .
angry people sing slowly .	people angry sing slowly .
boring people sing carefully .	people sing carefully boring .
sleepy children yell quickly .	yell quickly sleepy children .
kind children talk perfectly .	perfectly children kind talk .
upset people scream carefully .	people upset scream carefully .
kind people laugh carefully .	laugh people carefully kind .
careful teachers cry quietly .	teachers cry quietly careful .
young children read carefully .	children young carefully read .
young doctors cry quickly .	cry quickly doctors young .
wrong doctors sing quickly .	sing doctors wrong quickly .
busy doctors smile quickly .	smile doctors quickly busy .
important doctors practice quietly .	practice important quietly doctors .
gentle people stretch quietly .	gentle quietly stretch people .
upset children win quietly .	children quietly win upset .
hungry people cough perfectly .	cough perfectly people hungry .
sleepy teachers paint slowly .	paint teachers slowly sleepy .
angry teachers exercise quickly .	teachers angry quickly exercise .
kind doctors lie quietly .	doctors lie kind quietly .
smart teachers laugh carefully .	laugh smart teachers carefully .
gentle doctors whisper perfectly .	doctors whisper perfectly gentle .
tall teachers cry quickly .	teachers cry tall quickly .
curious people lie perfectly .	people perfectly curious lie .
confused children sing carefully .	sing confused carefully children .
kind doctors lose carefully .	kind lose doctors carefully .
young teachers sing slowly .	slowly young sing teachers .
quiet teachers sing quickly .	quickly teachers quiet sing .
tired doctors laugh perfectly .	doctors tired perfectly laugh .
lucky children sneeze quietly .	sneeze children quietly lucky .
helpful teachers lie carefully .	lie teachers carefully helpful .
kind doctors wave quickly .	kind wave quickly doctors .
bored children sneeze slowly .	sneeze slowly bored children .
surprised people sing slowly .	sing slowly people surprised .
boring doctors sing perfectly .	sing boring doctors perfectly .
bored children cry slowly .	cry bored slowly children .
young people whisper carefully .	whisper people carefully young .
happy people practice carefully .	happy practice people carefully .
clever children paint slowly .	children clever slowly paint .
tired people sing quickly .	people tired quickly sing .
bored teachers lose slowly .	bored lose teachers slowly .
bored children sneeze perfectly .	bored perfectly sneeze children .
curious children cry perfectly .	cry curious children perfectly .
gentle children cough carefully .	cough carefully gentle children .
clever doctors read carefully .	clever read doctors carefully .
young doctors exercise quietly .	quietly exercise doctors young .
strong doctors exercise quietly .	doctors quietly exercise strong .
busy doctors stretch perfectly .	doctors busy perfectly stretch .
healthy children cough quickly .	children cough healthy quickly .
important teachers laugh slowly .	teachers slowly important laugh .
angry children lie quietly .	lie quietly children angry .
lucky doctors lie slowly .	doctors lie slowly lucky .
important teachers sneeze perfectly .	perfectly sneeze teachers important .
angry children smile quietly .	quietly smile angry children .
gentle children sneeze perfectly .	children sneeze gentle perfectly .
kind people stretch quietly .	stretch quietly people kind .
young teachers win carefully .	young win carefully teachers .
angry children paint carefully .	carefully paint angry children .
quiet doctors lie slowly .	doctors quiet lie slowly .
friendly teachers lie quietly .	teachers lie quietly friendly .
wrong doctors whisper quickly .	whisper wrong quickly doctors .
sleepy doctors read slowly .	read slowly sleepy doctors .
clever people sneeze quickly .	clever quickly people sneeze .
curious teachers yell slowly .	curious slowly yell teachers .
quiet children exercise slowly .	slowly children exercise quiet .
strong teachers lie slowly .	lie teachers strong slowly .
careful teachers paint quickly .	teachers careful quickly paint .
bored people yell quickly .	bored yell people quickly .
boring people sneeze perfectly .	perfectly sneeze people boring .
important people scream quietly .	quietly scream people important .
tired children sneeze quietly .	quietly sneeze children tired .
confused doctors exercise quickly .	doctors confused quickly exercise .
nice doctors sing slowly .	slowly sing nice doctors .
young children laugh perfectly .	laugh perfectly young children .
careful people yell slowly .	yell people slowly careful .
gentle children cry slowly .	cry slowly gentle children .
curious doctors lose quietly .	lose curious doctors quietly .
confused teachers smile carefully .	teachers smile confused carefully .
upset children lose perfectly .	children upset lose perfectly .
smart people exercise quietly .	exercise quietly smart people .
friendly people win perfectly .	win perfectly people friendly .
clever teachers scream perfectly .	scream clever perfectly teachers .
tall doctors practice quietly .	tall practice quietly doctors .
angry teachers practice slowly .	teachers angry practice slowly .
surprised children laugh quickly .	quickly laugh children surprised .
sleepy children read perfectly .	children perfectly read sleepy .
tall people stretch slowly .	stretch people slowly tall .
curious children talk perfectly .	curious talk perfectly children .
happy teachers stretch quickly .	stretch teachers happy quickly .
quiet teachers lie perfectly .	quiet lie perfectly teachers .
quiet people practice slowly .	quiet slowly practice people .
happy doctors read quietly .	quietly read doctors happy .
lucky people win perfectly .	people lucky perfectly win .
tall doctors lose quietly .	tall quietly lose doctors .
happy children whisper perfectly .	whisper children perfectly happy .
healthy teachers paint slowly .	paint teachers healthy slowly .
helpful people sneeze carefully .	carefully helpful sneeze people .
excited people sneeze perfectly .	perfectly sneeze people excited .
wrong people win quickly .	quickly people wrong win .
boring teachers practice carefully .	practice teachers carefully boring .
strong people scream carefully .	people carefully strong scream .
careful teachers sneeze perfectly .	perfectly sneeze teachers careful .
clever teachers yell quickly .	quickly yell teachers clever .
important people cry quickly .	cry quickly important people .
friendly children sneeze slowly .	slowly children friendly sneeze .
excited teachers smile slowly .	slowly excited smile teachers .
clever teachers sneeze perfectly .	sneeze clever perfectly teachers .
tired teachers paint perfectly .	paint tired teachers perfectly .
clever doctors lie perfectly .	doctors clever perfectly lie .
careful doctors sing slowly .	careful sing doctors slowly .
hungry doctors read slowly .	read slowly doctors hungry .
upset doctors win slowly .	doctors win slowly upset .
helpful doctors talk slowly .	slowly talk doctors helpful .
healthy teachers scream quietly .	quietly scream teachers healthy .
kind doctors whisper perfectly .	perfectly whisper doctors kind .
young doctors exercise slowly .	exercise doctors slowly young .
bored children lie perfectly .	lie bored perfectly children .
lucky children talk quickly .	lucky quickly talk children .
curious children exercise carefully .	exercise carefully curious children .
upset doctors practice quietly .	practice quietly doctors upset .
sleepy children sing perfectly .	sing sleepy perfectly children .
tall teachers paint perfectly .	perfectly teachers paint tall .
lucky people smile quickly .	smile lucky quickly people .
smart teachers wave slowly .	slowly wave smart teachers .
sleepy teachers scream quietly .	teachers sleepy scream quietly .
bored doctors cry quietly .	doctors cry quietly bored .
kind people paint quickly .	people kind paint quickly .
curious doctors talk carefully .	curious carefully doctors talk .
quiet teachers cough carefully .	cough teachers quiet carefully .
surprised people lose quickly .	lose quickly surprised people .
happy children scream quickly .	children scream quickly happy .
curious children scream carefully .	curious carefully children scream .
hungry doctors wave slowly .	doctors slowly wave hungry .
sleepy doctors talk carefully .	doctors sleepy talk carefully .
young children lose carefully .	lose carefully children young .
gentle children cry quickly .	children quickly cry gentle .
helpful children smile perfectly .	smile helpful perfectly children .
gentle people scream slowly .	scream people slowly gentle .
smart doctors smile quickly .	smart quickly smile doctors .
gentle doctors cry quietly .	doctors quietly cry gentle .
strong doctors practice quietly .	doctors practice quietly strong .
curious people talk carefully .	carefully people curious talk .
angry people smile perfectly .	people perfectly angry smile .
helpful people cry quickly .	helpful quickly people cry .
kind children smile quietly .	smile children kind quietly .
healthy children practice quickly .	children healthy practice quickly .
tall teachers cough perfectly .	tall cough teachers perfectly .
quiet doctors stretch quickly .	doctors quickly stretch quiet .
friendly children laugh quickly .	children quickly friendly laugh .
young people paint perfectly .	people young perfectly paint .
important people wave quickly .	important wave people quickly .
careful children sneeze quietly .	children quietly careful sneeze .
lucky people talk quietly .	quietly people talk lucky .
young doctors paint perfectly .	young perfectly paint doctors .
helpful children cry perfectly .	children cry helpful perfectly .
surprised people sing quietly .	surprised quietly people sing .
angry children sneeze quietly .	sneeze angry quietly children .
kind doctors practice quickly .	quickly doctors practice kind .
clever children cry carefully .	cry carefully children clever .
lucky children exercise quickly .	exercise quickly children lucky .
tired children paint carefully .	children carefully paint tired .
tired teachers sneeze perfectly .	sneeze teachers perfectly tired .
bored children practice slowly .	bored practice slowly children .
excited teachers read carefully .	read carefully teachers excited .
young teachers whisper slowly .	teachers slowly whisper young .
excited doctors stretch slowly .	excited stretch doctors slowly .
hungry doctors read slowly .	slowly read hungry doctors .
clever doctors cry quickly .	cry quickly clever doctors .
upset teachers sing carefully .	teachers upset carefully sing .
tired teachers whisper carefully .	tired whisper teachers carefully .
busy doctors whisper perfectly .	whisper doctors perfectly busy .
confused doctors sing slowly .	sing slowly doctors confused .
friendly doctors sneeze perfectly .	doctors sneeze perfectly friendly .
gentle people wave slowly .	people gentle wave slowly .
confused doctors lose slowly .	slowly confused lose doctors .
confused teachers sing perfectly .	teachers perfectly sing confused .
lucky people lose slowly .	lose lucky slowly people .
clever children lose perfectly .	lose perfectly children clever .
helpful doctors exercise slowly .	doctors exercise helpful slowly .
careful teachers sneeze slowly .	teachers careful slowly sneeze .
clever children win perfectly .	win clever children perfectly .
sleepy children paint quietly .	children sleepy paint quietly .
bored teachers lose carefully .	lose teachers bored carefully .
boring people cry slowly .	cry people boring slowly .
bored people laugh quietly .	laugh quietly bored people .
bored people lie slowly .	people slowly bored lie .
strong people read perfectly .	strong perfectly people read .
boring children exercise carefully .	boring exercise carefully children .
nice people read carefully .	carefully read people nice .
upset children lose perfectly .	perfectly children upset lose .
young doctors paint carefully .	doctors carefully paint young .
happy doctors cry perfectly .	happy perfectly cry doctors .
young people yell slowly .	people young yell slowly .
sleepy people laugh quickly .	sleepy quickly laugh people .
excited people whisper slowly .	whisper slowly excited people .
young doctors sing perfectly .	sing doctors perfectly young .
excited teachers lose carefully .	excited lose teachers carefully .
friendly teachers yell perfectly .	teachers yell friendly perfectly .
surprised doctors stretch perfectly .	stretch doctors surprised perfectly .
smart people scream quietly .	people quietly smart scream .
boring people scream perfectly .	boring scream perfectly people .
clever children lie slowly .	clever slowly lie children .
quiet people cry slowly .	quiet slowly people cry .
strong people wave carefully .	people wave carefully strong .
hungry children cry quickly .	children cry quickly hungry .
hungry children cry quietly .	cry children hungry quietly .
happy people stretch carefully .	people happy carefully stretch .
friendly children yell perfectly .	perfectly friendly yell children .
angry teachers cough quickly .	quickly cough angry teachers .
sleepy children yell carefully .	carefully sleepy yell children .
gentle children sing perfectly .	sing gentle perfectly children .
lucky teachers sing quietly .	teachers lucky quietly sing .
boring teachers read perfectly .	perfectly teachers boring read .
young doctors lose quickly .	doctors young lose quickly .
helpful teachers paint perfectly .	paint perfectly helpful teachers .
important people cough quickly .	cough quickly important people .
upset people sneeze perfectly .	sneeze upset perfectly people .
happy doctors wave slowly .	doctors wave happy slowly .
quiet people sing carefully .	people carefully sing quiet .
important people laugh perfectly .	perfectly laugh important people .
tall people practice quickly .	tall quickly practice people .
smart teachers sing carefully .	carefully sing teachers smart .
gentle children lie carefully .	carefully children gentle lie .
young doctors win carefully .	carefully win young doctors .
clever doctors talk perfectly .	doctors talk perfectly clever .
hungry teachers laugh perfectly .	laugh hungry teachers perfectly .
angry children win slowly .	angry slowly children win .
happy children whisper perfectly .	children happy perfectly whisper .
tall children talk slowly .	slowly talk tall children .
healthy children practice quickly .	children practice healthy quickly .
sleepy doctors whisper perfectly .	whisper doctors perfectly sleepy .
angry people talk quickly .	talk angry quickly people .
boring doctors exercise perfectly .	doctors boring exercise perfectly .
healthy children laugh slowly .	laugh children healthy slowly .
lucky children exercise quickly .	lucky quickly children exercise .
curious people yell perfectly .	perfectly yell people curious .
wrong people cry perfectly .	people wrong cry perfectly .
wrong children lose slowly .	slowly lose children wrong .
curious people exercise perfectly .	exercise perfectly people curious .
healthy children practice slowly .	slowly practice children healthy .
nice people talk perfectly .	people perfectly nice talk .
lucky children laugh perfectly .	lucky laugh perfectly children .
boring teachers smile quickly .	smile teachers boring quickly .
smart teachers read perfectly .	teachers smart perfectly read .
quiet children lie slowly .	slowly children quiet lie .
tall people scream carefully .	scream people carefully tall .
sleepy teachers practice perfectly .	practice teachers sleepy perfectly .
important teachers whisper quickly .	whisper quickly important teachers .
happy teachers paint quietly .	paint happy teachers quietly .
boring teachers sneeze quietly .	sneeze quietly teachers boring .
curious people win perfectly .	people win curious perfectly .
helpful teachers practice perfectly .	teachers practice helpful perfectly .
happy people scream carefully .	scream happy people carefully .
nice teachers cough quickly .	cough nice quickly teachers .
young doctors sneeze slowly .	sneeze young slowly doctors .
friendly people sing perfectly .	sing perfectly friendly people .
friendly people win quietly .	win people quietly friendly .
sleepy children lie slowly .	slowly sleepy lie children .
tired teachers sing quickly .	teachers tired quickly sing .
careful teachers laugh quickly .	careful quickly teachers laugh .
curious children win quietly .	children win quietly curious .
smart children sneeze carefully .	sneeze smart carefully children .
strong teachers practice slowly .	slowly teachers strong practice .
gentle children lie quietly .	lie quietly children gentle .
happy teachers cough slowly .	slowly cough teachers happy .
curious doctors practice slowly .	doctors curious slowly practice .
sleepy teachers smile quickly .	smile sleepy teachers quickly .
smart doctors scream slowly .	smart scream doctors slowly .
wrong teachers sing carefully .	teachers wrong carefully sing .
wrong children cough slowly .	children cough slowly wrong .
confused children lose carefully .	carefully confused lose children .
bored people read carefully .	people read bored carefully .
gentle doctors smile slowly .	gentle smile slowly doctors .
happy people stretch quickly .	stretch quickly people happy .
hungry children scream quietly .	children hungry scream quietly .
