only the mirror that the driver had dropped should ever roll away .	the mirror that only the driver had dropped should ever roll away .
only those doctors who have brought the window can ever talk to the ladies .	those doctors who have only brought the window can ever talk to the ladies .
only that snake that had seen these books could ever learn .	that snake that had only seen these books could ever learn .
only the toys that the ladies will remember had ever broken these doors .	the toys that only the ladies will remember had ever broken these doors .
only this king who had held these spoons has ever confused this driver .	this king who had only held these spoons has ever confused this driver .
only those guys who have walked through this museum have ever moved that crayon .	those guys who have only walked through this museum have ever moved that crayon .
only these boys who should hate these bags will ever sell that shirt .	these boys who should only hate these bags will ever sell that shirt .
only the guy who had heard the hamster has ever bothered that patient .	the guy who had only heard the hamster has ever bothered that patient .
only the guy who could clean these books should ever run around the hospital .	the guy who could only clean these books should ever run around the hospital .
only the truck that the child has taken would ever drop .	the truck that only the child has taken would ever drop .
only that queen who the boy would sound like can ever drive to the room .	that queen who only the boy would sound like can ever drive to the room .
only those teachers who will think about that hat had ever run around the kitchen .	those teachers who will only think about that hat had ever run around the kitchen .
only the dancer who has seen the turtle had ever talked about those guys .	the dancer who has only seen the turtle had ever talked about those guys .
only those girls who the guys could talk about will ever appreciate that customer .	those girls who only the guys could talk about will ever appreciate that customer .
only that doll that this driver has seen will ever break .	that doll that only this driver has seen will ever break .
only the boy who this adult can look like should ever talk about those hats .	the boy who only this adult can look like should ever talk about those hats .
only that teacher who can talk about that guy has ever held the fork .	that teacher who can only talk about that guy has ever held the fork .
only these ladies who will remember that boy have ever bought this ring .	these ladies who will only remember that boy have ever bought this ring .
only the dentist who had heard the boy had ever talked to the patient .	the dentist who had only heard the boy had ever talked to the patient .
only those toys that those women have noticed had ever dropped .	those toys that only those women have noticed had ever dropped .
only this man who this dentist has talked about will ever clean those cars .	this man who only this dentist has talked about will ever clean those cars .
only that man who the doctor may talk about can ever listen to that driver .	that man who only the doctor may talk about can ever listen to that driver .
only the teachers who may talk can ever leave those schools .	the teachers who may only talk can ever leave those schools .
only this king who might talk about the bowl could ever practice .	this king who might only talk about the bowl could ever practice .
only the doctor that could notice this mirror has ever learned .	the doctor that could only notice this mirror has ever learned .
only the woman who must sell this doll will ever sound like these teachers .	the woman who must only sell this doll will ever sound like these teachers .
only the cup that this adult has talked about has ever dropped .	the cup that only this adult has talked about has ever dropped .
only this teacher who had thrown this shirt would ever clean this plate .	this teacher who had only thrown this shirt would ever clean this plate .
only the dancer who could smile had ever worried this girl .	the dancer who could only smile had ever worried this girl .
only this child who this doctor has talked about has ever lost those books .	this child who only this doctor has talked about has ever lost those books .
only this teacher who has thrown that bed has ever worried the people .	this teacher who has only thrown that bed has ever worried the people .
only this girl who might hate this horse would ever bring that hat .	this girl who might only hate this horse would ever bring that hat .
only this guy who would keep this dish had ever taken these books .	this guy who would only keep this dish had ever taken these books .
only the couch that can break has ever rolled away .	the couch that can only break has ever rolled away .
only these men who will think about the bicycle have ever bought the bowls .	these men who will only think about the bicycle have ever bought the bowls .
only those guys who can remember those birds would ever shake these cups .	those guys who can only remember those birds would ever shake these cups .
only the men that may forget this king should ever run .	the men that may only forget this king should ever run .
only these people who had heard this king have ever held those books .	these people who had only heard this king have ever held those books .
only that teacher who had seen those trucks can ever answer this adult .	that teacher who had only seen those trucks can ever answer this adult .
only the girl who had noticed that bag should ever paint .	the girl who had only noticed that bag should ever paint .
only that patient who might lose the spoons will ever whisper .	that patient who might only lose the spoons will ever whisper .
only this book that that customer had cleaned would ever roll away .	this book that only that customer had cleaned would ever roll away .
only that man who had gone to these rooms has ever waved .	that man who had only gone to these rooms has ever waved .
only the doctor that this customer can notice had ever broken the book .	the doctor that only this customer can notice had ever broken the book .
only this guy that has grown has ever learned .	this guy that has only grown has ever learned .
only these people who have found these dolls can ever sing .	these people who have only found these dolls can ever sing .
only the bed that this child can love had ever moved .	the bed that only this child can love had ever moved .
only this lady that would think about the cups should ever hate that dog .	this lady that would only think about the cups should ever hate that dog .
only these children who may lift this doll can ever shake the rings .	these children who may only lift this doll can ever shake the rings .
only this guy who would have those bowls would ever run around that restaurant .	this guy who would only have those bowls would ever run around that restaurant .
only this queen who has seen the cars will ever move this glass .	this queen who has only seen the cars will ever move this glass .
only that woman who had gone to those schools had ever taught the girls .	that woman who had only gone to those schools had ever taught the girls .
only the bicycle that this boy has kept should ever drop .	the bicycle that only this boy has kept should ever drop .
only that customer who should leave the museum should ever move these books .	that customer who should only leave the museum should ever move these books .
only those teachers who might love this dentist can ever shake these cars .	those teachers who might only love this dentist can ever shake these cars .
only the doctors who have remembered those turtles have ever kept the bowls .	the doctors who have only remembered those turtles have ever kept the bowls .
only this dish that the boy could hate would ever roll away .	this dish that only the boy could hate would ever roll away .
only the hat that this person had brought had ever rolled away .	the hat that only this person had brought had ever rolled away .
only the girls who can paint have ever fixed these cars .	the girls who can only paint have ever fixed these cars .
only these cats that can grow should ever notice those dogs .	these cats that can only grow should ever notice those dogs .
only the girl who could hold those rings had ever dropped that fork .	the girl who could only hold those rings had ever dropped that fork .
only the guys who may hear these teachers will ever keep that ship .	the guys who may only hear these teachers will ever keep that ship .
only the cat that this customer might talk about had ever seen the glass .	the cat that only this customer might talk about had ever seen the glass .
only this bird that has heard the adult can ever like that spoon .	this bird that has only heard the adult can ever like that spoon .
only that teacher who can love the guy can ever find these books .	that teacher who can only love the guy can ever find these books .
only that boy who should walk through this park has ever confused these ladies .	that boy who should only walk through this park has ever confused these ladies .
only that boy who has thrown those bags will ever listen to that customer .	that boy who has only thrown those bags will ever listen to that customer .
only these books that had rolled away can ever break .	these books that had only rolled away can ever break .
only this turtle that that child can look like has ever run .	this turtle that only that child can look like has ever run .
only that boy who had taken those cars had ever answered this customer .	that boy who had only taken those cars had ever answered this customer .
only the rabbit that could hate the cups had ever run .	the rabbit that could only hate the cups had ever run .
only that person that has seen the bird had ever grown .	that person that has only seen the bird had ever grown .
only those guys who could notice these hats had ever lost the glass .	those guys who could only notice these hats had ever lost the glass .
only the boy who could steal the ship can ever laugh .	the boy who could only steal the ship can ever laugh .
only this book that that mouse should like had ever broken these crayons .	this book that only that mouse should like had ever broken these crayons .
only the man who will think about these girls could ever hold these glasses .	the man who will only think about these girls could ever hold these glasses .
only the king who had passed those schools would ever practice .	the king who had only passed those schools would ever practice .
only that king who had talked about that customer will ever sneeze .	that king who had only talked about that customer will ever sneeze .
only the driver that should hate these crayons would ever like that cat .	the driver that should only hate these crayons would ever like that cat .
only the bird that the king might hear has ever learned .	the bird that only the king might hear has ever learned .
only the person who had talked will ever fix this doll .	the person who had only talked will ever fix this doll .
only this boat that the doctor had talked about has ever broken the bicycle .	this boat that only the doctor had talked about has ever broken the bicycle .
only the queen who will notice those birds can ever laugh .	the queen who will only notice those birds can ever laugh .
only the women who may drive to the schools should ever lose those hats .	the women who may only drive to the schools should ever lose those hats .
only that bicycle that that turtle would see should ever break the toys .	that bicycle that only that turtle would see should ever break the toys .
only this man who has talked should ever sing .	this man who has only talked should ever sing .
only this hamster that could sound like that king will ever grow .	this hamster that could only sound like that king will ever grow .
only the dentist who the dancer had talked about would ever talk to the people .	the dentist who only the dancer had talked about would ever talk to the people .
only the girls who would know that turtle should ever drive to the park .	the girls who would only know that turtle should ever drive to the park .
only the snake that the child had heard can ever grow .	the snake that only the child had heard can ever grow .
only the dentist who might hate those bags should ever work with the dentist .	the dentist who might only hate those bags should ever work with the dentist .
only the rabbit that has run will ever grow .	the rabbit that has only run will ever grow .
only the people who the ladies will look like had ever cried .	the people who only the ladies will look like had ever cried .
only the teacher who the guy will look like could ever look like the adult .	the teacher who only the guy will look like could ever look like the adult .
only this driver who has talked about the mice had ever talked about those ladies .	this driver who has only talked about the mice had ever talked about those ladies .
only the boys that those snakes must hate would ever break those books .	the boys that only those snakes must hate would ever break those books .
only that guy who has won should ever read .	that guy who has only won should ever read .
only the boys who should remember this bottle can ever sing .	the boys who should only remember this bottle can ever sing .
only this king that would hate this guy has ever run .	this king that would only hate this guy has ever run .
only this customer who would lose had ever run around the mall .	this customer who would only lose had ever run around the mall .
only this lady who has remembered the child should ever hold the forks .	this lady who has only remembered the child should ever hold the forks .
only the teacher who should move the ship had ever found that boat .	the teacher who should only move the ship had ever found that boat .
only these snakes that had heard the cat have ever thought about those birds .	these snakes that had only heard the cat have ever thought about those birds .
only this car that had rolled away has ever rolled away .	this car that had only rolled away has ever rolled away .
only this dancer that that woman must know will ever run .	this dancer that only that woman must know will ever run .
only these bags that those turtles had thought about can ever roll away .	these bags that only those turtles had thought about can ever roll away .
only the woman who the patient might sound like would ever paint .	the woman who only the patient might sound like would ever paint .
only this man who should hate this hamster would ever paint .	this man who should only hate this hamster would ever paint .
only the window that must move would ever drop .	the window that must only move would ever drop .
only these snakes that had seen the shirt have ever run .	these snakes that had only seen the shirt have ever run .
only the boys who had thought about this bag can ever worry this adult .	the boys who had only thought about this bag can ever worry this adult .
only those boys who these ladies must talk about would ever leave the library .	those boys who only these ladies must talk about would ever leave the library .
only those boys who can drop that box could ever whisper .	those boys who can only drop that box could ever whisper .
only that adult who had run around the library should ever steal the shirt .	that adult who had only run around the library should ever steal the shirt .
only those shirts that these children might sell had ever broken .	those shirts that only these children might sell had ever broken .
only the dancer who may smile can ever lose the dolls .	the dancer who may only smile can ever lose the dolls .
only those boys who could cry will ever shake the buttons .	those boys who could only cry will ever shake the buttons .
only that cup that had broken has ever dropped .	that cup that had only broken has ever dropped .
only this man who would whisper will ever scream .	this man who would only whisper will ever scream .
only this bag that the dog might think about had ever rolled away .	this bag that only the dog might think about had ever rolled away .
only the doctors who the children would sound like would ever leave this school .	the doctors who only the children would sound like would ever leave this school .
only that lady who has held the shirt had ever taught this dentist .	that lady who has only held the shirt had ever taught this dentist .
only these girls that might know those cats have ever thought about the crayon .	these girls that might only know those cats have ever thought about the crayon .
only that girl who may talk about that bed would ever answer that guy .	that girl who may only talk about that bed would ever answer that guy .
only that teacher who had heard these snakes will ever bother that driver .	that teacher who had only heard these snakes will ever bother that driver .
only the teachers who will like these forks will ever win .	the teachers who will only like these forks will ever win .
only this adult that could think about these birds will ever learn .	this adult that could only think about these birds will ever learn .
only the person who that patient has talked about has ever won .	the person who only that patient has talked about has ever won .
only that king who has heard that rabbit had ever talked about that book .	that king who has only heard that rabbit had ever talked about that book .
only that girl who has brought these plates could ever cry .	that girl who has only brought these plates could ever cry .
only this shirt that this driver has talked about has ever broken this book .	this shirt that only this driver has talked about has ever broken this book .
only that dentist who must drive to this kitchen would ever bring that shirt .	that dentist who must only drive to this kitchen would ever bring that shirt .
only this woman who had thrown these bowls could ever bring these boxes .	this woman who had only thrown these bowls could ever bring these boxes .
only those boys who must remember this bottle should ever sing .	those boys who must only remember this bottle should ever sing .
only the teacher who should leave the school has ever visited those women .	the teacher who should only leave the school has ever visited those women .
only the man who that guy has heard has ever kept the bag .	the man who only that guy has heard has ever kept the bag .
only the ladies who have talked about these chairs should ever fix this toy .	the ladies who have only talked about these chairs should ever fix this toy .
only the dentist who may bring this ring would ever help this girl .	the dentist who may only bring this ring would ever help this girl .
only that boy who will sell those buttons has ever lost the boys .	that boy who will only sell those buttons has ever lost the boys .
only this car that this girl may love had ever broken that truck .	this car that only this girl may love had ever broken that truck .
only that driver who has noticed the king should ever listen to those children .	that driver who has only noticed the king should ever listen to those children .
only the child that may see that bicycle could ever love the bowl .	the child that may only see that bicycle could ever love the bowl .
only that dancer who would know that dog has ever yelled .	that dancer who would only know that dog has ever yelled .
only the dancer who had thrown those dolls has ever moved these dolls .	the dancer who had only thrown those dolls has ever moved these dolls .
only the shirts that these guys had thrown should ever break .	the shirts that only these guys had thrown should ever break .
only that rabbit that had grown should ever run .	that rabbit that had only grown should ever run .
only the dentist who might find that spoon can ever praise this lady .	the dentist who might only find that spoon can ever praise this lady .
only that lady who has heard this queen has ever laughed .	that lady who has only heard this queen has ever laughed .
only this bag that this adult will keep would ever break .	this bag that only this adult will keep would ever break .
only the children that must hear that patient have ever learned .	the children that must only hear that patient have ever learned .
only this queen who had remembered this shoe has ever walked through these schools .	this queen who had only remembered this shoe has ever walked through these schools .
only the patient who must leave the library has ever fixed this book .	the patient who must only leave the library has ever fixed this book .
only those boys that had seen the plates had ever remembered the picture .	those boys that had only seen the plates had ever remembered the picture .
only that teacher who has talked about the plane has ever thrown the shoes .	that teacher who has only talked about the plane has ever thrown the shoes .
only those mice that would hate the car had ever eaten .	those mice that would only hate the car had ever eaten .
only this dancer that had heard those people will ever grow .	this dancer that had only heard those people will ever grow .
only these cats that had remembered the cups have ever learned .	these cats that had only remembered the cups have ever learned .
only these mice that had learned would ever love this man .	these mice that had only learned would ever love this man .
only this doctor who will keep this bottle has ever taken this window .	this doctor who will only keep this bottle has ever taken this window .
only this chair that the man could talk about has ever rolled away .	this chair that only the man could talk about has ever rolled away .
only that plate that this queen had remembered has ever broken those trucks .	that plate that only this queen had remembered has ever broken those trucks .
only this person who would drive to those schools had ever taught this teacher .	this person who would only drive to those schools had ever taught this teacher .
only these ladies who can talk about the trucks will ever talk to this girl .	these ladies who can only talk about the trucks will ever talk to this girl .
only the woman who will smile can ever exercise .	the woman who will only smile can ever exercise .
only this dentist that the lady can talk about can ever eat .	this dentist that only the lady can talk about can ever eat .
only these horses that should grow can ever love the pictures .	these horses that should only grow can ever love the pictures .
only that rabbit that would learn will ever hate those men .	that rabbit that would only learn will ever hate those men .
only that driver that that doctor might talk about has ever broken that rug .	that driver that only that doctor might talk about has ever broken that rug .
only those teachers who must notice that bottle had ever worked with the queen .	those teachers who must only notice that bottle had ever worked with the queen .
only the cats that these girls have talked about can ever run .	the cats that only these girls have talked about can ever run .
only this patient who can laugh had ever heard the dog .	this patient who can only laugh had ever heard the dog .
only these doctors who have seen the dish should ever listen to the adult .	these doctors who have only seen the dish should ever listen to the adult .
only the children that would run will ever see the mirror .	the children that would only run will ever see the mirror .
only this turtle that can grow has ever thought about these cats .	this turtle that can only grow has ever thought about these cats .
only the teachers who should smile would ever lift these pictures .	the teachers who should only smile would ever lift these pictures .
only the people that have heard the hamster had ever thought about this book .	the people that have only heard the hamster had ever thought about this book .
only those shirts that had rolled away should ever move .	those shirts that had only rolled away should ever move .
only that guy who could hear this boy will ever sound like that woman .	that guy who could only hear this boy will ever sound like that woman .
only the girls who had laughed can ever visit the men .	the girls who had only laughed can ever visit the men .
only this lady who should drive to this restaurant could ever know the teachers .	this lady who should only drive to this restaurant could ever know the teachers .
only these horses that could love those bottles had ever grown .	these horses that could only love those bottles had ever grown .
only the children who must talk about those teachers should ever worry that boy .	the children who must only talk about those teachers should ever worry that boy .
only the dancer who may hold these shoes would ever talk .	the dancer who may only hold these shoes would ever talk .
only those cups that might move can ever roll away .	those cups that might only move can ever roll away .
only the men who had walked through the bank had ever confused that king .	the men who had only walked through the bank had ever confused that king .
only that bird that can love these crayons has ever eaten .	that bird that can only love these crayons has ever eaten .
only the woman that has heard the snakes could ever run .	the woman that has only heard the snakes could ever run .
only that hamster that has heard this rabbit has ever run .	that hamster that has only heard this rabbit has ever run .
only those teachers who should throw that cup would ever bother that teacher .	those teachers who should only throw that cup would ever bother that teacher .
only these boys who those teachers would hear should ever practice .	these boys who only those teachers would hear should ever practice .
only the teachers who have taken that plane would ever appreciate those boys .	the teachers who have only taken that plane would ever appreciate those boys .
only these people who those guys may know had ever bothered those boys .	these people who only those guys may know had ever bothered those boys .
only this guy that might know that queen can ever grow .	this guy that might only know that queen can ever grow .
only the dentist who may read would ever pass this kitchen .	the dentist who may only read would ever pass this kitchen .
only that bed that this dentist might love has ever dropped .	that bed that only this dentist might love has ever dropped .
only this boy who must read can ever hear the doctors .	this boy who must only read can ever hear the doctors .
only that girl who can hear that queen has ever made this button .	that girl who can only hear that queen has ever made this button .
only that king who this dentist might sound like had ever talked about those windows .	that king who only this dentist might sound like had ever talked about those windows .
only that doctor who has talked about that car will ever paint .	that doctor who has only talked about that car will ever paint .
only those ladies who should forget that shoe have ever lost that plate .	those ladies who should only forget that shoe have ever lost that plate .
only this king who can steal the spoon can ever listen to these men .	this king who can only steal the spoon can ever listen to these men .
only these doctors that had learned would ever learn .	these doctors that had only learned would ever learn .
only that cup that that boy had noticed would ever roll away .	that cup that only that boy had noticed would ever roll away .
only the man who could notice the people had ever won .	the man who could only notice the people had ever won .
only this man who that adult has talked about has ever brought this bicycle .	this man who only that adult has talked about has ever brought this bicycle .
only that rabbit that should hear this snake has ever grown .	that rabbit that should only hear this snake has ever grown .
only this bowl that this patient has cleaned should ever drop .	this bowl that only this patient has cleaned should ever drop .
only those ladies who could love those men had ever made this crayon .	those ladies who could only love those men had ever made this crayon .
only the chairs that would roll away had ever rolled away .	the chairs that would only roll away had ever rolled away .
only that queen who has found that bag would ever care for those boys .	that queen who has only found that bag would ever care for those boys .
only that doctor who the dentist must know should ever whisper .	that doctor who only the dentist must know should ever whisper .
only the dentist who the lady must talk about would ever bother that guy .	the dentist who only the lady must talk about would ever bother that guy .
only the dancer who must scream should ever appreciate the adult .	the dancer who must only scream should ever appreciate the adult .
only this bottle that the guy may hate had ever rolled away .	this bottle that only the guy may hate had ever rolled away .
only these women who have noticed these windows have ever dropped these bottles .	these women who have only noticed these windows have ever dropped these bottles .
only the men who may sound like that hamster would ever hear that driver .	the men who may only sound like that hamster would ever hear that driver .
only the woman who might take those bowls will ever know that child .	the woman who might only take those bowls will ever know that child .
only those children who can clean the windows will ever help that teacher .	those children who can only clean the windows will ever help that teacher .
only this adult who may whisper had ever fixed the mirror .	this adult who may only whisper had ever fixed the mirror .
only that driver who had dropped the shoes could ever sound like the mice .	that driver who had only dropped the shoes could ever sound like the mice .
only those books that might move could ever drop .	those books that might only move could ever drop .
only the people who can lift the bowl can ever lose .	the people who can only lift the bowl can ever lose .
only that guy who has lost this shirt should ever read .	that guy who has only lost this shirt should ever read .
only this dancer that that girl has talked about had ever run .	this dancer that only that girl has talked about had ever run .
only that woman who should sound like that person had ever confused that woman .	that woman who should only sound like that person had ever confused that woman .
only this woman who had remembered this driver should ever make the truck .	this woman who had only remembered this driver should ever make the truck .
only the doctors who will see this doctor have ever lost .	the doctors who will only see this doctor have ever lost .
only that child that that girl should hear had ever eaten .	that child that only that girl should hear had ever eaten .
only this dentist who must stretch had ever thrown the bag .	this dentist who must only stretch had ever thrown the bag .
only this dancer who this doctor would know can ever lose that chair .	this dancer who only this doctor would know can ever lose that chair .
only the horses that have eaten should ever see that cup .	the horses that have only eaten should ever see that cup .
only this girl who has remembered those guys had ever fixed those glasses .	this girl who has only remembered those guys had ever fixed those glasses .
only this lady who had thought about that book can ever lift the buttons .	this lady who had only thought about that book can ever lift the buttons .
only this person that this patient had talked about could ever break the plate .	this person that only this patient had talked about could ever break the plate .
only that lady who had walked through the bank had ever bought that box .	that lady who had only walked through the bank had ever bought that box .
only the woman who would buy those boxes had ever lost the patient .	the woman who would only buy those boxes had ever lost the patient .
only these women who should see those dolls should ever clean this ring .	these women who should only see those dolls should ever clean this ring .
only this teacher who has dropped those trucks would ever go to that museum .	this teacher who has only dropped those trucks would ever go to that museum .
only that hamster that had run had ever noticed these horses .	that hamster that had only run had ever noticed these horses .
only those people who these doctors had talked about can ever smile .	those people who only these doctors had talked about can ever smile .
only this driver who would hold these bags can ever take these forks .	this driver who would only hold these bags can ever take these forks .
only this customer that might hear the boy has ever remembered this rabbit .	this customer that might only hear the boy has ever remembered this rabbit .
only the dancer that may like this dentist would ever learn .	the dancer that may only like this dentist would ever learn .
only those birds that those guys can sound like could ever grow .	those birds that only those guys can sound like could ever grow .
only the boys that the children might know could ever notice that plate .	the boys that only the children might know could ever notice that plate .
only the candles that should roll away can ever drop .	the candles that should only roll away can ever drop .
only this dog that will remember those pictures should ever remember that toy .	this dog that will only remember those pictures should ever remember that toy .
only that driver who will buy that bicycle had ever heard these cats .	that driver who will only buy that bicycle had ever heard these cats .
only this shirt that could move has ever broken .	this shirt that could only move has ever broken .
only this crayon that the person had talked about would ever break that shirt .	this crayon that only the person had talked about would ever break that shirt .
only this teacher that this man may talk about will ever grow .	this teacher that only this man may talk about will ever grow .
only the boys who may know that doctor have ever heard those turtles .	the boys who may only know that doctor have ever heard those turtles .
only those men that could run had ever seen these women .	those men that could only run had ever seen these women .
only the queen who has made the chair had ever left that room .	the queen who has only made the chair had ever left that room .
only that doctor who had seen the plates had ever cried .	that doctor who had only seen the plates had ever cried .
only the shoe that had rolled away would ever roll away .	the shoe that had only rolled away would ever roll away .
only that lady who had brought the doll had ever gone to this kitchen .	that lady who had only brought the doll had ever gone to this kitchen .
only the child who will sound like that dancer will ever look like the cats .	the child who will only sound like that dancer will ever look like the cats .
only that bag that this queen might fix had ever dropped .	that bag that only this queen might fix had ever dropped .
only those boys who have thought about the horse would ever talk about the shoe .	those boys who have only thought about the horse would ever talk about the shoe .
only that king that has thought about that couch should ever learn .	that king that has only thought about that couch should ever learn .
only the mirror that this lady had noticed should ever break these dolls .	the mirror that only this lady had noticed should ever break these dolls .
only this adult that that king might look like has ever noticed this person .	this adult that only that king might look like has ever noticed this person .
only these ladies who may like the bed should ever pass those rooms .	these ladies who may only like the bed should ever pass those rooms .
only the people that will think about the doors had ever eaten .	the people that will only think about the doors had ever eaten .
only the boys who have thought about the button have ever painted .	the boys who have only thought about the button have ever painted .
only that person that could love those rings can ever love that ring .	that person that could only love those rings can ever love that ring .
only the lady who the queen may look like will ever look like this dentist .	the lady who only the queen may look like will ever look like this dentist .
only the lady that must see this boat could ever hate these bottles .	the lady that must only see this boat could ever hate these bottles .
only this guy who this customer had heard will ever teach the adult .	this guy who only this customer had heard will ever teach the adult .
only this queen who this guy may sound like has ever cried .	this queen who only this guy may sound like has ever cried .
only this person who would throw those cars can ever scare that lady .	this person who would only throw those cars can ever scare that lady .
only the girls who would talk about the rings would ever scare the boys .	the girls who would only talk about the rings would ever scare the boys .
only the rabbit that should run would ever run .	the rabbit that should only run would ever run .
only that dog that might think about the fork had ever seen these dishes .	that dog that might only think about the fork had ever seen these dishes .
only the dancer who had moved this bottle could ever sneeze .	the dancer who had only moved this bottle could ever sneeze .
only that patient that the child might talk about would ever break this ring .	that patient that only the child might talk about would ever break this ring .
only these girls who might forget these doors had ever kept the spoons .	these girls who might only forget these doors had ever kept the spoons .
only this person who should know that girl had ever painted .	this person who should only know that girl had ever painted .
only these toys that those men had cleaned have ever dropped .	these toys that only those men had cleaned have ever dropped .
only this girl who had heard this turtle would ever throw those rings .	this girl who had only heard this turtle would ever throw those rings .
only those guys who have waved should ever teach those men .	those guys who have only waved should ever teach those men .
only the dogs that the ladies must talk about should ever break those bags .	the dogs that only the ladies must talk about should ever break those bags .
only this guy that the queen would talk about has ever learned .	this guy that only the queen would talk about has ever learned .
only this man who this person will hear had ever thrown the bowl .	this man who only this person will hear had ever thrown the bowl .
only the ladies who have moved that picture have ever painted .	the ladies who have only moved that picture have ever painted .
only this customer that had heard that teacher should ever like that spoon .	this customer that had only heard that teacher should ever like that spoon .
only this doctor who has talked about those boats would ever hear this rabbit .	this doctor who has only talked about those boats would ever hear this rabbit .
only those men who must pass this room can ever win .	those men who must only pass this room can ever win .
only the lady who may buy this dish would ever hear that driver .	the lady who may only buy this dish would ever hear that driver .
only that man who could talk about the button had ever brought these windows .	that man who could only talk about the button had ever brought these windows .
only that doctor that that man had thought about would ever break the rings .	that doctor that only that man had thought about would ever break the rings .
only this glass that had rolled away would ever roll away .	this glass that had only rolled away would ever roll away .
only the person who may return to this school will ever smile .	the person who may only return to this school will ever smile .
only that lady who had waved had ever read .	that lady who had only waved had ever read .
only that dentist who must scream has ever lost .	that dentist who must only scream has ever lost .
only the patient that that person should know had ever remembered the plates .	the patient that only that person should know had ever remembered the plates .
only this guy who would lie will ever find that ship .	this guy who would only lie will ever find that ship .
only this woman who may lift this dish had ever talked about the crayon .	this woman who may only lift this dish had ever talked about the crayon .
only the men who had laughed would ever lie .	the men who had only laughed would ever lie .
only that king who should see that car could ever sing .	that king who should only see that car could ever sing .
only the people who may make the bowls have ever fixed these crayons .	the people who may only make the bowls have ever fixed these crayons .
only the bag that has moved has ever rolled away .	the bag that has only moved has ever rolled away .
only these boys who may read could ever sell this book .	these boys who may only read could ever sell this book .
only these people that must learn could ever love the crayon .	these people that must only learn could ever love the crayon .
only that patient who can hear this dancer would ever return to this school .	that patient who can only hear this dancer would ever return to this school .
only that man who can laugh could ever smile .	that man who can only laugh could ever smile .
only the dogs that had thought about these doctors had ever eaten .	the dogs that had only thought about these doctors had ever eaten .
only those teachers who may think about that ship should ever listen to the teachers .	those teachers who may only think about that ship should ever listen to the teachers .
only this person who that teacher had talked about has ever read .	this person who only that teacher had talked about has ever read .
only this dancer who should hear that cat should ever cough .	this dancer who should only hear that cat should ever cough .
only the men who had walked through these schools have ever talked about this door .	the men who had only walked through these schools have ever talked about this door .
only that lady that the queen had heard had ever eaten .	that lady that only the queen had heard had ever eaten .
only these doctors who can hear those snakes can ever teach these women .	these doctors who can only hear those snakes can ever teach these women .
only this dentist who this girl could talk about will ever cry .	this dentist who only this girl could talk about will ever cry .
only the queen that had thought about the boy will ever forget the driver .	the queen that had only thought about the boy will ever forget the driver .
only that doll that that dentist has thought about had ever broken .	that doll that only that dentist has thought about had ever broken .
only the beds that these girls can fix can ever roll away .	the beds that only these girls can fix can ever roll away .
only the teacher who had talked about the hamster had ever bought those spoons .	the teacher who had only talked about the hamster had ever bought those spoons .
only that woman who this child would talk about should ever scare these children .	that woman who only this child would talk about should ever scare these children .
only those ladies who have lost those cups should ever make the pictures .	those ladies who have only lost those cups should ever make the pictures .
only that plane that the dancer might hate has ever moved .	that plane that only the dancer might hate has ever moved .
only those children who the doctors should talk about had ever yelled .	those children who only the doctors should talk about had ever yelled .
only the people who could think about those candles will ever shake this ship .	the people who could only think about those candles will ever shake this ship .
only this teacher who would stretch has ever laughed .	this teacher who would only stretch has ever laughed .
only that dancer who has walked through this museum will ever paint .	that dancer who has only walked through this museum will ever paint .
only the bottle that had dropped would ever drop .	the bottle that had only dropped would ever drop .
only this driver who has gone to that school could ever lie .	this driver who has only gone to that school could ever lie .
only that queen who the guy had heard had ever cleaned the plane .	that queen who only the guy had heard had ever cleaned the plane .
only these cars that have broken have ever rolled away .	these cars that have only broken have ever rolled away .
only the men who must remember these teachers had ever thrown the bottles .	the men who must only remember these teachers had ever thrown the bottles .
only the books that the teachers might think about had ever broken .	the books that only the teachers might think about had ever broken .
only these people who have remembered those books had ever held these toys .	these people who have only remembered those books had ever held these toys .
only the queen who had yelled has ever talked about those rings .	the queen who had only yelled has ever talked about those rings .
only the woman that that king may talk about has ever learned .	the woman that only that king may talk about has ever learned .
only those trucks that those boys had talked about should ever roll away .	those trucks that only those boys had talked about should ever roll away .
only the rings that the people had remembered could ever break .	the rings that only the people had remembered could ever break .
only that lady that the person has heard will ever notice the guy .	that lady that only the person has heard will ever notice the guy .
only this adult who would stretch has ever cried .	this adult who would only stretch has ever cried .
only the rabbits that should know this snake have ever grown .	the rabbits that should only know this snake have ever grown .
only the patient who this patient will look like had ever heard this girl .	the patient who only this patient will look like had ever heard this girl .
only this person who will notice that customer will ever make this glass .	this person who will only notice that customer will ever make this glass .
only the doctors who might hold the truck should ever stretch .	the doctors who might only hold the truck should ever stretch .
only these girls that will remember those boats will ever love the car .	these girls that will only remember those boats will ever love the car .
only this dentist who might smile had ever yelled .	this dentist who might only smile had ever yelled .
only that teacher who the adult must sound like had ever left the school .	that teacher who only the adult must sound like had ever left the school .
only that lady who had heard this bird has ever thrown those cars .	that lady who had only heard this bird has ever thrown those cars .
only the doctors who will sell the shirts could ever move the rocket .	the doctors who will only sell the shirts could ever move the rocket .
only that queen that this adult would talk about would ever eat .	that queen that only this adult would talk about would ever eat .
only that king that has heard the person should ever grow .	that king that has only heard the person should ever grow .
only the teachers who might cough could ever walk through this mall .	the teachers who might only cough could ever walk through this mall .
only those girls who these women can hear can ever talk about that queen .	those girls who only these women can hear can ever talk about that queen .
only those mice that the girls will see will ever break this crayon .	those mice that only the girls will see will ever break this crayon .
only this driver who might like the truck will ever find this ring .	this driver who might only like the truck will ever find this ring .
only that teacher who would talk about that box will ever scream .	that teacher who would only talk about that box will ever scream .
only that girl who has thought about the driver has ever lost that glass .	that girl who has only thought about the driver has ever lost that glass .
only the woman who had talked about the men will ever smile .	the woman who had only talked about the men will ever smile .
only that king who had heard the man had ever dropped this shirt .	that king who had only heard the man had ever dropped this shirt .
only these boys that would see this cup should ever run .	these boys that would only see this cup should ever run .
only the person who can leave the museum can ever teach these ladies .	the person who can only leave the museum can ever teach these ladies .
only the dancer who has talked about that adult will ever look like the person .	the dancer who has only talked about that adult will ever look like the person .
only the men who will talk about that car had ever read .	the men who will only talk about that car had ever read .
only the man who would return to these rooms will ever answer this driver .	the man who would only return to these rooms will ever answer this driver .
only the king who the patient has talked about can ever cry .	the king who only the patient has talked about can ever cry .
only that queen who has passed the hospital would ever whisper .	that queen who has only passed the hospital would ever whisper .
only that girl who may lie could ever shake the shoe .	that girl who may only lie could ever shake the shoe .
only these teachers who could buy the forks had ever taken that shoe .	these teachers who could only buy the forks had ever taken that shoe .
only this teacher that might run could ever run .	this teacher that might only run could ever run .
only those men who would see this lady can ever shake those windows .	those men who would only see this lady can ever shake those windows .
only the lady who should drop the box has ever moved those windows .	the lady who should only drop the box has ever moved those windows .
only this turtle that that dentist must talk about will ever love the ship .	this turtle that only that dentist must talk about will ever love the ship .
only that driver who this girl could hear could ever go to that library .	that driver who only this girl could hear could ever go to that library .
only the guy that might like the rings had ever seen these children .	the guy that might only like the rings had ever seen these children .
only this adult who that boy could sound like has ever bought the candle .	this adult who only that boy could sound like has ever bought the candle .
only the king who will see this dentist could ever yell .	the king who will only see this dentist could ever yell .
only the child who will yell should ever find that hat .	the child who will only yell should ever find that hat .
only that person who this dentist must talk about had ever bought that bag .	that person who only this dentist must talk about had ever bought that bag .
only these candles that could move should ever move .	these candles that could only move should ever move .
only this girl who the woman can know can ever take that hat .	this girl who only the woman can know can ever take that hat .
only this king that should remember the boxes should ever remember that dancer .	this king that should only remember the boxes should ever remember that dancer .
only that queen who the woman has talked about had ever taught these ladies .	that queen who only the woman has talked about had ever taught these ladies .
only those horses that can like that hamster should ever forget this child .	those horses that can only like that hamster should ever forget this child .
only the customer that had eaten has ever seen the bag .	the customer that had only eaten has ever seen the bag .
only the girl who could sound like this person should ever yell .	the girl who could only sound like this person should ever yell .
only this dentist who would talk about the bicycle had ever made this toy .	this dentist who would only talk about the bicycle had ever made this toy .
only these men who would think about those crayons would ever sing .	these men who would only think about those crayons would ever sing .
only the customer who can cough could ever return to this mall .	the customer who can only cough could ever return to this mall .
only those girls who those guys have talked about should ever drive to this museum .	those girls who only those guys have talked about should ever drive to this museum .
only that doll that the guy had thought about has ever rolled away .	that doll that only the guy had thought about has ever rolled away .
only these forks that these women had moved have ever dropped .	these forks that only these women had moved have ever dropped .
only the girls who had noticed those glasses have ever passed that mall .	the girls who had only noticed those glasses have ever passed that mall .
only that dentist who that lady has talked about has ever heard this driver .	that dentist who only that lady has talked about has ever heard this driver .
only the boys who had waved could ever yell .	the boys who had only waved could ever yell .
only this patient who has held those buttons could ever go to this mall .	this patient who has only held those buttons could ever go to this mall .
only the child that had thought about these shoes should ever grow .	the child that had only thought about these shoes should ever grow .
only the queen who could read has ever painted .	the queen who could only read has ever painted .
only that lady that the boy will talk about has ever run .	that lady that only the boy will talk about has ever run .
only those ladies who these guys had talked about should ever talk about those ladies .	those ladies who only these guys had talked about should ever talk about those ladies .
only these women who have moved the plate have ever painted .	these women who have only moved the plate have ever painted .
only these people that these boys have heard had ever noticed these glasses .	these people that only these boys have heard had ever noticed these glasses .
only that driver who had made those crayons can ever read .	that driver who had only made those crayons can ever read .
only the shoes that these children have kept should ever drop .	the shoes that only these children have kept should ever drop .
only those people who will talk about those boys will ever appreciate the doctors .	those people who will only talk about those boys will ever appreciate the doctors .
only the guys who had noticed that hat should ever sing .	the guys who had only noticed that hat should ever sing .
only this doctor who this child can talk about can ever cough .	this doctor who only this child can talk about can ever cough .
only this chair that the dentist has remembered has ever broken the bottles .	this chair that only the dentist has remembered has ever broken the bottles .
only this box that the person would like had ever moved .	this box that only the person would like had ever moved .
only those teachers that will like these horses should ever run .	those teachers that will only like these horses should ever run .
only that doctor who has noticed the cars has ever heard these women .	that doctor who has only noticed the cars has ever heard these women .
only these girls who have remembered these crayons can ever hear that snake .	these girls who have only remembered these crayons can ever hear that snake .
only that horse that might sound like those horses can ever learn .	that horse that might only sound like those horses can ever learn .
only the dancer who has painted could ever help that boy .	the dancer who has only painted could ever help that boy .
only the man who that woman can know had ever found that customer .	the man who only that woman can know had ever found that customer .
only this customer that would love those doors would ever grow .	this customer that would only love those doors would ever grow .
only the bag that that lady has talked about can ever move .	the bag that only that lady has talked about can ever move .
only the lady who must lose would ever listen to that patient .	the lady who must only lose would ever listen to that patient .
only the guys who can notice the cats had ever talked about these books .	the guys who can only notice the cats had ever talked about these books .
only this driver who this king had talked about should ever sneeze .	this driver who only this king had talked about should ever sneeze .
only those doctors who can fix these trucks could ever sound like the dancer .	those doctors who can only fix these trucks could ever sound like the dancer .
only this adult who has dropped the rocket could ever sound like the girls .	this adult who has only dropped the rocket could ever sound like the girls .
only that patient who can steal the fork would ever sneeze .	that patient who can only steal the fork would ever sneeze .
only those dishes that would break should ever break .	those dishes that would only break should ever break .
only this queen who had talked had ever lost those cups .	this queen who had only talked had ever lost those cups .
only these doctors that had run could ever learn .	these doctors that had only run could ever learn .
only that man who has lost these shoes has ever brought those doors .	that man who has only lost these shoes has ever brought those doors .
only that child that the boy had seen will ever break these cups .	that child that only the boy had seen will ever break these cups .
only the candle that that guy has brought could ever break .	the candle that only that guy has brought could ever break .
only those ladies who could talk about that boy have ever helped the girls .	those ladies who could only talk about that boy have ever helped the girls .
only these dolls that had dropped have ever rolled away .	these dolls that had only dropped have ever rolled away .
only that girl who will sound like these doctors would ever read .	that girl who will only sound like these doctors would ever read .
only that hat that that child will remember has ever moved .	that hat that only that child will remember has ever moved .
only this doll that must drop has ever dropped .	this doll that must only drop has ever dropped .
only these children who those boys will talk about have ever heard these guys .	these children who only those boys will talk about have ever heard these guys .
only that shoe that the dancer had seen had ever broken the book .	that shoe that only the dancer had seen had ever broken the book .
only the customer who had brought the bowls has ever laughed .	the customer who had only brought the bowls has ever laughed .
only that person who had run around this park has ever talked .	that person who had only run around this park has ever talked .
only the people who will paint had ever answered the men .	the people who will only paint had ever answered the men .
only the dancer who will like that bottle could ever praise these women .	the dancer who will only like that bottle could ever praise these women .
only the men who have seen that spoon would ever sell that shoe .	the men who have only seen that spoon would ever sell that shoe .
only those people who must forget those cups have ever painted .	those people who must only forget those cups have ever painted .
only those boats that have broken would ever drop .	those boats that have only broken would ever drop .
only these girls who have talked about those toys could ever exercise .	these girls who have only talked about those toys could ever exercise .
only that king who has talked about that hamster has ever yelled .	that king who has only talked about that hamster has ever yelled .
only that child who had lost the crayons would ever scare that teacher .	that child who had only lost the crayons would ever scare that teacher .
only that person that this adult had talked about has ever thought about these ladies .	that person that only this adult had talked about has ever thought about these ladies .
only those plates that these snakes will like had ever rolled away .	those plates that only these snakes will like had ever rolled away .
only the doctors who have fixed these boats can ever whisper .	the doctors who have only fixed these boats can ever whisper .
only this mirror that will break should ever break .	this mirror that will only break should ever break .
only this mouse that has heard that cat had ever seen the boats .	this mouse that has only heard that cat had ever seen the boats .
only those children who the teachers would sound like can ever keep those plates .	those children who only the teachers would sound like can ever keep those plates .
only that man that had noticed the child has ever learned .	that man that had only noticed the child has ever learned .
only the doctor who would talk will ever stretch .	the doctor who would only talk will ever stretch .
only the bird that the doctor has remembered will ever break the windows .	the bird that only the doctor has remembered will ever break the windows .
only this girl who has seen the bottles has ever bothered these ladies .	this girl who has only seen the bottles has ever bothered these ladies .
only that lady who could paint would ever keep that window .	that lady who could only paint would ever keep that window .
only these children that had seen these dishes had ever grown .	these children that had only seen these dishes had ever grown .
only these ladies who those ladies can hear can ever whisper .	these ladies who only those ladies can hear can ever whisper .
only this dancer who would know this dancer would ever talk .	this dancer who would only know this dancer would ever talk .
only that turtle that has eaten has ever learned .	that turtle that has only eaten has ever learned .
only that dish that this girl has talked about could ever roll away .	that dish that only this girl has talked about could ever roll away .
only this queen who has made those books would ever listen to the boy .	this queen who has only made those books would ever listen to the boy .
only this plane that the customer should think about could ever break those chairs .	this plane that only the customer should think about could ever break those chairs .
only that rocket that that child may talk about should ever break .	that rocket that only that child may talk about should ever break .
only that guy that would learn will ever grow .	that guy that would only learn will ever grow .
only this woman that that man will know has ever eaten .	this woman that only that man will know has ever eaten .
only those ladies who those men should look like will ever take this window .	those ladies who only those men should look like will ever take this window .
only that child who might forget those buttons can ever look like that dancer .	that child who might only forget those buttons can ever look like that dancer .
only this teacher who the child could look like has ever confused these children .	this teacher who only the child could look like has ever confused these children .
only the adult who had found this fork would ever lose .	the adult who had only found this fork would ever lose .
only the men who may laugh could ever have the dolls .	the men who may only laugh could ever have the dolls .
only the candle that this turtle has seen will ever roll away .	the candle that only this turtle has seen will ever roll away .
only the boys who must run around that room can ever run around this library .	the boys who must only run around that room can ever run around this library .
only this lady who that person would know should ever stretch .	this lady who only that person would know should ever stretch .
only this bottle that would drop had ever dropped .	this bottle that would only drop had ever dropped .
only these women who should like these women had ever scared that girl .	these women who should only like these women had ever scared that girl .
only this doll that that dentist has noticed has ever rolled away .	this doll that only that dentist has noticed has ever rolled away .
only these ladies who the boys could sound like should ever lift those beds .	these ladies who only the boys could sound like should ever lift those beds .
only the dogs that can love the windows have ever seen the guy .	the dogs that can only love the windows have ever seen the guy .
only that lady who has noticed those boys has ever thrown the fork .	that lady who has only noticed those boys has ever thrown the fork .
only this fork that that dancer had found could ever break .	this fork that only that dancer had found could ever break .
only these windows that those teachers can like can ever roll away .	these windows that only those teachers can like can ever roll away .
only the women who must like those girls could ever return to these rooms .	the women who must only like those girls could ever return to these rooms .
only the teachers that should love this button should ever eat .	the teachers that should only love this button should ever eat .
only that fork that that lady had kept had ever rolled away .	that fork that only that lady had kept had ever rolled away .
only that candle that that customer will hate would ever roll away .	that candle that only that customer will hate would ever roll away .
only the women who can whisper would ever care for the ladies .	the women who can only whisper would ever care for the ladies .
only this bed that has rolled away would ever break .	this bed that has only rolled away would ever break .
only this lady who should leave the rooms could ever cough .	this lady who should only leave the rooms could ever cough .
only that guy who should hear this king has ever made the dolls .	that guy who should only hear this king has ever made the dolls .
only that driver who this man might hear could ever appreciate that person .	that driver who only this man might hear could ever appreciate that person .
only that teacher that must eat had ever seen the doll .	that teacher that must only eat had ever seen the doll .
only these teachers who will fix this bag will ever talk about these horses .	these teachers who will only fix this bag will ever talk about these horses .
only those ladies who have seen the snake should ever take this cup .	those ladies who have only seen the snake should ever take this cup .
only this dentist who might win will ever worry the person .	this dentist who might only win will ever worry the person .
only the child who could lose can ever stretch .	the child who could only lose can ever stretch .
only this car that would drop has ever broken .	this car that would only drop has ever broken .
only the girls who had fixed that crayon had ever worried these ladies .	the girls who had only fixed that crayon had ever worried these ladies .
only these people who these boys would know have ever bothered the child .	these people who only these boys would know have ever bothered the child .
only that bag that may roll away has ever dropped .	that bag that may only roll away has ever dropped .
only those children who had thought about these shoes can ever keep those shirts .	those children who had only thought about these shoes can ever keep those shirts .
only the boy who had noticed that boy can ever look like that lady .	the boy who had only noticed that boy can ever look like that lady .
only this cat that may notice these windows would ever eat .	this cat that may only notice these windows would ever eat .
only that lady who must forget the cats has ever taught this girl .	that lady who must only forget the cats has ever taught this girl .
only this person that will see the women has ever eaten .	this person that will only see the women has ever eaten .
only the guys who would talk about the cup would ever stretch .	the guys who would only talk about the cup would ever stretch .
only this man who this lady should talk about should ever run around the mall .	this man who only this lady should talk about should ever run around the mall .
only those boxes that the horses might remember could ever move .	those boxes that only the horses might remember could ever move .
only the men who would love that dentist had ever helped this girl .	the men who would only love that dentist had ever helped this girl .
only the adult who the queen might look like had ever taught the girls .	the adult who only the queen might look like had ever taught the girls .
only these turtles that had grown would ever grow .	these turtles that had only grown would ever grow .
only the teacher that may think about these dolls had ever seen these cars .	the teacher that may only think about these dolls had ever seen these cars .
only that hamster that the teacher had talked about had ever learned .	that hamster that only the teacher had talked about had ever learned .
only the books that may roll away have ever broken .	the books that may only roll away have ever broken .
only this driver who should cough has ever lost that customer .	this driver who should only cough has ever lost that customer .
only the guy who should walk through this restaurant could ever sneeze .	the guy who should only walk through this restaurant could ever sneeze .
only the women who had lost should ever scream .	the women who had only lost should ever scream .
only the people who had found the bowl would ever buy these bowls .	the people who had only found the bowl would ever buy these bowls .
only those women who those guys may talk about should ever buy this book .	those women who only those guys may talk about should ever buy this book .
only this child that this patient might hear would ever hate the fork .	this child that only this patient might hear would ever hate the fork .
only the dancer who might scream will ever talk about that dentist .	the dancer who might only scream will ever talk about that dentist .
only the boys who may walk through the library would ever hold the cars .	the boys who may only walk through the library would ever hold the cars .
only the boy who should take that plate had ever read .	the boy who should only take that plate had ever read .
only the child who that dancer has heard will ever scream .	the child who only that dancer has heard will ever scream .
only the dancer who this man might talk about will ever hold those dolls .	the dancer who only this man might talk about will ever hold those dolls .
only the people who can look like the lady will ever exercise .	the people who can only look like the lady will ever exercise .
only that driver who would walk through the hospital has ever cleaned the doors .	that driver who would only walk through the hospital has ever cleaned the doors .
only the women who these children had heard can ever fix that door .	the women who only these children had heard can ever fix that door .
only the dentist who can hear these dogs can ever lose the candle .	the dentist who can only hear these dogs can ever lose the candle .
only this candle that the doctor might find had ever broken .	this candle that only the doctor might find had ever broken .
only these teachers who will talk about this dancer can ever throw this shirt .	these teachers who will only talk about this dancer can ever throw this shirt .
only the driver who had lost would ever cough .	the driver who had only lost would ever cough .
only this boy who has left this library has ever dropped that fork .	this boy who has only left this library has ever dropped that fork .
only that patient who can run around those schools has ever dropped this car .	that patient who can only run around those schools has ever dropped this car .
only these doctors who may sound like that king have ever yelled .	these doctors who may only sound like that king have ever yelled .
only that dentist who the dentist had heard has ever heard those horses .	that dentist who only the dentist had heard has ever heard those horses .
only these rings that the men have kept had ever moved .	these rings that only the men have kept had ever moved .
only the guy that has learned can ever learn .	the guy that has only learned can ever learn .
only that woman who might love that shirt should ever bother this boy .	that woman who might only love that shirt should ever bother this boy .
only the dogs that can think about these horses had ever thought about the bottles .	the dogs that can only think about these horses had ever thought about the bottles .
only those dishes that these boys would like can ever break these hats .	those dishes that only these boys would like can ever break these hats .
only this dentist who that driver has heard has ever left the kitchen .	this dentist who only that driver has heard has ever left the kitchen .
only that customer who can yell has ever read .	that customer who can only yell has ever read .
only that dog that that patient must hear had ever thought about this patient .	that dog that only that patient must hear had ever thought about this patient .
only these women who might remember that candle should ever read .	these women who might only remember that candle should ever read .
only the mouse that should sound like this woman would ever see this spoon .	the mouse that should only sound like this woman would ever see this spoon .
only the guy who has thought about those bowls could ever drive to that school .	the guy who has only thought about those bowls could ever drive to that school .
only the crayons that these mice will see can ever roll away .	the crayons that only these mice will see can ever roll away .
only these dishes that may move have ever rolled away .	these dishes that may only move have ever rolled away .
only those guys that had noticed those beds should ever notice these cars .	those guys that had only noticed those beds should ever notice these cars .
only these people who might hear these teachers had ever taken the book .	these people who might only hear these teachers had ever taken the book .
only those teachers who must think about that shirt will ever appreciate the patient .	those teachers who must only think about that shirt will ever appreciate the patient .
only those women who have talked about that bicycle could ever appreciate the teachers .	those women who have only talked about that bicycle could ever appreciate the teachers .
only the adult who may run around the kitchen will ever know the hamster .	the adult who may only run around the kitchen will ever know the hamster .
only that shirt that the child would remember has ever broken these toys .	that shirt that only the child would remember has ever broken these toys .
only those toys that the people have found should ever roll away .	those toys that only the people have found should ever roll away .
only these children who could laugh should ever keep the beds .	these children who could only laugh should ever keep the beds .
only this person who might leave the hospital had ever found that shoe .	this person who might only leave the hospital had ever found that shoe .
only the woman who has held that button will ever worry this king .	the woman who has only held that button will ever worry this king .
only these teachers who would practice had ever gone to the park .	these teachers who would only practice had ever gone to the park .
only that man who has remembered that book has ever waved .	that man who has only remembered that book has ever waved .
only this boy who may sound like the rabbit should ever paint .	this boy who may only sound like the rabbit should ever paint .
only the girls who had talked about the truck have ever lost these cars .	the girls who had only talked about the truck have ever lost these cars .
only those children who have talked about the doctor have ever confused the person .	those children who have only talked about the doctor have ever confused the person .
only those doors that can drop have ever moved .	those doors that can only drop have ever moved .
only the plate that has dropped had ever broken .	the plate that has only dropped had ever broken .
only that woman who has fixed this rocket could ever make this shoe .	that woman who has only fixed this rocket could ever make this shoe .
only the dancer who the lady would know could ever sing .	the dancer who only the lady would know could ever sing .
only the horse that should learn should ever run .	the horse that should only learn should ever run .
only that doctor who has remembered these cars could ever find this crayon .	that doctor who has only remembered these cars could ever find this crayon .
only the ladies who had held those doors should ever make those glasses .	the ladies who had only held those doors should ever make those glasses .
only the men who had remembered these bottles could ever understand this guy .	the men who had only remembered these bottles could ever understand this guy .
only the man that had noticed these hats should ever see these books .	the man that had only noticed these hats should ever see these books .
only that king who had passed those schools has ever heard this child .	that king who had only passed those schools has ever heard this child .
only the bed that the turtle could notice had ever broken this bowl .	the bed that only the turtle could notice had ever broken this bowl .
only the child who had made this dish would ever keep this book .	the child who had only made this dish would ever keep this book .
only this patient that could look like this driver would ever learn .	this patient that could only look like this driver would ever learn .
only this teacher who has cried would ever sing .	this teacher who has only cried would ever sing .
only those doctors who the people have talked about should ever understand those ladies .	those doctors who only the people have talked about should ever understand those ladies .
only the guys that have run should ever forget those doors .	the guys that have only run should ever forget those doors .
only that woman who will read could ever scream .	that woman who will only read could ever scream .
only that man that this queen would talk about had ever grown .	that man that only this queen would talk about had ever grown .
only the customer who had thought about the adult will ever talk .	the customer who had only thought about the adult will ever talk .
only that book that will break would ever break .	that book that will only break would ever break .
only the child who could scream can ever stretch .	the child who could only scream can ever stretch .
only this child that may notice this mouse should ever eat .	this child that may only notice this mouse should ever eat .
only the women who have heard that patient would ever teach the men .	the women who have only heard that patient would ever teach the men .
only the person who would hold this mirror can ever scare this man .	the person who would only hold this mirror can ever scare this man .
only the driver who that driver can know could ever fix those windows .	the driver who only that driver can know could ever fix those windows .
only that dancer that that lady will look like had ever remembered the box .	that dancer that only that lady will look like had ever remembered the box .
only this boy who could cry can ever buy the beds .	this boy who could only cry can ever buy the beds .
only those people who have run around that bank had ever visited the person .	those people who have only run around that bank had ever visited the person .
only this queen who might like these women would ever laugh .	this queen who might only like these women would ever laugh .
only that person who must keep that ring has ever confused that queen .	that person who must only keep that ring has ever confused that queen .
only those guys who could win had ever bought this shoe .	those guys who could only win had ever bought this shoe .
only that child who should lie had ever found the candles .	that child who should only lie had ever found the candles .
only the doctors who should hold these spoons had ever visited those ladies .	the doctors who should only hold these spoons had ever visited those ladies .
only this mouse that can learn had ever learned .	this mouse that can only learn had ever learned .
only this doctor who this dentist had heard had ever lost .	this doctor who only this dentist had heard had ever lost .
only that bicycle that may move has ever moved .	that bicycle that may only move has ever moved .
only the horses that had remembered this lady have ever remembered the girls .	the horses that had only remembered this lady have ever remembered the girls .
only this adult who had talked about that customer could ever talk .	this adult who had only talked about that customer could ever talk .
only that ship that this woman has remembered could ever roll away .	that ship that only this woman has remembered could ever roll away .
only this person who may talk about that car can ever go to this library .	this person who may only talk about that car can ever go to this library .
only the adult that has remembered these spoons will ever like this fork .	the adult that has only remembered these spoons will ever like this fork .
only that king who this boy could talk about had ever held the car .	that king who only this boy could talk about had ever held the car .
only the guy who could cough will ever drop the cars .	the guy who could only cough will ever drop the cars .
only those doctors who can talk about that boy have ever passed these rooms .	those doctors who can only talk about that boy have ever passed these rooms .
only that spoon that the driver has thought about has ever broken .	that spoon that only the driver has thought about has ever broken .
only this driver who can find this toy should ever understand these people .	this driver who can only find this toy should ever understand these people .
only the lady who had waved will ever hear this driver .	the lady who had only waved will ever hear this driver .
only this boat that that adult will think about has ever broken the book .	this boat that only that adult will think about has ever broken the book .
only this patient who the teacher may talk about would ever worry the dancer .	this patient who only the teacher may talk about would ever worry the dancer .
only the queen who could bring this ring would ever clean that truck .	the queen who could only bring this ring would ever clean that truck .
only the dentist who the doctor might talk about would ever answer these boys .	the dentist who only the doctor might talk about would ever answer these boys .
only those bags that have broken could ever drop .	those bags that have only broken could ever drop .
only this doctor that must hate this dentist has ever thought about this king .	this doctor that must only hate this dentist has ever thought about this king .
only these glasses that these teachers would remember had ever rolled away .	these glasses that only these teachers would remember had ever rolled away .
only the girl who this patient has heard should ever wave .	the girl who only this patient has heard should ever wave .
only this customer who had seen those turtles will ever walk through this restaurant .	this customer who had only seen those turtles will ever walk through this restaurant .
only that dentist that had heard this child had ever run .	that dentist that had only heard this child had ever run .
only the people who must hear these girls can ever bring that door .	the people who must only hear these girls can ever bring that door .
only the dancer who must know these turtles will ever laugh .	the dancer who must only know these turtles will ever laugh .
only that book that this patient has remembered had ever dropped .	that book that only this patient has remembered had ever dropped .
only the boys that can love the rabbits should ever think about the forks .	the boys that can only love the rabbits should ever think about the forks .
only those men who have read had ever talked .	those men who have only read had ever talked .
only this man who would sell those books should ever lose .	this man who would only sell those books should ever lose .
only that man who could take the glass should ever sell those spoons .	that man who could only take the glass should ever sell those spoons .
only those girls who had noticed the teachers had ever walked through the schools .	those girls who had only noticed the teachers had ever walked through the schools .
only this car that that guy had talked about would ever move .	this car that only that guy had talked about would ever move .
only those forks that those children might hold will ever move .	those forks that only those children might hold will ever move .
only those boys who must whisper would ever sneeze .	those boys who must only whisper would ever sneeze .
only that man who could drive to the library will ever teach that customer .	that man who could only drive to the library will ever teach that customer .
only these girls who have heard those men had ever won .	these girls who have only heard those men had ever won .
only the cats that may forget this doctor have ever run .	the cats that may only forget this doctor have ever run .
only that woman who had lost the plane could ever read .	that woman who had only lost the plane could ever read .
only these ladies that may sound like that lady have ever grown .	these ladies that may only sound like that lady have ever grown .
only this car that this child will buy had ever dropped .	this car that only this child will buy had ever dropped .
only the girl who might pass that mall will ever throw those toys .	the girl who might only pass that mall will ever throw those toys .
only this woman who that boy must hear has ever kept these pictures .	this woman who only that boy must hear has ever kept these pictures .
only this lady who must lose these bowls can ever scream .	this lady who must only lose these bowls can ever scream .
only this car that that patient has talked about has ever dropped .	this car that only that patient has talked about has ever dropped .
only that queen who that child would talk about will ever run around those schools .	that queen who only that child would talk about will ever run around those schools .
only those shirts that had rolled away had ever rolled away .	those shirts that had only rolled away had ever rolled away .
only the chair that that guy has held could ever break .	the chair that only that guy has held could ever break .
only the shirts that would roll away have ever moved .	the shirts that would only roll away have ever moved .
only the candle that this dancer had remembered had ever rolled away .	the candle that only this dancer had remembered had ever rolled away .
only those snakes that could learn had ever noticed those bowls .	those snakes that could only learn had ever noticed those bowls .
only that ring that can drop can ever drop .	that ring that can only drop can ever drop .
only the boy that the man had heard had ever run .	the boy that only the man had heard had ever run .
only that spoon that the turtle might remember has ever broken .	that spoon that only the turtle might remember has ever broken .
only this hat that has broken could ever break .	this hat that has only broken could ever break .
only the teacher that the guy had heard should ever learn .	the teacher that only the guy had heard should ever learn .
only these horses that the children should hear have ever learned .	these horses that only the children should hear have ever learned .
only that king who had noticed this snake should ever praise that man .	that king who had only noticed this snake should ever praise that man .
only this girl that has eaten would ever learn .	this girl that has only eaten would ever learn .
only those doctors who had noticed that dish could ever leave these schools .	those doctors who had only noticed that dish could ever leave these schools .
only these books that these people might remember had ever broken the boat .	these books that only these people might remember had ever broken the boat .
only that cat that can learn will ever grow .	that cat that can only learn will ever grow .
only the doctors that have run could ever eat .	the doctors that have only run could ever eat .
only the horse that has learned would ever hate that bicycle .	the horse that has only learned would ever hate that bicycle .
only this bed that had rolled away had ever moved .	this bed that had only rolled away had ever moved .
only the men who would like the chair have ever thrown that bed .	the men who would only like the chair have ever thrown that bed .
only this driver who will remember these dishes should ever run around the bank .	this driver who will only remember these dishes should ever run around the bank .
only the bag that the doctor had remembered can ever break .	the bag that only the doctor had remembered can ever break .
only these people who those people have talked about have ever lost this boy .	these people who only those people have talked about have ever lost this boy .
only this picture that had rolled away has ever rolled away .	this picture that had only rolled away has ever rolled away .
only these children who those teachers had talked about should ever wave .	these children who only those teachers had talked about should ever wave .
only the boys who should hate that king would ever lose these cars .	the boys who should only hate that king would ever lose these cars .
only the adult who should win should ever worry that doctor .	the adult who should only win should ever worry that doctor .
only these teachers who have heard those boys will ever practice .	these teachers who have only heard those boys will ever practice .
only that turtle that could hate the cars has ever eaten .	that turtle that could only hate the cars has ever eaten .
only that patient who this queen might talk about could ever have those bags .	that patient who only this queen might talk about could ever have those bags .
only the queen who that boy had heard has ever lost that door .	the queen who only that boy had heard has ever lost that door .
only those toys that must drop had ever moved .	those toys that must only drop had ever moved .
only that bottle that this patient would talk about has ever broken the plate .	that bottle that only this patient would talk about has ever broken the plate .
only these boys who have taken that book could ever leave the room .	these boys who have only taken that book could ever leave the room .
only this girl who the customer has heard will ever fix this ship .	this girl who only the customer has heard will ever fix this ship .
only the children that may think about this woman have ever eaten .	the children that may only think about this woman have ever eaten .
only the teachers who should whisper could ever move that candle .	the teachers who should only whisper could ever move that candle .
only that girl who had bought this rug has ever gone to the mall .	that girl who had only bought this rug has ever gone to the mall .
only the man who has made those bowls had ever confused those people .	the man who has only made those bowls had ever confused those people .
only that doll that has dropped could ever drop .	that doll that has only dropped could ever drop .
only those children who could look like these mice had ever taught this queen .	those children who could only look like these mice had ever taught this queen .
only the teachers who must see this child will ever teach this child .	the teachers who must only see this child will ever teach this child .
only the boys who can think about these books will ever work with that driver .	the boys who can only think about these books will ever work with that driver .
only that king who would sell that doll can ever win .	that king who would only sell that doll can ever win .
only the dog that has heard these girls had ever thought about this chair .	the dog that has only heard these girls had ever thought about this chair .
only this bed that that driver has talked about had ever broken .	this bed that only that driver has talked about had ever broken .
only this adult who that person can sound like had ever won .	this adult who only that person can sound like had ever won .
only that man that that patient should talk about has ever thought about the plates .	that man that only that patient should talk about has ever thought about the plates .
only this turtle that would eat can ever learn .	this turtle that would only eat can ever learn .
only those snakes that have heard this lady had ever thought about these cats .	those snakes that have only heard this lady had ever thought about these cats .
only the button that had rolled away has ever rolled away .	the button that had only rolled away has ever rolled away .
only the birds that can remember that plane have ever learned .	the birds that can only remember that plane have ever learned .
only the book that this child has bought would ever roll away .	the book that only this child has bought would ever roll away .
only the doctors who could sneeze would ever talk about the box .	the doctors who could only sneeze would ever talk about the box .
only this rocket that this dentist had bought will ever roll away .	this rocket that only this dentist had bought will ever roll away .
only the boys who must forget the shoes can ever practice .	the boys who must only forget the shoes can ever practice .
only that dentist who that person could talk about can ever laugh .	that dentist who only that person could talk about can ever laugh .
only that person who this guy might sound like had ever left this mall .	that person who only this guy might sound like had ever left this mall .
only this patient that must know this bird can ever grow .	this patient that must only know this bird can ever grow .
only the lady who had dropped these cups could ever hold this bag .	the lady who had only dropped these cups could ever hold this bag .
only that customer who could think about that plane has ever lost this couch .	that customer who could only think about that plane has ever lost this couch .
only this turtle that the girl might talk about can ever remember this dish .	this turtle that only the girl might talk about can ever remember this dish .
only these doctors who had remembered those bottles have ever dropped the candle .	these doctors who had only remembered those bottles have ever dropped the candle .
only these children who must steal that glass should ever cry .	these children who must only steal that glass should ever cry .
only this child that this teacher has remembered will ever break these boxes .	this child that only this teacher has remembered will ever break these boxes .
only that spoon that this lady had moved will ever drop .	that spoon that only this lady had moved will ever drop .
only this queen who could forget these hats will ever return to this restaurant .	this queen who could only forget these hats will ever return to this restaurant .
only these people that could think about the boy should ever grow .	these people that could only think about the boy should ever grow .
only the patient who will talk about this crayon has ever painted .	the patient who will only talk about this crayon has ever painted .
only this turtle that that customer had heard will ever run .	this turtle that only that customer had heard will ever run .
only the snakes that those men had seen have ever broken that ring .	the snakes that only those men had seen have ever broken that ring .
only this girl who had yelled had ever moved those forks .	this girl who had only yelled had ever moved those forks .
only these doctors who would go to those rooms have ever won .	these doctors who would only go to those rooms have ever won .
only these men who the teachers have heard would ever teach that guy .	these men who only the teachers have heard would ever teach that guy .
only these teachers who could drive to these rooms have ever painted .	these teachers who could only drive to these rooms have ever painted .
only the women who will love that ship should ever scream .	the women who will only love that ship should ever scream .
only the teacher who had painted had ever yelled .	the teacher who had only painted had ever yelled .
only that king who the queen will talk about can ever scare the woman .	that king who only the queen will talk about can ever scare the woman .
only that king who this boy had talked about would ever go to that kitchen .	that king who only this boy had talked about would ever go to that kitchen .
only these shoes that those men had thrown would ever drop .	these shoes that only those men had thrown would ever drop .
only the driver that this guy would know could ever see the bird .	the driver that only this guy would know could ever see the bird .
only this dancer who could make the window has ever heard that bird .	this dancer who could only make the window has ever heard that bird .
only the lady who may lift this mirror should ever sneeze .	the lady who may only lift this mirror should ever sneeze .
only this car that will break had ever moved .	this car that will only break had ever moved .
only that bowl that the girl should talk about would ever break the bag .	that bowl that only the girl should talk about would ever break the bag .
only this girl that the dancer must know can ever run .	this girl that only the dancer must know can ever run .
only the fork that the man might sell has ever moved .	the fork that only the man might sell has ever moved .
only these teachers who had moved these spoons could ever whisper .	these teachers who had only moved these spoons could ever whisper .
only this dentist who had remembered that dog should ever read .	this dentist who had only remembered that dog should ever read .
only those doctors that the teachers had talked about can ever break that dish .	those doctors that only the teachers had talked about can ever break that dish .
only that driver that should eat had ever learned .	that driver that should only eat had ever learned .
only that man who the person may hear could ever pass the schools .	that man who only the person may hear could ever pass the schools .
only these mice that had noticed those people can ever eat .	these mice that had only noticed those people can ever eat .
only the children that have thought about this cup have ever run .	the children that have only thought about this cup have ever run .
only this lady who has taken this fork would ever practice .	this lady who has only taken this fork would ever practice .
only the patient who may notice the mice will ever win .	the patient who may only notice the mice will ever win .
only the girls who had seen the boat could ever cry .	the girls who had only seen the boat could ever cry .
only this teacher who had seen that boat should ever worry that patient .	this teacher who had only seen that boat should ever worry that patient .
only the birds that have grown have ever eaten .	the birds that have only grown have ever eaten .
only that dancer who the king should hear can ever praise the people .	that dancer who only the king should hear can ever praise the people .
only this customer who had remembered the ship should ever drop that ship .	this customer who had only remembered the ship should ever drop that ship .
only the teacher who had heard this snake would ever work with those people .	the teacher who had only heard this snake would ever work with those people .
only the guys who have talked about these rabbits will ever take the book .	the guys who have only talked about these rabbits will ever take the book .
only this boy that may hear that mouse could ever run .	this boy that may only hear that mouse could ever run .
only that picture that would break had ever moved .	that picture that would only break had ever moved .
only this child who the patient would sound like would ever whisper .	this child who only the patient would sound like would ever whisper .
only that doctor who has kept that button should ever move the ring .	that doctor who has only kept that button should ever move the ring .
only the girls who those guys must look like could ever lift this bottle .	the girls who only those guys must look like could ever lift this bottle .
only this turtle that had thought about those forks would ever learn .	this turtle that had only thought about those forks would ever learn .
only this guy who would remember the bicycle has ever cleaned that shoe .	this guy who would only remember the bicycle has ever cleaned that shoe .
only the horses that could run will ever grow .	the horses that could only run will ever grow .
only this doctor that will forget the shirts will ever notice that ship .	this doctor that will only forget the shirts will ever notice that ship .
only the chair that can break had ever rolled away .	the chair that can only break had ever rolled away .
only that window that has rolled away should ever break .	that window that has only rolled away should ever break .
only the snake that that rabbit can remember had ever broken that book .	the snake that only that rabbit can remember had ever broken that book .
only the mouse that had seen the rings will ever remember the doctor .	the mouse that had only seen the rings will ever remember the doctor .
only this dentist who the girl would look like would ever bother that girl .	this dentist who only the girl would look like would ever bother that girl .
only that person who had laughed can ever talk about the bags .	that person who had only laughed can ever talk about the bags .
only that child that this guy has heard can ever like those cups .	that child that only this guy has heard can ever like those cups .
only this guy who may hear this driver had ever taught the dentist .	this guy who may only hear this driver had ever taught the dentist .
only these people that could remember those snakes had ever thought about the horses .	these people that could only remember those snakes had ever thought about the horses .
only this bottle that that dancer had moved had ever rolled away .	this bottle that only that dancer had moved had ever rolled away .
only those children who may talk about that ship had ever heard these turtles .	those children who may only talk about that ship had ever heard these turtles .
only that girl who must pass this mall could ever worry that boy .	that girl who must only pass this mall could ever worry that boy .
only this patient who has left the schools had ever heard the rabbit .	this patient who has only left the schools had ever heard the rabbit .
only this dancer who had held this bottle should ever buy the books .	this dancer who had only held this bottle should ever buy the books .
only those teachers who had remembered those dolls can ever talk to the lady .	those teachers who had only remembered those dolls can ever talk to the lady .
only the turtles that could run have ever noticed these shoes .	the turtles that could only run have ever noticed these shoes .
only that patient who this lady had talked about could ever whisper .	that patient who only this lady had talked about could ever whisper .
only the dentist that can love this crayon had ever remembered this snake .	the dentist that can only love this crayon had ever remembered this snake .
only those doctors who would forget the driver have ever lost these boxes .	those doctors who would only forget the driver have ever lost these boxes .
only that guy who might read should ever sell these boxes .	that guy who might only read should ever sell these boxes .
only these girls who might fix the box could ever fix the boat .	these girls who might only fix the box could ever fix the boat .
only this picture that that doctor had seen has ever broken .	this picture that only that doctor had seen has ever broken .
only that doll that the driver has thought about has ever broken the trucks .	that doll that only the driver has thought about has ever broken the trucks .
only this doctor who should sound like those guys would ever visit the guy .	this doctor who should only sound like those guys would ever visit the guy .
only this dentist who has heard this customer can ever scream .	this dentist who has only heard this customer can ever scream .
only the boy who has heard that child could ever sneeze .	the boy who has only heard that child could ever sneeze .
only the hat that has rolled away should ever roll away .	the hat that has only rolled away should ever roll away .
only that shoe that can roll away had ever rolled away .	that shoe that can only roll away had ever rolled away .
only the guys that may look like this queen would ever think about this door .	the guys that may only look like this queen would ever think about this door .
only these teachers that could run had ever noticed the boy .	these teachers that could only run had ever noticed the boy .
only the girl who must hear that hamster had ever moved the bowls .	the girl who must only hear that hamster had ever moved the bowls .
only that dentist that can learn has ever thought about this cat .	that dentist that can only learn has ever thought about this cat .
only that lady who should see that shoe had ever talked about those girls .	that lady who should only see that shoe had ever talked about those girls .
only those boats that these women had brought should ever move .	those boats that only these women had brought should ever move .
only that customer that has heard the lady has ever remembered those windows .	that customer that has only heard the lady has ever remembered those windows .
only that bicycle that that bird must forget had ever broken this boat .	that bicycle that only that bird must forget had ever broken this boat .
only that picture that the queen had talked about has ever broken .	that picture that only the queen had talked about has ever broken .
only those men who have remembered this boat can ever buy those bags .	those men who have only remembered this boat can ever buy those bags .
only these boys who might stretch have ever found that customer .	these boys who might only stretch have ever found that customer .
only this ring that this customer must talk about has ever moved .	this ring that only this customer must talk about has ever moved .
only these boys who will leave the hospital can ever sound like that dancer .	these boys who will only leave the hospital can ever sound like that dancer .
only the boy who has thought about this bed should ever yell .	the boy who has only thought about this bed should ever yell .
only this box that that snake might think about could ever break .	this box that only that snake might think about could ever break .
only that bottle that the man would think about has ever dropped .	that bottle that only the man would think about has ever dropped .
only that dog that has grown has ever run .	that dog that has only grown has ever run .
only this girl who this doctor might sound like had ever scared this girl .	this girl who only this doctor might sound like had ever scared this girl .
only this button that that hamster would see has ever rolled away .	this button that only that hamster would see has ever rolled away .
only the cups that these birds had thought about had ever broken .	the cups that only these birds had thought about had ever broken .
only the queen who can move this toy has ever answered those girls .	the queen who can only move this toy has ever answered those girls .
only the books that had broken can ever move .	the books that had only broken can ever move .
only these teachers who may fix this glass have ever lost those ladies .	these teachers who may only fix this glass have ever lost those ladies .
only that adult who has moved that button should ever smile .	that adult who has only moved that button should ever smile .
only these books that have moved should ever break .	these books that have only moved should ever break .
only this adult who might like this king would ever cry .	this adult who might only like this king would ever cry .
only the boy who has heard that customer had ever brought the buttons .	the boy who has only heard that customer had ever brought the buttons .
only these bottles that those mice might think about would ever drop .	these bottles that only those mice might think about would ever drop .
only those ladies that had learned have ever grown .	those ladies that had only learned have ever grown .
only this girl who will forget the bags should ever drop that shirt .	this girl who will only forget the bags should ever drop that shirt .
only the king who would love that mouse has ever worried the patient .	the king who would only love that mouse has ever worried the patient .
only those women who can talk about this boy have ever helped this king .	those women who can only talk about this boy have ever helped this king .
only that box that the turtle had thought about has ever dropped .	that box that only the turtle had thought about has ever dropped .
only these children who these ladies might know should ever make this box .	these children who only these ladies might know should ever make this box .
only the customer who must remember those books would ever sing .	the customer who must only remember those books would ever sing .
only that man who could see the bird will ever throw these pictures .	that man who could only see the bird will ever throw these pictures .
only the men who would exercise had ever lost .	the men who would only exercise had ever lost .
only that lady who had heard this snake had ever worried those guys .	that lady who had only heard this snake had ever worried those guys .
only that man who might lie will ever smile .	that man who might only lie will ever smile .
only that king who the boy might talk about can ever throw this box .	that king who only the boy might talk about can ever throw this box .
only the box that has broken could ever roll away .	the box that has only broken could ever roll away .
only the hamster that had seen the woman has ever remembered that shirt .	the hamster that had only seen the woman has ever remembered that shirt .
only the book that the mouse had remembered will ever break .	the book that only the mouse had remembered will ever break .
only the rabbits that must remember this book could ever eat .	the rabbits that must only remember this book could ever eat .
only this man who the driver has heard has ever answered that girl .	this man who only the driver has heard has ever answered that girl .
only this dancer who has held those forks would ever bother that lady .	this dancer who has only held those forks would ever bother that lady .
only the dancer who had made the glass can ever drive to the hospital .	the dancer who had only made the glass can ever drive to the hospital .
only that dancer who should remember those people can ever practice .	that dancer who should only remember those people can ever practice .
only that customer who had talked about those spoons had ever taught the doctor .	that customer who had only talked about those spoons had ever taught the doctor .
only the boat that that queen might see will ever break those glasses .	the boat that only that queen might see will ever break those glasses .
only these women who will have that candle can ever know that guy .	these women who will only have that candle can ever know that guy .
only the toys that the women could find have ever dropped .	the toys that only the women could find have ever dropped .
only this adult who has left the bank had ever bothered this child .	this adult who has only left the bank had ever bothered this child .
only this boat that would move would ever roll away .	this boat that would only move would ever roll away .
only the guys that must know these people had ever learned .	the guys that must only know these people had ever learned .
only this box that might break will ever roll away .	this box that might only break will ever roll away .
only those doctors who these ladies had heard should ever make the car .	those doctors who only these ladies had heard should ever make the car .
only those women who should hate this bottle should ever cry .	those women who should only hate this bottle should ever cry .
only the ring that might break has ever broken .	the ring that might only break has ever broken .
only the woman who could hear this boy could ever talk .	the woman who could only hear this boy could ever talk .
only those children that would remember the ladies had ever seen this cup .	those children that would only remember the ladies had ever seen this cup .
only that person who the patient might talk about has ever heard that lady .	that person who only the patient might talk about has ever heard that lady .
only this lady who that person would talk about can ever stretch .	this lady who only that person would talk about can ever stretch .
only the doctor that the king would know can ever think about these books .	the doctor that only the king would know can ever think about these books .
only that guy who will have the hats has ever brought the mirror .	that guy who will only have the hats has ever brought the mirror .
only the doctors who should drop these crayons should ever paint .	the doctors who should only drop these crayons should ever paint .
only that guy who this girl has talked about could ever wave .	that guy who only this girl has talked about could ever wave .
only that snake that would look like this boy could ever hate that plane .	that snake that would only look like this boy could ever hate that plane .
only the children who can think about those dishes could ever talk about these hats .	the children who can only think about those dishes could ever talk about these hats .
only that crayon that could roll away will ever drop .	that crayon that could only roll away will ever drop .
only that customer who might forget the queen can ever take this door .	that customer who might only forget the queen can ever take this door .
only this dentist who has fixed those hats has ever talked about those dishes .	this dentist who has only fixed those hats has ever talked about those dishes .
only those chairs that those boys had seen can ever break that bed .	those chairs that only those boys had seen can ever break that bed .
only the men who will notice the bed would ever walk through the bank .	the men who will only notice the bed would ever walk through the bank .
only that hamster that the person may hear would ever love the cups .	that hamster that only the person may hear would ever love the cups .
only these teachers who have remembered the shirt should ever have those beds .	these teachers who have only remembered the shirt should ever have those beds .
only the cats that can remember these spoons can ever learn .	the cats that can only remember these spoons can ever learn .
only that child who has run around the room had ever answered those women .	that child who has only run around the room had ever answered those women .
only the patient who can paint could ever talk about that couch .	the patient who can only paint could ever talk about that couch .
only the ladies who will talk about this dish have ever fixed this cup .	the ladies who will only talk about this dish have ever fixed this cup .
only the dancer that had seen these windows had ever run .	the dancer that had only seen these windows had ever run .
only that mirror that could break can ever roll away .	that mirror that could only break can ever roll away .
only the bicycle that the person had brought can ever move .	the bicycle that only the person had brought can ever move .
only these teachers who had brought that picture could ever practice .	these teachers who had only brought that picture could ever practice .
only this boy who the patient had talked about would ever shake these buttons .	this boy who only the patient had talked about would ever shake these buttons .
only the ladies that those ladies have talked about had ever run .	the ladies that only those ladies have talked about had ever run .
only this mouse that has run has ever seen these cups .	this mouse that has only run has ever seen these cups .
only that dancer that would eat will ever run .	that dancer that would only eat will ever run .
only the shoe that might drop will ever roll away .	the shoe that might only drop will ever roll away .
only the people who could know the snake had ever moved these glasses .	the people who could only know the snake had ever moved these glasses .
only the king who has passed these schools has ever read .	the king who has only passed these schools has ever read .
only this driver who should make the bags would ever talk .	this driver who should only make the bags would ever talk .
only those girls who have seen these teachers have ever found the shirts .	those girls who have only seen these teachers have ever found the shirts .
only the doctor who should look like that doctor will ever lose .	the doctor who should only look like that doctor will ever lose .
only that lady who that boy may sound like should ever understand that woman .	that lady who only that boy may sound like should ever understand that woman .
only the man that that mouse will forget should ever break those trucks .	the man that only that mouse will forget should ever break those trucks .
only these doctors who would notice the teachers can ever make this cup .	these doctors who would only notice the teachers can ever make this cup .
only this woman who would take these doors can ever yell .	this woman who would only take these doors can ever yell .
only the teacher who has talked about the snakes had ever made the ring .	the teacher who has only talked about the snakes had ever made the ring .
only the birds that those ladies had heard would ever eat .	the birds that only those ladies had heard would ever eat .
only these people who can hear this king will ever sneeze .	these people who can only hear this king will ever sneeze .
only the truck that that girl has bought had ever dropped .	the truck that only that girl has bought had ever dropped .
only the doctors who should leave the library will ever cough .	the doctors who should only leave the library will ever cough .
only this shoe that this queen might like can ever move .	this shoe that only this queen might like can ever move .
only the man who could run around the schools has ever moved that car .	the man who could only run around the schools has ever moved that car .
only the guy who had taken these beds can ever talk about the hats .	the guy who had only taken these beds can ever talk about the hats .
only this dancer that the man may sound like has ever run .	this dancer that only the man may sound like has ever run .
only that lady that should grow had ever run .	that lady that should only grow had ever run .
only this turtle that that dentist might sound like has ever grown .	this turtle that only that dentist might sound like has ever grown .
only the fork that has dropped has ever broken .	the fork that has only dropped has ever broken .
only this queen who the child can talk about should ever answer these men .	this queen who only the child can talk about should ever answer these men .
only this king who had thrown this doll would ever sound like those cats .	this king who had only thrown this doll would ever sound like those cats .
only this queen who that guy had heard had ever taken this boat .	this queen who only that guy had heard had ever taken this boat .
only the doctor who would forget these cups can ever lie .	the doctor who would only forget these cups can ever lie .
only that patient that has heard these rabbits had ever eaten .	that patient that has only heard these rabbits had ever eaten .
only that teacher who must pass this kitchen would ever paint .	that teacher who must only pass this kitchen would ever paint .
only these dishes that these horses have seen could ever roll away .	these dishes that only these horses have seen could ever roll away .
only these people who have heard that teacher had ever heard those boys .	these people who have only heard that teacher had ever heard those boys .
only these ladies who will pass this hospital can ever scream .	these ladies who will only pass this hospital can ever scream .
only these ladies who may hate the cats should ever sing .	these ladies who may only hate the cats should ever sing .
only that book that this boy had seen can ever break this ring .	that book that only this boy had seen can ever break this ring .
only that dancer that can like those rings can ever grow .	that dancer that can only like those rings can ever grow .
only that dancer who has lost that doll can ever hold that door .	that dancer who has only lost that doll can ever hold that door .
only the man who has walked through the hospital would ever praise this driver .	the man who has only walked through the hospital would ever praise this driver .
only the doctor who must forget these bags will ever answer the girls .	the doctor who must only forget these bags will ever answer the girls .
only that customer that had grown would ever forget the girl .	that customer that had only grown would ever forget the girl .
only this woman who the king may talk about should ever lie .	this woman who only the king may talk about should ever lie .
only the child that can hear this king could ever grow .	the child that can only hear this king could ever grow .
only this hat that that adult had found had ever moved .	this hat that only that adult had found had ever moved .
only that girl who can clean that bag would ever stretch .	that girl who can only clean that bag would ever stretch .
only the men who must walk through this library could ever move this ship .	the men who must only walk through this library could ever move this ship .
only that dancer who that dentist will talk about can ever smile .	that dancer who only that dentist will talk about can ever smile .
only those women that would sound like these ladies had ever run .	those women that would only sound like these ladies had ever run .
only this driver who could talk about the dentist has ever heard the bird .	this driver who could only talk about the dentist has ever heard the bird .
only the customer that has grown can ever love this snake .	the customer that has only grown can ever love this snake .
only this boy who should think about that plane can ever shake these bags .	this boy who should only think about that plane can ever shake these bags .
only that guy who has read has ever made this bottle .	that guy who has only read has ever made this bottle .
only these pictures that these ladies had talked about will ever move .	these pictures that only these ladies had talked about will ever move .
only those cups that those guys must bring can ever drop .	those cups that only those guys must bring can ever drop .
only the girls who have thought about the buttons had ever won .	the girls who have only thought about the buttons had ever won .
only the adult who must fix that dish will ever hold the bottle .	the adult who must only fix that dish will ever hold the bottle .
only this girl who will notice these windows will ever paint .	this girl who will only notice these windows will ever paint .
only this shoe that may break can ever break .	this shoe that may only break can ever break .
only this teacher who might talk about those bottles could ever shake the fork .	this teacher who might only talk about those bottles could ever shake the fork .
only this patient who has brought the bags could ever exercise .	this patient who has only brought the bags could ever exercise .
only the customer that has remembered those boats will ever run .	the customer that has only remembered those boats will ever run .
only that dancer that must sound like these cats will ever hate that lady .	that dancer that must only sound like these cats will ever hate that lady .
only these teachers who can sell that ship should ever bring this crayon .	these teachers who can only sell that ship should ever bring this crayon .
only that woman who would lie would ever cough .	that woman who would only lie would ever cough .
only the king who must scream has ever talked to these people .	the king who must only scream has ever talked to these people .
only that adult who must keep the book will ever care for this patient .	that adult who must only keep the book will ever care for this patient .
only the girl who may drop this couch had ever laughed .	the girl who may only drop this couch had ever laughed .
only this woman who might know those horses can ever sing .	this woman who might only know those horses can ever sing .
only the teacher who should lift those cars could ever wave .	the teacher who should only lift those cars could ever wave .
only these men who should look like that rabbit can ever buy these boxes .	these men who should only look like that rabbit can ever buy these boxes .
only those boys who may forget the cat will ever know the birds .	those boys who may only forget the cat will ever know the birds .
only the car that that guy might see had ever rolled away .	the car that only that guy might see had ever rolled away .
only the child who should laugh would ever walk through this park .	the child who should only laugh would ever walk through this park .
only these ladies that will think about the glasses had ever grown .	these ladies that will only think about the glasses had ever grown .
only this king who has cleaned the doors could ever win .	this king who has only cleaned the doors could ever win .
only that shoe that that teacher will talk about will ever break .	that shoe that only that teacher will talk about will ever break .
only the guy that the patient has heard can ever hate the bed .	the guy that only the patient has heard can ever hate the bed .
only that plane that this dancer had bought would ever break .	that plane that only this dancer had bought would ever break .
only that king who this man has heard had ever waved .	that king who only this man has heard had ever waved .
only the driver who has moved the bowls should ever win .	the driver who has only moved the bowls should ever win .
only those guys that these teachers must sound like had ever learned .	those guys that only these teachers must sound like had ever learned .
only these girls who have lost those cars would ever talk to that person .	these girls who have only lost those cars would ever talk to that person .
only those women that these mice should like have ever broken these trucks .	those women that only these mice should like have ever broken these trucks .
only those dolls that might roll away had ever rolled away .	those dolls that might only roll away had ever rolled away .
only this boy that will think about the forks has ever run .	this boy that will only think about the forks has ever run .
only this bowl that that king has talked about had ever dropped .	this bowl that only that king has talked about had ever dropped .
only the snake that that child had talked about would ever see that car .	the snake that only that child had talked about would ever see that car .
only these ladies who would know the mouse have ever run around this park .	these ladies who would only know the mouse have ever run around this park .
only this girl who has thrown the truck has ever fixed these bowls .	this girl who has only thrown the truck has ever fixed these bowls .
only those ladies who may shake this dish could ever know that cat .	those ladies who may only shake this dish could ever know that cat .
only the woman who can lose could ever hold the bed .	the woman who can only lose could ever hold the bed .
only this teacher who this customer can hear can ever look like the girls .	this teacher who only this customer can hear can ever look like the girls .
only that dancer who had laughed will ever go to that school .	that dancer who had only laughed will ever go to that school .
only that customer who had heard the child has ever heard those women .	that customer who had only heard the child has ever heard those women .
only the candle that the doctor will think about could ever roll away .	the candle that only the doctor will think about could ever roll away .
only the girl who this king must look like would ever talk about these dishes .	the girl who only this king must look like would ever talk about these dishes .
only this man who might see the rug can ever talk about these boys .	this man who might only see the rug can ever talk about these boys .
only the women who had passed the schools had ever gone to that mall .	the women who had only passed the schools had ever gone to that mall .
only the person that might eat could ever forget the cats .	the person that might only eat could ever forget the cats .
only the doctor who must read should ever look like these rabbits .	the doctor who must only read should ever look like these rabbits .
only that child who could forget that doctor has ever heard that boy .	that child who could only forget that doctor has ever heard that boy .
only the woman who can smile can ever find that boat .	the woman who can only smile can ever find that boat .
only that boy who should find the rings could ever laugh .	that boy who should only find the rings could ever laugh .
only the child who will lose the bottle had ever confused that driver .	the child who will only lose the bottle had ever confused that driver .
only that king who the doctor should sound like should ever hold that boat .	that king who only the doctor should sound like should ever hold that boat .
only the doctors who can like the book can ever leave this bank .	the doctors who can only like the book can ever leave this bank .
only these dolls that the guys had noticed had ever broken those cars .	these dolls that only the guys had noticed had ever broken those cars .
only that child who has thought about the crayons could ever whisper .	that child who has only thought about the crayons could ever whisper .
only this doctor who has talked can ever teach the guy .	this doctor who has only talked can ever teach the guy .
only that man who must walk through those schools should ever work with those doctors .	that man who must only walk through those schools should ever work with those doctors .
only the crayons that the boys can lose could ever break .	the crayons that only the boys can lose could ever break .
only this adult who can hate these hats can ever appreciate the teachers .	this adult who can only hate these hats can ever appreciate the teachers .
only the teacher who would laugh will ever look like this bird .	the teacher who would only laugh will ever look like this bird .
only the person that the king must talk about had ever learned .	the person that only the king must talk about had ever learned .
only that lady that might run could ever remember those candles .	that lady that might only run could ever remember those candles .
only this queen who can return to these schools had ever visited the guy .	this queen who can only return to these schools had ever visited the guy .
only this man that could run could ever grow .	this man that could only run could ever grow .
only these men that have remembered this person will ever run .	these men that have only remembered this person will ever run .
only these boys that should eat have ever seen the doctor .	these boys that should only eat have ever seen the doctor .
only the adult who can forget the customer can ever make the trucks .	the adult who can only forget the customer can ever make the trucks .
only this mirror that this girl had talked about should ever break that truck .	this mirror that only this girl had talked about should ever break that truck .
only this cat that will sound like these ladies would ever notice this crayon .	this cat that will only sound like these ladies would ever notice this crayon .
only that cat that the king must talk about can ever grow .	that cat that only the king must talk about can ever grow .
only this man who has left this museum had ever laughed .	this man who has only left this museum had ever laughed .
only this adult who the queen has heard had ever thrown that candle .	this adult who only the queen has heard had ever thrown that candle .
only that adult who should see the teacher had ever brought the cars .	that adult who should only see the teacher had ever brought the cars .
only these bottles that can break had ever dropped .	these bottles that can only break had ever dropped .
only that dancer who had brought these chairs has ever waved .	that dancer who had only brought these chairs has ever waved .
only this lady that that queen will look like should ever hate the ladies .	this lady that only that queen will look like should ever hate the ladies .
only this snake that has remembered that hat has ever run .	this snake that has only remembered that hat has ever run .
only the shoe that the snake might remember will ever move .	the shoe that only the snake might remember will ever move .
only those girls who should look like that child will ever shake the boxes .	those girls who should only look like that child will ever shake the boxes .
only these teachers who had lost could ever sound like the boys .	these teachers who had only lost could ever sound like the boys .
