your grandmother that hears these doctors could hate herself .	your grandmother that hears these doctors could hate themselves .
the doctors who talk about Anne were n't talking about themselves .	the doctors who talk about Anne were n't talking about herself .
that king that knows these doctors had talked about himself .	that king that knows these doctors had talked about themselves .
these teachers that can n't see your sister looked like themselves .	these teachers that can n't see your sister looked like herself .
my teachers who have talked about Scott had n't talked about themselves .	my teachers who have talked about Scott had n't talked about himself .
your wife that noticed Eric had noticed herself .	your wife that noticed Eric had noticed himself .
these children that think about my mom hate themselves .	these children that think about my mom hate herself .
my friends who wo n't love April hear themselves .	my friends who wo n't love April hear herself .
the king who loves your friends does n't sound like himself .	the king who loves your friends does n't sound like themselves .
this man that heard the children did n't hear himself .	this man that heard the children did n't hear themselves .
those people that have n't thought about your mom forgot themselves .	those people that have n't thought about your mom forgot herself .
these children who were talking about your mother have n't seen themselves .	these children who were talking about your mother have n't seen herself .
the teachers that heard your mother sounded like themselves .	the teachers that heard your mother sounded like herself .
that girl that loves my brother likes herself .	that girl that loves my brother likes himself .
your mom that was n't talking about my teachers looked like herself .	your mom that was n't talking about my teachers looked like themselves .
my brother that may look like Julie had remembered himself .	my brother that may look like Julie had remembered herself .
the lady that did n't love these people could remember herself .	the lady that did n't love these people could remember themselves .
the king that does n't think about that woman has talked about himself .	the king that does n't think about that woman has talked about herself .
my mother that had n't seen the teachers looks like herself .	my mother that had n't seen the teachers looks like themselves .
those people who sounded like the boy look like themselves .	those people who sounded like the boy look like himself .
your friends who would see Kristen liked themselves .	your friends who would see Kristen liked herself .
that guy who might think about the children sounded like himself .	that guy who might think about the children sounded like themselves .
my husband that is talking about the girl has n't remembered himself .	my husband that is talking about the girl has n't remembered herself .
this guy who would hear your teachers loves himself .	this guy who would hear your teachers loves themselves .
my cousins that have seen that king did n't notice themselves .	my cousins that have seen that king did n't notice himself .
the teachers who noticed my father know themselves .	the teachers who noticed my father know himself .
these people that are n't talking about Michael must hate themselves .	these people that are n't talking about Michael must hate himself .
your dad that hears your cousins looks like himself .	your dad that hears your cousins looks like themselves .
those doctors who forgot your husband remembered themselves .	those doctors who forgot your husband remembered himself .
that woman who sounds like the boy thought about herself .	that woman who sounds like the boy thought about himself .
that guy that is talking about Kayla was n't thinking about himself .	that guy that is talking about Kayla was n't thinking about herself .
that girl that liked Gregory talks about herself .	that girl that liked Gregory talks about himself .
your dad that liked my cousins was thinking about himself .	your dad that liked my cousins was thinking about themselves .
that king who could n't hear those teachers talks about himself .	that king who could n't hear those teachers talks about themselves .
those doctors who liked that lady talk about themselves .	those doctors who liked that lady talk about herself .
these doctors that have heard your dad may see themselves .	these doctors that have heard your dad may see himself .
my doctors that thought about the man like themselves .	my doctors that thought about the man like himself .
your friends who did n't remember my father do n't forget themselves .	your friends who did n't remember my father do n't forget himself .
my cousins that know this queen look like themselves .	my cousins that know this queen look like herself .
my teachers who talked about Carl talk about themselves .	my teachers who talked about Carl talk about himself .
the people who saw my sister sound like themselves .	the people who saw my sister sound like herself .
that girl that hears this man hears herself .	that girl that hears this man hears himself .
my mother who had n't talked about my son wo n't know herself .	my mother who had n't talked about my son wo n't know himself .
my son that has heard your cousins loves himself .	my son that has heard your cousins loves themselves .
my friends who saw George heard themselves .	my friends who saw George heard himself .
your daughter that was n't thinking about this guy heard herself .	your daughter that was n't thinking about this guy heard himself .
your husband that had n't talked about that queen loves himself .	your husband that had n't talked about that queen loves herself .
these people that had seen my son thought about themselves .	these people that had seen my son thought about himself .
my doctors that would n't think about that woman heard themselves .	my doctors that would n't think about that woman heard herself .
these doctors that sounded like your grandmother talked about themselves .	these doctors that sounded like your grandmother talked about herself .
your sister that should n't hate Todd knows herself .	your sister that should n't hate Todd knows himself .
these children that should n't hear Sara did n't hate themselves .	these children that should n't hear Sara did n't hate herself .
my husband who has n't noticed your teachers looked like himself .	my husband who has n't noticed your teachers looked like themselves .
this king that would n't know your grandmother looked like himself .	this king that would n't know your grandmother looked like herself .
your husband who hears those doctors knows himself .	your husband who hears those doctors knows themselves .
that girl that had n't remembered the man talks about herself .	that girl that had n't remembered the man talks about himself .
your father that looks like these people has n't thought about himself .	your father that looks like these people has n't thought about themselves .
your mother that forgot my father liked herself .	your mother that forgot my father liked himself .
your friends that are n't talking about James can n't like themselves .	your friends that are n't talking about James can n't like himself .
your doctors who had n't heard this lady look like themselves .	your doctors who had n't heard this lady look like herself .
your wife that had n't noticed my doctors was n't talking about herself .	your wife that had n't noticed my doctors was n't talking about themselves .
your cousins that remembered this lady do n't hate themselves .	your cousins that remembered this lady do n't hate herself .
this king who was talking about this woman talks about himself .	this king who was talking about this woman talks about herself .
that boy who talked about your teachers has noticed himself .	that boy who talked about your teachers has noticed themselves .
my son who sees that lady could know himself .	my son who sees that lady could know herself .
the doctors that hear that man loved themselves .	the doctors that hear that man loved himself .
my cousins that did n't talk about your son looked like themselves .	my cousins that did n't talk about your son looked like himself .
my mother that might like Donald liked herself .	my mother that might like Donald liked himself .
the man who heard this queen had n't talked about himself .	the man who heard this queen had n't talked about herself .
your father who would n't like those people was n't talking about himself .	your father who would n't like those people was n't talking about themselves .
the king who thinks about that lady has n't talked about himself .	the king who thinks about that lady has n't talked about herself .
this girl who has heard those children wo n't forget herself .	this girl who has heard those children wo n't forget themselves .
the teachers who talk about Richard have seen themselves .	the teachers who talk about Richard have seen himself .
those people that knew the queen loved themselves .	those people that knew the queen loved herself .
that girl who has n't seen those people should n't think about herself .	that girl who has n't seen those people should n't think about themselves .
my daughter who has remembered the teachers knew herself .	my daughter who has remembered the teachers knew themselves .
my son who should n't remember my friends knew himself .	my son who should n't remember my friends knew themselves .
this guy who would n't see Janet looked like himself .	this guy who would n't see Janet looked like herself .
that man who forgot these teachers liked himself .	that man who forgot these teachers liked themselves .
your teachers who have seen the king should hate themselves .	your teachers who have seen the king should hate himself .
that boy that does n't hear your wife is n't talking about himself .	that boy that does n't hear your wife is n't talking about herself .
this girl who could see that king talked about herself .	this girl who could see that king talked about himself .
my cousins that could like your brother see themselves .	my cousins that could like your brother see himself .
this king that might remember the children sees himself .	this king that might remember the children sees themselves .
this lady that has thought about your friends would look like herself .	this lady that has thought about your friends would look like themselves .
the children who liked my daughter had n't noticed themselves .	the children who liked my daughter had n't noticed herself .
your husband who had n't thought about your friends would n't forget himself .	your husband who had n't thought about your friends would n't forget themselves .
your mom that hears the man was n't thinking about herself .	your mom that hears the man was n't thinking about himself .
your teachers that hate that woman have n't heard themselves .	your teachers that hate that woman have n't heard herself .
that lady who has remembered your cousins has n't seen herself .	that lady who has remembered your cousins has n't seen themselves .
the teachers who had seen the woman can forget themselves .	the teachers who had seen the woman can forget herself .
my grandmother that might like Jason will think about herself .	my grandmother that might like Jason will think about himself .
my mother that talked about that man had n't heard herself .	my mother that talked about that man had n't heard himself .
your friends who knew my grandmother could forget themselves .	your friends who knew my grandmother could forget herself .
the teachers who may look like my brother can n't hear themselves .	the teachers who may look like my brother can n't hear himself .
the king that sees your wife heard himself .	the king that sees your wife heard herself .
that girl who looked like this boy can n't sound like herself .	that girl who looked like this boy can n't sound like himself .
the guy that could n't like my friends should forget himself .	the guy that could n't like my friends should forget themselves .
the children that sounded like your grandmother can n't look like themselves .	the children that sounded like your grandmother can n't look like herself .
this woman who talks about those teachers saw herself .	this woman who talks about those teachers saw themselves .
my cousins who talked about Allison sound like themselves .	my cousins who talked about Allison sound like herself .
my dad that had heard Cindy will forget himself .	my dad that had heard Cindy will forget herself .
your cousins that heard my wife remembered themselves .	your cousins that heard my wife remembered herself .
the king who forgot my teachers liked himself .	the king who forgot my teachers liked themselves .
that guy that has seen this woman forgot himself .	that guy that has seen this woman forgot herself .
my daughter who could n't see my husband had remembered herself .	my daughter who could n't see my husband had remembered himself .
my brother who is talking about the doctors had n't talked about himself .	my brother who is talking about the doctors had n't talked about themselves .
these people that love the queen noticed themselves .	these people that love the queen noticed herself .
my sister who can n't think about your husband heard herself .	my sister who can n't think about your husband heard himself .
your teachers that talk about this boy could n't sound like themselves .	your teachers that talk about this boy could n't sound like himself .
my wife who knew your teachers had n't noticed herself .	my wife who knew your teachers had n't noticed themselves .
the children who hate that lady noticed themselves .	the children who hate that lady noticed herself .
the doctors that look like Alexander might remember themselves .	the doctors that look like Alexander might remember himself .
the people who notice Jane had n't noticed themselves .	the people who notice Jane had n't noticed herself .
my husband who forgot your grandmother sounded like himself .	my husband who forgot your grandmother sounded like herself .
this king who sees your teachers noticed himself .	this king who sees your teachers noticed themselves .
your daughter who loved my cousins must notice herself .	your daughter who loved my cousins must notice themselves .
your sister who may notice my father heard herself .	your sister who may notice my father heard himself .
that king that hears Emily would forget himself .	that king that hears Emily would forget herself .
that guy that is n't thinking about your friends loves himself .	that guy that is n't thinking about your friends loves themselves .
my doctors that saw your son looked like themselves .	my doctors that saw your son looked like himself .
these children who must notice Catherine talked about themselves .	these children who must notice Catherine talked about herself .
your husband who has n't seen your wife had n't remembered himself .	your husband who has n't seen your wife had n't remembered herself .
your wife that does n't sound like the doctors may talk about herself .	your wife that does n't sound like the doctors may talk about themselves .
that girl that has thought about your friends sees herself .	that girl that has thought about your friends sees themselves .
the boy that had n't thought about my doctors can know himself .	the boy that had n't thought about my doctors can know themselves .
your mother that has n't heard my brother forgot herself .	your mother that has n't heard my brother forgot himself .
the man who loves your friends thought about himself .	the man who loves your friends thought about themselves .
the woman that was n't thinking about the people talks about herself .	the woman that was n't thinking about the people talks about themselves .
this girl that is n't talking about your father heard herself .	this girl that is n't talking about your father heard himself .
the boy that wo n't know my wife talked about himself .	the boy that wo n't know my wife talked about herself .
my sister who was n't talking about these doctors may look like herself .	my sister who was n't talking about these doctors may look like themselves .
my friends who loved this man saw themselves .	my friends who loved this man saw himself .
this man who saw my mother looked like himself .	this man who saw my mother looked like herself .
this queen who had thought about your brother looks like herself .	this queen who had thought about your brother looks like himself .
your dad that may sound like this woman liked himself .	your dad that may sound like this woman liked herself .
these teachers that might know my mom talked about themselves .	these teachers that might know my mom talked about herself .
the teachers that had remembered my grandmother talk about themselves .	the teachers that had remembered my grandmother talk about herself .
the man who looks like your grandmother likes himself .	the man who looks like your grandmother likes herself .
my dad that saw this woman has remembered himself .	my dad that saw this woman has remembered herself .
the doctors that must know my dad talked about themselves .	the doctors that must know my dad talked about himself .
my wife that had n't seen William does n't notice herself .	my wife that had n't seen William does n't notice himself .
that lady that has thought about those children could n't hate herself .	that lady that has thought about those children could n't hate themselves .
the girl that must like the doctors heard herself .	the girl that must like the doctors heard themselves .
this woman that was n't talking about my teachers looks like herself .	this woman that was n't talking about my teachers looks like themselves .
the doctors who were n't talking about Wendy had heard themselves .	the doctors who were n't talking about Wendy had heard herself .
my son that will like that woman can n't love himself .	my son that will like that woman can n't love herself .
these children who are n't talking about your dad might hate themselves .	these children who are n't talking about your dad might hate himself .
my brother that had n't noticed your teachers has thought about himself .	my brother that had n't noticed your teachers has thought about themselves .
your cousins who had n't heard my brother sounded like themselves .	your cousins who had n't heard my brother sounded like himself .
the people that loved that woman had n't noticed themselves .	the people that loved that woman had n't noticed herself .
these doctors that would love my wife see themselves .	these doctors that would love my wife see herself .
that girl who forgot my husband knows herself .	that girl who forgot my husband knows himself .
these doctors who know Todd could sound like themselves .	these doctors who know Todd could sound like himself .
your doctors that can n't look like Anna love themselves .	your doctors that can n't look like Anna love herself .
this queen that had seen these teachers likes herself .	this queen that had seen these teachers likes themselves .
your mom who had n't seen Aaron must talk about herself .	your mom who had n't seen Aaron must talk about himself .
the doctors who thought about Jerry sound like themselves .	the doctors who thought about Jerry sound like himself .
my brother who loved my doctors knew himself .	my brother who loved my doctors knew themselves .
that guy that likes Wendy might remember himself .	that guy that likes Wendy might remember herself .
the girl that was n't talking about the man loves herself .	the girl that was n't talking about the man loves himself .
your friends that forgot Becky hate themselves .	your friends that forgot Becky hate herself .
the doctors that forgot my father were n't talking about themselves .	the doctors that forgot my father were n't talking about himself .
my husband who has noticed my grandmother can like himself .	my husband who has noticed my grandmother can like herself .
the teachers that forgot your daughter could love themselves .	the teachers that forgot your daughter could love herself .
your daughter who can sound like Scott sees herself .	your daughter who can sound like Scott sees himself .
these teachers that had remembered Carol had n't seen themselves .	these teachers that had remembered Carol had n't seen herself .
the boy that should sound like my grandmother will hate himself .	the boy that should sound like my grandmother will hate herself .
this lady who knows my son wo n't like herself .	this lady who knows my son wo n't like himself .
that man that liked Jennifer is n't thinking about himself .	that man that liked Jennifer is n't thinking about herself .
the doctors who saw this boy hate themselves .	the doctors who saw this boy hate himself .
my mother who has seen Donald liked herself .	my mother who has seen Donald liked himself .
your sister that has noticed those people had heard herself .	your sister that has noticed those people had heard themselves .
my grandmother that had n't heard that boy might notice herself .	my grandmother that had n't heard that boy might notice himself .
this girl who has seen your friends forgot herself .	this girl who has seen your friends forgot themselves .
these children that sounded like Donald think about themselves .	these children that sounded like Donald think about himself .
the teachers that knew Laurie hate themselves .	the teachers that knew Laurie hate herself .
the man that had seen the children sounds like himself .	the man that had seen the children sounds like themselves .
my father that sees that girl had talked about himself .	my father that sees that girl had talked about herself .
your daughter that knew your father hears herself .	your daughter that knew your father hears himself .
this girl that liked my cousins looks like herself .	this girl that liked my cousins looks like themselves .
these children who sound like your father can like themselves .	these children who sound like your father can like himself .
those doctors that loved Mark would n't hear themselves .	those doctors that loved Mark would n't hear himself .
your friends that loved that boy may love themselves .	your friends that loved that boy may love himself .
the doctors that hear my grandmother look like themselves .	the doctors that hear my grandmother look like herself .
this queen who knew Jason knew herself .	this queen who knew Jason knew himself .
your grandmother who heard these people thought about herself .	your grandmother who heard these people thought about themselves .
your father that remembered your daughter has n't remembered himself .	your father that remembered your daughter has n't remembered herself .
my father who will hate those children sounded like himself .	my father who will hate those children sounded like themselves .
those people that had seen Rebecca forget themselves .	those people that had seen Rebecca forget herself .
these children who will think about Steven have n't remembered themselves .	these children who will think about Steven have n't remembered himself .
your daughter who had n't thought about the teachers has talked about herself .	your daughter who had n't thought about the teachers has talked about themselves .
the people who will sound like my dad might notice themselves .	the people who will sound like my dad might notice himself .
that man who would look like that lady loved himself .	that man who would look like that lady loved herself .
this lady that had n't talked about the people has noticed herself .	this lady that had n't talked about the people has noticed themselves .
your brother that heard my doctors sees himself .	your brother that heard my doctors sees themselves .
the queen who has n't talked about my doctors forgot herself .	the queen who has n't talked about my doctors forgot themselves .
the children who see my brother can n't think about themselves .	the children who see my brother can n't think about himself .
this woman who thought about those teachers knew herself .	this woman who thought about those teachers knew themselves .
the boy that looks like Deborah is talking about himself .	the boy that looks like Deborah is talking about herself .
my father who would n't look like my cousins can love himself .	my father who would n't look like my cousins can love themselves .
my doctors that are n't thinking about Jessica remembered themselves .	my doctors that are n't thinking about Jessica remembered herself .
that queen who had n't seen my brother sees herself .	that queen who had n't seen my brother sees himself .
these teachers that sounded like that girl are n't thinking about themselves .	these teachers that sounded like that girl are n't thinking about herself .
my friends who were thinking about my daughter think about themselves .	my friends who were thinking about my daughter think about herself .
your daughter that did n't sound like that guy did n't talk about herself .	your daughter that did n't sound like that guy did n't talk about himself .
these doctors that could n't sound like the woman looked like themselves .	these doctors that could n't sound like the woman looked like herself .
these children that notice the girl would like themselves .	these children that notice the girl would like herself .
my father who must notice Laurie looked like himself .	my father who must notice Laurie looked like herself .
the lady that may see your cousins was n't talking about herself .	the lady that may see your cousins was n't talking about themselves .
my father who has n't remembered your teachers was n't talking about himself .	my father who has n't remembered your teachers was n't talking about themselves .
my brother that could see the lady can n't hate himself .	my brother that could see the lady can n't hate herself .
your brother who thought about Sandra likes himself .	your brother who thought about Sandra likes herself .
my wife that loves this guy thought about herself .	my wife that loves this guy thought about himself .
your teachers who must talk about Ronald are n't talking about themselves .	your teachers who must talk about Ronald are n't talking about himself .
the queen who has noticed those doctors looks like herself .	the queen who has noticed those doctors looks like themselves .
my grandmother who was talking about your son likes herself .	my grandmother who was talking about your son likes himself .
this girl who remembered the doctors knew herself .	this girl who remembered the doctors knew themselves .
these people who know your mother can n't remember themselves .	these people who know your mother can n't remember herself .
that man that noticed this lady had noticed himself .	that man that noticed this lady had noticed herself .
the man that has talked about your mom may like himself .	the man that has talked about your mom may like herself .
this queen that would n't see Patrick saw herself .	this queen that would n't see Patrick saw himself .
that boy that saw my cousins is talking about himself .	that boy that saw my cousins is talking about themselves .
your doctors who were n't thinking about that man have heard themselves .	your doctors who were n't thinking about that man have heard himself .
my daughter who thinks about that man thinks about herself .	my daughter who thinks about that man thinks about himself .
that girl that may love my doctors sounds like herself .	that girl that may love my doctors sounds like themselves .
your grandmother who had n't seen my doctors loves herself .	your grandmother who had n't seen my doctors loves themselves .
the people who do n't know Jason had n't heard themselves .	the people who do n't know Jason had n't heard himself .
your mom who has heard the teachers knew herself .	your mom who has heard the teachers knew themselves .
my wife who has remembered the teachers would notice herself .	my wife who has remembered the teachers would notice themselves .
my daughter that knows the man sees herself .	my daughter that knows the man sees himself .
my father who was n't thinking about that girl was n't thinking about himself .	my father who was n't thinking about that girl was n't thinking about herself .
these people that forget that queen had n't heard themselves .	these people that forget that queen had n't heard herself .
this man who loved those people has n't noticed himself .	this man who loved those people has n't noticed themselves .
those doctors that saw my sister looked like themselves .	those doctors that saw my sister looked like herself .
that lady who would love this boy must like herself .	that lady who would love this boy must like himself .
your friends who are n't talking about my wife have noticed themselves .	your friends who are n't talking about my wife have noticed herself .
my friends that noticed Joseph did n't notice themselves .	my friends that noticed Joseph did n't notice himself .
the guy who had n't thought about your teachers has n't seen himself .	the guy who had n't thought about your teachers has n't seen themselves .
this man that loved your daughter loves himself .	this man that loved your daughter loves herself .
your dad that talked about those doctors loved himself .	your dad that talked about those doctors loved themselves .
those doctors who like your mother heard themselves .	those doctors who like your mother heard herself .
these teachers that liked that guy sounded like themselves .	these teachers that liked that guy sounded like himself .
these teachers who are n't talking about that boy were talking about themselves .	these teachers who are n't talking about that boy were talking about himself .
this king that liked those people talked about himself .	this king that liked those people talked about themselves .
my mother who sounds like my doctors has n't heard herself .	my mother who sounds like my doctors has n't heard themselves .
this king that was n't talking about that woman thinks about himself .	this king that was n't talking about that woman thinks about herself .
my husband who talks about Tracy can notice himself .	my husband who talks about Tracy can notice herself .
the children who should notice my husband can like themselves .	the children who should notice my husband can like himself .
this boy who will know my sister will look like himself .	this boy who will know my sister will look like herself .
my doctors that may hear the guy had n't heard themselves .	my doctors that may hear the guy had n't heard himself .
your grandmother who has n't thought about my brother will look like herself .	your grandmother who has n't thought about my brother will look like himself .
this girl that thought about those children has n't heard herself .	this girl that thought about those children has n't heard themselves .
my wife that had noticed my teachers likes herself .	my wife that had noticed my teachers likes themselves .
your wife that may love the guy sounds like herself .	your wife that may love the guy sounds like himself .
the children who will look like the woman remember themselves .	the children who will look like the woman remember herself .
my sister that loved this boy has n't heard herself .	my sister that loved this boy has n't heard himself .
my dad who was thinking about these children might sound like himself .	my dad who was thinking about these children might sound like themselves .
your mother who had noticed those children forgot herself .	your mother who had noticed those children forgot themselves .
this girl who liked my friends forgot herself .	this girl who liked my friends forgot themselves .
this queen who has noticed these children has noticed herself .	this queen who has noticed these children has noticed themselves .
your father that heard your doctors sees himself .	your father that heard your doctors sees themselves .
this king who has noticed your cousins loved himself .	this king who has noticed your cousins loved themselves .
the girl who should know these children sees herself .	the girl who should know these children sees themselves .
this queen who had n't talked about my brother knows herself .	this queen who had n't talked about my brother knows himself .
my mom that has n't thought about the teachers is thinking about herself .	my mom that has n't thought about the teachers is thinking about themselves .
your cousins that noticed the man could n't look like themselves .	your cousins that noticed the man could n't look like himself .
my daughter that sees this king noticed herself .	my daughter that sees this king noticed himself .
my friends who love my sister had n't noticed themselves .	my friends who love my sister had n't noticed herself .
those children that have n't thought about Jane see themselves .	those children that have n't thought about Jane see herself .
my grandmother that remembered my teachers did n't notice herself .	my grandmother that remembered my teachers did n't notice themselves .
the lady that looks like your son thinks about herself .	the lady that looks like your son thinks about himself .
the people who would love this guy talked about themselves .	the people who would love this guy talked about himself .
your cousins that think about Barbara are n't talking about themselves .	your cousins that think about Barbara are n't talking about herself .
your husband who sounded like your sister would n't remember himself .	your husband who sounded like your sister would n't remember herself .
these doctors who might look like my brother know themselves .	these doctors who might look like my brother know himself .
this boy who will sound like the doctors should n't notice himself .	this boy who will sound like the doctors should n't notice themselves .
that boy who has n't heard Sally sounds like himself .	that boy who has n't heard Sally sounds like herself .
the woman who should know the children is n't thinking about herself .	the woman who should know the children is n't thinking about themselves .
my friends who look like your father know themselves .	my friends who look like your father know himself .
your doctors that are thinking about the queen sounded like themselves .	your doctors that are thinking about the queen sounded like herself .
my dad who can n't hear those people had n't thought about himself .	my dad who can n't hear those people had n't thought about themselves .
your dad who thinks about Laurie loved himself .	your dad who thinks about Laurie loved herself .
this girl that had n't seen these people hears herself .	this girl that had n't seen these people hears themselves .
your mother who knows those teachers noticed herself .	your mother who knows those teachers noticed themselves .
your teachers that must remember that girl have n't remembered themselves .	your teachers that must remember that girl have n't remembered herself .
the lady who would n't love your father wo n't talk about herself .	the lady who would n't love your father wo n't talk about himself .
your doctors who see the boy thought about themselves .	your doctors who see the boy thought about himself .
my father who looks like my friends was n't talking about himself .	my father who looks like my friends was n't talking about themselves .
my son that is n't thinking about the teachers likes himself .	my son that is n't thinking about the teachers likes themselves .
this man that did n't hate Becky thinks about himself .	this man that did n't hate Becky thinks about herself .
that boy who could n't look like my daughter thought about himself .	that boy who could n't look like my daughter thought about herself .
this guy who forgot these children sounded like himself .	this guy who forgot these children sounded like themselves .
my cousins that had heard my dad knew themselves .	my cousins that had heard my dad knew himself .
my brother who will hate your teachers sounds like himself .	my brother who will hate your teachers sounds like themselves .
these children who noticed Julie have noticed themselves .	these children who noticed Julie have noticed herself .
that woman that was n't thinking about my father loves herself .	that woman that was n't thinking about my father loves himself .
the people that had n't thought about this boy will forget themselves .	the people that had n't thought about this boy will forget himself .
this lady that could n't hate Jerry had n't remembered herself .	this lady that could n't hate Jerry had n't remembered himself .
your teachers who talked about this man would hate themselves .	your teachers who talked about this man would hate himself .
your mom who would n't like my son must talk about herself .	your mom who would n't like my son must talk about himself .
your mother that looked like the guy did n't like herself .	your mother that looked like the guy did n't like himself .
that guy that heard Becca has n't noticed himself .	that guy that heard Becca has n't noticed herself .
my dad who noticed my mother saw himself .	my dad who noticed my mother saw herself .
my friends that hear Sara know themselves .	my friends that hear Sara know herself .
that guy that has n't heard my cousins has talked about himself .	that guy that has n't heard my cousins has talked about themselves .
those doctors that are talking about this man should n't look like themselves .	those doctors that are talking about this man should n't look like himself .
my daughter that is thinking about your father thinks about herself .	my daughter that is thinking about your father thinks about himself .
my sister that would forget my friends could n't forget herself .	my sister that would forget my friends could n't forget themselves .
your daughter who had n't noticed these children sounds like herself .	your daughter who had n't noticed these children sounds like themselves .
your teachers who talked about Mary heard themselves .	your teachers who talked about Mary heard herself .
your teachers that talked about this man could n't remember themselves .	your teachers that talked about this man could n't remember himself .
your brother that noticed that woman has seen himself .	your brother that noticed that woman has seen herself .
my grandmother who had remembered your doctors could talk about herself .	my grandmother who had remembered your doctors could talk about themselves .
your wife that wo n't notice my friends is n't talking about herself .	your wife that wo n't notice my friends is n't talking about themselves .
those teachers that looked like Ronald know themselves .	those teachers that looked like Ronald know himself .
my sister that had seen my son liked herself .	my sister that had seen my son liked himself .
this girl that heard these children talked about herself .	this girl that heard these children talked about themselves .
my sister who has noticed Noah has n't remembered herself .	my sister who has noticed Noah has n't remembered himself .
that lady that knows your dad looks like herself .	that lady that knows your dad looks like himself .
these children that look like my wife should n't sound like themselves .	these children that look like my wife should n't sound like herself .
the children who sound like that woman saw themselves .	the children who sound like that woman saw herself .
your cousins that talked about Thomas like themselves .	your cousins that talked about Thomas like himself .
my mother that is thinking about my son should n't like herself .	my mother that is thinking about my son should n't like himself .
these doctors that notice Richard can know themselves .	these doctors that notice Richard can know himself .
the doctors that may notice Stephanie forget themselves .	the doctors that may notice Stephanie forget herself .
the children that should like Patrick could love themselves .	the children that should like Patrick could love himself .
your brother who can love Anne has n't noticed himself .	your brother who can love Anne has n't noticed herself .
the guy who sees these doctors could like himself .	the guy who sees these doctors could like themselves .
that queen who thought about Gregory knew herself .	that queen who thought about Gregory knew himself .
my sister who likes your doctors knew herself .	my sister who likes your doctors knew themselves .
the woman who noticed your doctors can n't talk about herself .	the woman who noticed your doctors can n't talk about themselves .
your doctors who remember that king hate themselves .	your doctors who remember that king hate himself .
your doctors who think about April are talking about themselves .	your doctors who think about April are talking about herself .
this guy that knows Becky sees himself .	this guy that knows Becky sees herself .
your friends who knew my father are thinking about themselves .	your friends who knew my father are thinking about himself .
my teachers that noticed my sister liked themselves .	my teachers that noticed my sister liked herself .
the teachers who should know Robert notice themselves .	the teachers who should know Robert notice himself .
your cousins who noticed my sister forget themselves .	your cousins who noticed my sister forget herself .
my friends who think about the woman look like themselves .	my friends who think about the woman look like herself .
these doctors who sounded like Andrew forgot themselves .	these doctors who sounded like Andrew forgot himself .
my dad that likes the doctors looks like himself .	my dad that likes the doctors looks like themselves .
those people that remember Tracy had n't noticed themselves .	those people that remember Tracy had n't noticed herself .
your teachers that forgot my sister hear themselves .	your teachers that forgot my sister hear herself .
my dad that sounded like Alice noticed himself .	my dad that sounded like Alice noticed herself .
those people who must love my father liked themselves .	those people who must love my father liked himself .
the teachers that have n't thought about this lady looked like themselves .	the teachers that have n't thought about this lady looked like herself .
my father who would hear Vanessa forgot himself .	my father who would hear Vanessa forgot herself .
that lady who looks like the people looked like herself .	that lady who looks like the people looked like themselves .
my friends that could n't love this woman had n't seen themselves .	my friends that could n't love this woman had n't seen herself .
the girl who should love the boy could hear herself .	the girl who should love the boy could hear himself .
my friends that have talked about the woman sound like themselves .	my friends that have talked about the woman sound like herself .
my grandmother that knew your doctors had n't heard herself .	my grandmother that knew your doctors had n't heard themselves .
that boy that can love the teachers has n't seen himself .	that boy that can love the teachers has n't seen themselves .
your friends that talk about Sara will forget themselves .	your friends that talk about Sara will forget herself .
your son who thinks about Rachel forgot himself .	your son who thinks about Rachel forgot herself .
your grandmother who does n't know those children could n't forget herself .	your grandmother who does n't know those children could n't forget themselves .
the woman who is thinking about the king was talking about herself .	the woman who is thinking about the king was talking about himself .
your cousins that can notice this woman thought about themselves .	your cousins that can notice this woman thought about herself .
my son who was thinking about my wife hears himself .	my son who was thinking about my wife hears herself .
the boy who looks like my teachers sees himself .	the boy who looks like my teachers sees themselves .
the teachers who like your son notice themselves .	the teachers who like your son notice himself .
your husband that saw these children was thinking about himself .	your husband that saw these children was thinking about themselves .
these children that noticed Carl noticed themselves .	these children that noticed Carl noticed himself .
those children who wo n't know the boy loved themselves .	those children who wo n't know the boy loved himself .
my cousins that were talking about Anna remember themselves .	my cousins that were talking about Anna remember herself .
your father who wo n't forget Marie has remembered himself .	your father who wo n't forget Marie has remembered herself .
my daughter that is n't thinking about my friends can n't look like herself .	my daughter that is n't thinking about my friends can n't look like themselves .
this queen that can see those doctors saw herself .	this queen that can see those doctors saw themselves .
your cousins who have n't seen the king have thought about themselves .	your cousins who have n't seen the king have thought about himself .
the man who thought about my doctors does n't sound like himself .	the man who thought about my doctors does n't sound like themselves .
the teachers who had n't seen the guy would n't notice themselves .	the teachers who had n't seen the guy would n't notice himself .
that man that has n't noticed your mother talks about himself .	that man that has n't noticed your mother talks about herself .
my teachers who have n't talked about your wife liked themselves .	my teachers who have n't talked about your wife liked herself .
my grandmother who would know Dan knew herself .	my grandmother who would know Dan knew himself .
your teachers that think about my son should talk about themselves .	your teachers that think about my son should talk about himself .
my teachers who had heard Brian should know themselves .	my teachers who had heard Brian should know himself .
these teachers that have noticed this woman knew themselves .	these teachers that have noticed this woman knew herself .
my doctors who can hear that woman hear themselves .	my doctors who can hear that woman hear herself .
that queen who liked your husband had n't talked about herself .	that queen who liked your husband had n't talked about himself .
the people that had n't seen that girl saw themselves .	the people that had n't seen that girl saw herself .
your grandmother who was n't thinking about your friends can n't hear herself .	your grandmother who was n't thinking about your friends can n't hear themselves .
your cousins who forgot my grandmother were thinking about themselves .	your cousins who forgot my grandmother were thinking about herself .
the man who thought about Julie hears himself .	the man who thought about Julie hears herself .
those children that wo n't forget Alexander thought about themselves .	those children that wo n't forget Alexander thought about himself .
this boy who noticed your friends thinks about himself .	this boy who noticed your friends thinks about themselves .
my husband that had n't remembered that woman knew himself .	my husband that had n't remembered that woman knew herself .
this woman that has noticed these children does n't know herself .	this woman that has noticed these children does n't know themselves .
my dad who should think about your mom might hear himself .	my dad who should think about your mom might hear herself .
my father who loves your daughter has n't noticed himself .	my father who loves your daughter has n't noticed herself .
that king that had n't remembered those teachers had noticed himself .	that king that had n't remembered those teachers had noticed themselves .
my mom who sounded like your friends loves herself .	my mom who sounded like your friends loves themselves .
your teachers that look like your mom are talking about themselves .	your teachers that look like your mom are talking about herself .
my mother that talks about this guy hears herself .	my mother that talks about this guy hears himself .
that king that had n't thought about my cousins would like himself .	that king that had n't thought about my cousins would like themselves .
those people who will know my son can n't look like themselves .	those people who will know my son can n't look like himself .
that boy who must look like your daughter has talked about himself .	that boy who must look like your daughter has talked about herself .
the people who hear this king will see themselves .	the people who hear this king will see himself .
the people who are thinking about William hate themselves .	the people who are thinking about William hate himself .
that king who talks about those children loved himself .	that king who talks about those children loved themselves .
my cousins that were n't thinking about this girl will forget themselves .	my cousins that were n't thinking about this girl will forget herself .
my wife that thinks about the boy has talked about herself .	my wife that thinks about the boy has talked about himself .
this king who loves my mom wo n't notice himself .	this king who loves my mom wo n't notice herself .
these doctors who sounded like your sister saw themselves .	these doctors who sounded like your sister saw herself .
my cousins who can n't like your brother knew themselves .	my cousins who can n't like your brother knew himself .
the doctors that have remembered Liam look like themselves .	the doctors that have remembered Liam look like himself .
your friends who heard your grandmother noticed themselves .	your friends who heard your grandmother noticed herself .
the king that may love those teachers has thought about himself .	the king that may love those teachers has thought about themselves .
the man who could n't know that lady could n't think about himself .	the man who could n't know that lady could n't think about herself .
that queen who can n't think about that king should sound like herself .	that queen who can n't think about that king should sound like himself .
your teachers who remembered that lady had noticed themselves .	your teachers who remembered that lady had noticed herself .
this boy that is n't thinking about those people would see himself .	this boy that is n't thinking about those people would see themselves .
those teachers that knew your sister might love themselves .	those teachers that knew your sister might love herself .
the children that did n't remember the man will look like themselves .	the children that did n't remember the man will look like himself .
your grandmother who sees your doctors knew herself .	your grandmother who sees your doctors knew themselves .
that king that has n't seen this lady might forget himself .	that king that has n't seen this lady might forget herself .
these children that were n't thinking about your brother are talking about themselves .	these children that were n't thinking about your brother are talking about himself .
my friends who can n't sound like that boy had heard themselves .	my friends who can n't sound like that boy had heard himself .
the guy who looks like my mom was n't thinking about himself .	the guy who looks like my mom was n't thinking about herself .
your friends that loved your mom should notice themselves .	your friends that loved your mom should notice herself .
your son who sees my friends knows himself .	your son who sees my friends knows themselves .
my wife that sees these teachers might see herself .	my wife that sees these teachers might see themselves .
my sister that would n't talk about these doctors may talk about herself .	my sister that would n't talk about these doctors may talk about themselves .
my teachers who have n't heard your mom are n't talking about themselves .	my teachers who have n't heard your mom are n't talking about herself .
that man who may think about Denise does n't think about himself .	that man who may think about Denise does n't think about herself .
this girl who sounded like my son knew herself .	this girl who sounded like my son knew himself .
your cousins that wo n't look like this girl wo n't see themselves .	your cousins that wo n't look like this girl wo n't see herself .
your father that had n't thought about my mother has n't seen himself .	your father that had n't thought about my mother has n't seen herself .
that lady who heard Mark talked about herself .	that lady who heard Mark talked about himself .
that queen that looked like my doctors loves herself .	that queen that looked like my doctors loves themselves .
my mom who can see this king has n't heard herself .	my mom who can see this king has n't heard himself .
the guy that had n't heard my cousins is talking about himself .	the guy that had n't heard my cousins is talking about themselves .
those doctors who have remembered Kevin had talked about themselves .	those doctors who have remembered Kevin had talked about himself .
my friends that sounded like Steve may sound like themselves .	my friends that sounded like Steve may sound like himself .
this boy that should hate your wife liked himself .	this boy that should hate your wife liked herself .
your dad that loved these children does n't sound like himself .	your dad that loved these children does n't sound like themselves .
my dad who has remembered that lady knows himself .	my dad who has remembered that lady knows herself .
your doctors that liked your son should n't hear themselves .	your doctors that liked your son should n't hear himself .
my son who sounds like these doctors was n't talking about himself .	my son who sounds like these doctors was n't talking about themselves .
my doctors who hear James must forget themselves .	my doctors who hear James must forget himself .
that girl who could look like John talked about herself .	that girl who could look like John talked about himself .
my mom who had noticed my cousins thought about herself .	my mom who had noticed my cousins thought about themselves .
your husband that knew your cousins talked about himself .	your husband that knew your cousins talked about themselves .
my husband that was thinking about these teachers thinks about himself .	my husband that was thinking about these teachers thinks about themselves .
your brother that liked the children had n't talked about himself .	your brother that liked the children had n't talked about themselves .
the lady that had thought about George had n't thought about herself .	the lady that had thought about George had n't thought about himself .
this woman who would n't remember my cousins had n't noticed herself .	this woman who would n't remember my cousins had n't noticed themselves .
your doctors that might notice this king notice themselves .	your doctors that might notice this king notice himself .
your teachers that may forget your mother wo n't look like themselves .	your teachers that may forget your mother wo n't look like herself .
this lady who loved that guy forgot herself .	this lady who loved that guy forgot himself .
the queen that is n't talking about the children saw herself .	the queen that is n't talking about the children saw themselves .
your wife that can n't hate these children has n't remembered herself .	your wife that can n't hate these children has n't remembered themselves .
my teachers that sound like Donna thought about themselves .	my teachers that sound like Donna thought about herself .
your doctors who can talk about this man talked about themselves .	your doctors who can talk about this man talked about himself .
my wife that knew my cousins would hate herself .	my wife that knew my cousins would hate themselves .
the children who think about Naomi have n't remembered themselves .	the children who think about Naomi have n't remembered herself .
those doctors who hate that woman could notice themselves .	those doctors who hate that woman could notice herself .
the queen who would know my cousins heard herself .	the queen who would know my cousins heard themselves .
your daughter who has thought about these children does n't love herself .	your daughter who has thought about these children does n't love themselves .
this guy that knows the woman is talking about himself .	this guy that knows the woman is talking about herself .
my son who does n't look like the lady did n't look like himself .	my son who does n't look like the lady did n't look like herself .
my cousins who talk about Janet look like themselves .	my cousins who talk about Janet look like herself .
my teachers that looked like my dad remember themselves .	my teachers that looked like my dad remember himself .
the girl that has n't seen the people has noticed herself .	the girl that has n't seen the people has noticed themselves .
the children that had n't talked about Nicole sounded like themselves .	the children that had n't talked about Nicole sounded like herself .
your wife that talked about this king sounded like herself .	your wife that talked about this king sounded like himself .
the queen that should look like the doctors looked like herself .	the queen that should look like the doctors looked like themselves .
that lady that does n't remember my cousins could n't look like herself .	that lady that does n't remember my cousins could n't look like themselves .
your daughter who did n't talk about that guy would forget herself .	your daughter who did n't talk about that guy would forget himself .
this woman who had seen my father has n't thought about herself .	this woman who had seen my father has n't thought about himself .
these people that knew my wife saw themselves .	these people that knew my wife saw herself .
my friends who know your grandmother would hate themselves .	my friends who know your grandmother would hate herself .
my daughter who talks about the guy talked about herself .	my daughter who talks about the guy talked about himself .
your friends who would love Donna had n't thought about themselves .	your friends who would love Donna had n't thought about herself .
the guy who thought about Nina is talking about himself .	the guy who thought about Nina is talking about herself .
these teachers that hear Judy know themselves .	these teachers that hear Judy know herself .
my teachers who do n't forget that man see themselves .	my teachers who do n't forget that man see himself .
your grandmother that can love this boy remembered herself .	your grandmother that can love this boy remembered himself .
your sister that knew my cousins may hear herself .	your sister that knew my cousins may hear themselves .
my daughter who is talking about your cousins has n't heard herself .	my daughter who is talking about your cousins has n't heard themselves .
this lady who looked like your doctors did n't like herself .	this lady who looked like your doctors did n't like themselves .
the king who had n't noticed my daughter likes himself .	the king who had n't noticed my daughter likes herself .
that boy who could hear this girl can n't see himself .	that boy who could hear this girl can n't see herself .
your teachers that love my dad do n't remember themselves .	your teachers that love my dad do n't remember himself .
this girl who would forget your teachers wo n't know herself .	this girl who would forget your teachers wo n't know themselves .
this lady that noticed my dad is thinking about herself .	this lady that noticed my dad is thinking about himself .
your mom that had thought about my cousins looks like herself .	your mom that had thought about my cousins looks like themselves .
the girl who forgot the teachers will remember herself .	the girl who forgot the teachers will remember themselves .
my father that sounds like my sister saw himself .	my father that sounds like my sister saw herself .
your dad that should n't remember Tracy remembered himself .	your dad that should n't remember Tracy remembered herself .
the children who had n't noticed this girl have talked about themselves .	the children who had n't noticed this girl have talked about herself .
my cousins who saw Jason will look like themselves .	my cousins who saw Jason will look like himself .
that girl who remembered these children sees herself .	that girl who remembered these children sees themselves .
the boy who heard Sarah sees himself .	the boy who heard Sarah sees herself .
your mother who was thinking about the people loves herself .	your mother who was thinking about the people loves themselves .
those teachers that had thought about this lady talked about themselves .	those teachers that had thought about this lady talked about herself .
my brother who should sound like Susan loved himself .	my brother who should sound like Susan loved herself .
this queen that could hate David sees herself .	this queen that could hate David sees himself .
your daughter that did n't notice these doctors saw herself .	your daughter that did n't notice these doctors saw themselves .
the teachers that know your mother are thinking about themselves .	the teachers that know your mother are thinking about herself .
those doctors who should n't think about that girl might remember themselves .	those doctors who should n't think about that girl might remember herself .
my cousins that forget your mom sounded like themselves .	my cousins that forget your mom sounded like herself .
the girl that had n't remembered those teachers would hate herself .	the girl that had n't remembered those teachers would hate themselves .
the people who may love my mother had n't talked about themselves .	the people who may love my mother had n't talked about herself .
your sister who has n't noticed the doctors will hate herself .	your sister who has n't noticed the doctors will hate themselves .
your grandmother that could remember Aaron has n't seen herself .	your grandmother that could remember Aaron has n't seen himself .
that man who would love my mom should sound like himself .	that man who would love my mom should sound like herself .
your teachers who can n't notice this woman should think about themselves .	your teachers who can n't notice this woman should think about herself .
this girl who had heard those doctors is talking about herself .	this girl who had heard those doctors is talking about themselves .
my brother who looks like the girl saw himself .	my brother who looks like the girl saw herself .
my husband who had remembered Barbara knows himself .	my husband who had remembered Barbara knows herself .
that lady that thinks about these teachers knew herself .	that lady that thinks about these teachers knew themselves .
my mother that talked about my teachers saw herself .	my mother that talked about my teachers saw themselves .
my mother who sounds like my father can look like herself .	my mother who sounds like my father can look like himself .
my father that wo n't talk about your friends likes himself .	my father that wo n't talk about your friends likes themselves .
my wife that should look like my dad is n't thinking about herself .	my wife that should look like my dad is n't thinking about himself .
your husband that is thinking about those teachers talked about himself .	your husband that is thinking about those teachers talked about themselves .
your daughter that should n't remember this guy loves herself .	your daughter that should n't remember this guy loves himself .
this queen who noticed your friends can n't forget herself .	this queen who noticed your friends can n't forget themselves .
the teachers that had n't heard my sister have n't talked about themselves .	the teachers that had n't heard my sister have n't talked about herself .
the children who hear Gregory sound like themselves .	the children who hear Gregory sound like himself .
my cousins who should n't talk about my father remembered themselves .	my cousins who should n't talk about my father remembered himself .
the girl who was talking about that king had n't talked about herself .	the girl who was talking about that king had n't talked about himself .
the teachers who must hate Noah must forget themselves .	the teachers who must hate Noah must forget himself .
the queen that could know your teachers had n't seen herself .	the queen that could know your teachers had n't seen themselves .
the lady who saw your father can look like herself .	the lady who saw your father can look like himself .
my cousins who hear that boy saw themselves .	my cousins who hear that boy saw himself .
your friends who are n't talking about your dad are n't talking about themselves .	your friends who are n't talking about your dad are n't talking about himself .
your cousins that like your mother have seen themselves .	your cousins that like your mother have seen herself .
the guy that was n't thinking about my doctors thought about himself .	the guy that was n't thinking about my doctors thought about themselves .
the queen who loves those children would n't know herself .	the queen who loves those children would n't know themselves .
your brother that wo n't love Tracy sounded like himself .	your brother that wo n't love Tracy sounded like herself .
this queen that hears my doctors has remembered herself .	this queen that hears my doctors has remembered themselves .
your grandmother that was thinking about these children is talking about herself .	your grandmother that was thinking about these children is talking about themselves .
my husband who was n't talking about these children remembered himself .	my husband who was n't talking about these children remembered themselves .
my mother that sees these people was thinking about herself .	my mother that sees these people was thinking about themselves .
your grandmother who talks about this boy could notice herself .	your grandmother who talks about this boy could notice himself .
your brother that must like these people would n't sound like himself .	your brother that must like these people would n't sound like themselves .
this boy who was n't thinking about Linda has n't heard himself .	this boy who was n't thinking about Linda has n't heard herself .
that boy that must look like Stephanie liked himself .	that boy that must look like Stephanie liked herself .
my teachers that did n't see James did n't know themselves .	my teachers that did n't see James did n't know himself .
my cousins who were talking about this queen were n't talking about themselves .	my cousins who were talking about this queen were n't talking about herself .
this king who was thinking about this girl likes himself .	this king who was thinking about this girl likes herself .
my doctors who had heard that queen forget themselves .	my doctors who had heard that queen forget herself .
your doctors that may think about Emily should n't talk about themselves .	your doctors that may think about Emily should n't talk about herself .
my brother that does n't think about your doctors remembered himself .	my brother that does n't think about your doctors remembered themselves .
this guy who had seen Tracy sounded like himself .	this guy who had seen Tracy sounded like herself .
my brother that loved your mother does n't think about himself .	my brother that loved your mother does n't think about herself .
my brother that noticed your daughter wo n't forget himself .	my brother that noticed your daughter wo n't forget herself .
your teachers who must forget that boy sound like themselves .	your teachers who must forget that boy sound like himself .
the boy that had n't seen my friends will see himself .	the boy that had n't seen my friends will see themselves .
the lady that talks about that king sounded like herself .	the lady that talks about that king sounded like himself .
my son who had remembered those doctors likes himself .	my son who had remembered those doctors likes themselves .
your dad who forgot these people wo n't hear himself .	your dad who forgot these people wo n't hear themselves .
your father who does n't forget these doctors should n't sound like himself .	your father who does n't forget these doctors should n't sound like themselves .
your friends who were thinking about this girl do n't notice themselves .	your friends who were thinking about this girl do n't notice herself .
that girl that is n't talking about Paul has seen herself .	that girl that is n't talking about Paul has seen himself .
these people who might forget my mom had seen themselves .	these people who might forget my mom had seen herself .
those people that have heard the lady are n't thinking about themselves .	those people that have heard the lady are n't thinking about herself .
my son that noticed your doctors had heard himself .	my son that noticed your doctors had heard themselves .
that woman that could hear my cousins has remembered herself .	that woman that could hear my cousins has remembered themselves .
my teachers who were thinking about this lady must like themselves .	my teachers who were thinking about this lady must like herself .
your sister who should talk about Kevin sounded like herself .	your sister who should talk about Kevin sounded like himself .
this king who has heard your friends looked like himself .	this king who has heard your friends looked like themselves .
your grandmother who talks about my teachers can notice herself .	your grandmother who talks about my teachers can notice themselves .
my wife that had thought about Daniel had noticed herself .	my wife that had thought about Daniel had noticed himself .
my mom that would n't remember those children had thought about herself .	my mom that would n't remember those children had thought about themselves .
the man that wo n't hear the children will love himself .	the man that wo n't hear the children will love themselves .
your mom who thought about that boy heard herself .	your mom who thought about that boy heard himself .
your mother that would n't know my father is talking about herself .	your mother that would n't know my father is talking about himself .
the queen that is talking about Steven remembered herself .	the queen that is talking about Steven remembered himself .
those children that were n't thinking about the woman talked about themselves .	those children that were n't thinking about the woman talked about herself .
my dad that can like Linda has n't thought about himself .	my dad that can like Linda has n't thought about herself .
this guy that might hear your cousins has n't heard himself .	this guy that might hear your cousins has n't heard themselves .
my mom that can n't see Todd had seen herself .	my mom that can n't see Todd had seen himself .
that king who was thinking about that girl sees himself .	that king who was thinking about that girl sees herself .
your sister that had n't noticed your son looked like herself .	your sister that had n't noticed your son looked like himself .
your brother that has talked about my cousins looks like himself .	your brother that has talked about my cousins looks like themselves .
this guy that noticed my wife did n't love himself .	this guy that noticed my wife did n't love herself .
the boy that has n't heard the lady loves himself .	the boy that has n't heard the lady loves herself .
your son that will sound like Renee has n't noticed himself .	your son that will sound like Renee has n't noticed herself .
your father that should n't think about your teachers heard himself .	your father that should n't think about your teachers heard themselves .
the man who likes Julie had seen himself .	the man who likes Julie had seen herself .
my cousins who remember Richard saw themselves .	my cousins who remember Richard saw himself .
your wife who loves your dad sounds like herself .	your wife who loves your dad sounds like himself .
your mom that had seen that guy sees herself .	your mom that had seen that guy sees himself .
my teachers who thought about Deborah had remembered themselves .	my teachers who thought about Deborah had remembered herself .
those doctors that forget William notice themselves .	those doctors that forget William notice himself .
my brother that should n't think about Sarah thinks about himself .	my brother that should n't think about Sarah thinks about herself .
this lady that has n't noticed John should notice herself .	this lady that has n't noticed John should notice himself .
your wife that would n't forget that man could n't remember herself .	your wife that would n't forget that man could n't remember himself .
your mom that had n't heard my brother sees herself .	your mom that had n't heard my brother sees himself .
those people that had heard my brother had thought about themselves .	those people that had heard my brother had thought about himself .
this lady who noticed the doctors could forget herself .	this lady who noticed the doctors could forget themselves .
my son that did n't look like that woman was n't talking about himself .	my son that did n't look like that woman was n't talking about herself .
that lady that was n't talking about those people sees herself .	that lady that was n't talking about those people sees themselves .
the people that thought about your mother have thought about themselves .	the people that thought about your mother have thought about herself .
this guy that hears Amelia would n't think about himself .	this guy that hears Amelia would n't think about herself .
your doctors that do n't forget Becca noticed themselves .	your doctors that do n't forget Becca noticed herself .
my dad that does n't talk about this queen was n't thinking about himself .	my dad that does n't talk about this queen was n't thinking about herself .
your friends who should n't sound like Michael thought about themselves .	your friends who should n't sound like Michael thought about himself .
your father that did n't notice Leslie saw himself .	your father that did n't notice Leslie saw herself .
your brother who wo n't forget these children will notice himself .	your brother who wo n't forget these children will notice themselves .
your dad that talked about your friends has n't seen himself .	your dad that talked about your friends has n't seen themselves .
the man who talks about these people has n't remembered himself .	the man who talks about these people has n't remembered themselves .
my sister who looked like these people likes herself .	my sister who looked like these people likes themselves .
those teachers who see this guy sounded like themselves .	those teachers who see this guy sounded like himself .
my sister that loved my doctors talks about herself .	my sister that loved my doctors talks about themselves .
your cousins who had remembered your wife could hate themselves .	your cousins who had remembered your wife could hate herself .
your doctors that love Dan loved themselves .	your doctors that love Dan loved himself .
my father who remembered this lady has n't noticed himself .	my father who remembered this lady has n't noticed herself .
your cousins that looked like this boy were thinking about themselves .	your cousins that looked like this boy were thinking about himself .
that man who had heard your teachers sounds like himself .	that man who had heard your teachers sounds like themselves .
that boy who could forget the woman should n't talk about himself .	that boy who could forget the woman should n't talk about herself .
your daughter that talked about Eric did n't talk about herself .	your daughter that talked about Eric did n't talk about himself .
your wife who should n't see Christopher may hear herself .	your wife who should n't see Christopher may hear himself .
your grandmother that would talk about Timothy knew herself .	your grandmother that would talk about Timothy knew himself .
my mom that has talked about these teachers has thought about herself .	my mom that has talked about these teachers has thought about themselves .
my mom that noticed Eric heard herself .	my mom that noticed Eric heard himself .
my teachers who should notice Julia would n't talk about themselves .	my teachers who should notice Julia would n't talk about herself .
that girl that is n't thinking about my brother had n't talked about herself .	that girl that is n't thinking about my brother had n't talked about himself .
that queen that may notice my friends did n't hear herself .	that queen that may notice my friends did n't hear themselves .
your brother that can like these people must know himself .	your brother that can like these people must know themselves .
these children who had thought about this queen like themselves .	these children who had thought about this queen like herself .
these people that are thinking about your mom must love themselves .	these people that are thinking about your mom must love herself .
my daughter that is talking about your father can love herself .	my daughter that is talking about your father can love himself .
that man who looked like this lady hears himself .	that man who looked like this lady hears herself .
my doctors who hear this boy would love themselves .	my doctors who hear this boy would love himself .
the teachers who had thought about this boy remembered themselves .	the teachers who had thought about this boy remembered himself .
this man who can n't see those teachers saw himself .	this man who can n't see those teachers saw themselves .
that lady who is n't talking about your cousins can n't look like herself .	that lady who is n't talking about your cousins can n't look like themselves .
the children that remembered my wife were n't talking about themselves .	the children that remembered my wife were n't talking about herself .
this guy that is thinking about those children talks about himself .	this guy that is thinking about those children talks about themselves .
your cousins that love Tracy had n't seen themselves .	your cousins that love Tracy had n't seen herself .
that man that had noticed your sister has n't remembered himself .	that man that had noticed your sister has n't remembered herself .
these people that would look like Brian saw themselves .	these people that would look like Brian saw himself .
that lady who sees the teachers could n't forget herself .	that lady who sees the teachers could n't forget themselves .
these teachers that were thinking about Robert saw themselves .	these teachers that were thinking about Robert saw himself .
the queen who had noticed Guy talked about herself .	the queen who had noticed Guy talked about himself .
this man that can n't think about those children heard himself .	this man that can n't think about those children heard themselves .
the guy who can n't sound like my doctors can n't remember himself .	the guy who can n't sound like my doctors can n't remember themselves .
the children who have n't seen your grandmother could love themselves .	the children who have n't seen your grandmother could love herself .
that man who talks about those teachers had heard himself .	that man who talks about those teachers had heard themselves .
this queen who has heard this king had n't thought about herself .	this queen who has heard this king had n't thought about himself .
my grandmother that has talked about Steven might like herself .	my grandmother that has talked about Steven might like himself .
your doctors who remembered my mom will remember themselves .	your doctors who remembered my mom will remember herself .
your father who should n't look like those doctors had heard himself .	your father who should n't look like those doctors had heard themselves .
my brother that heard my doctors can remember himself .	my brother that heard my doctors can remember themselves .
my wife who thought about your doctors did n't look like herself .	my wife who thought about your doctors did n't look like themselves .
your cousins who had noticed the guy had heard themselves .	your cousins who had noticed the guy had heard himself .
the queen who may notice those doctors may talk about herself .	the queen who may notice those doctors may talk about themselves .
that guy who looks like Jennifer can see himself .	that guy who looks like Jennifer can see herself .
this queen who looks like Brett should love herself .	this queen who looks like Brett should love himself .
my teachers that might hate this guy look like themselves .	my teachers that might hate this guy look like himself .
your grandmother that has thought about those teachers sounds like herself .	your grandmother that has thought about those teachers sounds like themselves .
these people that have seen Melissa loved themselves .	these people that have seen Melissa loved herself .
your friends that have n't noticed your grandmother forgot themselves .	your friends that have n't noticed your grandmother forgot herself .
the doctors that sound like your mother should talk about themselves .	the doctors that sound like your mother should talk about herself .
your husband who sounded like that queen heard himself .	your husband who sounded like that queen heard herself .
that queen that thinks about your dad loves herself .	that queen that thinks about your dad loves himself .
this lady who could notice my husband likes herself .	this lady who could notice my husband likes himself .
this king who will know that queen heard himself .	this king who will know that queen heard herself .
the queen who might know the children will love herself .	the queen who might know the children will love themselves .
your son that has remembered my sister looked like himself .	your son that has remembered my sister looked like herself .
my doctors who are n't talking about Gregory could think about themselves .	my doctors who are n't talking about Gregory could think about himself .
your cousins that could n't see the queen are thinking about themselves .	your cousins that could n't see the queen are thinking about herself .
the guy who has n't noticed those people has noticed himself .	the guy who has n't noticed those people has noticed themselves .
my cousins that noticed the man forgot themselves .	my cousins that noticed the man forgot himself .
the boy that saw Alice saw himself .	the boy that saw Alice saw herself .
your friends that knew your mother notice themselves .	your friends that knew your mother notice herself .
these children that think about the lady would forget themselves .	these children that think about the lady would forget herself .
the boy who can n't know Nicole was thinking about himself .	the boy who can n't know Nicole was thinking about herself .
my wife that likes this man did n't notice herself .	my wife that likes this man did n't notice himself .
the doctors who look like Ronald had talked about themselves .	the doctors who look like Ronald had talked about himself .
this lady who knew this guy had n't remembered herself .	this lady who knew this guy had n't remembered himself .
your doctors who were n't thinking about that lady should see themselves .	your doctors who were n't thinking about that lady should see herself .
your son who should n't know your grandmother can n't sound like himself .	your son who should n't know your grandmother can n't sound like herself .
that lady who was n't thinking about my dad may think about herself .	that lady who was n't thinking about my dad may think about himself .
my friends who wo n't forget this girl talked about themselves .	my friends who wo n't forget this girl talked about herself .
this lady that has n't remembered those people talked about herself .	this lady that has n't remembered those people talked about themselves .
my cousins that talk about Ann love themselves .	my cousins that talk about Ann love herself .
your wife that was n't talking about the king was thinking about herself .	your wife that was n't talking about the king was thinking about himself .
these people who might look like this guy hear themselves .	these people who might look like this guy hear himself .
your son who looks like the doctors heard himself .	your son who looks like the doctors heard themselves .
your doctors who thought about the queen looked like themselves .	your doctors who thought about the queen looked like herself .
your father who does n't remember these doctors is n't thinking about himself .	your father who does n't remember these doctors is n't thinking about themselves .
my son that could n't hear the people hears himself .	my son that could n't hear the people hears themselves .
this woman that hears your teachers had n't seen herself .	this woman that hears your teachers had n't seen themselves .
your husband that can n't notice your daughter forgot himself .	your husband that can n't notice your daughter forgot herself .
your cousins that have n't remembered your husband do n't notice themselves .	your cousins that have n't remembered your husband do n't notice himself .
my mom who knew these children loves herself .	my mom who knew these children loves themselves .
your son that can n't know those doctors does n't forget himself .	your son that can n't know those doctors does n't forget themselves .
the girl that sounded like these doctors heard herself .	the girl that sounded like these doctors heard themselves .
those doctors who can n't know that girl were n't thinking about themselves .	those doctors who can n't know that girl were n't thinking about herself .
that guy who loves Ann has talked about himself .	that guy who loves Ann has talked about herself .
my cousins that know your wife forget themselves .	my cousins that know your wife forget herself .
this lady who saw my father noticed herself .	this lady who saw my father noticed himself .
those children that will hate my sister hear themselves .	those children that will hate my sister hear herself .
these children who like Michelle hate themselves .	these children who like Michelle hate herself .
the girl that sounded like my doctors will remember herself .	the girl that sounded like my doctors will remember themselves .
that king who did n't like my mother must talk about himself .	that king who did n't like my mother must talk about herself .
this woman that knew the guy noticed herself .	this woman that knew the guy noticed himself .
my friends who would sound like the man think about themselves .	my friends who would sound like the man think about himself .
that queen that was n't thinking about Brett forgot herself .	that queen that was n't thinking about Brett forgot himself .
your friends who remembered that boy forget themselves .	your friends who remembered that boy forget himself .
my doctors who have n't talked about Amelia have noticed themselves .	my doctors who have n't talked about Amelia have noticed herself .
that girl who was n't talking about the people knows herself .	that girl who was n't talking about the people knows themselves .
this man that talked about this woman noticed himself .	this man that talked about this woman noticed herself .
those doctors who were n't talking about Scott were n't thinking about themselves .	those doctors who were n't talking about Scott were n't thinking about himself .
your friends who must love your son talk about themselves .	your friends who must love your son talk about himself .
my dad that might hear this woman looked like himself .	my dad that might hear this woman looked like herself .
the teachers that should n't talk about Kevin love themselves .	the teachers that should n't talk about Kevin love himself .
the king that saw Anne may forget himself .	the king that saw Anne may forget herself .
my cousins that notice your dad would n't know themselves .	my cousins that notice your dad would n't know himself .
this man who heard the doctors might like himself .	this man who heard the doctors might like themselves .
the queen that must look like Peter thinks about herself .	the queen that must look like Peter thinks about himself .
my husband who sees these doctors should talk about himself .	my husband who sees these doctors should talk about themselves .
my cousins who looked like this man are n't talking about themselves .	my cousins who looked like this man are n't talking about himself .
this man that thinks about your mother talked about himself .	this man that thinks about your mother talked about herself .
the man that should n't notice those teachers saw himself .	the man that should n't notice those teachers saw themselves .
that woman that does n't love my brother liked herself .	that woman that does n't love my brother liked himself .
my friends who like Aaron hate themselves .	my friends who like Aaron hate himself .
the lady who liked those people did n't see herself .	the lady who liked those people did n't see themselves .
the teachers that should see this girl had n't remembered themselves .	the teachers that should see this girl had n't remembered herself .
my dad that hears my teachers forgot himself .	my dad that hears my teachers forgot themselves .
my grandmother that can n't remember that man has remembered herself .	my grandmother that can n't remember that man has remembered himself .
this king that would hate Samantha likes himself .	this king that would hate Samantha likes herself .
your friends that would n't love that queen would n't love themselves .	your friends that would n't love that queen would n't love herself .
my sister who saw the children may forget herself .	my sister who saw the children may forget themselves .
that queen who noticed your friends remembered herself .	that queen who noticed your friends remembered themselves .
my doctors who had n't heard Todd remember themselves .	my doctors who had n't heard Todd remember himself .
my daughter who wo n't notice your friends talked about herself .	my daughter who wo n't notice your friends talked about themselves .
my brother that loves Julia is talking about himself .	my brother that loves Julia is talking about herself .
this queen that should n't remember this boy sounds like herself .	this queen that should n't remember this boy sounds like himself .
my friends who looked like your brother have talked about themselves .	my friends who looked like your brother have talked about himself .
these teachers who knew my mother think about themselves .	these teachers who knew my mother think about herself .
the children who noticed Kevin were n't talking about themselves .	the children who noticed Kevin were n't talking about himself .
these children who had heard my mother did n't forget themselves .	these children who had heard my mother did n't forget herself .
those people that heard Aaron have remembered themselves .	those people that heard Aaron have remembered himself .
my cousins who remember this man noticed themselves .	my cousins who remember this man noticed himself .
these children that remembered Richard hate themselves .	these children that remembered Richard hate himself .
your daughter who would think about my husband has remembered herself .	your daughter who would think about my husband has remembered himself .
your son who must sound like the lady may like himself .	your son who must sound like the lady may like herself .
that king that has noticed my friends sounded like himself .	that king that has noticed my friends sounded like themselves .
the king that sounds like those children knew himself .	the king that sounds like those children knew themselves .
my friends who looked like my sister notice themselves .	my friends who looked like my sister notice herself .
the king that has n't seen my wife has n't talked about himself .	the king that has n't seen my wife has n't talked about herself .
this man who has n't heard those children has thought about himself .	this man who has n't heard those children has thought about themselves .
your grandmother who was talking about Steven would know herself .	your grandmother who was talking about Steven would know himself .
your cousins who do n't sound like the woman thought about themselves .	your cousins who do n't sound like the woman thought about herself .
that boy who should hear Jessica had noticed himself .	that boy who should hear Jessica had noticed herself .
your brother who thought about those people may like himself .	your brother who thought about those people may like themselves .
your brother that should talk about my mom sounded like himself .	your brother that should talk about my mom sounded like herself .
those doctors that might remember this queen have n't heard themselves .	those doctors that might remember this queen have n't heard herself .
my doctors who remember my daughter love themselves .	my doctors who remember my daughter love herself .
this woman that has noticed this guy loved herself .	this woman that has noticed this guy loved himself .
those doctors that can n't notice James did n't know themselves .	those doctors that can n't notice James did n't know himself .
your brother that heard my mother was talking about himself .	your brother that heard my mother was talking about herself .
that woman that likes Scott should talk about herself .	that woman that likes Scott should talk about himself .
that girl who had noticed your brother hears herself .	that girl who had noticed your brother hears himself .
your doctors who liked your mom had n't thought about themselves .	your doctors who liked your mom had n't thought about herself .
your son who looks like Jennifer knew himself .	your son who looks like Jennifer knew herself .
this man that liked the people must hear himself .	this man that liked the people must hear themselves .
your father that was talking about Melissa liked himself .	your father that was talking about Melissa liked herself .
my son who knew those children sees himself .	my son who knew those children sees themselves .
that lady that thought about these teachers thinks about herself .	that lady that thought about these teachers thinks about themselves .
these children that talked about Dan might see themselves .	these children that talked about Dan might see himself .
those teachers who could hear that lady are thinking about themselves .	those teachers who could hear that lady are thinking about herself .
that man who sounds like these people had heard himself .	that man who sounds like these people had heard themselves .
your husband that knew those teachers could think about himself .	your husband that knew those teachers could think about themselves .
this woman that loved Brian may love herself .	this woman that loved Brian may love himself .
that girl that had n't remembered those teachers is thinking about herself .	that girl that had n't remembered those teachers is thinking about themselves .
the children who look like that king must love themselves .	the children who look like that king must love himself .
your husband who did n't see my cousins should n't hate himself .	your husband who did n't see my cousins should n't hate themselves .
your grandmother who sounded like your teachers would forget herself .	your grandmother who sounded like your teachers would forget themselves .
your friends who thought about this king are talking about themselves .	your friends who thought about this king are talking about himself .
my husband who has n't seen my mom has n't seen himself .	my husband who has n't seen my mom has n't seen herself .
my teachers that liked my mom hate themselves .	my teachers that liked my mom hate herself .
these teachers who should see this guy forget themselves .	these teachers who should see this guy forget himself .
my teachers that have n't remembered Paul sounded like themselves .	my teachers that have n't remembered Paul sounded like himself .
your sister who talks about those children forgot herself .	your sister who talks about those children forgot themselves .
your cousins who could remember my wife heard themselves .	your cousins who could remember my wife heard herself .
my teachers that have noticed Paul have n't seen themselves .	my teachers that have noticed Paul have n't seen himself .
the guy who had n't thought about this queen has n't thought about himself .	the guy who had n't thought about this queen has n't thought about herself .
this lady that thinks about your friends has n't heard herself .	this lady that thinks about your friends has n't heard themselves .
my husband who was n't thinking about your doctors can hear himself .	my husband who was n't thinking about your doctors can hear themselves .
your mom who will notice the children sounded like herself .	your mom who will notice the children sounded like themselves .
my cousins who notice the boy hear themselves .	my cousins who notice the boy hear himself .
my teachers that wo n't see this queen had noticed themselves .	my teachers that wo n't see this queen had noticed herself .
this woman who must forget the man could n't sound like herself .	this woman who must forget the man could n't sound like himself .
the queen that looks like my friends forgot herself .	the queen that looks like my friends forgot themselves .
my grandmother who sounded like that man can n't forget herself .	my grandmother who sounded like that man can n't forget himself .
that king who will see the girl has heard himself .	that king who will see the girl has heard herself .
my teachers that sounded like your sister talked about themselves .	my teachers that sounded like your sister talked about herself .
the children who had heard Liam think about themselves .	the children who had heard Liam think about himself .
my husband who heard this queen sounds like himself .	my husband who heard this queen sounds like herself .
my mother that had seen these doctors could sound like herself .	my mother that had seen these doctors could sound like themselves .
your teachers that thought about the guy do n't notice themselves .	your teachers that thought about the guy do n't notice himself .
this guy who looked like my cousins could like himself .	this guy who looked like my cousins could like themselves .
your doctors that have n't noticed Cindy were thinking about themselves .	your doctors that have n't noticed Cindy were thinking about herself .
your son that sees your teachers hears himself .	your son that sees your teachers hears themselves .
this girl who will notice my teachers sounds like herself .	this girl who will notice my teachers sounds like themselves .
my friends who liked the boy may notice themselves .	my friends who liked the boy may notice himself .
your doctors that had n't seen your father forgot themselves .	your doctors that had n't seen your father forgot himself .
my dad who has n't seen the woman has n't remembered himself .	my dad who has n't seen the woman has n't remembered herself .
your husband that is n't thinking about Samantha had n't thought about himself .	your husband that is n't thinking about Samantha had n't thought about herself .
those doctors who have n't talked about your dad can see themselves .	those doctors who have n't talked about your dad can see himself .
this lady that has n't seen those people has talked about herself .	this lady that has n't seen those people has talked about themselves .
this woman that could n't hear that boy loved herself .	this woman that could n't hear that boy loved himself .
that man who loved those doctors looked like himself .	that man who loved those doctors looked like themselves .
my mom that had talked about those people knew herself .	my mom that had talked about those people knew themselves .
my husband that talked about your cousins has remembered himself .	my husband that talked about your cousins has remembered themselves .
your husband who saw my friends has seen himself .	your husband who saw my friends has seen themselves .
your friends that had heard my son are talking about themselves .	your friends that had heard my son are talking about himself .
your doctors that were thinking about the queen had remembered themselves .	your doctors that were thinking about the queen had remembered herself .
the man that looked like that woman thinks about himself .	the man that looked like that woman thinks about herself .
your teachers who had talked about Allison did n't forget themselves .	your teachers who had talked about Allison did n't forget herself .
that girl who was talking about my son liked herself .	that girl who was talking about my son liked himself .
the guy who forgot this lady would n't hear himself .	the guy who forgot this lady would n't hear herself .
your teachers who do n't love the king forgot themselves .	your teachers who do n't love the king forgot himself .
that girl that did n't talk about your doctors would forget herself .	that girl that did n't talk about your doctors would forget themselves .
my grandmother that would hate my teachers can forget herself .	my grandmother that would hate my teachers can forget themselves .
your doctors who have noticed my sister would n't know themselves .	your doctors who have noticed my sister would n't know herself .
the teachers who thought about my father would look like themselves .	the teachers who thought about my father would look like himself .
my cousins who are talking about that man forgot themselves .	my cousins who are talking about that man forgot himself .
those teachers that looked like your daughter liked themselves .	those teachers that looked like your daughter liked herself .
those teachers who know that lady had heard themselves .	those teachers who know that lady had heard herself .
my doctors that remember my husband love themselves .	my doctors that remember my husband love himself .
your teachers who do n't think about your brother loved themselves .	your teachers who do n't think about your brother loved himself .
my doctors who love the girl noticed themselves .	my doctors who love the girl noticed herself .
your wife that looked like your son must know herself .	your wife that looked like your son must know himself .
my husband who would look like your daughter has heard himself .	my husband who would look like your daughter has heard herself .
my dad that looked like Melissa sounds like himself .	my dad that looked like Melissa sounds like herself .
the man that noticed the queen might sound like himself .	the man that noticed the queen might sound like herself .
my brother who can n't hear my doctors liked himself .	my brother who can n't hear my doctors liked themselves .
your grandmother who was n't talking about the boy knows herself .	your grandmother who was n't talking about the boy knows himself .
the man that sounds like Ann looked like himself .	the man that sounds like Ann looked like herself .
your mom that thinks about the doctors sounds like herself .	your mom that thinks about the doctors sounds like themselves .
my grandmother who sounds like that boy wo n't know herself .	my grandmother who sounds like that boy wo n't know himself .
your mother who is n't thinking about Joseph sounds like herself .	your mother who is n't thinking about Joseph sounds like himself .
the teachers who looked like your son should n't hate themselves .	the teachers who looked like your son should n't hate himself .
my mother who thinks about my father has talked about herself .	my mother who thinks about my father has talked about himself .
my husband that liked the woman had n't remembered himself .	my husband that liked the woman had n't remembered herself .
these teachers who were n't talking about my sister had seen themselves .	these teachers who were n't talking about my sister had seen herself .
your husband who can n't think about these doctors loved himself .	your husband who can n't think about these doctors loved themselves .
those children that have n't talked about Amy look like themselves .	those children that have n't talked about Amy look like herself .
this man who noticed those teachers sounded like himself .	this man who noticed those teachers sounded like themselves .
that queen who remembered my dad has n't talked about herself .	that queen who remembered my dad has n't talked about himself .
this king who hears this girl has heard himself .	this king who hears this girl has heard herself .
my wife that heard those children knew herself .	my wife that heard those children knew themselves .
that lady that had n't talked about my cousins remembered herself .	that lady that had n't talked about my cousins remembered themselves .
that lady that must talk about my dad would think about herself .	that lady that must talk about my dad would think about himself .
my son who was talking about your wife looked like himself .	my son who was talking about your wife looked like herself .
my son that was n't talking about my grandmother is n't talking about himself .	my son that was n't talking about my grandmother is n't talking about herself .
my wife who was talking about this boy forgot herself .	my wife who was talking about this boy forgot himself .
your brother who sounded like the teachers has n't heard himself .	your brother who sounded like the teachers has n't heard themselves .
the people that were thinking about my son will see themselves .	the people that were thinking about my son will see himself .
the doctors who talk about the boy wo n't hear themselves .	the doctors who talk about the boy wo n't hear himself .
this woman that wo n't forget those people sounds like herself .	this woman that wo n't forget those people sounds like themselves .
my grandmother who sounded like my husband had n't thought about herself .	my grandmother who sounded like my husband had n't thought about himself .
your sister who sounds like the doctors has noticed herself .	your sister who sounds like the doctors has noticed themselves .
your teachers who had n't remembered the woman look like themselves .	your teachers who had n't remembered the woman look like herself .
this girl who knows Aaron had n't seen herself .	this girl who knows Aaron had n't seen himself .
my wife who loves your husband liked herself .	my wife who loves your husband liked himself .
your mom that has n't thought about the doctors does n't love herself .	your mom that has n't thought about the doctors does n't love themselves .
those teachers who should notice Bill should hate themselves .	those teachers who should notice Bill should hate himself .
these children who had talked about your wife will hear themselves .	these children who had talked about your wife will hear herself .
your cousins who have noticed Marie may hear themselves .	your cousins who have noticed Marie may hear herself .
your mom who could love my doctors thinks about herself .	your mom who could love my doctors thinks about themselves .
my grandmother who can n't notice your cousins is n't thinking about herself .	my grandmother who can n't notice your cousins is n't thinking about themselves .
these teachers who forget Leslie might sound like themselves .	these teachers who forget Leslie might sound like herself .
your cousins who hear that boy think about themselves .	your cousins who hear that boy think about himself .
the guy who likes my teachers has n't thought about himself .	the guy who likes my teachers has n't thought about themselves .
the man who has n't noticed that lady thinks about himself .	the man who has n't noticed that lady thinks about herself .
those children who can n't forget this queen notice themselves .	those children who can n't forget this queen notice herself .
the teachers who had heard that king wo n't see themselves .	the teachers who had heard that king wo n't see himself .
my father that should n't notice these children should sound like himself .	my father that should n't notice these children should sound like themselves .
my husband that had seen your wife sounds like himself .	my husband that had seen your wife sounds like herself .
the boy that sounds like Becca thought about himself .	the boy that sounds like Becca thought about herself .
your friends that remembered that king talked about themselves .	your friends that remembered that king talked about himself .
the queen who must forget the doctors has noticed herself .	the queen who must forget the doctors has noticed themselves .
my sister who talked about my teachers loves herself .	my sister who talked about my teachers loves themselves .
that king who should hear your doctors has seen himself .	that king who should hear your doctors has seen themselves .
my wife who was talking about your doctors noticed herself .	my wife who was talking about your doctors noticed themselves .
this girl that sounded like those children did n't notice herself .	this girl that sounded like those children did n't notice themselves .
that king who heard those children is talking about himself .	that king who heard those children is talking about themselves .
the king who could n't look like your wife was n't thinking about himself .	the king who could n't look like your wife was n't thinking about herself .
the lady that sees these people had n't thought about herself .	the lady that sees these people had n't thought about themselves .
that queen who thinks about the boy liked herself .	that queen who thinks about the boy liked himself .
your doctors who forgot the man had n't heard themselves .	your doctors who forgot the man had n't heard himself .
the children who must forget Anna know themselves .	the children who must forget Anna know herself .
this man who does n't talk about those children is talking about himself .	this man who does n't talk about those children is talking about themselves .
your friends who should look like this queen saw themselves .	your friends who should look like this queen saw herself .
this man that sees Becky had noticed himself .	this man that sees Becky had noticed herself .
that woman who may think about James could think about herself .	that woman who may think about James could think about himself .
my wife who could like your doctors looked like herself .	my wife who could like your doctors looked like themselves .
your doctors that had heard this boy talked about themselves .	your doctors that had heard this boy talked about himself .
my son who had n't noticed those teachers talked about himself .	my son who had n't noticed those teachers talked about themselves .
my cousins that knew this girl loved themselves .	my cousins that knew this girl loved herself .
the lady that must look like these children hears herself .	the lady that must look like these children hears themselves .
my cousins that have n't seen George forget themselves .	my cousins that have n't seen George forget himself .
your grandmother that will hear my son noticed herself .	your grandmother that will hear my son noticed himself .
these children who would forget Robert have heard themselves .	these children who would forget Robert have heard himself .
your friends that like that lady have n't talked about themselves .	your friends that like that lady have n't talked about herself .
my husband who has seen those children might remember himself .	my husband who has seen those children might remember themselves .
these teachers that would know the woman see themselves .	these teachers that would know the woman see herself .
my grandmother that had n't remembered my son forgot herself .	my grandmother that had n't remembered my son forgot himself .
that girl who would n't notice those teachers is thinking about herself .	that girl who would n't notice those teachers is thinking about themselves .
your grandmother who could n't love those teachers must talk about herself .	your grandmother who could n't love those teachers must talk about themselves .
this guy that sounds like my cousins has noticed himself .	this guy that sounds like my cousins has noticed themselves .
the people that think about that boy forgot themselves .	the people that think about that boy forgot himself .
those doctors who talked about that king should hate themselves .	those doctors who talked about that king should hate himself .
these children that would talk about this king have remembered themselves .	these children that would talk about this king have remembered himself .
your grandmother who had n't thought about Paul did n't hear herself .	your grandmother who had n't thought about Paul did n't hear himself .
your doctors who know Jill think about themselves .	your doctors who know Jill think about herself .
the teachers that had n't thought about this girl did n't remember themselves .	the teachers that had n't thought about this girl did n't remember herself .
your doctors that know this woman looked like themselves .	your doctors that know this woman looked like herself .
my cousins who were n't thinking about Brian forgot themselves .	my cousins who were n't thinking about Brian forgot himself .
this woman that was n't thinking about these doctors has seen herself .	this woman that was n't thinking about these doctors has seen themselves .
this woman who will love your teachers sees herself .	this woman who will love your teachers sees themselves .
your son that could hate the teachers should n't forget himself .	your son that could hate the teachers should n't forget themselves .
the people who noticed that king can n't sound like themselves .	the people who noticed that king can n't sound like himself .
these children who like that girl had n't talked about themselves .	these children who like that girl had n't talked about herself .
this woman who was thinking about Timothy has remembered herself .	this woman who was thinking about Timothy has remembered himself .
my sister who looked like Thomas wo n't look like herself .	my sister who looked like Thomas wo n't look like himself .
that man that talks about your doctors thought about himself .	that man that talks about your doctors thought about themselves .
those doctors that sound like my son had talked about themselves .	those doctors that sound like my son had talked about himself .
the boy who had n't noticed Stephanie loved himself .	the boy who had n't noticed Stephanie loved herself .
the doctors that should n't see Alice were thinking about themselves .	the doctors that should n't see Alice were thinking about herself .
my husband who noticed those doctors could notice himself .	my husband who noticed those doctors could notice themselves .
that boy who was n't thinking about my grandmother sees himself .	that boy who was n't thinking about my grandmother sees herself .
my mom that was n't thinking about my friends knows herself .	my mom that was n't thinking about my friends knows themselves .
the lady who knew your husband talks about herself .	the lady who knew your husband talks about himself .
my teachers who see Patrick think about themselves .	my teachers who see Patrick think about himself .
my grandmother who may love those teachers would n't notice herself .	my grandmother who may love those teachers would n't notice themselves .
those people that forgot Brian had n't noticed themselves .	those people that forgot Brian had n't noticed himself .
these children who sound like William are n't talking about themselves .	these children who sound like William are n't talking about himself .
your mom who loved Bill noticed herself .	your mom who loved Bill noticed himself .
the boy who looked like those doctors is n't talking about himself .	the boy who looked like those doctors is n't talking about themselves .
my dad that can n't forget your daughter had heard himself .	my dad that can n't forget your daughter had heard herself .
my cousins that may notice Donald hear themselves .	my cousins that may notice Donald hear himself .
the queen who looked like those people sounds like herself .	the queen who looked like those people sounds like themselves .
those doctors who could hate Alice have remembered themselves .	those doctors who could hate Alice have remembered herself .
this woman who noticed the children remembered herself .	this woman who noticed the children remembered themselves .
your friends who would n't forget that boy would think about themselves .	your friends who would n't forget that boy would think about himself .
these teachers that have n't noticed Anna hate themselves .	these teachers that have n't noticed Anna hate herself .
these doctors who knew the king wo n't know themselves .	these doctors who knew the king wo n't know himself .
this king that had n't thought about Nancy sees himself .	this king that had n't thought about Nancy sees herself .
those people that remember Nina know themselves .	those people that remember Nina know herself .
that lady who sounded like your friends may love herself .	that lady who sounded like your friends may love themselves .
your cousins who must think about Barbara know themselves .	your cousins who must think about Barbara know herself .
your mom that had n't heard this man had noticed herself .	your mom that had n't heard this man had noticed himself .
those teachers that are n't talking about Amelia have n't seen themselves .	those teachers that are n't talking about Amelia have n't seen herself .
my mom that could n't think about Paul loves herself .	my mom that could n't think about Paul loves himself .
your daughter who can n't love the teachers forgot herself .	your daughter who can n't love the teachers forgot themselves .
these doctors who looked like that king had n't remembered themselves .	these doctors who looked like that king had n't remembered himself .
your doctors who see Kayla knew themselves .	your doctors who see Kayla knew herself .
my doctors that have thought about your grandmother heard themselves .	my doctors that have thought about your grandmother heard herself .
my dad who remembered your daughter forgot himself .	my dad who remembered your daughter forgot herself .
these people who thought about my husband had talked about themselves .	these people who thought about my husband had talked about himself .
my dad who has seen the lady has remembered himself .	my dad who has seen the lady has remembered herself .
my grandmother that must love that man heard herself .	my grandmother that must love that man heard himself .
your husband that noticed the teachers has seen himself .	your husband that noticed the teachers has seen themselves .
this woman who has n't thought about your friends was thinking about herself .	this woman who has n't thought about your friends was thinking about themselves .
my dad who noticed your teachers likes himself .	my dad who noticed your teachers likes themselves .
my brother who loved those people could think about himself .	my brother who loved those people could think about themselves .
the man that could n't talk about my daughter can n't hear himself .	the man that could n't talk about my daughter can n't hear herself .
my grandmother who thinks about that man forgot herself .	my grandmother who thinks about that man forgot himself .
my brother that can look like my teachers sounds like himself .	my brother that can look like my teachers sounds like themselves .
that queen who would n't see your cousins forgot herself .	that queen who would n't see your cousins forgot themselves .
the king that should hear your doctors heard himself .	the king that should hear your doctors heard themselves .
the children who had n't remembered your sister hate themselves .	the children who had n't remembered your sister hate herself .
the queen who talks about my doctors has n't talked about herself .	the queen who talks about my doctors has n't talked about themselves .
my friends that can like that lady were n't thinking about themselves .	my friends that can like that lady were n't thinking about herself .
the king that loved Lisa hears himself .	the king that loved Lisa hears herself .
those people who might notice my mom think about themselves .	those people who might notice my mom think about herself .
your mom that will notice David should n't look like herself .	your mom that will notice David should n't look like himself .
my sister that looks like your friends forgot herself .	my sister that looks like your friends forgot themselves .
your grandmother that did n't think about this king sees herself .	your grandmother that did n't think about this king sees himself .
this boy who sounds like my mother has n't talked about himself .	this boy who sounds like my mother has n't talked about herself .
the doctors who loved this guy have n't talked about themselves .	the doctors who loved this guy have n't talked about himself .
these children that had heard Renee had n't remembered themselves .	these children that had heard Renee had n't remembered herself .
my teachers who were n't thinking about that girl are n't thinking about themselves .	my teachers who were n't thinking about that girl are n't thinking about herself .
your dad who looked like these teachers talks about himself .	your dad who looked like these teachers talks about themselves .
my son that must remember my wife has remembered himself .	my son that must remember my wife has remembered herself .
your brother who has seen the people talks about himself .	your brother who has seen the people talks about themselves .
my son who liked Michelle has thought about himself .	my son who liked Michelle has thought about herself .
this king who will think about these teachers had n't thought about himself .	this king who will think about these teachers had n't thought about themselves .
your brother who had thought about Judy knew himself .	your brother who had thought about Judy knew herself .
this man who had talked about that lady has n't heard himself .	this man who had talked about that lady has n't heard herself .
my mom that will forget your dad knew herself .	my mom that will forget your dad knew himself .
my grandmother that can n't like those people knew herself .	my grandmother that can n't like those people knew themselves .
this woman who has n't talked about my teachers does n't see herself .	this woman who has n't talked about my teachers does n't see themselves .
those children who can n't hate my husband did n't sound like themselves .	those children who can n't hate my husband did n't sound like himself .
the king who hears your doctors has noticed himself .	the king who hears your doctors has noticed themselves .
my friends that look like David knew themselves .	my friends that look like David knew himself .
the woman who thinks about these children looks like herself .	the woman who thinks about these children looks like themselves .
that queen that has n't heard Bill will remember herself .	that queen that has n't heard Bill will remember himself .
the woman that should see your son knew herself .	the woman that should see your son knew himself .
my friends who did n't love my son have n't seen themselves .	my friends who did n't love my son have n't seen himself .
