the dentist was very very very very very very very very very nice .	the dentist sings very very very very very very very very very nice .
the dentist is really really really really really really really really bored .	the dentist reads really really really really really really really really bored .
the woman is very very very very very very very very young .	the woman cries very very very very very very very very young .
the boy is very very very very very very very very very smart .	the boy cries very very very very very very very very very smart .
the queen is really really really really really really really gentle .	the queen talks really really really really really really really gentle .
the girl is very very very very very very very busy .	the girl waves very very very very very very very busy .
the person is really really really really really really really really important .	the person cries really really really really really really really really important .
the adult is really really really really really really really angry .	the adult sings really really really really really really really angry .
the girl was very very very very very very very very very nice .	the girl talks very very very very very very very very very nice .
the teacher was really really really really really really really surprised .	the teacher sings really really really really really really really surprised .
the lady was very very very very very very very smart .	the lady sings very very very very very very very smart .
the king was really really really really really really really really really confused .	the king talks really really really really really really really really really confused .
the boy was very very very very very very very very happy .	the boy talks very very very very very very very very happy .
the adult is really really really really really really really really really really wrong .	the adult cries really really really really really really really really really really wrong .
the doctor is very very very very very very very friendly .	the doctor reads very very very very very very very friendly .
the king was very very very very very very very boring .	the king cries very very very very very very very boring .
the boy was very very very very very very very important .	the boy sings very very very very very very very important .
the king is really really really really really really really really really really curious .	the king cries really really really really really really really really really really curious .
the child was very very very very very very very very very very nice .	the child talks very very very very very very very very very very nice .
the man is very very very very very very very friendly .	the man paints very very very very very very very friendly .
the girl is very very very very very very very very very very strong .	the girl exercises very very very very very very very very very very strong .
the customer was very very very very very very very very very very quiet .	the customer cries very very very very very very very very very very quiet .
the patient was very very very very very very very happy .	the patient reads very very very very very very very happy .
the lady is very very very very very very very busy .	the lady waves very very very very very very very busy .
the lady is very very very very very very very friendly .	the lady cries very very very very very very very friendly .
the dentist is really really really really really really really boring .	the dentist talks really really really really really really really boring .
the customer is very very very very very very very very very friendly .	the customer talks very very very very very very very very very friendly .
the queen is very very very very very very very very very hungry .	the queen waves very very very very very very very very very hungry .
the girl is very very very very very very very very very very lucky .	the girl exercises very very very very very very very very very very lucky .
the king was very very very very very very very very very nice .	the king reads very very very very very very very very very nice .
the king is really really really really really really really really friendly .	the king talks really really really really really really really really friendly .
the girl is really really really really really really really upset .	the girl reads really really really really really really really upset .
the driver was really really really really really really really really really really smart .	the driver waves really really really really really really really really really really smart .
the boy is very very very very very very very bored .	the boy talks very very very very very very very bored .
the boy is really really really really really really really friendly .	the boy talks really really really really really really really friendly .
the driver was really really really really really really really quiet .	the driver waves really really really really really really really quiet .
the woman is really really really really really really really excited .	the woman exercises really really really really really really really excited .
the lady is very very very very very very very very very very upset .	the lady paints very very very very very very very very very very upset .
the teacher was very very very very very very very excited .	the teacher reads very very very very very very very excited .
the teacher is very very very very very very very sleepy .	the teacher reads very very very very very very very sleepy .
the person is very very very very very very very very very very smart .	the person waves very very very very very very very very very very smart .
the doctor is very very very very very very very very very very wrong .	the doctor sings very very very very very very very very very very wrong .
the dancer was really really really really really really really really really surprised .	the dancer exercises really really really really really really really really really surprised .
the guy is very very very very very very very very very very smart .	the guy waves very very very very very very very very very very smart .
the girl was very very very very very very very busy .	the girl sings very very very very very very very busy .
the dentist is really really really really really really really strong .	the dentist sings really really really really really really really strong .
the patient is really really really really really really really really really really friendly .	the patient paints really really really really really really really really really really friendly .
the doctor was really really really really really really really really really really friendly .	the doctor paints really really really really really really really really really really friendly .
the girl was very very very very very very very very excited .	the girl talks very very very very very very very very excited .
the person was really really really really really really really angry .	the person sings really really really really really really really angry .
the doctor was very very very very very very very angry .	the doctor talks very very very very very very very angry .
the girl was very very very very very very very very very very happy .	the girl sings very very very very very very very very very very happy .
the child was really really really really really really really really kind .	the child waves really really really really really really really really kind .
the man is very very very very very very very tired .	the man talks very very very very very very very tired .
the girl is really really really really really really really really really really excited .	the girl exercises really really really really really really really really really really excited .
the lady is very very very very very very very very very very curious .	the lady cries very very very very very very very very very very curious .
the queen is very very very very very very very very very excited .	the queen exercises very very very very very very very very very excited .
the dentist is very very very very very very very angry .	the dentist paints very very very very very very very angry .
the driver was very very very very very very very very angry .	the driver cries very very very very very very very very angry .
the customer is really really really really really really really really really confused .	the customer paints really really really really really really really really really confused .
the boy is very very very very very very very very helpful .	the boy talks very very very very very very very very helpful .
the king is really really really really really really really smart .	the king paints really really really really really really really smart .
the dentist was really really really really really really really really really excited .	the dentist waves really really really really really really really really really excited .
the doctor is very very very very very very very very very nice .	the doctor waves very very very very very very very very very nice .
the customer was very very very very very very very very very very important .	the customer waves very very very very very very very very very very important .
the person is really really really really really really really healthy .	the person waves really really really really really really really healthy .
the dancer was very very very very very very very very hungry .	the dancer paints very very very very very very very very hungry .
the person is very very very very very very very very very very boring .	the person reads very very very very very very very very very very boring .
the teacher is really really really really really really really really helpful .	the teacher cries really really really really really really really really helpful .
the king was really really really really really really really really really really boring .	the king talks really really really really really really really really really really boring .
the king was really really really really really really really really really really strong .	the king paints really really really really really really really really really really strong .
the king is really really really really really really really wrong .	the king exercises really really really really really really really wrong .
the boy is really really really really really really really really gentle .	the boy talks really really really really really really really really gentle .
the teacher is really really really really really really really really curious .	the teacher paints really really really really really really really really curious .
the lady is very very very very very very very hungry .	the lady cries very very very very very very very hungry .
the girl was very very very very very very very very very very surprised .	the girl waves very very very very very very very very very very surprised .
the adult was really really really really really really really tall .	the adult talks really really really really really really really tall .
the lady was very very very very very very very very very very clever .	the lady waves very very very very very very very very very very clever .
the patient was very very very very very very very very very very excited .	the patient exercises very very very very very very very very very very excited .
the child is very very very very very very very very very very tall .	the child sings very very very very very very very very very very tall .
the boy is very very very very very very very very busy .	the boy talks very very very very very very very very busy .
the king is really really really really really really really really really really surprised .	the king paints really really really really really really really really really really surprised .
the guy is really really really really really really really really careful .	the guy sings really really really really really really really really careful .
the king is very very very very very very very very very sleepy .	the king talks very very very very very very very very very sleepy .
the patient was really really really really really really really really really really strong .	the patient paints really really really really really really really really really really strong .
the dancer is really really really really really really really really really really lucky .	the dancer talks really really really really really really really really really really lucky .
the patient was really really really really really really really really really really excited .	the patient talks really really really really really really really really really really excited .
the teacher was really really really really really really really really boring .	the teacher exercises really really really really really really really really boring .
the child was very very very very very very very tired .	the child reads very very very very very very very tired .
the dentist was very very very very very very very important .	the dentist exercises very very very very very very very important .
the king was really really really really really really really really really friendly .	the king exercises really really really really really really really really really friendly .
the doctor is very very very very very very very very very healthy .	the doctor cries very very very very very very very very very healthy .
the man is really really really really really really really really really really busy .	the man waves really really really really really really really really really really busy .
the man was very very very very very very very very very tired .	the man sings very very very very very very very very very tired .
the customer was really really really really really really really really really really busy .	the customer reads really really really really really really really really really really busy .
the child was very very very very very very very very excited .	the child exercises very very very very very very very very excited .
the person is really really really really really really really really surprised .	the person reads really really really really really really really really surprised .
the customer is really really really really really really really really really strong .	the customer exercises really really really really really really really really really strong .
the man was very very very very very very very very confused .	the man cries very very very very very very very very confused .
the dentist is very very very very very very very careful .	the dentist paints very very very very very very very careful .
the woman is very very very very very very very very very very clever .	the woman sings very very very very very very very very very very clever .
the queen is really really really really really really really really helpful .	the queen sings really really really really really really really really helpful .
the woman is very very very very very very very very very angry .	the woman sings very very very very very very very very very angry .
the patient was very very very very very very very very very angry .	the patient waves very very very very very very very very very angry .
the girl is really really really really really really really really really really angry .	the girl waves really really really really really really really really really really angry .
the girl was really really really really really really really really really really happy .	the girl sings really really really really really really really really really really happy .
the driver is very very very very very very very very very surprised .	the driver paints very very very very very very very very very surprised .
the man was very very very very very very very very very very upset .	the man exercises very very very very very very very very very very upset .
the doctor is very very very very very very very very gentle .	the doctor exercises very very very very very very very very gentle .
the doctor is very very very very very very very very busy .	the doctor paints very very very very very very very very busy .
the man was very very very very very very very lucky .	the man exercises very very very very very very very lucky .
the man is really really really really really really really really really clever .	the man paints really really really really really really really really really clever .
the doctor is very very very very very very very very very very busy .	the doctor talks very very very very very very very very very very busy .
the boy is very very very very very very very very very gentle .	the boy reads very very very very very very very very very gentle .
the customer was really really really really really really really really really helpful .	the customer cries really really really really really really really really really helpful .
the child was really really really really really really really wrong .	the child paints really really really really really really really wrong .
the person is really really really really really really really really careful .	the person cries really really really really really really really really careful .
the driver is really really really really really really really important .	the driver sings really really really really really really really important .
the person is really really really really really really really really helpful .	the person waves really really really really really really really really helpful .
the teacher is really really really really really really really really really really careful .	the teacher paints really really really really really really really really really really careful .
the guy is really really really really really really really bored .	the guy waves really really really really really really really bored .
the customer is really really really really really really really kind .	the customer paints really really really really really really really kind .
the customer is very very very very very very very very very wrong .	the customer cries very very very very very very very very very wrong .
the adult is very very very very very very very very very very quiet .	the adult exercises very very very very very very very very very very quiet .
the lady is really really really really really really really really quiet .	the lady paints really really really really really really really really quiet .
the driver was really really really really really really really really really curious .	the driver exercises really really really really really really really really really curious .
the person was really really really really really really really really really really gentle .	the person talks really really really really really really really really really really gentle .
the man is really really really really really really really really confused .	the man waves really really really really really really really really confused .
the woman was really really really really really really really really confused .	the woman paints really really really really really really really really confused .
the girl was very very very very very very very very very very busy .	the girl paints very very very very very very very very very very busy .
the person is really really really really really really really really really excited .	the person exercises really really really really really really really really really excited .
the girl is very very very very very very very very happy .	the girl exercises very very very very very very very very happy .
the doctor is really really really really really really really really really friendly .	the doctor cries really really really really really really really really really friendly .
the queen is very very very very very very very very very very quiet .	the queen exercises very very very very very very very very very very quiet .
the child is really really really really really really really really upset .	the child cries really really really really really really really really upset .
the king is really really really really really really really really really really bored .	the king waves really really really really really really really really really really bored .
the man was very very very very very very very very helpful .	the man waves very very very very very very very very helpful .
the king was very very very very very very very very very very friendly .	the king cries very very very very very very very very very very friendly .
the patient is really really really really really really really important .	the patient reads really really really really really really really important .
the king was really really really really really really really really really really bored .	the king talks really really really really really really really really really really bored .
the woman was very very very very very very very very very very friendly .	the woman talks very very very very very very very very very very friendly .
the man is really really really really really really really confused .	the man talks really really really really really really really confused .
the person was really really really really really really really really young .	the person exercises really really really really really really really really young .
the child is very very very very very very very very very kind .	the child cries very very very very very very very very very kind .
the guy is really really really really really really really really really really nice .	the guy reads really really really really really really really really really really nice .
the woman is really really really really really really really really angry .	the woman sings really really really really really really really really angry .
the woman is really really really really really really really really really really happy .	the woman sings really really really really really really really really really really happy .
the doctor is very very very very very very very very very upset .	the doctor exercises very very very very very very very very very upset .
the man was very very very very very very very very very very wrong .	the man sings very very very very very very very very very very wrong .
the dentist is very very very very very very very very very quiet .	the dentist talks very very very very very very very very very quiet .
the doctor was very very very very very very very very sleepy .	the doctor cries very very very very very very very very sleepy .
the lady is very very very very very very very very excited .	the lady sings very very very very very very very very excited .
the teacher was really really really really really really really strong .	the teacher waves really really really really really really really strong .
the king was really really really really really really really really really really upset .	the king reads really really really really really really really really really really upset .
the child was very very very very very very very very very very lucky .	the child sings very very very very very very very very very very lucky .
the man is really really really really really really really really really sleepy .	the man talks really really really really really really really really really sleepy .
the girl is really really really really really really really really really really healthy .	the girl reads really really really really really really really really really really healthy .
the boy is really really really really really really really really happy .	the boy reads really really really really really really really really happy .
the guy was very very very very very very very very very very busy .	the guy waves very very very very very very very very very very busy .
the guy was really really really really really really really really really really friendly .	the guy talks really really really really really really really really really really friendly .
the girl was really really really really really really really really really really strong .	the girl reads really really really really really really really really really really strong .
the driver is very very very very very very very clever .	the driver cries very very very very very very very clever .
the child was very very very very very very very very very angry .	the child talks very very very very very very very very very angry .
the woman is very very very very very very very strong .	the woman reads very very very very very very very strong .
the driver was very very very very very very very busy .	the driver waves very very very very very very very busy .
the dentist was very very very very very very very quiet .	the dentist paints very very very very very very very quiet .
the customer is really really really really really really really smart .	the customer sings really really really really really really really smart .
the dancer was very very very very very very very very very gentle .	the dancer reads very very very very very very very very very gentle .
the queen is really really really really really really really bored .	the queen reads really really really really really really really bored .
the customer is really really really really really really really strong .	the customer exercises really really really really really really really strong .
the lady is really really really really really really really really really kind .	the lady paints really really really really really really really really really kind .
the child was very very very very very very very very very friendly .	the child waves very very very very very very very very very friendly .
the patient is really really really really really really really healthy .	the patient reads really really really really really really really healthy .
the boy is very very very very very very very very very very busy .	the boy paints very very very very very very very very very very busy .
the boy was really really really really really really really really really tired .	the boy talks really really really really really really really really really tired .
the boy is really really really really really really really really really curious .	the boy reads really really really really really really really really really curious .
the child was very very very very very very very very very hungry .	the child talks very very very very very very very very very hungry .
the girl is really really really really really really really young .	the girl talks really really really really really really really young .
the patient is very very very very very very very very very smart .	the patient waves very very very very very very very very very smart .
the doctor is really really really really really really really really really helpful .	the doctor exercises really really really really really really really really really helpful .
the teacher is very very very very very very very very very very happy .	the teacher reads very very very very very very very very very very happy .
the customer is really really really really really really really really smart .	the customer exercises really really really really really really really really smart .
the teacher was very very very very very very very very sleepy .	the teacher sings very very very very very very very very sleepy .
the teacher is really really really really really really really really friendly .	the teacher talks really really really really really really really really friendly .
the dentist was really really really really really really really really really really strong .	the dentist talks really really really really really really really really really really strong .
the king was very very very very very very very very curious .	the king waves very very very very very very very very curious .
the driver was very very very very very very very kind .	the driver sings very very very very very very very kind .
the dentist is very very very very very very very very curious .	the dentist sings very very very very very very very very curious .
the child is very very very very very very very very very tall .	the child exercises very very very very very very very very very tall .
the teacher is really really really really really really really really really really important .	the teacher reads really really really really really really really really really really important .
the customer was very very very very very very very very very very angry .	the customer talks very very very very very very very very very very angry .
the man was really really really really really really really hungry .	the man talks really really really really really really really hungry .
the dancer was very very very very very very very very very very quiet .	the dancer cries very very very very very very very very very very quiet .
the king was very very very very very very very very very very surprised .	the king paints very very very very very very very very very very surprised .
the driver was really really really really really really really really happy .	the driver waves really really really really really really really really happy .
the person is really really really really really really really really really bored .	the person paints really really really really really really really really really bored .
the child was very very very very very very very very very very important .	the child waves very very very very very very very very very very important .
the person is very very very very very very very very very very upset .	the person cries very very very very very very very very very very upset .
the man is very very very very very very very very helpful .	the man cries very very very very very very very very helpful .
the doctor is very very very very very very very clever .	the doctor exercises very very very very very very very clever .
the adult is very very very very very very very very very sleepy .	the adult paints very very very very very very very very very sleepy .
the man is very very very very very very very important .	the man exercises very very very very very very very important .
the customer was really really really really really really really really really sleepy .	the customer paints really really really really really really really really really sleepy .
the guy is very very very very very very very very very very sleepy .	the guy talks very very very very very very very very very very sleepy .
the guy was very very very very very very very very very very healthy .	the guy reads very very very very very very very very very very healthy .
the woman is very very very very very very very very very very tall .	the woman reads very very very very very very very very very very tall .
the king was really really really really really really really really really really helpful .	the king sings really really really really really really really really really really helpful .
the lady is really really really really really really really important .	the lady exercises really really really really really really really important .
the boy is really really really really really really really confused .	the boy talks really really really really really really really confused .
the dancer is very very very very very very very quiet .	the dancer exercises very very very very very very very quiet .
the driver is really really really really really really really really really really gentle .	the driver waves really really really really really really really really really really gentle .
the person was really really really really really really really angry .	the person waves really really really really really really really angry .
the doctor is very very very very very very very clever .	the doctor talks very very very very very very very clever .
the queen was really really really really really really really really really really angry .	the queen talks really really really really really really really really really really angry .
the lady is very very very very very very very very very very bored .	the lady exercises very very very very very very very very very very bored .
the woman was very very very very very very very very lucky .	the woman reads very very very very very very very very lucky .
the customer is really really really really really really really really strong .	the customer sings really really really really really really really really strong .
the doctor is really really really really really really really angry .	the doctor sings really really really really really really really angry .
the teacher is very very very very very very very very friendly .	the teacher paints very very very very very very very very friendly .
the guy was really really really really really really really really really really angry .	the guy paints really really really really really really really really really really angry .
the dentist was very very very very very very very nice .	the dentist sings very very very very very very very nice .
the person was very very very very very very very very important .	the person paints very very very very very very very very important .
the child was really really really really really really really really nice .	the child sings really really really really really really really really nice .
the adult is very very very very very very very very very very kind .	the adult reads very very very very very very very very very very kind .
the patient was really really really really really really really really really healthy .	the patient waves really really really really really really really really really healthy .
the queen is really really really really really really really really really surprised .	the queen waves really really really really really really really really really surprised .
the woman is very very very very very very very very very gentle .	the woman talks very very very very very very very very very gentle .
the king was really really really really really really really really really really quiet .	the king waves really really really really really really really really really really quiet .
the girl was really really really really really really really really really young .	the girl paints really really really really really really really really really young .
the child was very very very very very very very very very very upset .	the child talks very very very very very very very very very very upset .
the driver was really really really really really really really really wrong .	the driver waves really really really really really really really really wrong .
the guy is really really really really really really really really really gentle .	the guy waves really really really really really really really really really gentle .
the queen is really really really really really really really bored .	the queen waves really really really really really really really bored .
the dentist is really really really really really really really really tired .	the dentist paints really really really really really really really really tired .
the woman is very very very very very very very very very friendly .	the woman talks very very very very very very very very very friendly .
the dancer is really really really really really really really really really really wrong .	the dancer sings really really really really really really really really really really wrong .
the driver is really really really really really really really really really really wrong .	the driver paints really really really really really really really really really really wrong .
the boy was very very very very very very very very very very careful .	the boy talks very very very very very very very very very very careful .
the teacher is really really really really really really really really really young .	the teacher waves really really really really really really really really really young .
the girl was very very very very very very very very quiet .	the girl paints very very very very very very very very quiet .
the boy was really really really really really really really important .	the boy waves really really really really really really really important .
the adult was very very very very very very very very very very wrong .	the adult paints very very very very very very very very very very wrong .
the person is very very very very very very very very wrong .	the person cries very very very very very very very very wrong .
the driver was very very very very very very very very very very kind .	the driver cries very very very very very very very very very very kind .
the child is very very very very very very very boring .	the child cries very very very very very very very boring .
the dentist is very very very very very very very very tired .	the dentist cries very very very very very very very very tired .
the man is very very very very very very very very very very quiet .	the man exercises very very very very very very very very very very quiet .
the dancer is really really really really really really really really really tall .	the dancer sings really really really really really really really really really tall .
the child is very very very very very very very very very tall .	the child paints very very very very very very very very very tall .
the boy is very very very very very very very very very very young .	the boy paints very very very very very very very very very very young .
the customer was very very very very very very very very upset .	the customer paints very very very very very very very very upset .
the queen is very very very very very very very very very very excited .	the queen talks very very very very very very very very very very excited .
the man is really really really really really really really really really bored .	the man talks really really really really really really really really really bored .
the lady is very very very very very very very friendly .	the lady talks very very very very very very very friendly .
the adult was really really really really really really really really really careful .	the adult talks really really really really really really really really really careful .
the customer is really really really really really really really really surprised .	the customer cries really really really really really really really really surprised .
the king was really really really really really really really really really really surprised .	the king sings really really really really really really really really really really surprised .
the customer is really really really really really really really really confused .	the customer exercises really really really really really really really really confused .
the adult was really really really really really really really really really really gentle .	the adult exercises really really really really really really really really really really gentle .
the dentist is very very very very very very very busy .	the dentist cries very very very very very very very busy .
the patient is really really really really really really really really really smart .	the patient waves really really really really really really really really really smart .
the adult was very very very very very very very very excited .	the adult paints very very very very very very very very excited .
the king is really really really really really really really careful .	the king exercises really really really really really really really careful .
the child was really really really really really really really really really really upset .	the child exercises really really really really really really really really really really upset .
the dancer was very very very very very very very very very very strong .	the dancer waves very very very very very very very very very very strong .
the guy was very very very very very very very hungry .	the guy paints very very very very very very very hungry .
the guy is very very very very very very very very healthy .	the guy waves very very very very very very very very healthy .
the man was really really really really really really really upset .	the man waves really really really really really really really upset .
the guy was very very very very very very very very very very nice .	the guy paints very very very very very very very very very very nice .
the child is really really really really really really really young .	the child cries really really really really really really really young .
the child is very very very very very very very friendly .	the child sings very very very very very very very friendly .
the adult is really really really really really really really really really really tall .	the adult paints really really really really really really really really really really tall .
the customer is really really really really really really really really friendly .	the customer sings really really really really really really really really friendly .
the doctor is very very very very very very very very young .	the doctor cries very very very very very very very very young .
the teacher is really really really really really really really helpful .	the teacher sings really really really really really really really helpful .
the teacher was really really really really really really really really excited .	the teacher cries really really really really really really really really excited .
the dancer was very very very very very very very very bored .	the dancer exercises very very very very very very very very bored .
the adult was very very very very very very very bored .	the adult reads very very very very very very very bored .
the dentist is very very very very very very very healthy .	the dentist cries very very very very very very very healthy .
the dentist was really really really really really really really really really kind .	the dentist reads really really really really really really really really really kind .
the king is really really really really really really really really really busy .	the king reads really really really really really really really really really busy .
the child is very very very very very very very very bored .	the child cries very very very very very very very very bored .
the woman was really really really really really really really really helpful .	the woman paints really really really really really really really really helpful .
the dentist was very very very very very very very very very healthy .	the dentist cries very very very very very very very very very healthy .
the doctor is very very very very very very very very very tall .	the doctor exercises very very very very very very very very very tall .
the dentist was really really really really really really really confused .	the dentist paints really really really really really really really confused .
the dentist was really really really really really really really really really sleepy .	the dentist talks really really really really really really really really really sleepy .
the driver is very very very very very very very lucky .	the driver waves very very very very very very very lucky .
the queen is really really really really really really really really really busy .	the queen paints really really really really really really really really really busy .
the man is really really really really really really really busy .	the man cries really really really really really really really busy .
the child was really really really really really really really really really strong .	the child waves really really really really really really really really really strong .
the dancer is really really really really really really really tired .	the dancer exercises really really really really really really really tired .
the child is really really really really really really really really surprised .	the child talks really really really really really really really really surprised .
the queen is really really really really really really really healthy .	the queen waves really really really really really really really healthy .
the dentist is really really really really really really really really angry .	the dentist exercises really really really really really really really really angry .
the person was very very very very very very very young .	the person waves very very very very very very very young .
the dentist is very very very very very very very gentle .	the dentist cries very very very very very very very gentle .
the driver was really really really really really really really really healthy .	the driver talks really really really really really really really really healthy .
the man is really really really really really really really bored .	the man exercises really really really really really really really bored .
the guy was very very very very very very very very wrong .	the guy exercises very very very very very very very very wrong .
the child is really really really really really really really really really healthy .	the child reads really really really really really really really really really healthy .
the person was very very very very very very very very lucky .	the person waves very very very very very very very very lucky .
the adult is really really really really really really really tired .	the adult cries really really really really really really really tired .
the lady was really really really really really really really really really really important .	the lady waves really really really really really really really really really really important .
the patient is very very very very very very very very very very hungry .	the patient paints very very very very very very very very very very hungry .
the girl is very very very very very very very important .	the girl talks very very very very very very very important .
the driver was very very very very very very very confused .	the driver reads very very very very very very very confused .
the customer is really really really really really really really really curious .	the customer cries really really really really really really really really curious .
the woman is really really really really really really really wrong .	the woman paints really really really really really really really wrong .
the dentist is really really really really really really really really really really lucky .	the dentist cries really really really really really really really really really really lucky .
the doctor is really really really really really really really really happy .	the doctor sings really really really really really really really really happy .
the teacher was very very very very very very very very strong .	the teacher sings very very very very very very very very strong .
the lady was very very very very very very very upset .	the lady reads very very very very very very very upset .
the customer was very very very very very very very very nice .	the customer cries very very very very very very very very nice .
the dentist was very very very very very very very happy .	the dentist waves very very very very very very very happy .
the child was very very very very very very very very curious .	the child waves very very very very very very very very curious .
the boy is really really really really really really really really helpful .	the boy reads really really really really really really really really helpful .
the girl is really really really really really really really really really wrong .	the girl exercises really really really really really really really really really wrong .
the dancer was really really really really really really really really really hungry .	the dancer exercises really really really really really really really really really hungry .
the driver was very very very very very very very very careful .	the driver exercises very very very very very very very very careful .
the queen was really really really really really really really really confused .	the queen cries really really really really really really really really confused .
the girl was very very very very very very very very very curious .	the girl waves very very very very very very very very very curious .
the dancer is really really really really really really really really really really excited .	the dancer waves really really really really really really really really really really excited .
the queen is really really really really really really really kind .	the queen talks really really really really really really really kind .
the teacher is really really really really really really really sleepy .	the teacher talks really really really really really really really sleepy .
the driver was really really really really really really really really really quiet .	the driver paints really really really really really really really really really quiet .
the dancer was very very very very very very very very boring .	the dancer sings very very very very very very very very boring .
the guy was very very very very very very very very very clever .	the guy cries very very very very very very very very very clever .
the woman was really really really really really really really really really really quiet .	the woman paints really really really really really really really really really really quiet .
the woman is very very very very very very very very very quiet .	the woman reads very very very very very very very very very quiet .
the queen is very very very very very very very very very hungry .	the queen reads very very very very very very very very very hungry .
the guy was very very very very very very very very very very excited .	the guy cries very very very very very very very very very very excited .
the patient was really really really really really really really really really really quiet .	the patient sings really really really really really really really really really really quiet .
the boy was really really really really really really really really really really smart .	the boy exercises really really really really really really really really really really smart .
the customer is really really really really really really really really boring .	the customer sings really really really really really really really really boring .
the dentist is really really really really really really really really really really careful .	the dentist paints really really really really really really really really really really careful .
the teacher is really really really really really really really really really important .	the teacher paints really really really really really really really really really important .
the girl was really really really really really really really nice .	the girl paints really really really really really really really nice .
the person was very very very very very very very very tall .	the person waves very very very very very very very very tall .
the woman was really really really really really really really careful .	the woman cries really really really really really really really careful .
the child is really really really really really really really bored .	the child reads really really really really really really really bored .
the man was very very very very very very very excited .	the man sings very very very very very very very excited .
the customer was very very very very very very very very excited .	the customer cries very very very very very very very very excited .
the adult was very very very very very very very very very helpful .	the adult cries very very very very very very very very very helpful .
the dentist is very very very very very very very very very very smart .	the dentist waves very very very very very very very very very very smart .
the teacher was really really really really really really really quiet .	the teacher exercises really really really really really really really quiet .
the guy is very very very very very very very very gentle .	the guy talks very very very very very very very very gentle .
the lady was really really really really really really really clever .	the lady reads really really really really really really really clever .
the customer is very very very very very very very very important .	the customer sings very very very very very very very very important .
the adult is very very very very very very very very tall .	the adult paints very very very very very very very very tall .
the doctor was very very very very very very very very very boring .	the doctor exercises very very very very very very very very very boring .
the guy was very very very very very very very hungry .	the guy waves very very very very very very very hungry .
the dentist is very very very very very very very very very helpful .	the dentist paints very very very very very very very very very helpful .
the dancer was very very very very very very very very very tall .	the dancer reads very very very very very very very very very tall .
the dancer is very very very very very very very very very very tall .	the dancer waves very very very very very very very very very very tall .
the dentist was very very very very very very very very very very curious .	the dentist talks very very very very very very very very very very curious .
the child was very very very very very very very very tired .	the child sings very very very very very very very very tired .
the person was very very very very very very very very sleepy .	the person talks very very very very very very very very sleepy .
the person is really really really really really really really really young .	the person paints really really really really really really really really young .
the man is really really really really really really really really really healthy .	the man talks really really really really really really really really really healthy .
the child is very very very very very very very kind .	the child sings very very very very very very very kind .
the man is very very very very very very very very strong .	the man reads very very very very very very very very strong .
the queen is very very very very very very very very very very strong .	the queen reads very very very very very very very very very very strong .
the man was very very very very very very very important .	the man cries very very very very very very very important .
the dentist is very very very very very very very very very very kind .	the dentist cries very very very very very very very very very very kind .
the boy is really really really really really really really really really sleepy .	the boy waves really really really really really really really really really sleepy .
the man was really really really really really really really really really really lucky .	the man talks really really really really really really really really really really lucky .
the doctor is very very very very very very very strong .	the doctor paints very very very very very very very strong .
the teacher was really really really really really really really really really quiet .	the teacher paints really really really really really really really really really quiet .
the child is very very very very very very very very excited .	the child waves very very very very very very very very excited .
the driver is very very very very very very very kind .	the driver cries very very very very very very very kind .
the dentist was really really really really really really really really really quiet .	the dentist exercises really really really really really really really really really quiet .
the man is very very very very very very very very bored .	the man waves very very very very very very very very bored .
the patient is very very very very very very very very very kind .	the patient reads very very very very very very very very very kind .
the child is really really really really really really really really really really excited .	the child waves really really really really really really really really really really excited .
the lady was very very very very very very very confused .	the lady waves very very very very very very very confused .
the king is really really really really really really really really upset .	the king talks really really really really really really really really upset .
the lady is really really really really really really really smart .	the lady sings really really really really really really really smart .
the guy was very very very very very very very very very very happy .	the guy exercises very very very very very very very very very very happy .
the boy was very very very very very very very very very very surprised .	the boy waves very very very very very very very very very very surprised .
the doctor was very very very very very very very healthy .	the doctor paints very very very very very very very healthy .
the boy is really really really really really really really really really really smart .	the boy cries really really really really really really really really really really smart .
the woman is very very very very very very very very very very nice .	the woman sings very very very very very very very very very very nice .
the woman was really really really really really really really really really angry .	the woman cries really really really really really really really really really angry .
the customer is very very very very very very very very surprised .	the customer paints very very very very very very very very surprised .
the dancer is really really really really really really really really strong .	the dancer talks really really really really really really really really strong .
the child is very very very very very very very very bored .	the child talks very very very very very very very very bored .
the woman was really really really really really really really really healthy .	the woman reads really really really really really really really really healthy .
the patient is very very very very very very very very important .	the patient cries very very very very very very very very important .
the dancer is very very very very very very very gentle .	the dancer talks very very very very very very very gentle .
the teacher was very very very very very very very very important .	the teacher waves very very very very very very very very important .
the woman was very very very very very very very very confused .	the woman exercises very very very very very very very very confused .
the driver is really really really really really really really boring .	the driver sings really really really really really really really boring .
the doctor is really really really really really really really really really really clever .	the doctor talks really really really really really really really really really really clever .
the boy is very very very very very very very very very surprised .	the boy reads very very very very very very very very very surprised .
the doctor is really really really really really really really really gentle .	the doctor waves really really really really really really really really gentle .
the patient was very very very very very very very friendly .	the patient talks very very very very very very very friendly .
the guy is very very very very very very very very sleepy .	the guy paints very very very very very very very very sleepy .
the driver is really really really really really really really confused .	the driver paints really really really really really really really confused .
the teacher was very very very very very very very nice .	the teacher exercises very very very very very very very nice .
the doctor is really really really really really really really really really excited .	the doctor reads really really really really really really really really really excited .
the man is very very very very very very very excited .	the man exercises very very very very very very very excited .
the guy was really really really really really really really really really healthy .	the guy paints really really really really really really really really really healthy .
the lady was really really really really really really really nice .	the lady waves really really really really really really really nice .
the adult was really really really really really really really really really really tall .	the adult talks really really really really really really really really really really tall .
the person was very very very very very very very hungry .	the person waves very very very very very very very hungry .
the guy is very very very very very very very wrong .	the guy sings very very very very very very very wrong .
the man was really really really really really really really really hungry .	the man cries really really really really really really really really hungry .
the woman is really really really really really really really really really boring .	the woman cries really really really really really really really really really boring .
the king is very very very very very very very healthy .	the king reads very very very very very very very healthy .
the child was really really really really really really really really really helpful .	the child paints really really really really really really really really really helpful .
the child is very very very very very very very very excited .	the child exercises very very very very very very very very excited .
the dancer is very very very very very very very very very very important .	the dancer talks very very very very very very very very very very important .
the woman was really really really really really really really nice .	the woman cries really really really really really really really nice .
the child is really really really really really really really really really really nice .	the child reads really really really really really really really really really really nice .
the dancer was very very very very very very very very kind .	the dancer sings very very very very very very very very kind .
the girl was really really really really really really really really hungry .	the girl sings really really really really really really really really hungry .
the driver is really really really really really really really really hungry .	the driver exercises really really really really really really really really hungry .
the woman was very very very very very very very bored .	the woman reads very very very very very very very bored .
the guy was very very very very very very very very lucky .	the guy reads very very very very very very very very lucky .
the woman is really really really really really really really happy .	the woman cries really really really really really really really happy .
the girl was really really really really really really really really really really young .	the girl paints really really really really really really really really really really young .
the dentist was very very very very very very very very very very strong .	the dentist talks very very very very very very very very very very strong .
the dentist was very very very very very very very very very excited .	the dentist paints very very very very very very very very very excited .
the girl is really really really really really really really really clever .	the girl paints really really really really really really really really clever .
the queen is very very very very very very very very very surprised .	the queen cries very very very very very very very very very surprised .
the lady is really really really really really really really really really surprised .	the lady reads really really really really really really really really really surprised .
the boy is very very very very very very very very very gentle .	the boy exercises very very very very very very very very very gentle .
the teacher is really really really really really really really really confused .	the teacher reads really really really really really really really really confused .
the man was very very very very very very very angry .	the man sings very very very very very very very angry .
the boy was very very very very very very very very very very wrong .	the boy talks very very very very very very very very very very wrong .
the adult is very very very very very very very very tall .	the adult waves very very very very very very very very tall .
the boy was really really really really really really really boring .	the boy sings really really really really really really really boring .
the lady was really really really really really really really really really smart .	the lady reads really really really really really really really really really smart .
the patient is really really really really really really really boring .	the patient talks really really really really really really really boring .
the doctor was really really really really really really really confused .	the doctor paints really really really really really really really confused .
the child was really really really really really really really hungry .	the child sings really really really really really really really hungry .
the dancer was really really really really really really really really hungry .	the dancer exercises really really really really really really really really hungry .
the doctor was really really really really really really really really really really happy .	the doctor exercises really really really really really really really really really really happy .
the dentist was really really really really really really really smart .	the dentist sings really really really really really really really smart .
the teacher was really really really really really really really really really really important .	the teacher sings really really really really really really really really really really important .
the king is very very very very very very very very very tired .	the king paints very very very very very very very very very tired .
the man was very very very very very very very helpful .	the man sings very very very very very very very helpful .
the boy is really really really really really really really really really helpful .	the boy talks really really really really really really really really really helpful .
the customer is really really really really really really really really really healthy .	the customer reads really really really really really really really really really healthy .
the king was really really really really really really really really really hungry .	the king reads really really really really really really really really really hungry .
the person was really really really really really really really really really surprised .	the person cries really really really really really really really really really surprised .
the dancer was very very very very very very very very nice .	the dancer cries very very very very very very very very nice .
the girl is really really really really really really really really really really hungry .	the girl reads really really really really really really really really really really hungry .
the driver is very very very very very very very very bored .	the driver exercises very very very very very very very very bored .
the patient was very very very very very very very very very very curious .	the patient waves very very very very very very very very very very curious .
the woman was very very very very very very very very very very smart .	the woman waves very very very very very very very very very very smart .
the adult was really really really really really really really really really busy .	the adult cries really really really really really really really really really busy .
the doctor was very very very very very very very very nice .	the doctor cries very very very very very very very very nice .
the man was really really really really really really really really really wrong .	the man waves really really really really really really really really really wrong .
the dancer is really really really really really really really excited .	the dancer waves really really really really really really really excited .
the teacher was very very very very very very very lucky .	the teacher sings very very very very very very very lucky .
the guy was very very very very very very very very very curious .	the guy reads very very very very very very very very very curious .
the person was really really really really really really really really really really busy .	the person exercises really really really really really really really really really really busy .
the queen is really really really really really really really really upset .	the queen reads really really really really really really really really upset .
the dancer is really really really really really really really really important .	the dancer cries really really really really really really really really important .
the dentist is very very very very very very very very smart .	the dentist waves very very very very very very very very smart .
the doctor is very very very very very very very very very very tired .	the doctor exercises very very very very very very very very very very tired .
the woman was really really really really really really really really really really strong .	the woman reads really really really really really really really really really really strong .
the man was really really really really really really really busy .	the man cries really really really really really really really busy .
the dancer is really really really really really really really really really strong .	the dancer cries really really really really really really really really really strong .
the dentist was really really really really really really really healthy .	the dentist cries really really really really really really really healthy .
the person was very very very very very very very very very bored .	the person paints very very very very very very very very very bored .
the doctor was really really really really really really really really clever .	the doctor paints really really really really really really really really clever .
the dentist is very very very very very very very very very helpful .	the dentist sings very very very very very very very very very helpful .
the person is very very very very very very very very very clever .	the person waves very very very very very very very very very clever .
the lady is very very very very very very very very surprised .	the lady sings very very very very very very very very surprised .
the girl was really really really really really really really really hungry .	the girl paints really really really really really really really really hungry .
the person is very very very very very very very very very very young .	the person paints very very very very very very very very very very young .
the dancer was really really really really really really really really really really lucky .	the dancer reads really really really really really really really really really really lucky .
the customer was very very very very very very very surprised .	the customer paints very very very very very very very surprised .
the customer is very very very very very very very very very very clever .	the customer talks very very very very very very very very very very clever .
the child was very very very very very very very very very very happy .	the child cries very very very very very very very very very very happy .
the child was very very very very very very very very very tall .	the child exercises very very very very very very very very very tall .
the person is very very very very very very very very very busy .	the person cries very very very very very very very very very busy .
the doctor is very very very very very very very very very very clever .	the doctor sings very very very very very very very very very very clever .
the dancer is really really really really really really really really really careful .	the dancer talks really really really really really really really really really careful .
the person was very very very very very very very very very very lucky .	the person waves very very very very very very very very very very lucky .
the patient was really really really really really really really really young .	the patient exercises really really really really really really really really young .
the king was really really really really really really really really really really happy .	the king paints really really really really really really really really really really happy .
the guy is very very very very very very very very very very boring .	the guy waves very very very very very very very very very very boring .
the girl is really really really really really really really happy .	the girl cries really really really really really really really happy .
the queen is very very very very very very very very very very upset .	the queen sings very very very very very very very very very very upset .
the dancer was very very very very very very very very busy .	the dancer exercises very very very very very very very very busy .
the doctor was very very very very very very very very upset .	the doctor cries very very very very very very very very upset .
the child is very very very very very very very very tall .	the child paints very very very very very very very very tall .
the king is really really really really really really really really sleepy .	the king paints really really really really really really really really sleepy .
the king is very very very very very very very very tired .	the king cries very very very very very very very very tired .
the person was very very very very very very very very very tall .	the person cries very very very very very very very very very tall .
the woman is very very very very very very very very boring .	the woman sings very very very very very very very very boring .
the queen is really really really really really really really tall .	the queen reads really really really really really really really tall .
the adult is really really really really really really really bored .	the adult reads really really really really really really really bored .
the adult is very very very very very very very boring .	the adult reads very very very very very very very boring .
the dancer was very very very very very very very very clever .	the dancer cries very very very very very very very very clever .
the man was very very very very very very very tall .	the man paints very very very very very very very tall .
the king was really really really really really really really really really careful .	the king exercises really really really really really really really really really careful .
the doctor is really really really really really really really happy .	the doctor talks really really really really really really really happy .
the customer is really really really really really really really surprised .	the customer paints really really really really really really really surprised .
the guy was really really really really really really really sleepy .	the guy waves really really really really really really really sleepy .
the lady is very very very very very very very very very very strong .	the lady waves very very very very very very very very very very strong .
the king was very very very very very very very hungry .	the king reads very very very very very very very hungry .
the man was very very very very very very very healthy .	the man paints very very very very very very very healthy .
the child is really really really really really really really really really really healthy .	the child reads really really really really really really really really really really healthy .
the woman was really really really really really really really really really gentle .	the woman sings really really really really really really really really really gentle .
the man was really really really really really really really really really really upset .	the man talks really really really really really really really really really really upset .
the doctor was really really really really really really really surprised .	the doctor talks really really really really really really really surprised .
the person was very very very very very very very boring .	the person waves very very very very very very very boring .
the driver is really really really really really really really really friendly .	the driver exercises really really really really really really really really friendly .
the adult was very very very very very very very healthy .	the adult exercises very very very very very very very healthy .
the woman was very very very very very very very very helpful .	the woman exercises very very very very very very very very helpful .
the king was very very very very very very very very very wrong .	the king waves very very very very very very very very very wrong .
the lady was very very very very very very very smart .	the lady cries very very very very very very very smart .
the woman was very very very very very very very very very very busy .	the woman exercises very very very very very very very very very very busy .
the driver is really really really really really really really really really really busy .	the driver paints really really really really really really really really really really busy .
the woman is very very very very very very very very very very friendly .	the woman exercises very very very very very very very very very very friendly .
the woman is very very very very very very very very very surprised .	the woman sings very very very very very very very very very surprised .
the patient is really really really really really really really really young .	the patient reads really really really really really really really really young .
the dentist was really really really really really really really really tall .	the dentist cries really really really really really really really really tall .
the patient is very very very very very very very gentle .	the patient paints very very very very very very very gentle .
the customer is really really really really really really really really really really hungry .	the customer sings really really really really really really really really really really hungry .
the dancer is very very very very very very very very curious .	the dancer waves very very very very very very very very curious .
the patient is very very very very very very very very very very sleepy .	the patient cries very very very very very very very very very very sleepy .
the teacher is really really really really really really really really really angry .	the teacher talks really really really really really really really really really angry .
the dancer was really really really really really really really angry .	the dancer cries really really really really really really really angry .
the girl is really really really really really really really strong .	the girl cries really really really really really really really strong .
the driver was very very very very very very very very important .	the driver talks very very very very very very very very important .
the driver was very very very very very very very very very happy .	the driver exercises very very very very very very very very very happy .
the teacher is very very very very very very very angry .	the teacher sings very very very very very very very angry .
the dancer was very very very very very very very confused .	the dancer exercises very very very very very very very confused .
the girl was very very very very very very very very very gentle .	the girl reads very very very very very very very very very gentle .
the lady was very very very very very very very very excited .	the lady reads very very very very very very very very excited .
the lady is really really really really really really really really really really curious .	the lady waves really really really really really really really really really really curious .
the customer was really really really really really really really really really kind .	the customer cries really really really really really really really really really kind .
the driver is really really really really really really really really really tired .	the driver sings really really really really really really really really really tired .
the child is very very very very very very very very very very curious .	the child exercises very very very very very very very very very very curious .
the boy is very very very very very very very very careful .	the boy exercises very very very very very very very very careful .
the adult was very very very very very very very very healthy .	the adult sings very very very very very very very very healthy .
the lady is really really really really really really really really really really healthy .	the lady waves really really really really really really really really really really healthy .
the guy was really really really really really really really really really really boring .	the guy sings really really really really really really really really really really boring .
the lady was really really really really really really really really quiet .	the lady reads really really really really really really really really quiet .
the child is very very very very very very very very very very important .	the child sings very very very very very very very very very very important .
the teacher was very very very very very very very very very friendly .	the teacher cries very very very very very very very very very friendly .
the dentist is very very very very very very very very healthy .	the dentist exercises very very very very very very very very healthy .
the child is really really really really really really really really really really important .	the child sings really really really really really really really really really really important .
the king was really really really really really really really really really young .	the king sings really really really really really really really really really young .
the doctor is really really really really really really really really really really helpful .	the doctor cries really really really really really really really really really really helpful .
the boy was really really really really really really really lucky .	the boy sings really really really really really really really lucky .
the patient is very very very very very very very very bored .	the patient exercises very very very very very very very very bored .
the doctor is very very very very very very very very healthy .	the doctor talks very very very very very very very very healthy .
the girl is really really really really really really really busy .	the girl paints really really really really really really really busy .
the person is very very very very very very very strong .	the person paints very very very very very very very strong .
the king is really really really really really really really really really really happy .	the king reads really really really really really really really really really really happy .
the man was really really really really really really really really really gentle .	the man reads really really really really really really really really really gentle .
the girl was very very very very very very very very very very tall .	the girl cries very very very very very very very very very very tall .
the dentist was very very very very very very very very very very smart .	the dentist sings very very very very very very very very very very smart .
the woman was very very very very very very very angry .	the woman talks very very very very very very very angry .
the dentist is very very very very very very very very very very helpful .	the dentist sings very very very very very very very very very very helpful .
the girl was really really really really really really really really really tall .	the girl reads really really really really really really really really really tall .
the man was really really really really really really really really really really tall .	the man waves really really really really really really really really really really tall .
the woman was really really really really really really really really really smart .	the woman paints really really really really really really really really really smart .
the teacher is very very very very very very very gentle .	the teacher paints very very very very very very very gentle .
the teacher is very very very very very very very very very very important .	the teacher sings very very very very very very very very very very important .
the woman was really really really really really really really really really strong .	the woman exercises really really really really really really really really really strong .
the boy was really really really really really really really lucky .	the boy cries really really really really really really really lucky .
the driver was really really really really really really really bored .	the driver sings really really really really really really really bored .
the queen is really really really really really really really really really lucky .	the queen paints really really really really really really really really really lucky .
the lady is really really really really really really really really angry .	the lady sings really really really really really really really really angry .
the guy was very very very very very very very very upset .	the guy waves very very very very very very very very upset .
the dancer is very very very very very very very very young .	the dancer cries very very very very very very very very young .
the driver is really really really really really really really really really really happy .	the driver waves really really really really really really really really really really happy .
the king was very very very very very very very excited .	the king talks very very very very very very very excited .
the guy was really really really really really really really excited .	the guy talks really really really really really really really excited .
the patient is very very very very very very very very confused .	the patient talks very very very very very very very very confused .
the king is very very very very very very very very very nice .	the king talks very very very very very very very very very nice .
the boy was very very very very very very very careful .	the boy exercises very very very very very very very careful .
the dentist was very very very very very very very very excited .	the dentist reads very very very very very very very very excited .
the teacher is very very very very very very very very lucky .	the teacher paints very very very very very very very very lucky .
the driver was very very very very very very very very very very smart .	the driver exercises very very very very very very very very very very smart .
the queen is really really really really really really really really curious .	the queen talks really really really really really really really really curious .
the person is really really really really really really really young .	the person talks really really really really really really really young .
the child is very very very very very very very very upset .	the child exercises very very very very very very very very upset .
the lady was very very very very very very very very very happy .	the lady talks very very very very very very very very very happy .
the girl was very very very very very very very very very happy .	the girl reads very very very very very very very very very happy .
the customer is really really really really really really really really really young .	the customer cries really really really really really really really really really young .
the customer is very very very very very very very surprised .	the customer reads very very very very very very very surprised .
the doctor is really really really really really really really really really hungry .	the doctor exercises really really really really really really really really really hungry .
the doctor is very very very very very very very very very very upset .	the doctor talks very very very very very very very very very very upset .
the queen is really really really really really really really really really sleepy .	the queen paints really really really really really really really really really sleepy .
the woman is really really really really really really really really really really curious .	the woman paints really really really really really really really really really really curious .
the customer was very very very very very very very strong .	the customer reads very very very very very very very strong .
the dentist was really really really really really really really tall .	the dentist reads really really really really really really really tall .
the teacher is really really really really really really really healthy .	the teacher sings really really really really really really really healthy .
the lady is really really really really really really really excited .	the lady talks really really really really really really really excited .
the woman was very very very very very very very very very very boring .	the woman exercises very very very very very very very very very very boring .
the customer was really really really really really really really really happy .	the customer sings really really really really really really really really happy .
the dancer is really really really really really really really really really young .	the dancer cries really really really really really really really really really young .
the adult was very very very very very very very very very upset .	the adult reads very very very very very very very very very upset .
the boy is really really really really really really really really gentle .	the boy reads really really really really really really really really gentle .
the teacher is very very very very very very very very very very wrong .	the teacher sings very very very very very very very very very very wrong .
the customer was really really really really really really really really really gentle .	the customer waves really really really really really really really really really gentle .
the man was really really really really really really really really young .	the man waves really really really really really really really really young .
the customer is really really really really really really really busy .	the customer sings really really really really really really really busy .
the doctor was very very very very very very very happy .	the doctor paints very very very very very very very happy .
the doctor is really really really really really really really really kind .	the doctor waves really really really really really really really really kind .
the child was really really really really really really really really nice .	the child paints really really really really really really really really nice .
the person was really really really really really really really really really really sleepy .	the person talks really really really really really really really really really really sleepy .
the customer was very very very very very very very very curious .	the customer exercises very very very very very very very very curious .
the teacher is really really really really really really really really really tall .	the teacher talks really really really really really really really really really tall .
the dancer was very very very very very very very very confused .	the dancer reads very very very very very very very very confused .
the child is really really really really really really really really bored .	the child exercises really really really really really really really really bored .
the dentist was very very very very very very very very very quiet .	the dentist talks very very very very very very very very very quiet .
the lady was very very very very very very very friendly .	the lady sings very very very very very very very friendly .
the adult is very very very very very very very upset .	the adult sings very very very very very very very upset .
the person is very very very very very very very very very healthy .	the person waves very very very very very very very very very healthy .
the teacher was very very very very very very very very hungry .	the teacher exercises very very very very very very very very hungry .
the adult is very very very very very very very important .	the adult sings very very very very very very very important .
the lady was very very very very very very very surprised .	the lady talks very very very very very very very surprised .
the guy is really really really really really really really really really really bored .	the guy paints really really really really really really really really really really bored .
the girl was really really really really really really really really really really lucky .	the girl sings really really really really really really really really really really lucky .
the dancer is really really really really really really really upset .	the dancer cries really really really really really really really upset .
the doctor was very very very very very very very very very sleepy .	the doctor talks very very very very very very very very very sleepy .
the woman was really really really really really really really healthy .	the woman talks really really really really really really really healthy .
the lady is really really really really really really really really boring .	the lady cries really really really really really really really really boring .
the adult was very very very very very very very lucky .	the adult sings very very very very very very very lucky .
the boy is really really really really really really really quiet .	the boy cries really really really really really really really quiet .
the king was very very very very very very very very very surprised .	the king waves very very very very very very very very very surprised .
the driver was really really really really really really really really really upset .	the driver sings really really really really really really really really really upset .
the king was really really really really really really really really really curious .	the king waves really really really really really really really really really curious .
the person was really really really really really really really curious .	the person waves really really really really really really really curious .
the girl was really really really really really really really really bored .	the girl reads really really really really really really really really bored .
the boy is really really really really really really really really really tired .	the boy cries really really really really really really really really really tired .
the child was really really really really really really really really curious .	the child cries really really really really really really really really curious .
the dancer was very very very very very very very important .	the dancer cries very very very very very very very important .
the dancer was really really really really really really really really strong .	the dancer waves really really really really really really really really strong .
the doctor is very very very very very very very tall .	the doctor reads very very very very very very very tall .
the driver was really really really really really really really really really really friendly .	the driver reads really really really really really really really really really really friendly .
the dentist was really really really really really really really really really really tall .	the dentist waves really really really really really really really really really really tall .
the doctor was really really really really really really really really really happy .	the doctor sings really really really really really really really really really happy .
the boy was very very very very very very very curious .	the boy cries very very very very very very very curious .
the man was really really really really really really really really friendly .	the man reads really really really really really really really really friendly .
the teacher is very very very very very very very kind .	the teacher sings very very very very very very very kind .
the teacher is really really really really really really really really really lucky .	the teacher talks really really really really really really really really really lucky .
the child was very very very very very very very quiet .	the child cries very very very very very very very quiet .
the person is really really really really really really really really really really quiet .	the person waves really really really really really really really really really really quiet .
the boy was very very very very very very very very gentle .	the boy sings very very very very very very very very gentle .
the man was really really really really really really really really really really clever .	the man sings really really really really really really really really really really clever .
the dancer was very very very very very very very very angry .	the dancer exercises very very very very very very very very angry .
the patient is really really really really really really really smart .	the patient exercises really really really really really really really smart .
the boy was really really really really really really really really really clever .	the boy sings really really really really really really really really really clever .
the queen is very very very very very very very clever .	the queen reads very very very very very very very clever .
the queen was very very very very very very very very smart .	the queen paints very very very very very very very very smart .
the driver was really really really really really really really really lucky .	the driver sings really really really really really really really really lucky .
the adult is really really really really really really really really really really clever .	the adult exercises really really really really really really really really really really clever .
the adult was really really really really really really really really really really curious .	the adult cries really really really really really really really really really really curious .
the girl was really really really really really really really wrong .	the girl waves really really really really really really really wrong .
the woman was really really really really really really really really really really strong .	the woman sings really really really really really really really really really really strong .
the dancer was really really really really really really really really really really wrong .	the dancer reads really really really really really really really really really really wrong .
the girl was really really really really really really really really really happy .	the girl sings really really really really really really really really really happy .
the boy was really really really really really really really really really really gentle .	the boy exercises really really really really really really really really really really gentle .
the child was really really really really really really really really really friendly .	the child cries really really really really really really really really really friendly .
the king is very very very very very very very very very friendly .	the king paints very very very very very very very very very friendly .
the child was very very very very very very very very very bored .	the child exercises very very very very very very very very very bored .
the child was really really really really really really really really really really important .	the child reads really really really really really really really really really really important .
the patient was very very very very very very very very lucky .	the patient talks very very very very very very very very lucky .
the dentist is very very very very very very very gentle .	the dentist waves very very very very very very very gentle .
the customer is very very very very very very very very very very helpful .	the customer sings very very very very very very very very very very helpful .
the guy is really really really really really really really really really really boring .	the guy paints really really really really really really really really really really boring .
the driver is very very very very very very very upset .	the driver cries very very very very very very very upset .
the queen was really really really really really really really really hungry .	the queen reads really really really really really really really really hungry .
the man was very very very very very very very very very very young .	the man sings very very very very very very very very very very young .
the girl is very very very very very very very very very very gentle .	the girl waves very very very very very very very very very very gentle .
the guy was really really really really really really really curious .	the guy reads really really really really really really really curious .
the dancer is really really really really really really really really curious .	the dancer reads really really really really really really really really curious .
the king was very very very very very very very very very very sleepy .	the king waves very very very very very very very very very very sleepy .
the child was very very very very very very very very very very happy .	the child exercises very very very very very very very very very very happy .
the man was really really really really really really really really upset .	the man paints really really really really really really really really upset .
the customer was very very very very very very very very excited .	the customer waves very very very very very very very very excited .
the doctor is really really really really really really really wrong .	the doctor sings really really really really really really really wrong .
the dancer is really really really really really really really really confused .	the dancer exercises really really really really really really really really confused .
the child is very very very very very very very very very tall .	the child talks very very very very very very very very very tall .
the child is really really really really really really really really lucky .	the child reads really really really really really really really really lucky .
the driver is really really really really really really really really really bored .	the driver exercises really really really really really really really really really bored .
the dancer was very very very very very very very very very very helpful .	the dancer cries very very very very very very very very very very helpful .
the person was really really really really really really really clever .	the person sings really really really really really really really clever .
the driver is very very very very very very very very happy .	the driver waves very very very very very very very very happy .
the patient was very very very very very very very very surprised .	the patient talks very very very very very very very very surprised .
the doctor was very very very very very very very very very very friendly .	the doctor talks very very very very very very very very very very friendly .
the man was very very very very very very very very very helpful .	the man waves very very very very very very very very very helpful .
the boy was really really really really really really really really sleepy .	the boy exercises really really really really really really really really sleepy .
the child is really really really really really really really really smart .	the child sings really really really really really really really really smart .
the lady is very very very very very very very very very tired .	the lady talks very very very very very very very very very tired .
the driver is very very very very very very very very very kind .	the driver exercises very very very very very very very very very kind .
the queen is very very very very very very very very very very angry .	the queen cries very very very very very very very very very very angry .
the person is very very very very very very very curious .	the person reads very very very very very very very curious .
the person was very very very very very very very very very excited .	the person cries very very very very very very very very very excited .
the person was really really really really really really really young .	the person cries really really really really really really really young .
the man is really really really really really really really really really really tall .	the man paints really really really really really really really really really really tall .
the doctor is very very very very very very very very very lucky .	the doctor sings very very very very very very very very very lucky .
the girl was really really really really really really really really really really excited .	the girl paints really really really really really really really really really really excited .
the person was very very very very very very very very very very young .	the person reads very very very very very very very very very very young .
the adult was very very very very very very very excited .	the adult reads very very very very very very very excited .
the king is very very very very very very very very very upset .	the king paints very very very very very very very very very upset .
the doctor is really really really really really really really really curious .	the doctor exercises really really really really really really really really curious .
the boy is really really really really really really really really really kind .	the boy reads really really really really really really really really really kind .
the boy is really really really really really really really really happy .	the boy exercises really really really really really really really really happy .
the patient was very very very very very very very sleepy .	the patient cries very very very very very very very sleepy .
the teacher was really really really really really really really healthy .	the teacher reads really really really really really really really healthy .
the doctor is really really really really really really really really really important .	the doctor exercises really really really really really really really really really important .
the man was very very very very very very very very very nice .	the man cries very very very very very very very very very nice .
the king was really really really really really really really really really really bored .	the king waves really really really really really really really really really really bored .
the driver is really really really really really really really really curious .	the driver sings really really really really really really really really curious .
the teacher is really really really really really really really really surprised .	the teacher cries really really really really really really really really surprised .
the patient is really really really really really really really really really clever .	the patient cries really really really really really really really really really clever .
the patient is very very very very very very very very clever .	the patient cries very very very very very very very very clever .
the lady was very very very very very very very very very friendly .	the lady sings very very very very very very very very very friendly .
the lady is very very very very very very very very very gentle .	the lady sings very very very very very very very very very gentle .
the lady was really really really really really really really quiet .	the lady reads really really really really really really really quiet .
the child is very very very very very very very very very very upset .	the child sings very very very very very very very very very very upset .
the customer is really really really really really really really important .	the customer sings really really really really really really really important .
the person is really really really really really really really really really smart .	the person reads really really really really really really really really really smart .
the adult is really really really really really really really really really wrong .	the adult exercises really really really really really really really really really wrong .
the man is really really really really really really really really important .	the man reads really really really really really really really really important .
the patient was really really really really really really really really tired .	the patient cries really really really really really really really really tired .
the doctor is really really really really really really really really really clever .	the doctor waves really really really really really really really really really clever .
the customer is very very very very very very very wrong .	the customer reads very very very very very very very wrong .
the queen is very very very very very very very very wrong .	the queen exercises very very very very very very very very wrong .
the doctor is very very very very very very very angry .	the doctor cries very very very very very very very angry .
the teacher was really really really really really really really really tired .	the teacher paints really really really really really really really really tired .
the girl was very very very very very very very very very very curious .	the girl cries very very very very very very very very very very curious .
the man was very very very very very very very confused .	the man talks very very very very very very very confused .
the dancer was very very very very very very very very hungry .	the dancer exercises very very very very very very very very hungry .
the patient is really really really really really really really really really really smart .	the patient talks really really really really really really really really really really smart .
the lady is really really really really really really really important .	the lady talks really really really really really really really important .
the dentist was very very very very very very very kind .	the dentist reads very very very very very very very kind .
the man is very very very very very very very very bored .	the man talks very very very very very very very very bored .
the person is really really really really really really really excited .	the person exercises really really really really really really really excited .
the woman is really really really really really really really really important .	the woman waves really really really really really really really really important .
the customer is very very very very very very very very very very helpful .	the customer reads very very very very very very very very very very helpful .
the queen was really really really really really really really smart .	the queen cries really really really really really really really smart .
the lady was very very very very very very very very very very healthy .	the lady paints very very very very very very very very very very healthy .
the girl was really really really really really really really really excited .	the girl talks really really really really really really really really excited .
the boy was really really really really really really really quiet .	the boy cries really really really really really really really quiet .
the dentist is really really really really really really really friendly .	the dentist sings really really really really really really really friendly .
the dentist is very very very very very very very very very very wrong .	the dentist talks very very very very very very very very very very wrong .
the guy is very very very very very very very hungry .	the guy reads very very very very very very very hungry .
the lady was very very very very very very very very wrong .	the lady cries very very very very very very very very wrong .
the adult was very very very very very very very very very important .	the adult cries very very very very very very very very very important .
the lady was really really really really really really really really nice .	the lady exercises really really really really really really really really nice .
the adult is really really really really really really really really really really tired .	the adult waves really really really really really really really really really really tired .
the boy is really really really really really really really tired .	the boy paints really really really really really really really tired .
the dancer was very very very very very very very very very very tired .	the dancer waves very very very very very very very very very very tired .
the patient is very very very very very very very happy .	the patient exercises very very very very very very very happy .
the boy was very very very very very very very very very quiet .	the boy cries very very very very very very very very very quiet .
the queen was very very very very very very very very lucky .	the queen cries very very very very very very very very lucky .
the girl is really really really really really really really really really really wrong .	the girl sings really really really really really really really really really really wrong .
the girl is very very very very very very very very very very confused .	the girl waves very very very very very very very very very very confused .
the girl is really really really really really really really really confused .	the girl cries really really really really really really really really confused .
the dentist is very very very very very very very tired .	the dentist exercises very very very very very very very tired .
the driver is really really really really really really really really really important .	the driver waves really really really really really really really really really important .
the child is really really really really really really really really hungry .	the child exercises really really really really really really really really hungry .
the person was very very very very very very very very very very healthy .	the person exercises very very very very very very very very very very healthy .
the teacher was really really really really really really really really really confused .	the teacher paints really really really really really really really really really confused .
the girl is very very very very very very very very very very wrong .	the girl waves very very very very very very very very very very wrong .
the customer was really really really really really really really really gentle .	the customer cries really really really really really really really really gentle .
the driver was very very very very very very very very very very sleepy .	the driver exercises very very very very very very very very very very sleepy .
the woman was very very very very very very very gentle .	the woman sings very very very very very very very gentle .
the woman was very very very very very very very confused .	the woman waves very very very very very very very confused .
the king was very very very very very very very very boring .	the king talks very very very very very very very very boring .
the child is really really really really really really really really really really wrong .	the child paints really really really really really really really really really really wrong .
the doctor is really really really really really really really really really boring .	the doctor paints really really really really really really really really really boring .
the person is very very very very very very very wrong .	the person sings very very very very very very very wrong .
the adult was very very very very very very very very very very bored .	the adult cries very very very very very very very very very very bored .
the adult is really really really really really really really really really really strong .	the adult reads really really really really really really really really really really strong .
the girl is very very very very very very very very very upset .	the girl waves very very very very very very very very very upset .
the guy was really really really really really really really really hungry .	the guy reads really really really really really really really really hungry .
the dentist was really really really really really really really really really really sleepy .	the dentist talks really really really really really really really really really really sleepy .
the dancer was very very very very very very very lucky .	the dancer waves very very very very very very very lucky .
the doctor was very very very very very very very very very very kind .	the doctor sings very very very very very very very very very very kind .
the adult was very very very very very very very young .	the adult sings very very very very very very very young .
the dancer is really really really really really really really really sleepy .	the dancer exercises really really really really really really really really sleepy .
the lady was very very very very very very very happy .	the lady cries very very very very very very very happy .
the person was really really really really really really really really important .	the person exercises really really really really really really really really important .
the teacher is very very very very very very very very very very sleepy .	the teacher cries very very very very very very very very very very sleepy .
the boy is really really really really really really really really nice .	the boy exercises really really really really really really really really nice .
the lady is really really really really really really really happy .	the lady exercises really really really really really really really happy .
the customer was really really really really really really really really really really busy .	the customer waves really really really really really really really really really really busy .
the guy was very very very very very very very very very very tall .	the guy exercises very very very very very very very very very very tall .
the teacher was very very very very very very very very very upset .	the teacher exercises very very very very very very very very very upset .
the teacher was really really really really really really really really really tall .	the teacher talks really really really really really really really really really tall .
the girl is very very very very very very very quiet .	the girl paints very very very very very very very quiet .
the patient was really really really really really really really really really confused .	the patient waves really really really really really really really really really confused .
the queen was very very very very very very very very very very gentle .	the queen reads very very very very very very very very very very gentle .
the doctor is very very very very very very very very very excited .	the doctor talks very very very very very very very very very excited .
the guy was really really really really really really really really really excited .	the guy cries really really really really really really really really really excited .
the adult was very very very very very very very very very very healthy .	the adult exercises very very very very very very very very very very healthy .
the dancer was really really really really really really really really really tall .	the dancer paints really really really really really really really really really tall .
the guy is very very very very very very very kind .	the guy sings very very very very very very very kind .
the patient was really really really really really really really happy .	the patient paints really really really really really really really happy .
the customer was very very very very very very very very very very hungry .	the customer waves very very very very very very very very very very hungry .
the woman is really really really really really really really really really bored .	the woman waves really really really really really really really really really bored .
the queen was very very very very very very very wrong .	the queen sings very very very very very very very wrong .
the doctor was really really really really really really really hungry .	the doctor sings really really really really really really really hungry .
the child is very very very very very very very very very very quiet .	the child sings very very very very very very very very very very quiet .
the adult was really really really really really really really really really wrong .	the adult paints really really really really really really really really really wrong .
the driver is very very very very very very very very very very tall .	the driver sings very very very very very very very very very very tall .
the man was very very very very very very very lucky .	the man waves very very very very very very very lucky .
the doctor was really really really really really really really really clever .	the doctor waves really really really really really really really really clever .
the driver is really really really really really really really really confused .	the driver exercises really really really really really really really really confused .
the doctor is really really really really really really really really really wrong .	the doctor exercises really really really really really really really really really wrong .
the person is very very very very very very very very very curious .	the person sings very very very very very very very very very curious .
the dentist is really really really really really really really really really helpful .	the dentist reads really really really really really really really really really helpful .
the dancer is really really really really really really really really gentle .	the dancer talks really really really really really really really really gentle .
the doctor is really really really really really really really really really really tired .	the doctor talks really really really really really really really really really really tired .
the girl is very very very very very very very surprised .	the girl exercises very very very very very very very surprised .
the girl was really really really really really really really hungry .	the girl sings really really really really really really really hungry .
the boy is very very very very very very very clever .	the boy waves very very very very very very very clever .
the doctor was very very very very very very very friendly .	the doctor paints very very very very very very very friendly .
the patient was very very very very very very very very very very kind .	the patient cries very very very very very very very very very very kind .
the adult was very very very very very very very very tall .	the adult waves very very very very very very very very tall .
the lady was very very very very very very very very kind .	the lady reads very very very very very very very very kind .
the boy is very very very very very very very very very very tired .	the boy cries very very very very very very very very very very tired .
the adult is very very very very very very very wrong .	the adult talks very very very very very very very wrong .
the child was really really really really really really really really excited .	the child waves really really really really really really really really excited .
the dancer is really really really really really really really really really hungry .	the dancer talks really really really really really really really really really hungry .
the adult is very very very very very very very very very very healthy .	the adult waves very very very very very very very very very very healthy .
the teacher is really really really really really really really really really upset .	the teacher reads really really really really really really really really really upset .
the man was very very very very very very very very very very kind .	the man sings very very very very very very very very very very kind .
the guy was very very very very very very very clever .	the guy paints very very very very very very very clever .
the man is very very very very very very very young .	the man cries very very very very very very very young .
the queen was very very very very very very very quiet .	the queen waves very very very very very very very quiet .
the teacher is very very very very very very very very very bored .	the teacher reads very very very very very very very very very bored .
the adult is very very very very very very very very very confused .	the adult exercises very very very very very very very very very confused .
the dancer was very very very very very very very gentle .	the dancer exercises very very very very very very very gentle .
the child is very very very very very very very very very very healthy .	the child talks very very very very very very very very very very healthy .
the man is really really really really really really really really smart .	the man talks really really really really really really really really smart .
the lady was really really really really really really really really really bored .	the lady exercises really really really really really really really really really bored .
the guy was very very very very very very very boring .	the guy exercises very very very very very very very boring .
the woman was very very very very very very very busy .	the woman cries very very very very very very very busy .
the teacher is very very very very very very very very hungry .	the teacher waves very very very very very very very very hungry .
the lady is really really really really really really really careful .	the lady waves really really really really really really really careful .
the guy was very very very very very very very very very confused .	the guy exercises very very very very very very very very very confused .
the girl is really really really really really really really really really gentle .	the girl talks really really really really really really really really really gentle .
the person is very very very very very very very lucky .	the person talks very very very very very very very lucky .
the adult was very very very very very very very busy .	the adult talks very very very very very very very busy .
the girl was very very very very very very very very very excited .	the girl paints very very very very very very very very very excited .
the girl is very very very very very very very very very very wrong .	the girl exercises very very very very very very very very very very wrong .
the guy was really really really really really really really really really lucky .	the guy reads really really really really really really really really really lucky .
the dentist is very very very very very very very very smart .	the dentist reads very very very very very very very very smart .
the doctor was really really really really really really really really really really tired .	the doctor sings really really really really really really really really really really tired .
the teacher was very very very very very very very very tired .	the teacher reads very very very very very very very very tired .
the guy was very very very very very very very very very very smart .	the guy exercises very very very very very very very very very very smart .
the customer is very very very very very very very very young .	the customer exercises very very very very very very very very young .
the lady was really really really really really really really tall .	the lady talks really really really really really really really tall .
the boy is really really really really really really really really really nice .	the boy sings really really really really really really really really really nice .
the teacher was very very very very very very very very very very kind .	the teacher waves very very very very very very very very very very kind .
the guy was really really really really really really really friendly .	the guy cries really really really really really really really friendly .
the customer was really really really really really really really really hungry .	the customer exercises really really really really really really really really hungry .
the customer is really really really really really really really really angry .	the customer paints really really really really really really really really angry .
the guy is very very very very very very very upset .	the guy waves very very very very very very very upset .
the doctor is really really really really really really really really really really nice .	the doctor paints really really really really really really really really really really nice .
the patient was very very very very very very very very sleepy .	the patient talks very very very very very very very very sleepy .
the king is really really really really really really really excited .	the king exercises really really really really really really really excited .
the woman is really really really really really really really happy .	the woman paints really really really really really really really happy .
the king was very very very very very very very very gentle .	the king paints very very very very very very very very gentle .
the queen is very very very very very very very very very upset .	the queen cries very very very very very very very very very upset .
the man was very very very very very very very very very important .	the man exercises very very very very very very very very very important .
the dancer was really really really really really really really really really really smart .	the dancer exercises really really really really really really really really really really smart .
the child is really really really really really really really really curious .	the child cries really really really really really really really really curious .
the woman is very very very very very very very very very very excited .	the woman sings very very very very very very very very very very excited .
the dancer was really really really really really really really lucky .	the dancer waves really really really really really really really lucky .
the queen was really really really really really really really really really quiet .	the queen waves really really really really really really really really really quiet .
the teacher was very very very very very very very gentle .	the teacher exercises very very very very very very very gentle .
the driver is really really really really really really really really really angry .	the driver exercises really really really really really really really really really angry .
the king is very very very very very very very very important .	the king waves very very very very very very very very important .
the doctor is really really really really really really really really lucky .	the doctor talks really really really really really really really really lucky .
the child was very very very very very very very young .	the child exercises very very very very very very very young .
the child is very very very very very very very young .	the child waves very very very very very very very young .
the lady is really really really really really really really really smart .	the lady cries really really really really really really really really smart .
the man was really really really really really really really really really lucky .	the man cries really really really really really really really really really lucky .
the doctor was very very very very very very very important .	the doctor cries very very very very very very very important .
the lady is very very very very very very very very very very boring .	the lady paints very very very very very very very very very very boring .
the patient was very very very very very very very very very healthy .	the patient exercises very very very very very very very very very healthy .
the doctor was very very very very very very very very very very important .	the doctor waves very very very very very very very very very very important .
the lady is really really really really really really really really really really quiet .	the lady waves really really really really really really really really really really quiet .
the dentist is really really really really really really really sleepy .	the dentist reads really really really really really really really sleepy .
the person was really really really really really really really really really really careful .	the person exercises really really really really really really really really really really careful .
the customer was really really really really really really really happy .	the customer reads really really really really really really really happy .
the driver was very very very very very very very very very gentle .	the driver sings very very very very very very very very very gentle .
the driver is really really really really really really really really friendly .	the driver talks really really really really really really really really friendly .
the doctor was very very very very very very very very very very gentle .	the doctor sings very very very very very very very very very very gentle .
the woman was very very very very very very very very very nice .	the woman exercises very very very very very very very very very nice .
the king is very very very very very very very very very young .	the king sings very very very very very very very very very young .
the woman is really really really really really really really really really sleepy .	the woman reads really really really really really really really really really sleepy .
the man was really really really really really really really really careful .	the man reads really really really really really really really really careful .
the king was really really really really really really really friendly .	the king exercises really really really really really really really friendly .
the queen was really really really really really really really really really really healthy .	the queen sings really really really really really really really really really really healthy .
the king was very very very very very very very lucky .	the king waves very very very very very very very lucky .
the person is very very very very very very very bored .	the person reads very very very very very very very bored .
the person was very very very very very very very very busy .	the person talks very very very very very very very very busy .
the girl is very very very very very very very young .	the girl exercises very very very very very very very young .
the woman is very very very very very very very very kind .	the woman paints very very very very very very very very kind .
the guy is really really really really really really really really really quiet .	the guy reads really really really really really really really really really quiet .
the woman is really really really really really really really really really kind .	the woman exercises really really really really really really really really really kind .
the person was very very very very very very very young .	the person cries very very very very very very very young .
the person is really really really really really really really really really strong .	the person cries really really really really really really really really really strong .
the driver was really really really really really really really really nice .	the driver exercises really really really really really really really really nice .
the adult is really really really really really really really clever .	the adult waves really really really really really really really clever .
the teacher is really really really really really really really really really really curious .	the teacher sings really really really really really really really really really really curious .
the adult was really really really really really really really really really nice .	the adult sings really really really really really really really really really nice .
the girl is really really really really really really really really really angry .	the girl exercises really really really really really really really really really angry .
the lady was very very very very very very very very very friendly .	the lady reads very very very very very very very very very friendly .
the person was really really really really really really really really really really lucky .	the person reads really really really really really really really really really really lucky .
the teacher was very very very very very very very very very very curious .	the teacher waves very very very very very very very very very very curious .
the doctor is very very very very very very very very very very gentle .	the doctor paints very very very very very very very very very very gentle .
the person is very very very very very very very very very very confused .	the person exercises very very very very very very very very very very confused .
the boy is very very very very very very very very strong .	the boy cries very very very very very very very very strong .
the person is very very very very very very very very very very boring .	the person cries very very very very very very very very very very boring .
the lady is very very very very very very very very very very strong .	the lady reads very very very very very very very very very very strong .
the king was very very very very very very very very important .	the king exercises very very very very very very very very important .
the lady is really really really really really really really really quiet .	the lady cries really really really really really really really really quiet .
the driver was very very very very very very very very very very curious .	the driver cries very very very very very very very very very very curious .
the woman is really really really really really really really really healthy .	the woman cries really really really really really really really really healthy .
the doctor was very very very very very very very wrong .	the doctor talks very very very very very very very wrong .
the driver is very very very very very very very smart .	the driver talks very very very very very very very smart .
the teacher is really really really really really really really really healthy .	the teacher waves really really really really really really really really healthy .
the dancer is very very very very very very very very very very upset .	the dancer exercises very very very very very very very very very very upset .
the lady is really really really really really really really really really really strong .	the lady exercises really really really really really really really really really really strong .
the boy was really really really really really really really really surprised .	the boy talks really really really really really really really really surprised .
the lady is very very very very very very very very very very quiet .	the lady paints very very very very very very very very very very quiet .
the person was really really really really really really really really really lucky .	the person cries really really really really really really really really really lucky .
the woman is very very very very very very very curious .	the woman exercises very very very very very very very curious .
the lady was very very very very very very very very very confused .	the lady exercises very very very very very very very very very confused .
the driver was very very very very very very very healthy .	the driver exercises very very very very very very very healthy .
the child was very very very very very very very young .	the child waves very very very very very very very young .
the person is very very very very very very very happy .	the person sings very very very very very very very happy .
the girl is very very very very very very very very very excited .	the girl waves very very very very very very very very very excited .
the man is very very very very very very very very very curious .	the man talks very very very very very very very very very curious .
the girl is very very very very very very very very excited .	the girl exercises very very very very very very very very excited .
the lady was really really really really really really really really really important .	the lady reads really really really really really really really really really important .
the dentist is very very very very very very very very very hungry .	the dentist exercises very very very very very very very very very hungry .
the adult is really really really really really really really really really smart .	the adult sings really really really really really really really really really smart .
the woman was really really really really really really really really busy .	the woman sings really really really really really really really really busy .
the driver was really really really really really really really really really really happy .	the driver exercises really really really really really really really really really really happy .
the man is very very very very very very very kind .	the man paints very very very very very very very kind .
the person was very very very very very very very very very important .	the person waves very very very very very very very very very important .
the man is very very very very very very very very very very quiet .	the man waves very very very very very very very very very very quiet .
the dancer is really really really really really really really really excited .	the dancer paints really really really really really really really really excited .
the person is really really really really really really really kind .	the person cries really really really really really really really kind .
the adult is very very very very very very very very bored .	the adult exercises very very very very very very very very bored .
the adult was really really really really really really really excited .	the adult paints really really really really really really really excited .
the king is really really really really really really really really wrong .	the king paints really really really really really really really really wrong .
the dentist was very very very very very very very very quiet .	the dentist reads very very very very very very very very quiet .
the king is really really really really really really really strong .	the king reads really really really really really really really strong .
the person is really really really really really really really really really strong .	the person waves really really really really really really really really really strong .
the adult is very very very very very very very very tired .	the adult talks very very very very very very very very tired .
the boy is really really really really really really really really really really young .	the boy waves really really really really really really really really really really young .
the dentist is really really really really really really really bored .	the dentist waves really really really really really really really bored .
the king was really really really really really really really really really upset .	the king cries really really really really really really really really really upset .
the girl is very very very very very very very tall .	the girl waves very very very very very very very tall .
the guy was very very very very very very very very very very healthy .	the guy waves very very very very very very very very very very healthy .
the dentist is really really really really really really really really really really gentle .	the dentist cries really really really really really really really really really really gentle .
the lady is really really really really really really really really really really friendly .	the lady talks really really really really really really really really really really friendly .
the person is really really really really really really really busy .	the person reads really really really really really really really busy .
the lady was very very very very very very very confused .	the lady exercises very very very very very very very confused .
the driver is really really really really really really really really really hungry .	the driver waves really really really really really really really really really hungry .
the customer was very very very very very very very very very excited .	the customer reads very very very very very very very very very excited .
the queen is really really really really really really really really really excited .	the queen sings really really really really really really really really really excited .
the queen is really really really really really really really nice .	the queen exercises really really really really really really really nice .
the child is really really really really really really really really wrong .	the child exercises really really really really really really really really wrong .
the teacher is very very very very very very very sleepy .	the teacher cries very very very very very very very sleepy .
the driver is really really really really really really really excited .	the driver sings really really really really really really really excited .
the girl was very very very very very very very very confused .	the girl exercises very very very very very very very very confused .
the driver was very very very very very very very very very confused .	the driver cries very very very very very very very very very confused .
the driver is really really really really really really really excited .	the driver exercises really really really really really really really excited .
the customer is very very very very very very very very young .	the customer reads very very very very very very very very young .
the customer is really really really really really really really really gentle .	the customer waves really really really really really really really really gentle .
the girl is very very very very very very very very gentle .	the girl reads very very very very very very very very gentle .
the driver was very very very very very very very sleepy .	the driver waves very very very very very very very sleepy .
the patient was really really really really really really really really sleepy .	the patient cries really really really really really really really really sleepy .
the driver is very very very very very very very healthy .	the driver waves very very very very very very very healthy .
the boy is very very very very very very very strong .	the boy cries very very very very very very very strong .
the boy is really really really really really really really really sleepy .	the boy paints really really really really really really really really sleepy .
the adult is really really really really really really really really really excited .	the adult reads really really really really really really really really really excited .
the man is really really really really really really really really really angry .	the man sings really really really really really really really really really angry .
the queen was really really really really really really really really really curious .	the queen waves really really really really really really really really really curious .
the teacher was very very very very very very very very very nice .	the teacher paints very very very very very very very very very nice .
the person is really really really really really really really nice .	the person reads really really really really really really really nice .
the woman was very very very very very very very very strong .	the woman talks very very very very very very very very strong .
the child was very very very very very very very very very very tired .	the child waves very very very very very very very very very very tired .
the driver was very very very very very very very very very helpful .	the driver waves very very very very very very very very very helpful .
the doctor was really really really really really really really tall .	the doctor paints really really really really really really really tall .
the person was really really really really really really really really really really tall .	the person waves really really really really really really really really really really tall .
the person is very very very very very very very very healthy .	the person sings very very very very very very very very healthy .
the child was really really really really really really really surprised .	the child waves really really really really really really really surprised .
the king is very very very very very very very very excited .	the king cries very very very very very very very very excited .
