Denise thinks that your father is tired .	Denise works with your father is tired .
the child thinks that my daughter 's dentist 's grandmother is busy .	the child helps my daughter 's dentist 's grandmother is busy .
Kevin knows that your husband is busy .	Kevin scares your husband is busy .
the dancer thinks that my father 's wife 's friend is boring .	the dancer scares my father 's wife 's friend is boring .
Jerry knows that my brother 's cousin is helpful .	Jerry works with my brother 's cousin is helpful .
my boss knows that my daughter 's son is excited .	my boss talks to my daughter 's son is excited .
the person thinks that your dad 's doctor 's teacher is gentle .	the person helps your dad 's doctor 's teacher is gentle .
the adult thinks that my mother 's grandmother 's son is young .	the adult works with my mother 's grandmother 's son is young .
my boss knows that your doctor 's mom 's dentist is curious .	my boss works with your doctor 's mom 's dentist is curious .
Julie knows that my daughter 's friend is gentle .	Julie works with my daughter 's friend is gentle .
Alexander thinks that your wife is upset .	Alexander works with your wife is upset .
the teacher says that your wife is clever .	the teacher talks to your wife is clever .
my teacher knows that your teacher 's cousin is helpful .	my teacher helps your teacher 's cousin is helpful .
your friend knows that your father is tired .	your friend talks to your father is tired .
your cousin thinks that your father 's mom is smart .	your cousin talks to your father 's mom is smart .
my teacher thinks that my friend 's father is upset .	my teacher scares my friend 's father is upset .
Thomas knows that your boss is angry .	Thomas helps your boss is angry .
the customer knows that my daughter 's sister 's boss is strong .	the customer works with my daughter 's sister 's boss is strong .
Scott knows that your doctor 's sister 's cousin is careful .	Scott works with your doctor 's sister 's cousin is careful .
my friend knows that my mother is healthy .	my friend scares my mother is healthy .
Andrew thinks that my brother is lucky .	Andrew works with my brother is lucky .
Marie thinks that your dad 's husband 's teacher is quiet .	Marie helps your dad 's husband 's teacher is quiet .
Todd says that my sister is angry .	Todd scares my sister is angry .
the patient says that my wife 's mom 's dentist is wrong .	the patient talks to my wife 's mom 's dentist is wrong .
your dentist thinks that my cousin 's doctor is kind .	your dentist scares my cousin 's doctor is kind .
your boss knows that your wife 's mom is careful .	your boss works with your wife 's mom is careful .
my doctor says that your sister is surprised .	my doctor works with your sister is surprised .
the dentist says that your teacher 's daughter 's father is gentle .	the dentist works with your teacher 's daughter 's father is gentle .
Mary knows that your sister 's daughter is careful .	Mary helps your sister 's daughter is careful .
your boss says that my mother is helpful .	your boss talks to my mother is helpful .
Stephanie thinks that your dad 's cousin is lucky .	Stephanie works with your dad 's cousin is lucky .
Nina knows that my daughter is tired .	Nina works with my daughter is tired .
your dentist knows that your husband is tall .	your dentist works with your husband is tall .
Laurie says that your boss 's father is bored .	Laurie works with your boss 's father is bored .
Thomas says that your husband is smart .	Thomas works with your husband is smart .
your cousin thinks that my daughter is excited .	your cousin talks to my daughter is excited .
Andrew says that your mom 's dentist 's husband is confused .	Andrew talks to your mom 's dentist 's husband is confused .
my boss says that your teacher 's mother is hungry .	my boss talks to your teacher 's mother is hungry .
Timothy says that your father 's brother is young .	Timothy talks to your father 's brother is young .
the adult thinks that your teacher 's teacher is excited .	the adult talks to your teacher 's teacher is excited .
the person thinks that my father 's sister 's wife is wrong .	the person scares my father 's sister 's wife is wrong .
my boss says that your father 's husband 's doctor is helpful .	my boss talks to your father 's husband 's doctor is helpful .
the person says that my daughter 's boss is smart .	the person helps my daughter 's boss is smart .
Steve says that your friend 's cousin is kind .	Steve scares your friend 's cousin is kind .
Sara thinks that your grandmother 's grandmother 's dad is upset .	Sara helps your grandmother 's grandmother 's dad is upset .
my teacher thinks that your cousin 's brother is helpful .	my teacher helps your cousin 's brother is helpful .
your friend thinks that your mother 's doctor 's teacher is careful .	your friend scares your mother 's doctor 's teacher is careful .
the dancer says that your doctor 's dentist is strong .	the dancer works with your doctor 's dentist is strong .
Samantha says that your brother is healthy .	Samantha works with your brother is healthy .
your doctor says that my grandmother 's wife is strong .	your doctor works with my grandmother 's wife is strong .
your friend thinks that my daughter is tall .	your friend scares my daughter is tall .
my teacher says that my mom 's friend is excited .	my teacher talks to my mom 's friend is excited .
the patient says that my mother 's boss 's grandmother is boring .	the patient works with my mother 's boss 's grandmother is boring .
my teacher thinks that my dad 's cousin 's grandmother is careful .	my teacher works with my dad 's cousin 's grandmother is careful .
Scott says that your grandmother 's cousin 's husband is busy .	Scott talks to your grandmother 's cousin 's husband is busy .
James knows that my son 's brother is upset .	James works with my son 's brother is upset .
Carl thinks that my daughter 's father is happy .	Carl talks to my daughter 's father is happy .
the person knows that your grandmother is tired .	the person scares your grandmother is tired .
Alice thinks that your cousin 's mom is friendly .	Alice talks to your cousin 's mom is friendly .
Cindy knows that my dentist is gentle .	Cindy talks to my dentist is gentle .
John says that your daughter is young .	John helps your daughter is young .
Deborah thinks that my teacher is confused .	Deborah talks to my teacher is confused .
Susan knows that your mother is happy .	Susan works with your mother is happy .
my teacher says that my mom 's wife 's dentist is bored .	my teacher works with my mom 's wife 's dentist is bored .
my doctor says that my father is kind .	my doctor helps my father is kind .
Todd knows that my dad is gentle .	Todd works with my dad is gentle .
your dentist thinks that your mother is upset .	your dentist scares your mother is upset .
my friend knows that my mom is kind .	my friend helps my mom is kind .
your dentist thinks that your mother is quiet .	your dentist helps your mother is quiet .
your friend thinks that my wife is excited .	your friend helps my wife is excited .
my cousin thinks that your brother 's wife is upset .	my cousin talks to your brother 's wife is upset .
the child says that your mother is bored .	the child helps your mother is bored .
Wendy thinks that your doctor is boring .	Wendy scares your doctor is boring .
the dancer says that your friend 's grandmother is happy .	the dancer works with your friend 's grandmother is happy .
my doctor says that your doctor 's cousin is curious .	my doctor works with your doctor 's cousin is curious .
the dentist says that your dad 's wife 's mom is bored .	the dentist scares your dad 's wife 's mom is bored .
my teacher thinks that my sister is tall .	my teacher works with my sister is tall .
the driver thinks that your son 's sister 's doctor is confused .	the driver helps your son 's sister 's doctor is confused .
your doctor thinks that my mom 's son is gentle .	your doctor talks to my mom 's son is gentle .
your cousin thinks that your mom is happy .	your cousin talks to your mom is happy .
Lisa says that your brother 's mother 's sister is quiet .	Lisa works with your brother 's mother 's sister is quiet .
your boss thinks that my grandmother is excited .	your boss talks to my grandmother is excited .
Anne thinks that your mother is healthy .	Anne helps your mother is healthy .
my doctor thinks that my sister 's husband 's brother is bored .	my doctor scares my sister 's husband 's brother is bored .
the dentist thinks that my mom is curious .	the dentist helps my mom is curious .
your boss knows that my friend is smart .	your boss scares my friend is smart .
the dentist knows that your brother 's friend is careful .	the dentist helps your brother 's friend is careful .
Stephanie says that my teacher 's cousin 's daughter is curious .	Stephanie works with my teacher 's cousin 's daughter is curious .
Naomi thinks that your dentist 's teacher is busy .	Naomi scares your dentist 's teacher is busy .
my doctor thinks that your brother 's sister is upset .	my doctor works with your brother 's sister is upset .
the child thinks that my boss is friendly .	the child scares my boss is friendly .
my cousin says that your daughter is friendly .	my cousin works with your daughter is friendly .
my cousin knows that your mother 's son is busy .	my cousin scares your mother 's son is busy .
the doctor says that my dad 's sister is clever .	the doctor scares my dad 's sister is clever .
the child knows that my cousin 's mother is excited .	the child talks to my cousin 's mother is excited .
your doctor thinks that your son 's daughter is hungry .	your doctor scares your son 's daughter is hungry .
your friend knows that my son is strong .	your friend scares my son is strong .
the patient thinks that my teacher is upset .	the patient talks to my teacher is upset .
the patient thinks that my cousin is important .	the patient talks to my cousin is important .
my dentist says that your son is young .	my dentist works with your son is young .
my friend thinks that my grandmother is surprised .	my friend scares my grandmother is surprised .
my teacher says that my teacher 's friend 's friend is kind .	my teacher helps my teacher 's friend 's friend is kind .
your teacher knows that my wife 's father is curious .	your teacher scares my wife 's father is curious .
Carol thinks that my dentist is clever .	Carol works with my dentist is clever .
your cousin thinks that your husband 's grandmother is strong .	your cousin talks to your husband 's grandmother is strong .
the dentist knows that my friend 's daughter is hungry .	the dentist talks to my friend 's daughter is hungry .
your boss says that my brother 's friend 's wife is upset .	your boss talks to my brother 's friend 's wife is upset .
the adult says that my dentist 's wife 's doctor is kind .	the adult scares my dentist 's wife 's doctor is kind .
your doctor knows that your dentist 's doctor is healthy .	your doctor works with your dentist 's doctor is healthy .
Frank knows that my teacher is nice .	Frank works with my teacher is nice .
the dentist thinks that my dentist 's brother 's dentist is hungry .	the dentist helps my dentist 's brother 's dentist is hungry .
Laurie thinks that my husband 's dentist 's son is clever .	Laurie scares my husband 's dentist 's son is clever .
Laurie thinks that my doctor 's sister 's boss is kind .	Laurie talks to my doctor 's sister 's boss is kind .
Adam thinks that my teacher 's teacher is upset .	Adam helps my teacher 's teacher is upset .
the doctor says that my boss is tired .	the doctor talks to my boss is tired .
your teacher knows that my mom 's daughter is busy .	your teacher helps my mom 's daughter is busy .
my dentist thinks that my mother is upset .	my dentist helps my mother is upset .
Allison knows that your mom is strong .	Allison scares your mom is strong .
my teacher thinks that my cousin 's dad 's father is tall .	my teacher helps my cousin 's dad 's father is tall .
Kevin knows that my sister 's daughter is kind .	Kevin talks to my sister 's daughter is kind .
my boss knows that my grandmother is important .	my boss works with my grandmother is important .
my teacher knows that my dentist is strong .	my teacher works with my dentist is strong .
my cousin says that my boss is healthy .	my cousin talks to my boss is healthy .
Janet knows that my friend is angry .	Janet scares my friend is angry .
the patient thinks that your boss is confused .	the patient helps your boss is confused .
the adult says that your mom 's husband 's boss is wrong .	the adult helps your mom 's husband 's boss is wrong .
your dentist knows that your teacher is kind .	your dentist scares your teacher is kind .
my dentist says that my daughter is wrong .	my dentist helps my daughter is wrong .
Laurie says that my teacher 's brother is healthy .	Laurie helps my teacher 's brother is healthy .
the dentist knows that your dad 's boss 's sister is excited .	the dentist helps your dad 's boss 's sister is excited .
the adult says that your husband is lucky .	the adult works with your husband is lucky .
my dentist says that my mother 's husband 's father is important .	my dentist works with my mother 's husband 's father is important .
my teacher thinks that your husband 's friend 's grandmother is happy .	my teacher talks to your husband 's friend 's grandmother is happy .
my doctor says that my son 's dentist is kind .	my doctor helps my son 's dentist is kind .
Daniel says that my dad 's father 's daughter is kind .	Daniel scares my dad 's father 's daughter is kind .
the adult knows that my husband 's friend is clever .	the adult helps my husband 's friend is clever .
the person says that your dentist 's father is busy .	the person scares your dentist 's father is busy .
the person thinks that my wife 's mother is nice .	the person works with my wife 's mother is nice .
George says that your husband 's mother 's brother is friendly .	George works with your husband 's mother 's brother is friendly .
Becca thinks that your friend 's sister 's boss is strong .	Becca helps your friend 's sister 's boss is strong .
Donald knows that my husband 's teacher is strong .	Donald talks to my husband 's teacher is strong .
Erin knows that my doctor 's brother 's cousin is bored .	Erin helps my doctor 's brother 's cousin is bored .
my doctor knows that your boss is kind .	my doctor scares your boss is kind .
the patient thinks that your dad 's grandmother is tall .	the patient scares your dad 's grandmother is tall .
the dentist says that my boss 's son 's daughter is smart .	the dentist scares my boss 's son 's daughter is smart .
my teacher thinks that my cousin 's teacher 's daughter is excited .	my teacher works with my cousin 's teacher 's daughter is excited .
Anne knows that your grandmother 's teacher is angry .	Anne talks to your grandmother 's teacher is angry .
the teacher thinks that my dad 's mother is friendly .	the teacher talks to my dad 's mother is friendly .
Steve says that your sister 's mother 's daughter is tall .	Steve helps your sister 's mother 's daughter is tall .
the dancer thinks that your grandmother 's grandmother is strong .	the dancer talks to your grandmother 's grandmother is strong .
the customer says that your daughter 's grandmother 's friend is happy .	the customer helps your daughter 's grandmother 's friend is happy .
my teacher thinks that my teacher is angry .	my teacher helps my teacher is angry .
my friend thinks that my husband 's daughter 's son is important .	my friend scares my husband 's daughter 's son is important .
Carol knows that my friend is smart .	Carol scares my friend is smart .
my boss knows that my dentist 's sister is lucky .	my boss scares my dentist 's sister is lucky .
Stephanie knows that your cousin 's friend 's daughter is busy .	Stephanie talks to your cousin 's friend 's daughter is busy .
the teacher knows that your father is helpful .	the teacher helps your father is helpful .
the dancer thinks that your friend is smart .	the dancer works with your friend is smart .
Jill knows that your friend 's mother is happy .	Jill talks to your friend 's mother is happy .
your doctor says that your mother is nice .	your doctor works with your mother is nice .
the person knows that your mother is upset .	the person works with your mother is upset .
the customer thinks that your father is tired .	the customer talks to your father is tired .
the child says that your teacher is happy .	the child talks to your teacher is happy .
Scott knows that your son 's friend is tired .	Scott scares your son 's friend is tired .
April knows that your grandmother 's daughter is careful .	April works with your grandmother 's daughter is careful .
the child thinks that my boss 's mother is upset .	the child helps my boss 's mother is upset .
Steven says that my dentist 's friend is busy .	Steven scares my dentist 's friend is busy .
Donna knows that your dad is important .	Donna talks to your dad is important .
my teacher thinks that your boss is busy .	my teacher talks to your boss is busy .
the customer thinks that my dad 's doctor 's husband is smart .	the customer works with my dad 's doctor 's husband is smart .
Julia knows that my sister 's wife is busy .	Julia helps my sister 's wife is busy .
Naomi thinks that my wife 's dentist is angry .	Naomi scares my wife 's dentist is angry .
my doctor knows that your cousin is happy .	my doctor helps your cousin is happy .
your teacher says that my mom 's sister 's teacher is busy .	your teacher scares my mom 's sister 's teacher is busy .
your teacher thinks that your cousin is excited .	your teacher works with your cousin is excited .
the patient thinks that my husband 's cousin is strong .	the patient helps my husband 's cousin is strong .
the child thinks that my brother 's brother 's dad is confused .	the child talks to my brother 's brother 's dad is confused .
Nancy says that your son 's mom is smart .	Nancy talks to your son 's mom is smart .
Allison thinks that my boss 's daughter 's daughter is excited .	Allison works with my boss 's daughter 's daughter is excited .
Donna knows that my father is surprised .	Donna helps my father is surprised .
the customer says that your brother is happy .	the customer works with your brother is happy .
my cousin says that my doctor 's cousin 's friend is smart .	my cousin works with my doctor 's cousin 's friend is smart .
my cousin knows that my daughter 's doctor is busy .	my cousin talks to my daughter 's doctor is busy .
the doctor thinks that your doctor is strong .	the doctor helps your doctor is strong .
William says that my husband 's mom 's cousin is hungry .	William helps my husband 's mom 's cousin is hungry .
the customer knows that my wife is hungry .	the customer works with my wife is hungry .
my dentist knows that your dad 's dentist is sleepy .	my dentist works with your dad 's dentist is sleepy .
my dentist knows that your brother 's boss 's sister is kind .	my dentist scares your brother 's boss 's sister is kind .
my doctor says that my cousin is happy .	my doctor helps my cousin is happy .
your cousin says that my cousin is smart .	your cousin scares my cousin is smart .
your teacher says that my grandmother is kind .	your teacher talks to my grandmother is kind .
the adult knows that your sister is healthy .	the adult scares your sister is healthy .
Scott knows that your mother is important .	Scott works with your mother is important .
my dentist says that your wife 's dad is careful .	my dentist works with your wife 's dad is careful .
your boss thinks that my doctor 's son 's mom is excited .	your boss works with my doctor 's son 's mom is excited .
my teacher thinks that your sister 's wife is careful .	my teacher scares your sister 's wife is careful .
my dentist knows that my mom 's mom is angry .	my dentist helps my mom 's mom is angry .
Travis knows that your doctor is excited .	Travis works with your doctor is excited .
my boss says that my cousin is gentle .	my boss talks to my cousin is gentle .
Brett knows that your son 's friend is important .	Brett helps your son 's friend is important .
Jane knows that my boss is curious .	Jane talks to my boss is curious .
Lisa knows that your brother 's wife is clever .	Lisa talks to your brother 's wife is clever .
the person thinks that my sister is important .	the person helps my sister is important .
Nancy says that your dad is gentle .	Nancy talks to your dad is gentle .
the dancer says that my husband 's boss 's son is hungry .	the dancer scares my husband 's boss 's son is hungry .
my friend knows that your brother 's dentist is careful .	my friend works with your brother 's dentist is careful .
the dentist thinks that my mom 's teacher is tall .	the dentist scares my mom 's teacher is tall .
my doctor knows that my father 's teacher is careful .	my doctor works with my father 's teacher is careful .
William knows that your grandmother 's sister 's doctor is friendly .	William works with your grandmother 's sister 's doctor is friendly .
Liam says that your teacher 's husband is careful .	Liam helps your teacher 's husband is careful .
the person knows that my dad 's dentist 's mom is angry .	the person talks to my dad 's dentist 's mom is angry .
my teacher thinks that my father is confused .	my teacher helps my father is confused .
the person says that my friend is helpful .	the person scares my friend is helpful .
Robert says that my doctor is hungry .	Robert talks to my doctor is hungry .
your boss thinks that your friend 's dentist is kind .	your boss scares your friend 's dentist is kind .
your boss says that my sister 's doctor is smart .	your boss works with my sister 's doctor is smart .
your doctor thinks that your cousin 's grandmother is healthy .	your doctor scares your cousin 's grandmother is healthy .
the person knows that my husband 's dentist is tired .	the person works with my husband 's dentist is tired .
Aaron thinks that your doctor 's wife is clever .	Aaron talks to your doctor 's wife is clever .
Kristen says that my sister is smart .	Kristen talks to my sister is smart .
Kayla thinks that my dentist 's daughter is careful .	Kayla helps my dentist 's daughter is careful .
my doctor knows that my husband 's husband is tired .	my doctor talks to my husband 's husband is tired .
my teacher thinks that my wife 's teacher 's wife is confused .	my teacher works with my wife 's teacher 's wife is confused .
the doctor says that my son 's wife is boring .	the doctor talks to my son 's wife is boring .
the child says that my grandmother 's mom is quiet .	the child talks to my grandmother 's mom is quiet .
your boss thinks that your daughter 's teacher 's friend is curious .	your boss scares your daughter 's teacher 's friend is curious .
your dentist says that your daughter 's son 's sister is wrong .	your dentist scares your daughter 's son 's sister is wrong .
the dancer knows that your husband 's son 's dad is angry .	the dancer works with your husband 's son 's dad is angry .
my cousin says that my teacher 's dad 's father is kind .	my cousin helps my teacher 's dad 's father is kind .
your doctor knows that my mom 's son 's husband is smart .	your doctor scares my mom 's son 's husband is smart .
your boss thinks that my husband 's sister 's dentist is kind .	your boss helps my husband 's sister 's dentist is kind .
Carol knows that my boss is strong .	Carol scares my boss is strong .
Noah knows that your brother 's dad is busy .	Noah scares your brother 's dad is busy .
William thinks that your friend 's cousin is helpful .	William talks to your friend 's cousin is helpful .
your doctor thinks that your doctor 's sister 's dad is lucky .	your doctor scares your doctor 's sister 's dad is lucky .
my doctor knows that my brother is important .	my doctor talks to my brother is important .
my cousin thinks that my dentist is smart .	my cousin talks to my dentist is smart .
your dentist thinks that my teacher 's daughter 's dentist is friendly .	your dentist talks to my teacher 's daughter 's dentist is friendly .
the child knows that your sister 's mother 's brother is bored .	the child works with your sister 's mother 's brother is bored .
Eric knows that my father 's dad 's mom is busy .	Eric talks to my father 's dad 's mom is busy .
Jerry says that your grandmother is sleepy .	Jerry talks to your grandmother is sleepy .
the child thinks that my husband is important .	the child helps my husband is important .
Carl knows that your wife is happy .	Carl scares your wife is happy .
Sara thinks that your friend 's doctor is wrong .	Sara scares your friend 's doctor is wrong .
your teacher thinks that my mom is sleepy .	your teacher scares my mom is sleepy .
Judy knows that your friend 's husband is nice .	Judy works with your friend 's husband is nice .
your cousin knows that your daughter 's boss is upset .	your cousin works with your daughter 's boss is upset .
your dentist says that your boss is boring .	your dentist works with your boss is boring .
the child knows that my boss 's teacher is busy .	the child talks to my boss 's teacher is busy .
Paul says that your cousin 's sister 's wife is healthy .	Paul scares your cousin 's sister 's wife is healthy .
Linda says that my sister is kind .	Linda helps my sister is kind .
my teacher thinks that my mother 's boss 's brother is sleepy .	my teacher scares my mother 's boss 's brother is sleepy .
my friend thinks that your doctor is kind .	my friend works with your doctor is kind .
the teacher thinks that my friend 's cousin is smart .	the teacher works with my friend 's cousin is smart .
Denise knows that my grandmother 's sister is smart .	Denise scares my grandmother 's sister is smart .
the driver says that my dentist 's teacher 's wife is sleepy .	the driver helps my dentist 's teacher 's wife is sleepy .
Erin thinks that my brother 's dad 's mother is angry .	Erin helps my brother 's dad 's mother is angry .
your teacher knows that your mother 's dad 's father is nice .	your teacher works with your mother 's dad 's father is nice .
Scott says that my doctor is gentle .	Scott works with my doctor is gentle .
the child says that my son is healthy .	the child works with my son is healthy .
Scott says that your grandmother 's daughter is clever .	Scott helps your grandmother 's daughter is clever .
Nancy says that your son 's husband is helpful .	Nancy scares your son 's husband is helpful .
Barbara says that your son is surprised .	Barbara talks to your son is surprised .
my dentist thinks that my wife 's mother is quiet .	my dentist talks to my wife 's mother is quiet .
your dentist knows that my brother 's dad 's grandmother is sleepy .	your dentist helps my brother 's dad 's grandmother is sleepy .
the child knows that your mom 's sister is quiet .	the child talks to your mom 's sister is quiet .
Naomi thinks that your dentist 's father is boring .	Naomi helps your dentist 's father is boring .
Donna thinks that your cousin 's dentist is tired .	Donna helps your cousin 's dentist is tired .
my dentist knows that your mom is friendly .	my dentist helps your mom is friendly .
the dentist thinks that my friend is young .	the dentist talks to my friend is young .
Alexander thinks that my mother 's doctor 's mother is healthy .	Alexander helps my mother 's doctor 's mother is healthy .
my friend says that your dentist 's dentist is lucky .	my friend scares your dentist 's dentist is lucky .
Rebecca thinks that my father 's cousin 's friend is surprised .	Rebecca works with my father 's cousin 's friend is surprised .
the teacher says that your doctor 's brother is careful .	the teacher talks to your doctor 's brother is careful .
the dentist knows that your grandmother 's dad is strong .	the dentist works with your grandmother 's dad is strong .
your boss says that my mother is hungry .	your boss helps my mother is hungry .
the dancer thinks that your mom 's boss is gentle .	the dancer works with your mom 's boss is gentle .
the customer says that my brother 's boss is curious .	the customer helps my brother 's boss is curious .
the child knows that your grandmother is excited .	the child works with your grandmother is excited .
the dancer says that my father 's son is happy .	the dancer works with my father 's son is happy .
the driver knows that my friend 's doctor 's mother is smart .	the driver helps my friend 's doctor 's mother is smart .
the customer thinks that my wife 's sister is sleepy .	the customer talks to my wife 's sister is sleepy .
the customer says that your boss 's brother is curious .	the customer helps your boss 's brother is curious .
your boss knows that my brother is smart .	your boss works with my brother is smart .
the customer says that my dad 's teacher 's boss is strong .	the customer helps my dad 's teacher 's boss is strong .
Karen knows that your mom 's mother 's mom is smart .	Karen talks to your mom 's mother 's mom is smart .
Patrick knows that my father 's friend 's mother is hungry .	Patrick helps my father 's friend 's mother is hungry .
my boss thinks that my teacher 's boss is happy .	my boss talks to my teacher 's boss is happy .
Karen says that my daughter 's son 's doctor is important .	Karen talks to my daughter 's son 's doctor is important .
your teacher says that your cousin is healthy .	your teacher works with your cousin is healthy .
your dentist thinks that my boss 's wife is happy .	your dentist helps my boss 's wife is happy .
the patient says that my boss 's teacher 's doctor is helpful .	the patient scares my boss 's teacher 's doctor is helpful .
the person says that my friend 's dad is surprised .	the person helps my friend 's dad is surprised .
Amelia says that my grandmother 's mother 's friend is excited .	Amelia scares my grandmother 's mother 's friend is excited .
the person knows that your dad 's father is boring .	the person helps your dad 's father is boring .
the doctor knows that your husband 's daughter is strong .	the doctor talks to your husband 's daughter is strong .
Jill says that my sister 's sister is helpful .	Jill talks to my sister 's sister is helpful .
my doctor knows that your brother 's friend 's teacher is excited .	my doctor scares your brother 's friend 's teacher is excited .
Timothy says that my friend 's cousin is quiet .	Timothy works with my friend 's cousin is quiet .
your doctor says that your husband 's father 's mother is busy .	your doctor works with your husband 's father 's mother is busy .
your dentist says that your daughter 's mom 's wife is tall .	your dentist helps your daughter 's mom 's wife is tall .
James thinks that your dad is tired .	James helps your dad is tired .
the doctor knows that my son 's brother 's mom is quiet .	the doctor scares my son 's brother 's mom is quiet .
my friend says that your brother is boring .	my friend talks to your brother is boring .
Emily knows that your friend 's daughter is strong .	Emily helps your friend 's daughter is strong .
the teacher says that my father 's husband is friendly .	the teacher scares my father 's husband is friendly .
your friend thinks that my friend 's mom is bored .	your friend scares my friend 's mom is bored .
Julie says that your mother is tall .	Julie works with your mother is tall .
the dentist thinks that my sister 's wife 's boss is helpful .	the dentist helps my sister 's wife 's boss is helpful .
the child thinks that your daughter is friendly .	the child talks to your daughter is friendly .
your friend knows that my grandmother 's teacher 's sister is clever .	your friend scares my grandmother 's teacher 's sister is clever .
my friend knows that your father 's cousin 's mom is important .	my friend talks to your father 's cousin 's mom is important .
Denise says that your son is gentle .	Denise works with your son is gentle .
your friend thinks that your cousin 's mother 's daughter is happy .	your friend scares your cousin 's mother 's daughter is happy .
Thomas says that my husband 's sister is boring .	Thomas talks to my husband 's sister is boring .
my teacher says that my boss 's wife is sleepy .	my teacher works with my boss 's wife is sleepy .
the dancer says that my husband is bored .	the dancer talks to my husband is bored .
my teacher knows that my boss is healthy .	my teacher talks to my boss is healthy .
Scott knows that your cousin 's mother is sleepy .	Scott works with your cousin 's mother is sleepy .
the doctor thinks that your mom 's teacher 's son is happy .	the doctor works with your mom 's teacher 's son is happy .
your dentist says that your boss 's mom is lucky .	your dentist helps your boss 's mom is lucky .
your teacher says that my dad 's mom is healthy .	your teacher talks to my dad 's mom is healthy .
Sara knows that your dad 's dad is healthy .	Sara works with your dad 's dad is healthy .
the person thinks that my dad is important .	the person talks to my dad is important .
Karen thinks that your mother is busy .	Karen helps your mother is busy .
Frank thinks that my cousin is kind .	Frank helps my cousin is kind .
your dentist knows that my brother is careful .	your dentist works with my brother is careful .
my boss says that my doctor 's son is wrong .	my boss works with my doctor 's son is wrong .
the person knows that your wife 's doctor 's teacher is tall .	the person talks to your wife 's doctor 's teacher is tall .
my cousin says that my daughter is curious .	my cousin helps my daughter is curious .
my teacher knows that my boss is clever .	my teacher scares my boss is clever .
your doctor says that your cousin is young .	your doctor scares your cousin is young .
my boss thinks that your cousin 's son is young .	my boss scares your cousin 's son is young .
James thinks that my friend 's mom 's mother is clever .	James scares my friend 's mom 's mother is clever .
the customer says that my husband 's mother is clever .	the customer scares my husband 's mother is clever .
the patient says that your cousin 's dentist is tall .	the patient talks to your cousin 's dentist is tall .
Eric knows that my mother 's wife is wrong .	Eric talks to my mother 's wife is wrong .
the patient thinks that my mom 's teacher is busy .	the patient helps my mom 's teacher is busy .
Travis thinks that your dad 's husband 's daughter is surprised .	Travis works with your dad 's husband 's daughter is surprised .
the dancer says that your friend is surprised .	the dancer works with your friend is surprised .
your teacher thinks that your sister is excited .	your teacher scares your sister is excited .
your doctor thinks that my teacher 's husband 's daughter is young .	your doctor talks to my teacher 's husband 's daughter is young .
your boss knows that your daughter 's grandmother is happy .	your boss helps your daughter 's grandmother is happy .
Nancy knows that your doctor 's daughter is nice .	Nancy talks to your doctor 's daughter is nice .
the dancer knows that my friend 's husband is healthy .	the dancer helps my friend 's husband is healthy .
my doctor thinks that your wife 's friend is busy .	my doctor scares your wife 's friend is busy .
your doctor thinks that your grandmother 's dad 's grandmother is strong .	your doctor helps your grandmother 's dad 's grandmother is strong .
Sally thinks that your mom 's teacher 's dentist is nice .	Sally helps your mom 's teacher 's dentist is nice .
Barbara knows that my boss 's father 's doctor is smart .	Barbara helps my boss 's father 's doctor is smart .
your boss knows that your sister 's friend is confused .	your boss works with your sister 's friend is confused .
the doctor thinks that my teacher 's wife 's friend is sleepy .	the doctor works with my teacher 's wife 's friend is sleepy .
Alexander knows that your grandmother is gentle .	Alexander talks to your grandmother is gentle .
your dentist knows that my friend is sleepy .	your dentist works with my friend is sleepy .
the person says that your dentist is hungry .	the person talks to your dentist is hungry .
Jason knows that my father 's sister is quiet .	Jason works with my father 's sister is quiet .
your teacher says that your brother 's dentist 's dentist is angry .	your teacher scares your brother 's dentist 's dentist is angry .
my boss says that your grandmother is wrong .	my boss scares your grandmother is wrong .
Barbara knows that your son is smart .	Barbara works with your son is smart .
Donald says that my friend 's mother is nice .	Donald scares my friend 's mother is nice .
Judy knows that your son 's mom 's brother is kind .	Judy talks to your son 's mom 's brother is kind .
your teacher says that my doctor is nice .	your teacher helps my doctor is nice .
Kristen knows that my dentist 's doctor 's friend is bored .	Kristen helps my dentist 's doctor 's friend is bored .
Christopher says that my boss 's cousin 's teacher is happy .	Christopher works with my boss 's cousin 's teacher is happy .
the doctor says that your doctor is healthy .	the doctor talks to your doctor is healthy .
the patient knows that my daughter 's brother 's teacher is surprised .	the patient helps my daughter 's brother 's teacher is surprised .
my cousin says that my sister is nice .	my cousin scares my sister is nice .
my dentist thinks that your doctor is sleepy .	my dentist scares your doctor is sleepy .
the driver says that my father is curious .	the driver scares my father is curious .
your dentist thinks that your mom 's teacher 's brother is wrong .	your dentist works with your mom 's teacher 's brother is wrong .
the driver thinks that your son 's daughter 's doctor is helpful .	the driver helps your son 's daughter 's doctor is helpful .
my dentist knows that your boss is hungry .	my dentist talks to your boss is hungry .
your friend thinks that my brother 's teacher is excited .	your friend talks to my brother 's teacher is excited .
the dancer says that my father 's son 's boss is sleepy .	the dancer helps my father 's son 's boss is sleepy .
my cousin says that your sister 's mom is busy .	my cousin works with your sister 's mom is busy .
the adult thinks that your mother 's daughter is important .	the adult works with your mother 's daughter is important .
Julia says that my husband 's son 's son is upset .	Julia helps my husband 's son 's son is upset .
the patient thinks that your teacher 's wife 's mother is excited .	the patient helps your teacher 's wife 's mother is excited .
Catherine knows that your brother 's father 's brother is gentle .	Catherine helps your brother 's father 's brother is gentle .
the person thinks that your sister 's friend 's boss is nice .	the person helps your sister 's friend 's boss is nice .
my teacher thinks that my husband 's boss 's mom is strong .	my teacher talks to my husband 's boss 's mom is strong .
Ronald says that my mom is strong .	Ronald talks to my mom is strong .
my boss knows that your dad is nice .	my boss talks to your dad is nice .
my dentist knows that my daughter 's brother 's father is wrong .	my dentist scares my daughter 's brother 's father is wrong .
the adult knows that my wife 's wife 's boss is strong .	the adult scares my wife 's wife 's boss is strong .
Laurie says that my doctor is busy .	Laurie scares my doctor is busy .
my boss says that my teacher 's teacher is helpful .	my boss talks to my teacher 's teacher is helpful .
your boss knows that your husband 's dentist is hungry .	your boss scares your husband 's dentist is hungry .
the driver thinks that your son 's doctor 's boss is friendly .	the driver scares your son 's doctor 's boss is friendly .
my dentist knows that my teacher is busy .	my dentist scares my teacher is busy .
Jerry knows that my mom 's son 's mother is healthy .	Jerry helps my mom 's son 's mother is healthy .
the adult says that your daughter 's sister 's cousin is curious .	the adult helps your daughter 's sister 's cousin is curious .
my friend says that my wife is smart .	my friend scares my wife is smart .
my doctor knows that your brother is healthy .	my doctor scares your brother is healthy .
the teacher thinks that your wife is upset .	the teacher helps your wife is upset .
James knows that your brother is bored .	James scares your brother is bored .
Ronald thinks that your grandmother 's father 's son is busy .	Ronald scares your grandmother 's father 's son is busy .
your cousin thinks that your dad is surprised .	your cousin scares your dad is surprised .
the doctor says that my husband 's mom is healthy .	the doctor helps my husband 's mom is healthy .
your teacher knows that your brother is bored .	your teacher works with your brother is bored .
my dentist says that your dentist 's doctor is strong .	my dentist helps your dentist 's doctor is strong .
the customer knows that your mom 's dentist 's dentist is lucky .	the customer works with your mom 's dentist 's dentist is lucky .
the dancer says that your father 's doctor is important .	the dancer scares your father 's doctor is important .
my cousin thinks that your dentist is nice .	my cousin talks to your dentist is nice .
the person knows that my dentist is curious .	the person helps my dentist is curious .
the child knows that my boss 's wife 's dentist is tired .	the child works with my boss 's wife 's dentist is tired .
your teacher says that your wife is important .	your teacher helps your wife is important .
your teacher says that my wife 's dentist is curious .	your teacher helps my wife 's dentist is curious .
the adult says that your son 's son 's cousin is clever .	the adult helps your son 's son 's cousin is clever .
the patient says that my dad is happy .	the patient talks to my dad is happy .
Paul knows that your son 's wife 's doctor is wrong .	Paul helps your son 's wife 's doctor is wrong .
Jason says that my teacher 's sister is upset .	Jason works with my teacher 's sister is upset .
Paul thinks that your grandmother 's son 's grandmother is upset .	Paul works with your grandmother 's son 's grandmother is upset .
my boss knows that your dentist is smart .	my boss scares your dentist is smart .
Alexander says that my husband is strong .	Alexander works with my husband is strong .
my cousin knows that my grandmother 's mom 's brother is strong .	my cousin talks to my grandmother 's mom 's brother is strong .
the adult knows that your friend 's teacher 's cousin is wrong .	the adult helps your friend 's teacher 's cousin is wrong .
my friend thinks that my son is excited .	my friend talks to my son is excited .
the customer says that my doctor is happy .	the customer talks to my doctor is happy .
the person knows that my grandmother 's husband is busy .	the person scares my grandmother 's husband is busy .
your dentist knows that your mom is clever .	your dentist helps your mom is clever .
the driver thinks that my teacher is quiet .	the driver works with my teacher is quiet .
Samantha thinks that your daughter 's cousin is sleepy .	Samantha scares your daughter 's cousin is sleepy .
Michael knows that my grandmother 's wife is tired .	Michael works with my grandmother 's wife is tired .
Andrew thinks that my father is tall .	Andrew talks to my father is tall .
Leslie knows that your son 's cousin is important .	Leslie talks to your son 's cousin is important .
Jessica says that your teacher 's wife is sleepy .	Jessica scares your teacher 's wife is sleepy .
my teacher thinks that my wife 's boss is helpful .	my teacher scares my wife 's boss is helpful .
Julie says that my dentist 's daughter 's daughter is excited .	Julie scares my dentist 's daughter 's daughter is excited .
the dancer knows that your daughter is excited .	the dancer helps your daughter is excited .
my boss says that my father is upset .	my boss works with my father is upset .
the doctor thinks that my mom is lucky .	the doctor works with my mom is lucky .
Scott thinks that my doctor 's dad is healthy .	Scott helps my doctor 's dad is healthy .
my dentist says that your brother is happy .	my dentist scares your brother is happy .
my friend thinks that my dentist is wrong .	my friend helps my dentist is wrong .
Michael says that your husband 's mother 's friend is tall .	Michael helps your husband 's mother 's friend is tall .
the adult knows that my sister 's dad 's boss is wrong .	the adult helps my sister 's dad 's boss is wrong .
Julia thinks that your sister 's daughter is hungry .	Julia helps your sister 's daughter is hungry .
your teacher says that my wife is angry .	your teacher scares my wife is angry .
the driver says that my brother 's son is tired .	the driver works with my brother 's son is tired .
the doctor knows that my doctor 's dad is sleepy .	the doctor works with my doctor 's dad is sleepy .
the customer thinks that your teacher is clever .	the customer works with your teacher is clever .
Mark knows that my grandmother 's grandmother is gentle .	Mark works with my grandmother 's grandmother is gentle .
Renee says that my wife is kind .	Renee helps my wife is kind .
the dentist thinks that my son is confused .	the dentist works with my son is confused .
the adult says that your daughter 's friend is helpful .	the adult scares your daughter 's friend is helpful .
your boss says that my son 's teacher 's son is tired .	your boss helps my son 's teacher 's son is tired .
your friend knows that your daughter 's boss 's teacher is tall .	your friend scares your daughter 's boss 's teacher is tall .
my dentist says that my son is nice .	my dentist works with my son is nice .
the driver knows that my doctor 's doctor 's son is gentle .	the driver works with my doctor 's doctor 's son is gentle .
my boss thinks that your wife is gentle .	my boss talks to your wife is gentle .
my cousin says that your son 's friend is quiet .	my cousin works with your son 's friend is quiet .
Rachel says that your doctor 's mother is gentle .	Rachel scares your doctor 's mother is gentle .
my friend thinks that my doctor 's wife is gentle .	my friend works with my doctor 's wife is gentle .
Deborah knows that your grandmother 's teacher is strong .	Deborah works with your grandmother 's teacher is strong .
your friend thinks that your grandmother 's wife 's teacher is excited .	your friend scares your grandmother 's wife 's teacher is excited .
Scott says that your dad 's husband is clever .	Scott works with your dad 's husband is clever .
the person says that my mother 's dad 's teacher is nice .	the person helps my mother 's dad 's teacher is nice .
the teacher thinks that my son is healthy .	the teacher talks to my son is healthy .
my doctor knows that your daughter 's friend 's boss is smart .	my doctor works with your daughter 's friend 's boss is smart .
your doctor thinks that my brother is excited .	your doctor helps my brother is excited .
Anne knows that your husband 's sister 's boss is surprised .	Anne talks to your husband 's sister 's boss is surprised .
Peter thinks that your teacher 's cousin 's brother is nice .	Peter helps your teacher 's cousin 's brother is nice .
my doctor knows that your boss 's daughter 's dentist is tired .	my doctor talks to your boss 's daughter 's dentist is tired .
the dentist says that my son 's sister is tall .	the dentist works with my son 's sister is tall .
your dentist knows that my grandmother 's sister is curious .	your dentist talks to my grandmother 's sister is curious .
the driver thinks that your teacher 's brother 's daughter is excited .	the driver talks to your teacher 's brother 's daughter is excited .
your doctor thinks that my dentist 's son is boring .	your doctor helps my dentist 's son is boring .
the adult knows that your father 's mom is clever .	the adult scares your father 's mom is clever .
the teacher thinks that your sister 's daughter 's wife is healthy .	the teacher works with your sister 's daughter 's wife is healthy .
the dancer says that your teacher 's sister 's wife is careful .	the dancer talks to your teacher 's sister 's wife is careful .
Timothy knows that my dentist is gentle .	Timothy scares my dentist is gentle .
Daniel knows that my friend is angry .	Daniel helps my friend is angry .
Sally thinks that your friend is helpful .	Sally scares your friend is helpful .
my teacher thinks that your mom 's boss is happy .	my teacher talks to your mom 's boss is happy .
the dentist knows that my father 's brother is bored .	the dentist scares my father 's brother is bored .
my cousin thinks that my brother is strong .	my cousin talks to my brother is strong .
my friend knows that your brother 's daughter 's son is tired .	my friend scares your brother 's daughter 's son is tired .
the child says that my mom 's father 's dentist is curious .	the child helps my mom 's father 's dentist is curious .
Ronald thinks that my cousin 's sister 's dentist is kind .	Ronald scares my cousin 's sister 's dentist is kind .
the dancer knows that your mom is wrong .	the dancer scares your mom is wrong .
your boss says that your doctor 's son is wrong .	your boss helps your doctor 's son is wrong .
the dentist knows that my father 's brother is excited .	the dentist scares my father 's brother is excited .
the adult knows that my mom 's dad is lucky .	the adult talks to my mom 's dad is lucky .
William says that your father 's father is curious .	William scares your father 's father is curious .
your teacher says that your son 's father 's doctor is careful .	your teacher talks to your son 's father 's doctor is careful .
the person knows that my brother 's husband is smart .	the person works with my brother 's husband is smart .
your doctor thinks that my sister 's dad is boring .	your doctor helps my sister 's dad is boring .
my teacher says that your wife is bored .	my teacher talks to your wife is bored .
Brian knows that my friend 's doctor 's son is upset .	Brian helps my friend 's doctor 's son is upset .
the teacher knows that my boss 's teacher 's dad is sleepy .	the teacher scares my boss 's teacher 's dad is sleepy .
James knows that my husband 's wife is friendly .	James helps my husband 's wife is friendly .
Cindy says that your grandmother 's sister 's husband is clever .	Cindy scares your grandmother 's sister 's husband is clever .
the driver says that my wife 's grandmother is curious .	the driver helps my wife 's grandmother is curious .
the driver says that your sister 's friend is clever .	the driver helps your sister 's friend is clever .
the child says that your sister 's sister is kind .	the child helps your sister 's sister is kind .
the doctor knows that your grandmother is upset .	the doctor works with your grandmother is upset .
my cousin thinks that your grandmother is confused .	my cousin works with your grandmother is confused .
the customer knows that your grandmother is important .	the customer helps your grandmother is important .
the driver thinks that my cousin is strong .	the driver talks to my cousin is strong .
Melissa thinks that my daughter is confused .	Melissa works with my daughter is confused .
Barbara says that your brother 's cousin is tall .	Barbara works with your brother 's cousin is tall .
your friend thinks that my brother 's cousin is healthy .	your friend works with my brother 's cousin is healthy .
the adult thinks that your friend 's brother 's mother is lucky .	the adult talks to your friend 's brother 's mother is lucky .
the doctor knows that your dentist 's boss is helpful .	the doctor works with your dentist 's boss is helpful .
the dancer thinks that your dentist 's wife 's sister is careful .	the dancer works with your dentist 's wife 's sister is careful .
Anne knows that my grandmother is careful .	Anne scares my grandmother is careful .
Gregory knows that your teacher 's mom is quiet .	Gregory helps your teacher 's mom is quiet .
Tracy knows that my wife is curious .	Tracy helps my wife is curious .
the adult knows that your daughter 's cousin 's doctor is boring .	the adult talks to your daughter 's cousin 's doctor is boring .
Becky thinks that my husband 's brother 's husband is smart .	Becky works with my husband 's brother 's husband is smart .
your dentist thinks that my sister 's son is healthy .	your dentist helps my sister 's son is healthy .
the doctor thinks that my mom 's wife 's doctor is helpful .	the doctor helps my mom 's wife 's doctor is helpful .
your doctor thinks that your husband is bored .	your doctor works with your husband is bored .
your friend says that my mother 's daughter is wrong .	your friend helps my mother 's daughter is wrong .
the person says that my boss 's brother is confused .	the person scares my boss 's brother is confused .
your doctor says that my friend is nice .	your doctor talks to my friend is nice .
the teacher knows that your husband 's boss 's dentist is smart .	the teacher scares your husband 's boss 's dentist is smart .
the dancer knows that my dad 's father 's son is friendly .	the dancer helps my dad 's father 's son is friendly .
my friend says that my doctor 's father is sleepy .	my friend scares my doctor 's father is sleepy .
Laurie says that my father 's cousin is sleepy .	Laurie works with my father 's cousin is sleepy .
my friend knows that your cousin is busy .	my friend talks to your cousin is busy .
Steve says that your friend 's teacher is careful .	Steve works with your friend 's teacher is careful .
the doctor says that your dad 's wife is strong .	the doctor scares your dad 's wife is strong .
Patrick says that my son 's sister is important .	Patrick helps my son 's sister is important .
the doctor knows that my mother 's mom is young .	the doctor works with my mother 's mom is young .
the customer thinks that my dentist 's wife is helpful .	the customer works with my dentist 's wife is helpful .
Richard says that my grandmother 's mother is upset .	Richard talks to my grandmother 's mother is upset .
the doctor thinks that your husband is tall .	the doctor helps your husband is tall .
the doctor knows that your mom is helpful .	the doctor talks to your mom is helpful .
Becca says that your daughter 's brother is tired .	Becca works with your daughter 's brother is tired .
Leslie knows that your grandmother 's daughter is quiet .	Leslie helps your grandmother 's daughter is quiet .
Laura says that my son 's wife 's teacher is quiet .	Laura helps my son 's wife 's teacher is quiet .
my doctor thinks that your brother 's daughter is friendly .	my doctor helps your brother 's daughter is friendly .
the driver knows that your cousin is healthy .	the driver helps your cousin is healthy .
the dancer says that my father is clever .	the dancer works with my father is clever .
the teacher knows that my son 's grandmother is clever .	the teacher helps my son 's grandmother is clever .
the driver says that your cousin 's dentist is nice .	the driver works with your cousin 's dentist is nice .
Christopher knows that my mother 's friend is upset .	Christopher helps my mother 's friend is upset .
my teacher thinks that my grandmother is nice .	my teacher works with my grandmother is nice .
Samantha thinks that your teacher 's father 's friend is upset .	Samantha talks to your teacher 's father 's friend is upset .
my cousin knows that my sister 's wife is quiet .	my cousin scares my sister 's wife is quiet .
Amelia thinks that my mom 's wife is hungry .	Amelia works with my mom 's wife is hungry .
Alice knows that my brother is surprised .	Alice talks to my brother is surprised .
the doctor says that my son 's husband 's dad is gentle .	the doctor scares my son 's husband 's dad is gentle .
Leslie thinks that my mom is important .	Leslie works with my mom is important .
Elizabeth says that your husband 's doctor is happy .	Elizabeth helps your husband 's doctor is happy .
your friend says that your daughter is young .	your friend scares your daughter is young .
my cousin knows that my daughter 's dad 's sister is upset .	my cousin helps my daughter 's dad 's sister is upset .
the customer thinks that my father 's doctor is bored .	the customer helps my father 's doctor is bored .
your doctor says that my wife 's doctor is helpful .	your doctor helps my wife 's doctor is helpful .
my friend thinks that your dentist 's sister is boring .	my friend talks to your dentist 's sister is boring .
Leslie says that my grandmother 's husband 's son is tall .	Leslie talks to my grandmother 's husband 's son is tall .
your dentist thinks that your grandmother is hungry .	your dentist talks to your grandmother is hungry .
Bill thinks that your brother is surprised .	Bill talks to your brother is surprised .
the customer says that my friend is clever .	the customer scares my friend is clever .
your doctor says that my dad 's grandmother is happy .	your doctor works with my dad 's grandmother is happy .
my dentist thinks that your daughter is boring .	my dentist helps your daughter is boring .
Andrew says that your cousin 's mom is young .	Andrew helps your cousin 's mom is young .
the adult says that my mom is excited .	the adult helps my mom is excited .
Barbara thinks that my mom is healthy .	Barbara helps my mom is healthy .
Janet says that your son 's dentist is tall .	Janet works with your son 's dentist is tall .
your boss says that your boss 's friend 's brother is helpful .	your boss helps your boss 's friend 's brother is helpful .
Ronald says that your dad 's dentist 's doctor is quiet .	Ronald helps your dad 's dentist 's doctor is quiet .
my friend knows that your mother is healthy .	my friend helps your mother is healthy .
your teacher thinks that my daughter 's cousin 's friend is strong .	your teacher scares my daughter 's cousin 's friend is strong .
the customer says that my brother 's cousin 's sister is surprised .	the customer works with my brother 's cousin 's sister is surprised .
my teacher thinks that my son is tired .	my teacher talks to my son is tired .
your friend knows that my father 's husband 's dentist is angry .	your friend works with my father 's husband 's dentist is angry .
Liam says that my dentist 's doctor is sleepy .	Liam scares my dentist 's doctor is sleepy .
the patient knows that my father is strong .	the patient scares my father is strong .
my boss thinks that your mom 's friend 's teacher is hungry .	my boss scares your mom 's friend 's teacher is hungry .
Laurie says that your mother is angry .	Laurie helps your mother is angry .
Leslie thinks that my husband 's father 's friend is upset .	Leslie works with my husband 's father 's friend is upset .
Richard says that my daughter 's father is strong .	Richard talks to my daughter 's father is strong .
Julia knows that my dentist 's son 's son is nice .	Julia scares my dentist 's son 's son is nice .
Janet says that your boss 's cousin 's dad is curious .	Janet talks to your boss 's cousin 's dad is curious .
the adult thinks that my teacher 's son 's husband is tired .	the adult helps my teacher 's son 's husband is tired .
Jerry says that my mother 's doctor is curious .	Jerry helps my mother 's doctor is curious .
Carl knows that my boss is confused .	Carl helps my boss is confused .
Leslie thinks that your dentist is clever .	Leslie scares your dentist is clever .
Anna says that your boss 's mother is kind .	Anna talks to your boss 's mother is kind .
Alice says that my son 's sister 's mother is helpful .	Alice helps my son 's sister 's mother is helpful .
my friend knows that my doctor is upset .	my friend works with my doctor is upset .
your cousin says that your wife 's son is quiet .	your cousin scares your wife 's son is quiet .
the customer knows that my cousin is angry .	the customer talks to my cousin is angry .
the adult says that my grandmother 's dad 's son is young .	the adult helps my grandmother 's dad 's son is young .
my boss says that your wife is clever .	my boss scares your wife is clever .
your dentist thinks that your grandmother is sleepy .	your dentist scares your grandmother is sleepy .
your boss thinks that your friend 's friend is kind .	your boss works with your friend 's friend is kind .
your doctor says that my son 's boss 's wife is tired .	your doctor helps my son 's boss 's wife is tired .
Sandra says that your daughter 's grandmother is clever .	Sandra scares your daughter 's grandmother is clever .
Julia says that my mother 's mom is curious .	Julia helps my mother 's mom is curious .
the patient knows that my daughter is sleepy .	the patient works with my daughter is sleepy .
the doctor knows that your wife is important .	the doctor scares your wife is important .
the patient thinks that my sister 's son 's son is friendly .	the patient helps my sister 's son 's son is friendly .
the driver says that your doctor 's wife 's wife is wrong .	the driver helps your doctor 's wife 's wife is wrong .
Mary says that my friend is kind .	Mary helps my friend is kind .
the driver thinks that my father 's dentist is young .	the driver scares my father 's dentist is young .
the patient thinks that my father 's dentist is important .	the patient helps my father 's dentist is important .
the adult thinks that your mother is wrong .	the adult works with your mother is wrong .
the driver thinks that my teacher is sleepy .	the driver scares my teacher is sleepy .
your friend knows that my wife 's grandmother 's dad is surprised .	your friend helps my wife 's grandmother 's dad is surprised .
the driver thinks that your doctor is surprised .	the driver works with your doctor is surprised .
Guy knows that my father is confused .	Guy scares my father is confused .
your friend knows that your daughter is upset .	your friend talks to your daughter is upset .
the customer says that my husband is kind .	the customer scares my husband is kind .
my friend says that your teacher 's dad is quiet .	my friend talks to your teacher 's dad is quiet .
Daniel says that my mother is sleepy .	Daniel scares my mother is sleepy .
your boss says that my dad is happy .	your boss works with my dad is happy .
the customer says that your dad is careful .	the customer works with your dad is careful .
the dancer knows that my sister 's sister 's boss is clever .	the dancer works with my sister 's sister 's boss is clever .
Stephanie thinks that your son is clever .	Stephanie helps your son is clever .
your friend thinks that your mom 's daughter 's cousin is smart .	your friend scares your mom 's daughter 's cousin is smart .
your friend knows that my boss 's friend is careful .	your friend helps my boss 's friend is careful .
Barbara says that my dad 's grandmother 's dentist is surprised .	Barbara helps my dad 's grandmother 's dentist is surprised .
Andrew knows that my boss is wrong .	Andrew talks to my boss is wrong .
Nancy thinks that your doctor 's doctor 's father is boring .	Nancy helps your doctor 's doctor 's father is boring .
the dancer thinks that my doctor 's brother 's father is young .	the dancer works with my doctor 's brother 's father is young .
your cousin knows that my brother is strong .	your cousin helps my brother is strong .
Peter thinks that your mother 's friend 's mother is boring .	Peter works with your mother 's friend 's mother is boring .
my dentist says that my brother 's dad is clever .	my dentist helps my brother 's dad is clever .
the dancer knows that my grandmother is clever .	the dancer helps my grandmother is clever .
my friend says that your teacher is tired .	my friend scares your teacher is tired .
my friend knows that my grandmother is bored .	my friend helps my grandmother is bored .
Donald says that your dad 's son is upset .	Donald scares your dad 's son is upset .
the driver knows that my mother is excited .	the driver talks to my mother is excited .
your teacher thinks that my boss 's grandmother is lucky .	your teacher scares my boss 's grandmother is lucky .
Aaron knows that your brother 's sister is smart .	Aaron scares your brother 's sister is smart .
your doctor says that my dentist is careful .	your doctor helps my dentist is careful .
Kevin knows that your brother 's boss is kind .	Kevin talks to your brother 's boss is kind .
the dancer says that my father 's cousin is important .	the dancer helps my father 's cousin is important .
the child thinks that your father is confused .	the child works with your father is confused .
the adult says that your dad 's teacher is healthy .	the adult helps your dad 's teacher is healthy .
Cindy knows that your mother is confused .	Cindy scares your mother is confused .
Bill thinks that my wife 's friend 's friend is quiet .	Bill talks to my wife 's friend 's friend is quiet .
the person knows that my friend is smart .	the person helps my friend is smart .
the dentist thinks that my boss is angry .	the dentist helps my boss is angry .
my teacher thinks that my dentist is busy .	my teacher works with my dentist is busy .
your doctor knows that your daughter is quiet .	your doctor scares your daughter is quiet .
your doctor says that my teacher 's dentist is friendly .	your doctor helps my teacher 's dentist is friendly .
Joseph says that your boss 's dentist is nice .	Joseph helps your boss 's dentist is nice .
the doctor knows that my teacher is surprised .	the doctor scares my teacher is surprised .
the doctor says that your mother 's daughter is careful .	the doctor scares your mother 's daughter is careful .
your boss thinks that my dad 's mom is angry .	your boss works with my dad 's mom is angry .
Paul thinks that your grandmother is confused .	Paul helps your grandmother is confused .
your dentist thinks that my friend 's dad 's father is sleepy .	your dentist helps my friend 's dad 's father is sleepy .
the child thinks that my dentist 's wife is happy .	the child scares my dentist 's wife is happy .
my friend says that my boss 's husband 's husband is helpful .	my friend works with my boss 's husband 's husband is helpful .
your teacher knows that your husband 's grandmother is sleepy .	your teacher talks to your husband 's grandmother is sleepy .
Robert knows that my mother 's dentist is careful .	Robert scares my mother 's dentist is careful .
Aaron says that your boss is quiet .	Aaron talks to your boss is quiet .
my teacher knows that my friend 's wife 's brother is healthy .	my teacher scares my friend 's wife 's brother is healthy .
the child says that your son is busy .	the child works with your son is busy .
Julie knows that my friend 's dentist 's boss is excited .	Julie works with my friend 's dentist 's boss is excited .
your friend says that my doctor is healthy .	your friend scares my doctor is healthy .
the teacher thinks that your husband 's mom 's teacher is helpful .	the teacher talks to your husband 's mom 's teacher is helpful .
the driver thinks that your mom is wrong .	the driver talks to your mom is wrong .
Jane says that your mother 's doctor is happy .	Jane scares your mother 's doctor is happy .
Rachel knows that your cousin 's boss 's brother is tired .	Rachel helps your cousin 's boss 's brother is tired .
the person thinks that your boss 's husband is kind .	the person talks to your boss 's husband is kind .
the teacher knows that your daughter 's brother 's mother is sleepy .	the teacher talks to your daughter 's brother 's mother is sleepy .
your cousin thinks that your sister 's teacher is lucky .	your cousin talks to your sister 's teacher is lucky .
my cousin thinks that my mother 's son is confused .	my cousin helps my mother 's son is confused .
your boss thinks that my dad 's wife is nice .	your boss works with my dad 's wife is nice .
my doctor knows that my husband is tall .	my doctor talks to my husband is tall .
your friend thinks that my cousin is happy .	your friend works with my cousin is happy .
Travis knows that your grandmother 's dad is friendly .	Travis scares your grandmother 's dad is friendly .
my friend says that your wife 's dentist 's mom is sleepy .	my friend works with your wife 's dentist 's mom is sleepy .
Nicole knows that my doctor 's father 's mom is tired .	Nicole scares my doctor 's father 's mom is tired .
the customer thinks that your dad 's grandmother 's son is lucky .	the customer talks to your dad 's grandmother 's son is lucky .
Kayla thinks that my grandmother 's wife is important .	Kayla works with my grandmother 's wife is important .
Donna knows that my brother 's mother is tired .	Donna talks to my brother 's mother is tired .
my dentist says that your dentist is happy .	my dentist scares your dentist is happy .
my boss thinks that your friend is strong .	my boss helps your friend is strong .
Jill thinks that my wife 's grandmother is happy .	Jill helps my wife 's grandmother is happy .
Judy thinks that my doctor 's husband is young .	Judy scares my doctor 's husband is young .
Dan knows that your mother 's dad is strong .	Dan works with your mother 's dad is strong .
Andrew thinks that your wife is friendly .	Andrew scares your wife is friendly .
Nicole thinks that your dentist 's daughter is tall .	Nicole scares your dentist 's daughter is tall .
my teacher knows that your grandmother is sleepy .	my teacher scares your grandmother is sleepy .
the dentist thinks that my brother is angry .	the dentist talks to my brother is angry .
the patient thinks that your dad 's mother 's mom is friendly .	the patient works with your dad 's mother 's mom is friendly .
the dentist thinks that my brother is bored .	the dentist scares my brother is bored .
your cousin says that my brother is boring .	your cousin helps my brother is boring .
the child thinks that your dentist 's boss is clever .	the child works with your dentist 's boss is clever .
Joseph knows that my dad is helpful .	Joseph helps my dad is helpful .
the dentist says that my mother 's sister 's boss is upset .	the dentist helps my mother 's sister 's boss is upset .
the child knows that my boss is friendly .	the child works with my boss is friendly .
the dancer says that my daughter 's daughter is young .	the dancer talks to my daughter 's daughter is young .
the driver says that my wife is surprised .	the driver works with my wife is surprised .
your cousin thinks that your father is wrong .	your cousin scares your father is wrong .
the dentist thinks that my friend 's husband 's dad is lucky .	the dentist works with my friend 's husband 's dad is lucky .
Kayla thinks that my cousin is busy .	Kayla works with my cousin is busy .
my friend knows that my father 's daughter 's brother is tall .	my friend scares my father 's daughter 's brother is tall .
the child says that my cousin 's brother 's wife is strong .	the child helps my cousin 's brother 's wife is strong .
my boss thinks that your friend 's teacher is strong .	my boss helps your friend 's teacher is strong .
the teacher knows that your friend is healthy .	the teacher talks to your friend is healthy .
your doctor says that my mother is smart .	your doctor helps my mother is smart .
Linda says that my dentist 's cousin 's husband is happy .	Linda scares my dentist 's cousin 's husband is happy .
my doctor thinks that your brother is happy .	my doctor talks to your brother is happy .
the dentist thinks that my friend 's doctor 's grandmother is tired .	the dentist works with my friend 's doctor 's grandmother is tired .
the dentist thinks that your friend 's friend 's mother is excited .	the dentist works with your friend 's friend 's mother is excited .
Denise knows that my brother 's brother 's sister is confused .	Denise scares my brother 's brother 's sister is confused .
the patient knows that your father 's mom is sleepy .	the patient scares your father 's mom is sleepy .
my doctor says that your husband 's mom is young .	my doctor works with your husband 's mom is young .
the dentist thinks that your mom is boring .	the dentist helps your mom is boring .
my teacher knows that my mother 's mother 's cousin is friendly .	my teacher talks to my mother 's mother 's cousin is friendly .
the driver thinks that your mother 's mom 's mom is angry .	the driver helps your mother 's mom 's mom is angry .
the patient knows that your doctor 's husband 's friend is gentle .	the patient helps your doctor 's husband 's friend is gentle .
Gregory knows that your friend 's sister 's mom is healthy .	Gregory talks to your friend 's sister 's mom is healthy .
the adult thinks that my cousin 's father is busy .	the adult helps my cousin 's father is busy .
my doctor knows that my sister is excited .	my doctor talks to my sister is excited .
Liam says that my dad is friendly .	Liam scares my dad is friendly .
Michelle knows that your grandmother is quiet .	Michelle scares your grandmother is quiet .
Erin thinks that my grandmother is healthy .	Erin talks to my grandmother is healthy .
your doctor knows that my friend 's boss 's brother is excited .	your doctor scares my friend 's boss 's brother is excited .
George knows that my father 's boss 's son is young .	George works with my father 's boss 's son is young .
the teacher says that your friend 's doctor is gentle .	the teacher scares your friend 's doctor is gentle .
Donna says that my cousin is angry .	Donna helps my cousin is angry .
the child says that your grandmother is hungry .	the child talks to your grandmother is hungry .
your cousin thinks that my doctor 's doctor is clever .	your cousin works with my doctor 's doctor is clever .
the driver knows that my dad is confused .	the driver works with my dad is confused .
your dentist knows that my cousin 's dad 's wife is curious .	your dentist scares my cousin 's dad 's wife is curious .
the driver knows that my teacher 's dentist 's brother is sleepy .	the driver works with my teacher 's dentist 's brother is sleepy .
Mark says that your wife 's father is lucky .	Mark helps your wife 's father is lucky .
your boss says that my boss 's mom 's mom is nice .	your boss works with my boss 's mom 's mom is nice .
Jason thinks that my daughter is important .	Jason helps my daughter is important .
the driver says that your dad 's teacher is happy .	the driver helps your dad 's teacher is happy .
Christopher knows that your son is clever .	Christopher helps your son is clever .
Becca thinks that my husband is boring .	Becca talks to my husband is boring .
the dentist knows that your son is strong .	the dentist talks to your son is strong .
Michelle thinks that your teacher is careful .	Michelle helps your teacher is careful .
my doctor thinks that your son 's son is healthy .	my doctor works with your son 's son is healthy .
my doctor thinks that my dad 's wife 's teacher is quiet .	my doctor talks to my dad 's wife 's teacher is quiet .
the child knows that your mom is friendly .	the child talks to your mom is friendly .
my doctor says that your father 's daughter 's boss is busy .	my doctor helps your father 's daughter 's boss is busy .
the adult thinks that your mother 's husband is angry .	the adult scares your mother 's husband is angry .
the adult knows that your boss 's friend 's brother is strong .	the adult helps your boss 's friend 's brother is strong .
the person thinks that my teacher is young .	the person talks to my teacher is young .
the teacher says that your dentist 's brother 's dentist is sleepy .	the teacher helps your dentist 's brother 's dentist is sleepy .
the customer thinks that my cousin is hungry .	the customer scares my cousin is hungry .
Peter thinks that my father 's daughter 's brother is friendly .	Peter talks to my father 's daughter 's brother is friendly .
the customer knows that my son 's dentist is busy .	the customer helps my son 's dentist is busy .
my friend says that your dentist is friendly .	my friend works with your dentist is friendly .
the adult knows that your husband 's cousin 's wife is upset .	the adult works with your husband 's cousin 's wife is upset .
your doctor says that your brother is clever .	your doctor works with your brother is clever .
your cousin knows that your doctor is happy .	your cousin helps your doctor is happy .
the teacher knows that my sister is bored .	the teacher works with my sister is bored .
the child says that my mother 's teacher is friendly .	the child works with my mother 's teacher is friendly .
my teacher thinks that your son 's dad is sleepy .	my teacher scares your son 's dad is sleepy .
Donna knows that your doctor 's cousin is quiet .	Donna works with your doctor 's cousin is quiet .
the doctor thinks that your cousin 's mother 's doctor is busy .	the doctor helps your cousin 's mother 's doctor is busy .
your teacher says that your husband is happy .	your teacher works with your husband is happy .
the doctor says that your dad 's dad is tall .	the doctor helps your dad 's dad is tall .
my dentist thinks that my dad 's grandmother 's brother is careful .	my dentist works with my dad 's grandmother 's brother is careful .
Jerry says that my husband is friendly .	Jerry works with my husband is friendly .
my dentist thinks that my sister is boring .	my dentist talks to my sister is boring .
Lisa says that my cousin 's friend 's dad is nice .	Lisa talks to my cousin 's friend 's dad is nice .
the adult says that your mother 's boss is surprised .	the adult works with your mother 's boss is surprised .
Jerry thinks that my cousin 's wife 's friend is boring .	Jerry talks to my cousin 's wife 's friend is boring .
Vanessa knows that your mother 's dad 's son is tired .	Vanessa scares your mother 's dad 's son is tired .
the customer thinks that your son 's boss 's dad is happy .	the customer works with your son 's boss 's dad is happy .
Eric thinks that your sister 's wife 's dad is busy .	Eric scares your sister 's wife 's dad is busy .
the customer thinks that my mother 's son is bored .	the customer helps my mother 's son is bored .
my teacher says that your husband 's cousin 's father is bored .	my teacher helps your husband 's cousin 's father is bored .
my dentist thinks that your wife 's daughter 's cousin is wrong .	my dentist scares your wife 's daughter 's cousin is wrong .
my doctor says that your husband 's wife is important .	my doctor talks to your husband 's wife is important .
the teacher says that my friend 's teacher 's grandmother is healthy .	the teacher works with my friend 's teacher 's grandmother is healthy .
Leslie knows that your sister 's boss is tall .	Leslie talks to your sister 's boss is tall .
Aaron says that my sister 's daughter 's mother is young .	Aaron talks to my sister 's daughter 's mother is young .
the customer says that my dentist 's brother is strong .	the customer talks to my dentist 's brother is strong .
the teacher thinks that my daughter is boring .	the teacher works with my daughter is boring .
William thinks that my friend 's dentist is friendly .	William helps my friend 's dentist is friendly .
the driver says that my grandmother is healthy .	the driver helps my grandmother is healthy .
the driver knows that your cousin 's son is quiet .	the driver helps your cousin 's son is quiet .
Nina knows that my wife 's boss is healthy .	Nina scares my wife 's boss is healthy .
my doctor knows that my son is confused .	my doctor helps my son is confused .
the patient thinks that your husband 's wife is curious .	the patient works with your husband 's wife is curious .
your friend thinks that your boss 's brother is bored .	your friend works with your boss 's brother is bored .
Deborah says that my cousin 's father is lucky .	Deborah works with my cousin 's father is lucky .
the doctor thinks that my doctor 's dentist is lucky .	the doctor helps my doctor 's dentist is lucky .
your boss thinks that your doctor 's father 's mom is happy .	your boss helps your doctor 's father 's mom is happy .
your friend thinks that your cousin is healthy .	your friend scares your cousin is healthy .
Sara says that your friend is nice .	Sara works with your friend is nice .
the dancer knows that my mother is clever .	the dancer talks to my mother is clever .
Kevin thinks that my son 's mom 's father is gentle .	Kevin scares my son 's mom 's father is gentle .
your doctor thinks that my father 's husband is angry .	your doctor talks to my father 's husband is angry .
the teacher knows that your mom 's daughter is important .	the teacher talks to your mom 's daughter is important .
your cousin says that your teacher is excited .	your cousin talks to your teacher is excited .
my cousin says that your wife 's boss 's grandmother is surprised .	my cousin talks to your wife 's boss 's grandmother is surprised .
Samantha says that my grandmother 's mother 's son is young .	Samantha helps my grandmother 's mother 's son is young .
the patient says that your father is busy .	the patient helps your father is busy .
my teacher thinks that my mom 's dentist is confused .	my teacher scares my mom 's dentist is confused .
my cousin says that your friend 's mom 's friend is friendly .	my cousin helps your friend 's mom 's friend is friendly .
the patient says that my mom 's doctor 's sister is smart .	the patient talks to my mom 's doctor 's sister is smart .
my boss knows that your sister 's mom 's cousin is angry .	my boss works with your sister 's mom 's cousin is angry .
the person says that your grandmother 's brother 's mom is angry .	the person helps your grandmother 's brother 's mom is angry .
the driver knows that your dad 's son 's grandmother is angry .	the driver works with your dad 's son 's grandmother is angry .
Cindy knows that your doctor 's daughter 's son is curious .	Cindy works with your doctor 's daughter 's son is curious .
your doctor knows that your grandmother is strong .	your doctor helps your grandmother is strong .
Steven thinks that your wife 's doctor 's doctor is excited .	Steven talks to your wife 's doctor 's doctor is excited .
the driver thinks that my daughter is healthy .	the driver helps my daughter is healthy .
Ronald says that your mom 's grandmother is sleepy .	Ronald scares your mom 's grandmother is sleepy .
Bill thinks that my mom 's brother is tall .	Bill works with my mom 's brother is tall .
the doctor thinks that your doctor is careful .	the doctor helps your doctor is careful .
my doctor knows that my daughter 's dentist 's mother is quiet .	my doctor works with my daughter 's dentist 's mother is quiet .
the person knows that my boss 's son is helpful .	the person works with my boss 's son is helpful .
your teacher knows that my cousin is helpful .	your teacher helps my cousin is helpful .
your teacher knows that your boss is smart .	your teacher talks to your boss is smart .
George knows that your grandmother 's husband is gentle .	George scares your grandmother 's husband is gentle .
the customer says that your daughter 's teacher is boring .	the customer scares your daughter 's teacher is boring .
Wendy says that my dentist is wrong .	Wendy works with my dentist is wrong .
the dancer thinks that my husband 's daughter is surprised .	the dancer talks to my husband 's daughter is surprised .
the patient knows that your mother 's boss is busy .	the patient helps your mother 's boss is busy .
the dentist thinks that my doctor is kind .	the dentist talks to my doctor is kind .
the doctor says that my grandmother 's daughter is helpful .	the doctor helps my grandmother 's daughter is helpful .
the doctor thinks that my dad 's son is young .	the doctor helps my dad 's son is young .
Deborah thinks that my son 's mom is clever .	Deborah helps my son 's mom is clever .
the adult says that your wife 's husband 's friend is confused .	the adult talks to your wife 's husband 's friend is confused .
the adult says that my boss 's father is busy .	the adult scares my boss 's father is busy .
the doctor says that my doctor 's dad 's grandmother is tall .	the doctor works with my doctor 's dad 's grandmother is tall .
Todd says that my father is angry .	Todd helps my father is angry .
Barbara says that my wife 's daughter 's cousin is excited .	Barbara helps my wife 's daughter 's cousin is excited .
the child knows that my brother 's dentist 's mom is angry .	the child helps my brother 's dentist 's mom is angry .
the adult knows that your grandmother is bored .	the adult talks to your grandmother is bored .
Catherine knows that my boss 's wife 's daughter is upset .	Catherine works with my boss 's wife 's daughter is upset .
the dentist says that my husband is gentle .	the dentist scares my husband is gentle .
the customer says that my mom 's friend 's doctor is wrong .	the customer helps my mom 's friend 's doctor is wrong .
my cousin knows that your teacher 's boss 's husband is excited .	my cousin talks to your teacher 's boss 's husband is excited .
the customer thinks that your teacher is boring .	the customer talks to your teacher is boring .
your dentist thinks that my mother 's dad is tired .	your dentist talks to my mother 's dad is tired .
my teacher thinks that your brother 's mother is strong .	my teacher talks to your brother 's mother is strong .
the patient thinks that your sister is excited .	the patient works with your sister is excited .
the teacher says that your grandmother 's dentist is kind .	the teacher scares your grandmother 's dentist is kind .
the child knows that your teacher 's dentist 's dentist is kind .	the child works with your teacher 's dentist 's dentist is kind .
my dentist thinks that my dentist 's teacher 's friend is tired .	my dentist works with my dentist 's teacher 's friend is tired .
Scott says that your dentist is tall .	Scott talks to your dentist is tall .
the person thinks that my brother is boring .	the person scares my brother is boring .
the person knows that your husband is bored .	the person talks to your husband is bored .
my doctor knows that my father is upset .	my doctor talks to my father is upset .
the dentist thinks that your son 's grandmother 's dentist is kind .	the dentist talks to your son 's grandmother 's dentist is kind .
the adult knows that your cousin 's brother is boring .	the adult works with your cousin 's brother is boring .
your boss knows that your husband is important .	your boss scares your husband is important .
your boss says that your father is nice .	your boss scares your father is nice .
my boss says that my friend 's doctor is wrong .	my boss scares my friend 's doctor is wrong .
my cousin thinks that my friend is tired .	my cousin helps my friend is tired .
the patient knows that your sister is wrong .	the patient talks to your sister is wrong .
your boss thinks that my boss 's son is surprised .	your boss works with my boss 's son is surprised .
my doctor thinks that my dad is surprised .	my doctor works with my dad is surprised .
my teacher thinks that your wife is confused .	my teacher helps your wife is confused .
William knows that your boss 's wife 's mother is sleepy .	William works with your boss 's wife 's mother is sleepy .
your dentist thinks that your dentist 's sister 's teacher is smart .	your dentist helps your dentist 's sister 's teacher is smart .
the customer says that your mother 's husband is smart .	the customer talks to your mother 's husband is smart .
Steve knows that my cousin 's father 's grandmother is important .	Steve talks to my cousin 's father 's grandmother is important .
my doctor knows that your husband 's brother 's husband is tired .	my doctor helps your husband 's brother 's husband is tired .
the patient knows that my wife 's friend is nice .	the patient works with my wife 's friend is nice .
my cousin knows that my son is smart .	my cousin scares my son is smart .
Martin thinks that my husband 's dad 's father is important .	Martin helps my husband 's dad 's father is important .
the adult knows that your dad is helpful .	the adult works with your dad is helpful .
my doctor knows that your daughter is healthy .	my doctor scares your daughter is healthy .
Ann knows that your cousin is lucky .	Ann scares your cousin is lucky .
your cousin thinks that my sister 's father is confused .	your cousin works with my sister 's father is confused .
Jerry knows that my dentist 's boss 's daughter is lucky .	Jerry talks to my dentist 's boss 's daughter is lucky .
Cindy knows that my mom 's boss is tall .	Cindy talks to my mom 's boss is tall .
Laurie knows that my cousin is gentle .	Laurie works with my cousin is gentle .
my boss thinks that my teacher 's boss 's mom is surprised .	my boss helps my teacher 's boss 's mom is surprised .
the dentist thinks that your son 's mother is busy .	the dentist helps your son 's mother is busy .
Gregory knows that my dentist 's mom is upset .	Gregory helps my dentist 's mom is upset .
the dentist knows that my dad 's mom 's father is strong .	the dentist works with my dad 's mom 's father is strong .
my cousin thinks that my mother 's boss 's doctor is tired .	my cousin talks to my mother 's boss 's doctor is tired .
Thomas says that your brother 's dentist is sleepy .	Thomas scares your brother 's dentist is sleepy .
the driver thinks that my sister 's doctor is excited .	the driver talks to my sister 's doctor is excited .
the adult says that your father is young .	the adult scares your father is young .
Deborah thinks that my boss is careful .	Deborah talks to my boss is careful .
my teacher knows that my son 's mom is busy .	my teacher scares my son 's mom is busy .
my doctor thinks that your doctor 's brother 's husband is excited .	my doctor helps your doctor 's brother 's husband is excited .
the patient thinks that your daughter 's mom is tired .	the patient works with your daughter 's mom is tired .
Thomas thinks that my grandmother is clever .	Thomas talks to my grandmother is clever .
my doctor thinks that your sister 's husband is quiet .	my doctor scares your sister 's husband is quiet .
Judy says that your mom 's father is tired .	Judy helps your mom 's father is tired .
the dentist says that my son is angry .	the dentist helps my son is angry .
Brian thinks that my husband is confused .	Brian works with my husband is confused .
my friend knows that your mom 's boss is upset .	my friend talks to your mom 's boss is upset .
the customer says that my father 's brother 's friend is friendly .	the customer helps my father 's brother 's friend is friendly .
the child thinks that your boss 's doctor is gentle .	the child works with your boss 's doctor is gentle .
Brian thinks that your son 's teacher 's mother is healthy .	Brian works with your son 's teacher 's mother is healthy .
the teacher thinks that my daughter 's brother 's daughter is surprised .	the teacher works with my daughter 's brother 's daughter is surprised .
your boss thinks that your cousin is sleepy .	your boss scares your cousin is sleepy .
the driver says that your dad is tired .	the driver talks to your dad is tired .
Michael knows that your husband is wrong .	Michael works with your husband is wrong .
the dentist knows that your doctor is gentle .	the dentist helps your doctor is gentle .
the customer thinks that my wife 's husband is upset .	the customer works with my wife 's husband is upset .
the child thinks that my doctor is hungry .	the child works with my doctor is hungry .
Samantha says that your father is happy .	Samantha helps your father is happy .
my doctor knows that your grandmother 's boss is lucky .	my doctor helps your grandmother 's boss is lucky .
the adult thinks that your boss 's brother 's father is boring .	the adult talks to your boss 's brother 's father is boring .
your cousin says that your daughter 's mother 's cousin is angry .	your cousin works with your daughter 's mother 's cousin is angry .
the dentist knows that your dentist 's mother 's dad is clever .	the dentist talks to your dentist 's mother 's dad is clever .
Mark knows that my son 's dad is excited .	Mark scares my son 's dad is excited .
the customer says that my dentist is kind .	the customer helps my dentist is kind .
Liam thinks that my teacher is curious .	Liam works with my teacher is curious .
the teacher knows that your father is hungry .	the teacher helps your father is hungry .
the dancer knows that my doctor is curious .	the dancer works with my doctor is curious .
the teacher knows that your boss is helpful .	the teacher scares your boss is helpful .
Gregory says that your cousin 's boss 's wife is curious .	Gregory talks to your cousin 's boss 's wife is curious .
the person knows that your teacher is bored .	the person helps your teacher is bored .
the dancer says that my father 's brother 's boss is hungry .	the dancer talks to my father 's brother 's boss is hungry .
your friend thinks that your grandmother 's husband 's cousin is helpful .	your friend helps your grandmother 's husband 's cousin is helpful .
the child knows that your dad is clever .	the child scares your dad is clever .
your teacher knows that my dentist 's sister 's mom is upset .	your teacher helps my dentist 's sister 's mom is upset .
Martin knows that your doctor 's teacher is friendly .	Martin talks to your doctor 's teacher is friendly .
Michael thinks that my cousin 's boss is quiet .	Michael works with my cousin 's boss is quiet .
Brian says that your doctor 's dad 's sister is smart .	Brian talks to your doctor 's dad 's sister is smart .
the adult knows that my dentist 's brother is quiet .	the adult works with my dentist 's brother is quiet .
Tracy thinks that my son 's husband is hungry .	Tracy works with my son 's husband is hungry .
Guy thinks that my dentist is hungry .	Guy works with my dentist is hungry .
your boss knows that my doctor 's dentist 's boss is surprised .	your boss works with my doctor 's dentist 's boss is surprised .
your boss thinks that my son is hungry .	your boss talks to my son is hungry .
your doctor thinks that your grandmother 's sister 's doctor is happy .	your doctor scares your grandmother 's sister 's doctor is happy .
the child says that your dentist 's husband is confused .	the child scares your dentist 's husband is confused .
my cousin knows that your brother is confused .	my cousin helps your brother is confused .
the person says that my husband 's brother is lucky .	the person helps my husband 's brother is lucky .
Kayla knows that my teacher 's husband is curious .	Kayla helps my teacher 's husband is curious .
the adult knows that my doctor is helpful .	the adult helps my doctor is helpful .
the driver says that my dentist 's brother is nice .	the driver scares my dentist 's brother is nice .
your doctor thinks that your mom 's teacher is friendly .	your doctor helps your mom 's teacher is friendly .
the driver thinks that my doctor 's boss 's husband is quiet .	the driver scares my doctor 's boss 's husband is quiet .
the doctor says that your brother is gentle .	the doctor works with your brother is gentle .
my friend thinks that my teacher 's mom is wrong .	my friend works with my teacher 's mom is wrong .
my teacher knows that your grandmother is tired .	my teacher helps your grandmother is tired .
Brian says that my husband 's sister is quiet .	Brian talks to my husband 's sister is quiet .
your cousin says that your husband is friendly .	your cousin scares your husband is friendly .
Alexander knows that your sister is kind .	Alexander scares your sister is kind .
my friend says that your grandmother is healthy .	my friend works with your grandmother is healthy .
the adult knows that your sister 's boss is curious .	the adult works with your sister 's boss is curious .
Deborah knows that your boss 's daughter 's dad is bored .	Deborah talks to your boss 's daughter 's dad is bored .
my friend thinks that your doctor is sleepy .	my friend talks to your doctor is sleepy .
my dentist thinks that your father is gentle .	my dentist works with your father is gentle .
the dentist thinks that my dad 's doctor is lucky .	the dentist helps my dad 's doctor is lucky .
the doctor thinks that my wife 's mom is hungry .	the doctor scares my wife 's mom is hungry .
the customer knows that your doctor 's doctor is healthy .	the customer talks to your doctor 's doctor is healthy .
Donald thinks that my teacher is strong .	Donald works with my teacher is strong .
Gregory thinks that my friend 's daughter 's mother is happy .	Gregory works with my friend 's daughter 's mother is happy .
the doctor knows that your sister 's son is sleepy .	the doctor helps your sister 's son is sleepy .
Peter knows that my dad 's daughter 's daughter is wrong .	Peter talks to my dad 's daughter 's daughter is wrong .
Sandra thinks that my friend is sleepy .	Sandra helps my friend is sleepy .
the doctor says that your brother is bored .	the doctor scares your brother is bored .
David knows that my sister 's wife 's daughter is strong .	David helps my sister 's wife 's daughter is strong .
the person thinks that your dentist 's mom 's husband is excited .	the person talks to your dentist 's mom 's husband is excited .
Daniel thinks that my friend 's mom 's dad is busy .	Daniel scares my friend 's mom 's dad is busy .
the patient thinks that your mother is confused .	the patient talks to your mother is confused .
Bill thinks that my daughter 's mom 's teacher is bored .	Bill helps my daughter 's mom 's teacher is bored .
Catherine knows that my teacher 's brother is important .	Catherine helps my teacher 's brother is important .
the driver thinks that your boss 's dad 's son is gentle .	the driver talks to your boss 's dad 's son is gentle .
the person thinks that my grandmother is busy .	the person helps my grandmother is busy .
Steve says that your teacher 's friend is confused .	Steve helps your teacher 's friend is confused .
your cousin thinks that my mom 's husband is lucky .	your cousin talks to my mom 's husband is lucky .
Thomas says that your sister 's father 's father is strong .	Thomas scares your sister 's father 's father is strong .
Paul knows that my wife 's father is quiet .	Paul helps my wife 's father is quiet .
your boss thinks that your brother 's mom is sleepy .	your boss talks to your brother 's mom is sleepy .
your boss knows that my husband 's dentist is sleepy .	your boss helps my husband 's dentist is sleepy .
Amy knows that your dentist is busy .	Amy talks to your dentist is busy .
George knows that my son is clever .	George scares my son is clever .
Sarah knows that my cousin 's mom is curious .	Sarah talks to my cousin 's mom is curious .
my cousin says that your mom 's wife is tall .	my cousin talks to your mom 's wife is tall .
your dentist knows that my boss 's friend 's dentist is nice .	your dentist helps my boss 's friend 's dentist is nice .
the driver says that my teacher 's wife is wrong .	the driver scares my teacher 's wife is wrong .
the patient knows that my daughter is tall .	the patient talks to my daughter is tall .
my boss knows that my son is kind .	my boss scares my son is kind .
the customer says that my cousin 's brother 's husband is helpful .	the customer talks to my cousin 's brother 's husband is helpful .
Tracy says that my boss 's doctor 's sister is bored .	Tracy talks to my boss 's doctor 's sister is bored .
the teacher knows that your grandmother 's daughter 's boss is clever .	the teacher helps your grandmother 's daughter 's boss is clever .
your cousin says that my daughter 's daughter 's boss is helpful .	your cousin talks to my daughter 's daughter 's boss is helpful .
the child says that my mother 's husband 's grandmother is happy .	the child talks to my mother 's husband 's grandmother is happy .
the dancer says that my father is angry .	the dancer works with my father is angry .
the person says that your mother 's boss is upset .	the person talks to your mother 's boss is upset .
the dancer knows that your friend 's daughter 's father is lucky .	the dancer works with your friend 's daughter 's father is lucky .
Eric knows that your doctor 's teacher 's wife is clever .	Eric talks to your doctor 's teacher 's wife is clever .
my boss knows that my doctor 's doctor 's husband is wrong .	my boss scares my doctor 's doctor 's husband is wrong .
the dentist knows that my friend is tired .	the dentist helps my friend is tired .
the child says that your wife 's teacher is bored .	the child works with your wife 's teacher is bored .
Catherine says that your teacher 's mother is hungry .	Catherine talks to your teacher 's mother is hungry .
the dancer thinks that your doctor 's friend is busy .	the dancer helps your doctor 's friend is busy .
Timothy says that my wife 's husband 's teacher is young .	Timothy helps my wife 's husband 's teacher is young .
the doctor knows that my mom 's grandmother is quiet .	the doctor helps my mom 's grandmother is quiet .
Karen thinks that my doctor is strong .	Karen talks to my doctor is strong .
the child thinks that my son 's husband 's dentist is healthy .	the child scares my son 's husband 's dentist is healthy .
Rebecca thinks that my mother is young .	Rebecca helps my mother is young .
your doctor says that your dentist is busy .	your doctor helps your dentist is busy .
Gregory thinks that your mother 's teacher 's grandmother is tall .	Gregory talks to your mother 's teacher 's grandmother is tall .
the doctor thinks that your dad 's grandmother 's cousin is sleepy .	the doctor works with your dad 's grandmother 's cousin is sleepy .
my friend knows that my boss is tall .	my friend scares my boss is tall .
the teacher knows that your boss 's grandmother is wrong .	the teacher talks to your boss 's grandmother is wrong .
your boss says that my dentist 's husband 's brother is strong .	your boss talks to my dentist 's husband 's brother is strong .
my doctor knows that my doctor is friendly .	my doctor scares my doctor is friendly .
Rebecca knows that my cousin 's mother 's cousin is boring .	Rebecca works with my cousin 's mother 's cousin is boring .
the dancer says that your boss is tall .	the dancer works with your boss is tall .
Andrew knows that my dentist is wrong .	Andrew talks to my dentist is wrong .
the dentist thinks that my doctor 's doctor 's cousin is surprised .	the dentist scares my doctor 's doctor 's cousin is surprised .
my teacher knows that your husband is smart .	my teacher talks to your husband is smart .
