the doctor who has cleaned the toys had n't ever waved .	the doctor who has n't cleaned the toys had ever waved .
those teachers who had noticed those ladies do n't ever have the books .	those teachers who had n't noticed those ladies do ever have the books .
this shoe that that cat has thought about had n't ever moved .	this shoe that that cat has n't thought about had ever moved .
these women that had heard those turtles have n't ever noticed those mice .	these women that had n't heard those turtles have ever noticed those mice .
those horses that the women have heard have n't ever seen that mirror .	those horses that the women have n't heard have ever seen that mirror .
this person who had thought about those shirts can n't ever sound like the ladies .	this person who had n't thought about those shirts can ever sound like the ladies .
the person who had heard those teachers did n't ever answer this person .	the person who had n't heard those teachers did ever answer this person .
that adult who would look like those horses had n't ever thrown that bag .	that adult who would n't look like those horses had ever thrown that bag .
the person who should clean that picture would n't ever lift the shoe .	the person who should n't clean that picture would ever lift the shoe .
this dentist who can laugh can n't ever sing .	this dentist who can n't laugh can ever sing .
these people that have grown did n't ever run .	these people that have n't grown did ever run .
this car that the person does love has n't ever rolled away .	this car that the person does n't love has ever rolled away .
these horses that have thought about these boxes had n't ever seen these glasses .	these horses that have n't thought about these boxes had ever seen these glasses .
the patient who can notice the customer could n't ever scare that driver .	the patient who can n't notice the customer could ever scare that driver .
this door that this girl does steal did n't ever roll away .	this door that this girl does n't steal did ever roll away .
that person who did forget that dentist had n't ever moved the chair .	that person who did n't forget that dentist had ever moved the chair .
this doctor who could move the chairs has n't ever confused that person .	this doctor who could n't move the chairs has ever confused that person .
these children who did talk about that plate could n't ever walk through those schools .	these children who did n't talk about that plate could ever walk through those schools .
that adult who could drive to these schools can n't ever answer that girl .	that adult who could n't drive to these schools can ever answer that girl .
the men that could know this guy had n't ever eaten .	the men that could n't know this guy had ever eaten .
that man who the dancer has heard had n't ever won .	that man who the dancer has n't heard had ever won .
this doll that the girl can talk about does n't ever break the bags .	this doll that the girl can n't talk about does ever break the bags .
this customer who would exercise did n't ever teach the woman .	this customer who would n't exercise did ever teach the woman .
that patient who did clean the candle has n't ever talked to the customer .	that patient who did n't clean the candle has ever talked to the customer .
these books that had dropped do n't ever drop .	these books that had n't dropped do ever drop .
the men who can sound like this man could n't ever sneeze .	the men who can n't sound like this man could ever sneeze .
that boy who does lose this cup has n't ever cried .	that boy who does n't lose this cup has ever cried .
this patient who did remember this book should n't ever wave .	this patient who did n't remember this book should ever wave .
the fork that this dog should like had n't ever broken those trucks .	the fork that this dog should n't like had ever broken those trucks .
this book that this boy could see has n't ever dropped .	this book that this boy could n't see has ever dropped .
the girl who has dropped the pictures has n't ever won .	the girl who has n't dropped the pictures has ever won .
the patient who would throw the books can n't ever laugh .	the patient who would n't throw the books can ever laugh .
that driver that this patient has heard had n't ever grown .	that driver that this patient has n't heard had ever grown .
that adult who this dentist has heard had n't ever held that rocket .	that adult who this dentist has n't heard had ever held that rocket .
those people that could know this rabbit had n't ever run .	those people that could n't know this rabbit had ever run .
the driver who had talked about this car would n't ever have the ship .	the driver who had n't talked about this car would ever have the ship .
this person who had remembered the boxes did n't ever return to these schools .	this person who had n't remembered the boxes did ever return to these schools .
this box that had dropped has n't ever rolled away .	this box that had n't dropped has ever rolled away .
the dancer who had laughed has n't ever moved the trucks .	the dancer who had n't laughed has ever moved the trucks .
these children who can shake that fork could n't ever pass the museum .	these children who can n't shake that fork could ever pass the museum .
those snakes that those guys would talk about do n't ever remember the dog .	those snakes that those guys would n't talk about do ever remember the dog .
these girls who had fixed the candle had n't ever worked with this lady .	these girls who had n't fixed the candle had ever worked with this lady .
this queen who would know that rabbit should n't ever hear that girl .	this queen who would n't know that rabbit should ever hear that girl .
the doctors who could sneeze have n't ever painted .	the doctors who could n't sneeze have ever painted .
that customer that should forget this mirror could n't ever learn .	that customer that should n't forget this mirror could ever learn .
those children who did lose these forks have n't ever scared these doctors .	those children who did n't lose these forks have ever scared these doctors .
those people who did go to that kitchen can n't ever steal these plates .	those people who did n't go to that kitchen can ever steal these plates .
these horses that would look like that person had n't ever eaten .	these horses that would n't look like that person had ever eaten .
these boys who should whisper can n't ever bother these guys .	these boys who should n't whisper can ever bother these guys .
that woman who had talked has n't ever moved this ring .	that woman who had n't talked has ever moved this ring .
the child who did hate these shoes could n't ever make the windows .	the child who did n't hate these shoes could ever make the windows .
the toy that that hamster had seen has n't ever dropped .	the toy that that hamster had n't seen has ever dropped .
those ladies who have noticed that shirt do n't ever scare those doctors .	those ladies who have n't noticed that shirt do ever scare those doctors .
this dentist that that adult has heard has n't ever learned .	this dentist that that adult has n't heard has ever learned .
that dish that the man would talk about has n't ever broken the forks .	that dish that the man would n't talk about has ever broken the forks .
the guy who this woman can sound like should n't ever praise the dentist .	the guy who this woman can n't sound like should ever praise the dentist .
the bottle that has dropped has n't ever dropped .	the bottle that has n't dropped has ever dropped .
the spoon that this bird can notice did n't ever break .	the spoon that this bird can n't notice did ever break .
that king that the guy has seen has n't ever broken the candles .	that king that the guy has n't seen has ever broken the candles .
the doctor who had noticed these pictures has n't ever talked to this boy .	the doctor who had n't noticed these pictures has ever talked to this boy .
the dolls that had dropped had n't ever broken .	the dolls that had n't dropped had ever broken .
the driver that the lady could talk about could n't ever notice the ladies .	the driver that the lady could n't talk about could ever notice the ladies .
this dancer who could talk about those doctors has n't ever lost those dolls .	this dancer who could n't talk about those doctors has ever lost those dolls .
that rocket that has dropped can n't ever drop .	that rocket that has n't dropped can ever drop .
this picture that this child had found had n't ever broken .	this picture that this child had n't found had ever broken .
this person who does cry did n't ever visit the boy .	this person who does n't cry did ever visit the boy .
those doctors who have bought that box have n't ever answered that man .	those doctors who have n't bought that box have ever answered that man .
that dentist who did talk about the spoon had n't ever answered these women .	that dentist who did n't talk about the spoon had ever answered these women .
the teacher that would think about this mirror has n't ever remembered the bed .	the teacher that would n't think about this mirror has ever remembered the bed .
that doctor who had made the books should n't ever teach the dentist .	that doctor who had n't made the books should ever teach the dentist .
this dentist that this guy did look like could n't ever grow .	this dentist that this guy did n't look like could ever grow .
this guy who should bring that button has n't ever held the candle .	this guy who should n't bring that button has ever held the candle .
this bowl that the customer had noticed did n't ever break the rocket .	this bowl that the customer had n't noticed did ever break the rocket .
this adult who had left the school could n't ever visit those children .	this adult who had n't left the school could ever visit those children .
that guy who had thrown the book had n't ever brought the books .	that guy who had n't thrown the book had ever brought the books .
these people who should talk about the teachers have n't ever laughed .	these people who should n't talk about the teachers have ever laughed .
the cat that this customer has remembered has n't ever broken those plates .	the cat that this customer has n't remembered has ever broken those plates .
those people who those children can talk about could n't ever read .	those people who those children can n't talk about could ever read .
those ladies who had thrown those cars did n't ever lose .	those ladies who had n't thrown those cars did ever lose .
that girl that had seen those birds had n't ever seen these rabbits .	that girl that had n't seen those birds had ever seen these rabbits .
this person that should run had n't ever thought about that dish .	this person that should n't run had ever thought about that dish .
that dancer that would learn did n't ever grow .	that dancer that would n't learn did ever grow .
the lady who the woman could look like should n't ever throw the truck .	the lady who the woman could n't look like should ever throw the truck .
those men who did talk have n't ever worked with that doctor .	those men who did n't talk have ever worked with that doctor .
this dentist who this girl does hear should n't ever drop the boat .	this dentist who this girl does n't hear should ever drop the boat .
the person who has thought about this book has n't ever worked with the king .	the person who has n't thought about this book has ever worked with the king .
the glass that that driver can forget had n't ever broken .	the glass that that driver can n't forget had ever broken .
this adult that that dancer has talked about had n't ever run .	this adult that that dancer has n't talked about had ever run .
this spoon that the horse had thought about had n't ever moved .	this spoon that the horse had n't thought about had ever moved .
these dogs that these mice have noticed had n't ever broken the trucks .	these dogs that these mice have n't noticed had ever broken the trucks .
that patient who had waved has n't ever cried .	that patient who had n't waved has ever cried .
those doctors that have run do n't ever like those mice .	those doctors that have n't run do ever like those mice .
this patient who has walked through the room has n't ever yelled .	this patient who has n't walked through the room has ever yelled .
the men who should run around these rooms do n't ever take this chair .	the men who should n't run around these rooms do ever take this chair .
that woman who had talked about that mouse had n't ever talked about the turtle .	that woman who had n't talked about that mouse had ever talked about the turtle .
the queen who did forget the teacher could n't ever have those pictures .	the queen who did n't forget the teacher could ever have those pictures .
this cat that that queen did know did n't ever notice this spoon .	this cat that that queen did n't know did ever notice this spoon .
these men who should like the glass did n't ever yell .	these men who should n't like the glass did ever yell .
that dentist who has noticed that picture has n't ever worried the women .	that dentist who has n't noticed that picture has ever worried the women .
the guys who could think about that person have n't ever confused the king .	the guys who could n't think about that person have ever confused the king .
the doctor who could sneeze did n't ever teach the king .	the doctor who could n't sneeze did ever teach the king .
these rabbits that can see these pictures have n't ever thought about this customer .	these rabbits that can n't see these pictures have ever thought about this customer .
that hamster that does remember these boats would n't ever run .	that hamster that does n't remember these boats would ever run .
the customer who should cry has n't ever bought this glass .	the customer who should n't cry has ever bought this glass .
that dancer who this king has talked about has n't ever held the fork .	that dancer who this king has n't talked about has ever held the fork .
that king who should notice the girls had n't ever brought these rings .	that king who should n't notice the girls had ever brought these rings .
that child who this adult can look like could n't ever pass that mall .	that child who this adult can n't look like could ever pass that mall .
this customer who can hear the dogs has n't ever talked to these teachers .	this customer who can n't hear the dogs has ever talked to these teachers .
these birds that have learned had n't ever seen this teacher .	these birds that have n't learned had ever seen this teacher .
those girls that would hate this dog have n't ever learned .	those girls that would n't hate this dog have ever learned .
these bottles that the guys have bought could n't ever break .	these bottles that the guys have n't bought could ever break .
this man who did see the bottles did n't ever return to those rooms .	this man who did n't see the bottles did ever return to those rooms .
these girls that have grown could n't ever see the horses .	these girls that have n't grown could ever see the horses .
those ladies who had noticed those bags can n't ever read .	those ladies who had n't noticed those bags can ever read .
those pictures that should roll away could n't ever drop .	those pictures that should n't roll away could ever drop .
that king that can hear that turtle did n't ever remember those teachers .	that king that can n't hear that turtle did ever remember those teachers .
these guys who had talked about the turtle do n't ever care for this boy .	these guys who had n't talked about the turtle do ever care for this boy .
the woman who this child had heard had n't ever thrown the bowl .	the woman who this child had n't heard had ever thrown the bowl .
that hamster that has grown should n't ever forget the shirt .	that hamster that has n't grown should ever forget the shirt .
that lady who does forget these children has n't ever passed this mall .	that lady who does n't forget these children has ever passed this mall .
this doll that that queen would keep has n't ever broken .	this doll that that queen would n't keep has ever broken .
the dog that had grown had n't ever thought about those buttons .	the dog that had n't grown had ever thought about those buttons .
these cats that the children could hear have n't ever learned .	these cats that the children could n't hear have ever learned .
those boys who can wave would n't ever exercise .	those boys who can n't wave would ever exercise .
that child who has thought about that mirror has n't ever talked about the cars .	that child who has n't thought about that mirror has ever talked about the cars .
this couch that the customer can remember has n't ever broken this button .	this couch that the customer can n't remember has ever broken this button .
the man who this boy did sound like should n't ever hold that fork .	the man who this boy did n't sound like should ever hold that fork .
this bed that has dropped had n't ever dropped .	this bed that has n't dropped had ever dropped .
the ladies who had fixed those cars could n't ever appreciate these men .	the ladies who had n't fixed those cars could ever appreciate these men .
that cat that had noticed the teachers can n't ever eat .	that cat that had n't noticed the teachers can ever eat .
that queen who this customer could talk about had n't ever moved this bed .	that queen who this customer could n't talk about had ever moved this bed .
that adult that that child has talked about has n't ever run .	that adult that that child has n't talked about has ever run .
this picture that the lady should keep did n't ever drop .	this picture that the lady should n't keep did ever drop .
the dancer who did cry would n't ever bring this candle .	the dancer who did n't cry would ever bring this candle .
the horse that would sound like this dancer had n't ever noticed the window .	the horse that would n't sound like this dancer had ever noticed the window .
the lady who could look like those cats can n't ever scare these boys .	the lady who could n't look like those cats can ever scare these boys .
those ladies that these ladies can talk about had n't ever broken these glasses .	those ladies that these ladies can n't talk about had ever broken these glasses .
those doctors who had thrown those cars had n't ever lost those girls .	those doctors who had n't thrown those cars had ever lost those girls .
this dentist that has grown has n't ever run .	this dentist that has n't grown has ever run .
the dogs that have thought about these mice have n't ever thought about the toys .	the dogs that have n't thought about these mice have ever thought about the toys .
this girl who has waved has n't ever found this boy .	this girl who has n't waved has ever found this boy .
these books that the turtles had thought about had n't ever dropped .	these books that the turtles had n't thought about had ever dropped .
the dentist who has laughed had n't ever heard these children .	the dentist who has n't laughed had ever heard these children .
that bag that has broken can n't ever roll away .	that bag that has n't broken can ever roll away .
the man that would notice these spoons can n't ever run .	the man that would n't notice these spoons can ever run .
this ring that the man should forget had n't ever moved .	this ring that the man should n't forget had ever moved .
these women who had noticed this doctor had n't ever cleaned that plate .	these women who had n't noticed this doctor had ever cleaned that plate .
that patient that had heard that patient has n't ever eaten .	that patient that had n't heard that patient has ever eaten .
that boy that that dentist would look like could n't ever eat .	that boy that that dentist would n't look like could ever eat .
the doctor who should wave has n't ever painted .	the doctor who should n't wave has ever painted .
these dogs that could eat can n't ever learn .	these dogs that could n't eat can ever learn .
this bird that the guy had talked about had n't ever thought about the mice .	this bird that the guy had n't talked about had ever thought about the mice .
that king who did leave the museum has n't ever painted .	that king who did n't leave the museum has ever painted .
that dog that does think about that shoe does n't ever love that picture .	that dog that does n't think about that shoe does ever love that picture .
that dentist that the adult could sound like does n't ever run .	that dentist that the adult could n't sound like does ever run .
the cats that do learn would n't ever learn .	the cats that do n't learn would ever learn .
this customer who has held this bag would n't ever care for the women .	this customer who has n't held this bag would ever care for the women .
this boat that the bird has noticed had n't ever rolled away .	this boat that the bird has n't noticed had ever rolled away .
this plate that has rolled away would n't ever roll away .	this plate that has n't rolled away would ever roll away .
that dish that could drop has n't ever moved .	that dish that could n't drop has ever moved .
the boy who would talk about that plate does n't ever whisper .	the boy who would n't talk about that plate does ever whisper .
these girls who could throw those doors have n't ever bought this rocket .	these girls who could n't throw those doors have ever bought this rocket .
the child who could notice the chair has n't ever painted .	the child who could n't notice the chair has ever painted .
this mouse that the woman had heard should n't ever like this doll .	this mouse that the woman had n't heard should ever like this doll .
the boy who had thrown that candle has n't ever yelled .	the boy who had n't thrown that candle has ever yelled .
this doll that would move can n't ever roll away .	this doll that would n't move can ever roll away .
the boys who had talked about the spoon had n't ever passed these rooms .	the boys who had n't talked about the spoon had ever passed these rooms .
the dancer that that teacher can sound like has n't ever eaten .	the dancer that that teacher can n't sound like has ever eaten .
those snakes that the children have seen have n't ever broken these rings .	those snakes that the children have n't seen have ever broken these rings .
the patient that did love those turtles did n't ever forget the books .	the patient that did n't love those turtles did ever forget the books .
the women who can drop those dishes have n't ever lost this hat .	the women who can n't drop those dishes have ever lost this hat .
the cup that the man has bought did n't ever move .	the cup that the man has n't bought did ever move .
this guy who has taken the boxes had n't ever taught that woman .	this guy who has n't taken the boxes had ever taught that woman .
this dancer who has remembered those women can n't ever work with the king .	this dancer who has n't remembered those women can ever work with the king .
the window that this king had remembered has n't ever broken .	the window that this king had n't remembered has ever broken .
the boys who the teachers have talked about have n't ever lost the people .	the boys who the teachers have n't talked about have ever lost the people .
that adult that did notice the women has n't ever thought about these books .	that adult that did n't notice the women has ever thought about these books .
these trucks that those men do see do n't ever break this dish .	these trucks that those men do n't see do ever break this dish .
the doctors who do see the truck had n't ever walked through the park .	the doctors who do n't see the truck had ever walked through the park .
the guy that did run had n't ever seen the turtle .	the guy that did n't run had ever seen the turtle .
the customer who had fixed these boxes had n't ever lost .	the customer who had n't fixed these boxes had ever lost .
the boy who does talk does n't ever wave .	the boy who does n't talk does ever wave .
those women who do sound like the boys did n't ever sing .	those women who do n't sound like the boys did ever sing .
these horses that can grow could n't ever grow .	these horses that can n't grow could ever grow .
this bird that has thought about these trucks had n't ever learned .	this bird that has n't thought about these trucks had ever learned .
this driver who had thought about the plate does n't ever leave that library .	this driver who had n't thought about the plate does ever leave that library .
those people who can drop this spoon have n't ever read .	those people who can n't drop this spoon have ever read .
these ladies that have remembered that ring do n't ever eat .	these ladies that have n't remembered that ring do ever eat .
those pictures that have dropped should n't ever move .	those pictures that have n't dropped should ever move .
this customer who should hold these pictures had n't ever taken that shoe .	this customer who should n't hold these pictures had ever taken that shoe .
the men who had talked about this chair had n't ever moved that bowl .	the men who had n't talked about this chair had ever moved that bowl .
the boat that this boy should have has n't ever moved .	the boat that this boy should n't have has ever moved .
the people who would clean the door have n't ever heard these turtles .	the people who would n't clean the door have ever heard these turtles .
this ship that could drop would n't ever roll away .	this ship that could n't drop would ever roll away .
this dancer who should hear those people would n't ever talk to these teachers .	this dancer who should n't hear those people would ever talk to these teachers .
this boy that did run had n't ever eaten .	this boy that did n't run had ever eaten .
the patient that that cat would think about has n't ever broken these books .	the patient that that cat would n't think about has ever broken these books .
that dancer who the woman can talk about could n't ever whisper .	that dancer who the woman can n't talk about could ever whisper .
the person who has heard that person should n't ever praise this driver .	the person who has n't heard that person should ever praise this driver .
this box that that teacher has talked about did n't ever roll away .	this box that that teacher has n't talked about did ever roll away .
those women who did paint should n't ever throw these bottles .	those women who did n't paint should ever throw these bottles .
this patient that had heard this guy has n't ever seen the cat .	this patient that had n't heard this guy has ever seen the cat .
that adult who should remember these birds has n't ever painted .	that adult who should n't remember these birds has ever painted .
these girls who should take those boats could n't ever sell this fork .	these girls who should n't take those boats could ever sell this fork .
this driver who has remembered that candle would n't ever whisper .	this driver who has n't remembered that candle would ever whisper .
that guy who this dentist should sound like can n't ever drive to the park .	that guy who this dentist should n't sound like can ever drive to the park .
those children who have painted had n't ever bought these books .	those children who have n't painted had ever bought these books .
these forks that have dropped have n't ever broken .	these forks that have n't dropped have ever broken .
the dish that has dropped can n't ever break .	the dish that has n't dropped can ever break .
the guys who should think about those shirts should n't ever smile .	the guys who should n't think about those shirts should ever smile .
that lady who would forget this dish should n't ever read .	that lady who would n't forget this dish should ever read .
that king who this adult could sound like had n't ever visited that queen .	that king who this adult could n't sound like had ever visited that queen .
these boys that had heard these people can n't ever eat .	these boys that had n't heard these people can ever eat .
these men who could look like those boys have n't ever cried .	these men who could n't look like those boys have ever cried .
the patient who can run around these schools could n't ever whisper .	the patient who can n't run around these schools could ever whisper .
the adult that had eaten has n't ever thought about these bowls .	the adult that had n't eaten has ever thought about these bowls .
that queen that that dog had remembered does n't ever break this hat .	that queen that that dog had n't remembered does ever break this hat .
this adult that that person has talked about would n't ever run .	this adult that that person has n't talked about would ever run .
this queen who has gone to this library could n't ever whisper .	this queen who has n't gone to this library could ever whisper .
the man who had seen those trucks can n't ever take those bottles .	the man who had n't seen those trucks can ever take those bottles .
this man who should throw that doll would n't ever cough .	this man who should n't throw that doll would ever cough .
the hamster that would eat could n't ever grow .	the hamster that would n't eat could ever grow .
the lady who had taken this picture should n't ever move this window .	the lady who had n't taken this picture should ever move this window .
that child who can run around this kitchen did n't ever drop the mirror .	that child who can n't run around this kitchen did ever drop the mirror .
those girls who could hear that horse should n't ever practice .	those girls who could n't hear that horse should ever practice .
those women who the doctors should know do n't ever scream .	those women who the doctors should n't know do ever scream .
the queen that this lady would talk about has n't ever eaten .	the queen that this lady would n't talk about has ever eaten .
the mirror that that driver has remembered has n't ever rolled away .	the mirror that that driver has n't remembered has ever rolled away .
those doctors who do forget that plane had n't ever kept the mirror .	those doctors who do n't forget that plane had ever kept the mirror .
this child who this doctor had talked about could n't ever understand the person .	this child who this doctor had n't talked about could ever understand the person .
that person who should look like that guy has n't ever taught those women .	that person who should n't look like that guy has ever taught those women .
those people who could lie have n't ever heard those teachers .	those people who could n't lie have ever heard those teachers .
these men who can pass that mall would n't ever appreciate those boys .	these men who can n't pass that mall would ever appreciate those boys .
that fork that this doctor had noticed has n't ever dropped .	that fork that this doctor had n't noticed has ever dropped .
this woman who did forget those bags did n't ever whisper .	this woman who did n't forget those bags did ever whisper .
these girls who could like the car had n't ever found the doors .	these girls who could n't like the car had ever found the doors .
this window that had broken had n't ever broken .	this window that had n't broken had ever broken .
this lady who had cleaned these candles does n't ever pass this park .	this lady who had n't cleaned these candles does ever pass this park .
those doctors who can read have n't ever helped this dancer .	those doctors who can n't read have ever helped this dancer .
those birds that these children have heard had n't ever grown .	those birds that these children have n't heard had ever grown .
the customer who can remember these toys had n't ever made the box .	the customer who can n't remember these toys had ever made the box .
the doctor who the driver had talked about did n't ever praise this dentist .	the doctor who the driver had n't talked about did ever praise this dentist .
that girl that had seen the bags would n't ever learn .	that girl that had n't seen the bags would ever learn .
the teacher who would hear the guy did n't ever have those forks .	the teacher who would n't hear the guy did ever have those forks .
this glass that that dentist should talk about can n't ever break that glass .	this glass that that dentist should n't talk about can ever break that glass .
this guy that should like this turtle has n't ever seen that plane .	this guy that should n't like this turtle has ever seen that plane .
the children who can laugh can n't ever hear the people .	the children who can n't laugh can ever hear the people .
the customer who can go to the restaurant has n't ever passed that school .	the customer who can n't go to the restaurant has ever passed that school .
these bowls that these boys should like have n't ever broken that book .	these bowls that these boys should n't like have ever broken that book .
the king who has lost these buttons could n't ever exercise .	the king who has n't lost these buttons could ever exercise .
this doctor who the doctor can talk about should n't ever steal those crayons .	this doctor who the doctor can n't talk about should ever steal those crayons .
the mouse that has run had n't ever run .	the mouse that has n't run had ever run .
this person that had noticed these snakes should n't ever think about those crayons .	this person that had n't noticed these snakes should ever think about those crayons .
the queen that has remembered that doctor has n't ever remembered the people .	the queen that has n't remembered that doctor has ever remembered the people .
these men who the guys could hear did n't ever clean this spoon .	these men who the guys could n't hear did ever clean this spoon .
the teacher who the woman had heard did n't ever pass these rooms .	the teacher who the woman had n't heard did ever pass these rooms .
the plate that that person can bring has n't ever rolled away .	the plate that that person can n't bring has ever rolled away .
those doctors who should pass the museum do n't ever talk about the birds .	those doctors who should n't pass the museum do ever talk about the birds .
the horses that have run had n't ever noticed this dentist .	the horses that have n't run had ever noticed this dentist .
this mirror that the boy has fixed would n't ever roll away .	this mirror that the boy has n't fixed would ever roll away .
that cat that this man had talked about could n't ever think about the rabbits .	that cat that this man had n't talked about could ever think about the rabbits .
that child who has thought about that shirt has n't ever found the bottle .	that child who has n't thought about that shirt has ever found the bottle .
those girls who should talk about the book should n't ever move this spoon .	those girls who should n't talk about the book should ever move this spoon .
this dentist that should think about those cats had n't ever seen those boats .	this dentist that should n't think about those cats had ever seen those boats .
that lady that does learn can n't ever learn .	that lady that does n't learn can ever learn .
that customer that this dancer should sound like had n't ever noticed this doctor .	that customer that this dancer should n't sound like had ever noticed this doctor .
these forks that these teachers did take had n't ever dropped .	these forks that these teachers did n't take had ever dropped .
the dishes that do move had n't ever moved .	the dishes that do n't move had ever moved .
that adult who that boy could know should n't ever shake the bottles .	that adult who that boy could n't know should ever shake the bottles .
the children who do think about the shoe should n't ever care for the guy .	the children who do n't think about the shoe should ever care for the guy .
the dancer who had brought those plates does n't ever care for the men .	the dancer who had n't brought those plates does ever care for the men .
these toys that have moved have n't ever rolled away .	these toys that have n't moved have ever rolled away .
the boy who the teacher has heard has n't ever cried .	the boy who the teacher has n't heard has ever cried .
these children that could grow have n't ever learned .	these children that could n't grow have ever learned .
these men who have gone to the bank have n't ever lost .	these men who have n't gone to the bank have ever lost .
that child who should exercise has n't ever taken those rings .	that child who should n't exercise has ever taken those rings .
that doctor who should see the shirt could n't ever talk .	that doctor who should n't see the shirt could ever talk .
those girls that could run should n't ever eat .	those girls that could n't run should ever eat .
those children who did like this shoe do n't ever clean the bowl .	those children who did n't like this shoe do ever clean the bowl .
the patient who would cry had n't ever run around the park .	the patient who would n't cry had ever run around the park .
the men who could sell the bag did n't ever care for that driver .	the men who could n't sell the bag did ever care for that driver .
these people who can hear those cats have n't ever fixed the shoe .	these people who can n't hear those cats have ever fixed the shoe .
that driver who would practice would n't ever fix that mirror .	that driver who would n't practice would ever fix that mirror .
the men who do pass the room can n't ever cry .	the men who do n't pass the room can ever cry .
this queen who does walk through the restaurant did n't ever talk to that dancer .	this queen who does n't walk through the restaurant did ever talk to that dancer .
this child who has heard those mice has n't ever gone to the room .	this child who has n't heard those mice has ever gone to the room .
that queen that that dentist does talk about had n't ever seen that fork .	that queen that that dentist does n't talk about had ever seen that fork .
this driver who the child has heard would n't ever take those crayons .	this driver who the child has n't heard would ever take those crayons .
the guy that has grown had n't ever run .	the guy that has n't grown had ever run .
that customer who has laughed would n't ever find the button .	that customer who has n't laughed would ever find the button .
the lady that this teacher has thought about has n't ever broken the beds .	the lady that this teacher has n't thought about has ever broken the beds .
this dancer who did like the woman would n't ever yell .	this dancer who did n't like the woman would ever yell .
those children who did win have n't ever scared these ladies .	those children who did n't win have ever scared these ladies .
the people who do think about the picture can n't ever walk through that kitchen .	the people who do n't think about the picture can ever walk through that kitchen .
these children who should love the mirror had n't ever brought those shoes .	these children who should n't love the mirror had ever brought those shoes .
the dog that that woman should know could n't ever grow .	the dog that that woman should n't know could ever grow .
those ladies who do go to this park did n't ever drive to these schools .	those ladies who do n't go to this park did ever drive to these schools .
the child that had learned should n't ever hate the door .	the child that had n't learned should ever hate the door .
the women who should see the dog could n't ever go to that bank .	the women who should n't see the dog could ever go to that bank .
the boys who had thought about this cup had n't ever fixed these trucks .	the boys who had n't thought about this cup had ever fixed these trucks .
the boy who can take these books would n't ever leave this park .	the boy who can n't take these books would ever leave this park .
the bird that this child could forget had n't ever broken that spoon .	the bird that this child could n't forget had ever broken that spoon .
the men who do hear the girl have n't ever cried .	the men who do n't hear the girl have ever cried .
this customer who the teacher had talked about has n't ever worked with the dentist .	this customer who the teacher had n't talked about has ever worked with the dentist .
the bottles that these horses have remembered had n't ever rolled away .	the bottles that these horses have n't remembered had ever rolled away .
the teacher who had seen the rabbit did n't ever drop the window .	the teacher who had n't seen the rabbit did ever drop the window .
this patient who had talked about those cats would n't ever find the bowls .	this patient who had n't talked about those cats would ever find the bowls .
the lady who this woman had talked about has n't ever lost these doors .	the lady who this woman had n't talked about has ever lost these doors .
that queen that that person does know had n't ever run .	that queen that that person does n't know had ever run .
these children who have remembered those shirts should n't ever move this rug .	these children who have n't remembered those shirts should ever move this rug .
the dancer that that guy does talk about had n't ever noticed that bed .	the dancer that that guy does n't talk about had ever noticed that bed .
the king that this king has talked about would n't ever remember this doctor .	the king that this king has n't talked about would ever remember this doctor .
this teacher that did see that shoe does n't ever remember that box .	this teacher that did n't see that shoe does ever remember that box .
these children that had remembered that ring should n't ever grow .	these children that had n't remembered that ring should ever grow .
the mouse that that queen has thought about has n't ever broken the windows .	the mouse that that queen has n't thought about has ever broken the windows .
those guys that have eaten had n't ever thought about the doctors .	those guys that have n't eaten had ever thought about the doctors .
those plates that should move did n't ever break .	those plates that should n't move did ever break .
the snakes that those guys should sound like had n't ever grown .	the snakes that those guys should n't sound like had ever grown .
this person who this boy has talked about has n't ever cried .	this person who this boy has n't talked about has ever cried .
the beds that these doctors have dropped do n't ever roll away .	the beds that these doctors have n't dropped do ever roll away .
those doctors who had yelled had n't ever talked .	those doctors who had n't yelled had ever talked .
these horses that have eaten have n't ever noticed this shirt .	these horses that have n't eaten have ever noticed this shirt .
the guy who could sneeze has n't ever scared these girls .	the guy who could n't sneeze has ever scared these girls .
the guy who has thought about the adult has n't ever made that doll .	the guy who has n't thought about the adult has ever made that doll .
the birds that those women have talked about could n't ever love the book .	the birds that those women have n't talked about could ever love the book .
the boys who had talked about the rocket do n't ever lose .	the boys who had n't talked about the rocket do ever lose .
this boat that this girl does see has n't ever broken this picture .	this boat that this girl does n't see has ever broken this picture .
the dishes that have broken have n't ever dropped .	the dishes that have n't broken have ever dropped .
this boy who had run around these schools would n't ever sell the bottle .	this boy who had n't run around these schools would ever sell the bottle .
those women who should drive to the restaurant could n't ever run around the hospital .	those women who should n't drive to the restaurant could ever run around the hospital .
the king that had remembered this lady has n't ever thought about this cup .	the king that had n't remembered this lady has ever thought about this cup .
the rabbit that can sound like those dogs had n't ever remembered these shirts .	the rabbit that can n't sound like those dogs had ever remembered these shirts .
that boy who could sound like these men does n't ever visit that doctor .	that boy who could n't sound like these men does ever visit that doctor .
this door that the horse had noticed did n't ever break these doors .	this door that the horse had n't noticed did ever break these doors .
that bird that this lady had talked about does n't ever break the toys .	that bird that this lady had n't talked about does ever break the toys .
the teachers who would throw the fork have n't ever helped this woman .	the teachers who would n't throw the fork have ever helped this woman .
those boys who had found these hats could n't ever praise that child .	those boys who had n't found these hats could ever praise that child .
the birds that had heard those people could n't ever remember the girl .	the birds that had n't heard those people could ever remember the girl .
the king that has heard this rabbit had n't ever grown .	the king that has n't heard this rabbit had ever grown .
that teacher who does shake this window did n't ever buy the books .	that teacher who does n't shake this window did ever buy the books .
that boy who should notice that plate has n't ever painted .	that boy who should n't notice that plate has ever painted .
this adult who had moved the doors should n't ever return to that school .	this adult who had n't moved the doors should ever return to that school .
these chairs that have rolled away have n't ever rolled away .	these chairs that have n't rolled away have ever rolled away .
those books that these ladies have seen would n't ever drop .	those books that these ladies have n't seen would ever drop .
the children who had lost that ship do n't ever scream .	the children who had n't lost that ship do ever scream .
these girls that have eaten had n't ever remembered the box .	these girls that have n't eaten had ever remembered the box .
those guys who would hate these bottles do n't ever lose that box .	those guys who would n't hate these bottles do ever lose that box .
the people who had thought about these cars did n't ever win .	the people who had n't thought about these cars did ever win .
this dentist who would take the books had n't ever dropped the cars .	this dentist who would n't take the books had ever dropped the cars .
the box that the boy had brought has n't ever broken .	the box that the boy had n't brought has ever broken .
that guy who has heard this lady had n't ever helped that woman .	that guy who has n't heard this lady had ever helped that woman .
this plane that the guy has talked about had n't ever broken .	this plane that the guy has n't talked about had ever broken .
this queen that that guy can sound like has n't ever remembered those pictures .	this queen that that guy can n't sound like has ever remembered those pictures .
the cars that did move had n't ever broken .	the cars that did n't move had ever broken .
the picture that this girl could forget has n't ever broken .	the picture that this girl could n't forget has ever broken .
these men who should look like that cat did n't ever look like these horses .	these men who should n't look like that cat did ever look like these horses .
that dancer who has remembered the dog has n't ever made that doll .	that dancer who has n't remembered the dog has ever made that doll .
that person who would cry has n't ever cried .	that person who would n't cry has ever cried .
that dancer who this man can talk about has n't ever helped this driver .	that dancer who this man can n't talk about has ever helped this driver .
this adult who has passed these rooms did n't ever sneeze .	this adult who has n't passed these rooms did ever sneeze .
the teacher who has heard those guys could n't ever buy the book .	the teacher who has n't heard those guys could ever buy the book .
these ladies who had thought about those rabbits did n't ever clean that plane .	these ladies who had n't thought about those rabbits did ever clean that plane .
that boy who could love this bowl has n't ever lost this crayon .	that boy who could n't love this bowl has ever lost this crayon .
these girls who could forget this rocket do n't ever look like that cat .	these girls who could n't forget this rocket do ever look like that cat .
that candle that has dropped had n't ever moved .	that candle that has n't dropped had ever moved .
the driver who had remembered the ladies had n't ever answered the women .	the driver who had n't remembered the ladies had ever answered the women .
these ladies who did cough had n't ever dropped the buttons .	these ladies who did n't cough had ever dropped the buttons .
the horse that this teacher can talk about had n't ever grown .	the horse that this teacher can n't talk about had ever grown .
that adult who can lose this cup had n't ever helped this patient .	that adult who can n't lose this cup had ever helped this patient .
this teacher who could whisper had n't ever taught this king .	this teacher who could n't whisper had ever taught this king .
those boys who can hate the book do n't ever care for the teachers .	those boys who can n't hate the book do ever care for the teachers .
those cups that could roll away had n't ever moved .	those cups that could n't roll away had ever moved .
that boy who had heard the guys did n't ever walk through those schools .	that boy who had n't heard the guys did ever walk through those schools .
this woman who has made the cup has n't ever painted .	this woman who has n't made the cup has ever painted .
that girl who should steal those windows should n't ever care for this adult .	that girl who should n't steal those windows should ever care for this adult .
the plates that would drop can n't ever drop .	the plates that would n't drop can ever drop .
the guy who has heard that doctor has n't ever kept that bowl .	the guy who has n't heard that doctor has ever kept that bowl .
the man who that patient had talked about should n't ever whisper .	the man who that patient had n't talked about should ever whisper .
the shoe that the turtle has remembered could n't ever drop .	the shoe that the turtle has n't remembered could ever drop .
this lady that could hate that dancer had n't ever learned .	this lady that could n't hate that dancer had ever learned .
the girls who could talk about these books can n't ever yell .	the girls who could n't talk about these books can ever yell .
that customer who could notice this lady can n't ever understand the adult .	that customer who could n't notice this lady can ever understand the adult .
those buttons that have rolled away can n't ever break .	those buttons that have n't rolled away can ever break .
that dentist that that rabbit could love could n't ever break the chair .	that dentist that that rabbit could n't love could ever break the chair .
the doctors who the people had talked about did n't ever shake the beds .	the doctors who the people had n't talked about did ever shake the beds .
that man who has seen those trucks has n't ever run around this park .	that man who has n't seen those trucks has ever run around this park .
that customer who that doctor did sound like should n't ever have that book .	that customer who that doctor did n't sound like should ever have that book .
those people who had seen these ladies have n't ever left this school .	those people who had n't seen these ladies have ever left this school .
the box that this dentist did lift did n't ever roll away .	the box that this dentist did n't lift did ever roll away .
that patient who should forget this mirror did n't ever know the person .	that patient who should n't forget this mirror did ever know the person .
the adult that does like those cups did n't ever like this adult .	the adult that does n't like those cups did ever like this adult .
these children that these boys had heard had n't ever eaten .	these children that these boys had n't heard had ever eaten .
those people that those girls can hear would n't ever see that spoon .	those people that those girls can n't hear would ever see that spoon .
the customer who has bought the cars has n't ever made the rings .	the customer who has n't bought the cars has ever made the rings .
that driver that did eat did n't ever notice the children .	that driver that did n't eat did ever notice the children .
this car that should drop could n't ever roll away .	this car that should n't drop could ever roll away .
these guys who the women should look like have n't ever brought this box .	these guys who the women should n't look like have ever brought this box .
those guys who have talked about those people do n't ever look like this bird .	those guys who have n't talked about those people do ever look like this bird .
this window that had broken had n't ever moved .	this window that had n't broken had ever moved .
these women that could run have n't ever noticed this driver .	these women that could n't run have ever noticed this driver .
these dogs that should run did n't ever grow .	these dogs that should n't run did ever grow .
these shirts that the girls should forget have n't ever moved .	these shirts that the girls should n't forget have ever moved .
this woman who has laughed could n't ever hear this king .	this woman who has n't laughed could ever hear this king .
those windows that those girls did talk about have n't ever broken the plane .	those windows that those girls did n't talk about have ever broken the plane .
the snake that that guy has heard had n't ever noticed this bag .	the snake that that guy has n't heard had ever noticed this bag .
the queen that that child does sound like would n't ever grow .	the queen that that child does n't sound like would ever grow .
this woman who should see this rocket has n't ever waved .	this woman who should n't see this rocket has ever waved .
that doctor who had noticed this adult could n't ever lose .	that doctor who had n't noticed this adult could ever lose .
the men who have held this dish do n't ever worry that boy .	the men who have n't held this dish do ever worry that boy .
the teacher who had lost those boats can n't ever bring this hat .	the teacher who had n't lost those boats can ever bring this hat .
the teachers who can lie did n't ever win .	the teachers who can n't lie did ever win .
this mouse that that woman has talked about can n't ever like the candle .	this mouse that that woman has n't talked about can ever like the candle .
those guys that had eaten had n't ever seen that candle .	those guys that had n't eaten had ever seen that candle .
those guys who can keep the plane have n't ever gone to this restaurant .	those guys who can n't keep the plane have ever gone to this restaurant .
these men who do read have n't ever thrown these chairs .	these men who do n't read have ever thrown these chairs .
these doctors who did steal the hats did n't ever shake these crayons .	these doctors who did n't steal the hats did ever shake these crayons .
that book that the teacher would talk about had n't ever rolled away .	that book that the teacher would n't talk about had ever rolled away .
this person who would buy the rocket had n't ever left this restaurant .	this person who would n't buy the rocket had ever left this restaurant .
the boys who do shake those chairs have n't ever painted .	the boys who do n't shake those chairs have ever painted .
that boy who had gone to that mall had n't ever kept that book .	that boy who had n't gone to that mall had ever kept that book .
the dentist who can sound like the dogs would n't ever know this turtle .	the dentist who can n't sound like the dogs would ever know this turtle .
the child who does hate the rabbits has n't ever confused the child .	the child who does n't hate the rabbits has ever confused the child .
those boys who had noticed these doctors had n't ever lost .	those boys who had n't noticed these doctors had ever lost .
the queen who does look like this patient has n't ever won .	the queen who does n't look like this patient has ever won .
those people who could lie should n't ever stretch .	those people who could n't lie should ever stretch .
that person that can eat had n't ever eaten .	that person that can n't eat had ever eaten .
that bed that this dentist had found should n't ever break .	that bed that this dentist had n't found should ever break .
the doctor who had seen this child can n't ever bring those plates .	the doctor who had n't seen this child can ever bring those plates .
this bag that that lady can talk about did n't ever drop .	this bag that that lady can n't talk about did ever drop .
that man who did shake that ring has n't ever scared those girls .	that man who did n't shake that ring has ever scared those girls .
those cups that those men had found did n't ever move .	those cups that those men had n't found did ever move .
those rings that have moved had n't ever dropped .	those rings that have n't moved had ever dropped .
those guys who these ladies had heard do n't ever shake this couch .	those guys who these ladies had n't heard do ever shake this couch .
the doctor who had seen those cats has n't ever taken those shirts .	the doctor who had n't seen those cats has ever taken those shirts .
the teachers who should lie could n't ever whisper .	the teachers who should n't lie could ever whisper .
the mirror that had rolled away had n't ever moved .	the mirror that had n't rolled away had ever moved .
the bottle that the horse had seen would n't ever drop .	the bottle that the horse had n't seen would ever drop .
these windows that have rolled away can n't ever move .	these windows that have n't rolled away can ever move .
the patient that the king has heard has n't ever eaten .	the patient that the king has n't heard has ever eaten .
the child who this adult would know had n't ever found those people .	the child who this adult would n't know had ever found those people .
these cups that those people could notice had n't ever moved .	these cups that those people could n't notice had ever moved .
these cats that had thought about this woman could n't ever notice those dogs .	these cats that had n't thought about this woman could ever notice those dogs .
those men who do sound like those ladies did n't ever praise the girls .	those men who do n't sound like those ladies did ever praise the girls .
that snake that that person had heard had n't ever seen the plane .	that snake that that person had n't heard had ever seen the plane .
those teachers who have cleaned the windows had n't ever moved this bottle .	those teachers who have n't cleaned the windows had ever moved this bottle .
that teacher who the woman would know has n't ever worked with the person .	that teacher who the woman would n't know has ever worked with the person .
the child who did shake the button would n't ever scare the people .	the child who did n't shake the button would ever scare the people .
the turtle that would eat can n't ever eat .	the turtle that would n't eat can ever eat .
the man who has noticed this rocket would n't ever talk .	the man who has n't noticed this rocket would ever talk .
this adult that this dancer does hear would n't ever learn .	this adult that this dancer does n't hear would ever learn .
these guys who could paint should n't ever stretch .	these guys who could n't paint should ever stretch .
that driver who should scream can n't ever run around those schools .	that driver who should n't scream can ever run around those schools .
those teachers that did grow do n't ever grow .	those teachers that did n't grow do ever grow .
the car that this adult should have had n't ever moved .	the car that this adult should n't have had ever moved .
that dancer who this girl has heard should n't ever cry .	that dancer who this girl has n't heard should ever cry .
this adult who has read did n't ever exercise .	this adult who has n't read did ever exercise .
the teachers who those boys had heard had n't ever heard those teachers .	the teachers who those boys had n't heard had ever heard those teachers .
the dog that had run has n't ever remembered the plane .	the dog that had n't run has ever remembered the plane .
that king who had seen this box had n't ever fixed this book .	that king who had n't seen this box had ever fixed this book .
the woman who does walk through this park would n't ever laugh .	the woman who does n't walk through this park would ever laugh .
the child who should talk about this hamster did n't ever make that couch .	the child who should n't talk about this hamster did ever make that couch .
the women who those women had heard should n't ever lift the book .	the women who those women had n't heard should ever lift the book .
this teacher who did make these dishes has n't ever heard these women .	this teacher who did n't make these dishes has ever heard these women .
the dancer who had won has n't ever worried that driver .	the dancer who had n't won has ever worried that driver .
the doctors that the men did hear would n't ever notice the spoons .	the doctors that the men did n't hear would ever notice the spoons .
these snakes that can hear those boys have n't ever learned .	these snakes that can n't hear those boys have ever learned .
the turtles that had grown could n't ever run .	the turtles that had n't grown could ever run .
this turtle that that woman had remembered did n't ever break the boxes .	this turtle that that woman had n't remembered did ever break the boxes .
the bottle that did roll away would n't ever break .	the bottle that did n't roll away would ever break .
this adult who had seen these rings has n't ever read .	this adult who had n't seen these rings has ever read .
this king that had grown has n't ever remembered the car .	this king that had n't grown has ever remembered the car .
the child who should make those shirts can n't ever cry .	the child who should n't make those shirts can ever cry .
this queen that had run has n't ever noticed these trucks .	this queen that had n't run has ever noticed these trucks .
the horse that has thought about those bowls has n't ever seen the turtle .	the horse that has n't thought about those bowls has ever seen the turtle .
the candle that would drop would n't ever roll away .	the candle that would n't drop would ever roll away .
these people who could lose the cars do n't ever return to this bank .	these people who could n't lose the cars do ever return to this bank .
this girl who does lift this dish had n't ever left the school .	this girl who does n't lift this dish had ever left the school .
this dentist who has heard that child had n't ever talked .	this dentist who has n't heard that child had ever talked .
that mirror that that girl would see does n't ever drop .	that mirror that that girl would n't see does ever drop .
the queen that has heard these girls has n't ever seen those forks .	the queen that has n't heard these girls has ever seen those forks .
that king who has made that shirt had n't ever heard the customer .	that king who has n't made that shirt had ever heard the customer .
the ladies that have learned had n't ever noticed those books .	the ladies that have n't learned had ever noticed those books .
the doctor that this girl does talk about did n't ever learn .	the doctor that this girl does n't talk about did ever learn .
this person that did grow should n't ever see that plane .	this person that did n't grow should ever see that plane .
the car that does break can n't ever drop .	the car that does n't break can ever drop .
these ladies who had seen this boat can n't ever work with that girl .	these ladies who had n't seen this boat can ever work with that girl .
the dish that had broken would n't ever move .	the dish that had n't broken would ever move .
that adult who would make that mirror has n't ever bought the forks .	that adult who would n't make that mirror has ever bought the forks .
that person who had seen this doll had n't ever walked through these schools .	that person who had n't seen this doll had ever walked through these schools .
the shirts that do roll away can n't ever break .	the shirts that do n't roll away can ever break .
that customer that this girl has heard would n't ever remember the king .	that customer that this girl has n't heard would ever remember the king .
the guy who had kept these bowls had n't ever kept those shoes .	the guy who had n't kept these bowls had ever kept those shoes .
the boys that would forget this candle had n't ever grown .	the boys that would n't forget this candle had ever grown .
the queen who can sound like this rabbit had n't ever made this doll .	the queen who can n't sound like this rabbit had ever made this doll .
the children that can eat could n't ever like those people .	the children that can n't eat could ever like those people .
those boys who have cried have n't ever talked to those women .	those boys who have n't cried have ever talked to those women .
these boys that have run had n't ever seen those chairs .	these boys that have n't run had ever seen those chairs .
this ring that that driver has remembered has n't ever dropped .	this ring that that driver has n't remembered has ever dropped .
this adult who that queen does look like can n't ever exercise .	this adult who that queen does n't look like can ever exercise .
the teachers who have walked through that school would n't ever practice .	the teachers who have n't walked through that school would ever practice .
this child that the driver does talk about does n't ever hate that fork .	this child that the driver does n't talk about does ever hate that fork .
this child who had noticed this crayon has n't ever painted .	this child who had n't noticed this crayon has ever painted .
that king who can like the mouse has n't ever talked .	that king who can n't like the mouse has ever talked .
this couch that the woman would shake does n't ever drop .	this couch that the woman would n't shake does ever drop .
the boys that had learned had n't ever thought about those turtles .	the boys that had n't learned had ever thought about those turtles .
those boxes that the girls should bring can n't ever move .	those boxes that the girls should n't bring can ever move .
the guys who had run around the school do n't ever paint .	the guys who had n't run around the school do ever paint .
these ladies that had noticed this ship do n't ever love that toy .	these ladies that had n't noticed this ship do ever love that toy .
the driver who has heard those mice had n't ever worked with that doctor .	the driver who has n't heard those mice had ever worked with that doctor .
the snake that that lady did look like had n't ever grown .	the snake that that lady did n't look like had ever grown .
this ship that this teacher has noticed did n't ever drop .	this ship that this teacher has n't noticed did ever drop .
the lady who that adult could hear could n't ever steal the dish .	the lady who that adult could n't hear could ever steal the dish .
those teachers who did like those boys have n't ever held the dishes .	those teachers who did n't like those boys have ever held the dishes .
this dancer who does talk about those men has n't ever painted .	this dancer who does n't talk about those men has ever painted .
the children who would scream had n't ever thrown the toys .	the children who would n't scream had ever thrown the toys .
the guys who could like this bird have n't ever won .	the guys who could n't like this bird have ever won .
the king that the girl has talked about had n't ever broken that bed .	the king that the girl has n't talked about had ever broken that bed .
the women who have talked about this cat have n't ever held those chairs .	the women who have n't talked about this cat have ever held those chairs .
the woman who this dentist could talk about does n't ever lose those cars .	the woman who this dentist could n't talk about does ever lose those cars .
the horses that did eat did n't ever run .	the horses that did n't eat did ever run .
this king who could practice would n't ever find these buttons .	this king who could n't practice would ever find these buttons .
this boy that has thought about those dogs had n't ever grown .	this boy that has n't thought about those dogs had ever grown .
that guy who should hold that cup has n't ever taken that chair .	that guy who should n't hold that cup has ever taken that chair .
these children who had yelled have n't ever painted .	these children who had n't yelled have ever painted .
the ladies who do talk about the boats had n't ever made the boat .	the ladies who do n't talk about the boats had ever made the boat .
the child who can like the mouse would n't ever clean the couch .	the child who can n't like the mouse would ever clean the couch .
the rug that that lady had talked about had n't ever broken those cups .	the rug that that lady had n't talked about had ever broken those cups .
the turtle that the lady has heard can n't ever grow .	the turtle that the lady has n't heard can ever grow .
the man that did sound like the lady can n't ever see the dogs .	the man that did n't sound like the lady can ever see the dogs .
this window that had dropped does n't ever move .	this window that had n't dropped does ever move .
those women who can think about those dishes should n't ever teach these women .	those women who can n't think about those dishes should ever teach these women .
the person who the queen would talk about had n't ever scared the guys .	the person who the queen would n't talk about had ever scared the guys .
these doctors who can know this boy had n't ever dropped those glasses .	these doctors who can n't know this boy had ever dropped those glasses .
the ladies who have left the school had n't ever laughed .	the ladies who have n't left the school had ever laughed .
this teacher that the adult would talk about has n't ever learned .	this teacher that the adult would n't talk about has ever learned .
these children who have thought about the cars had n't ever kept those dolls .	these children who have n't thought about the cars had ever kept those dolls .
those ladies who have thought about this window have n't ever heard the patient .	those ladies who have n't thought about this window have ever heard the patient .
this person who did wave had n't ever won .	this person who did n't wave had ever won .
the doctor who has talked about the rabbits had n't ever brought the cars .	the doctor who has n't talked about the rabbits had ever brought the cars .
the girl who could win should n't ever talk .	the girl who could n't win should ever talk .
the window that would drop has n't ever broken .	the window that would n't drop has ever broken .
that king who has heard that child does n't ever understand this king .	that king who has n't heard that child does ever understand this king .
the guys who can know the bird do n't ever practice .	the guys who can n't know the bird do ever practice .
these doors that the ladies had remembered had n't ever broken this book .	these doors that the ladies had n't remembered had ever broken this book .
this dentist who did know the doctors would n't ever look like those women .	this dentist who did n't know the doctors would ever look like those women .
that child who had waved has n't ever bothered the teacher .	that child who had n't waved has ever bothered the teacher .
that doctor who does laugh should n't ever exercise .	that doctor who does n't laugh should ever exercise .
these doctors who these women can talk about had n't ever left this restaurant .	these doctors who these women can n't talk about had ever left this restaurant .
that shirt that the rabbit can think about does n't ever drop .	that shirt that the rabbit can n't think about does ever drop .
the teachers who should look like this hamster had n't ever heard this queen .	the teachers who should n't look like this hamster had ever heard this queen .
those ladies who do see the dishes had n't ever taken these crayons .	those ladies who do n't see the dishes had ever taken these crayons .
the boys who could pass that bank had n't ever lost the king .	the boys who could n't pass that bank had ever lost the king .
the adult who could remember that dentist could n't ever read .	the adult who could n't remember that dentist could ever read .
the hats that those doctors had noticed had n't ever rolled away .	the hats that those doctors had n't noticed had ever rolled away .
these girls who these girls would talk about do n't ever hold those books .	these girls who these girls would n't talk about do ever hold those books .
that customer who does exercise does n't ever talk .	that customer who does n't exercise does ever talk .
this bird that has noticed these teachers has n't ever seen this book .	this bird that has n't noticed these teachers has ever seen this book .
these teachers who had seen that doll did n't ever steal those books .	these teachers who had n't seen that doll did ever steal those books .
that doctor who has passed this school could n't ever drive to that mall .	that doctor who has n't passed this school could ever drive to that mall .
the cat that has eaten has n't ever run .	the cat that has n't eaten has ever run .
this king who has passed that school has n't ever dropped the box .	this king who has n't passed that school has ever dropped the box .
the bird that could know that king had n't ever noticed this boy .	the bird that could n't know that king had ever noticed this boy .
the lady who should move this window should n't ever make that mirror .	the lady who should n't move this window should ever make that mirror .
the rabbits that do think about this book had n't ever noticed those ladies .	the rabbits that do n't think about this book had ever noticed those ladies .
the ring that would break had n't ever rolled away .	the ring that would n't break had ever rolled away .
the people that the teachers did talk about can n't ever notice these bottles .	the people that the teachers did n't talk about can ever notice these bottles .
this box that that queen would notice had n't ever broken these spoons .	this box that that queen would n't notice had ever broken these spoons .
the king who has heard that doctor has n't ever helped the ladies .	the king who has n't heard that doctor has ever helped the ladies .
the windows that had dropped have n't ever dropped .	the windows that had n't dropped have ever dropped .
the lady that has thought about this rug had n't ever grown .	the lady that has n't thought about this rug had ever grown .
that doctor who had seen these ladies did n't ever know the king .	that doctor who had n't seen these ladies did ever know the king .
the boy who that driver can sound like could n't ever laugh .	the boy who that driver can n't sound like could ever laugh .
that doctor that did see the dancer has n't ever grown .	that doctor that did n't see the dancer has ever grown .
the ladies who would talk about the bags had n't ever run around that museum .	the ladies who would n't talk about the bags had ever run around that museum .
this rocket that this teacher would move had n't ever moved .	this rocket that this teacher would n't move had ever moved .
the dogs that do run did n't ever learn .	the dogs that do n't run did ever learn .
the people who the women had talked about have n't ever waved .	the people who the women had n't talked about have ever waved .
that toy that this teacher should talk about did n't ever move .	that toy that this teacher should n't talk about did ever move .
that child who the dancer could know could n't ever bring that chair .	that child who the dancer could n't know could ever bring that chair .
that patient that can forget this crayon had n't ever seen those plates .	that patient that can n't forget this crayon had ever seen those plates .
these women that have run did n't ever notice these books .	these women that have n't run did ever notice these books .
the child who has painted had n't ever taught the girls .	the child who has n't painted had ever taught the girls .
that girl that had thought about the customer did n't ever think about that dog .	that girl that had n't thought about the customer did ever think about that dog .
these ladies who had heard the cat would n't ever lose .	these ladies who had n't heard the cat would ever lose .
the queen who would love the adult had n't ever bought the ring .	the queen who would n't love the adult had ever bought the ring .
the ladies who have talked about that plane have n't ever brought this rug .	the ladies who have n't talked about that plane have ever brought this rug .
these teachers who would go to that museum had n't ever bothered that queen .	these teachers who would n't go to that museum had ever bothered that queen .
this adult that did learn can n't ever like this bird .	this adult that did n't learn can ever like this bird .
the customer who has remembered the bed has n't ever lost that king .	the customer who has n't remembered the bed has ever lost that king .
those people who should walk through the schools would n't ever talk about these girls .	those people who should n't walk through the schools would ever talk about these girls .
those ladies who did leave the schools have n't ever lost .	those ladies who did n't leave the schools have ever lost .
the boys who those women had heard can n't ever cough .	the boys who those women had n't heard can ever cough .
those girls who would talk about those glasses would n't ever look like the lady .	those girls who would n't talk about those glasses would ever look like the lady .
these girls that those guys did know can n't ever notice the cars .	these girls that those guys did n't know can ever notice the cars .
the men that do learn do n't ever like those cups .	the men that do n't learn do ever like those cups .
the women who these boys would talk about can n't ever have those beds .	the women who these boys would n't talk about can ever have those beds .
these boys who would buy the toys could n't ever sound like the man .	these boys who would n't buy the toys could ever sound like the man .
those men who could love the plate had n't ever lost this car .	those men who could n't love the plate had ever lost this car .
that bed that should drop had n't ever dropped .	that bed that should n't drop had ever dropped .
that doctor who has remembered this doctor does n't ever hear the boy .	that doctor who has n't remembered this doctor does ever hear the boy .
the child who that adult can hear did n't ever fix the shirts .	the child who that adult can n't hear did ever fix the shirts .
this doctor who this customer could know should n't ever keep this boat .	this doctor who this customer could n't know should ever keep this boat .
the child who did practice should n't ever walk through this room .	the child who did n't practice should ever walk through this room .
this man who the patient has talked about could n't ever lose these boats .	this man who the patient has n't talked about could ever lose these boats .
these doctors who have yelled could n't ever teach that king .	these doctors who have n't yelled could ever teach that king .
that customer that this turtle has thought about has n't ever broken that door .	that customer that this turtle has n't thought about has ever broken that door .
the boat that that cat had noticed can n't ever move .	the boat that that cat had n't noticed can ever move .
those people that should like those birds do n't ever run .	those people that should n't like those birds do ever run .
the rabbit that this person has noticed could n't ever break those windows .	the rabbit that this person has n't noticed could ever break those windows .
those guys who have talked about those rabbits do n't ever drive to this kitchen .	those guys who have n't talked about those rabbits do ever drive to this kitchen .
this queen who had fixed the ship has n't ever talked .	this queen who had n't fixed the ship has ever talked .
these turtles that those children have heard did n't ever grow .	these turtles that those children have n't heard did ever grow .
that shoe that that man should see could n't ever roll away .	that shoe that that man should n't see could ever roll away .
that boy that does know the cats had n't ever eaten .	that boy that does n't know the cats had ever eaten .
that boy who has lost has n't ever dropped that mirror .	that boy who has n't lost has ever dropped that mirror .
that king who had talked about the dogs would n't ever fix the books .	that king who had n't talked about the dogs would ever fix the books .
this child that this dancer has heard could n't ever grow .	this child that this dancer has n't heard could ever grow .
the book that this snake has thought about did n't ever move .	the book that this snake has n't thought about did ever move .
those dolls that those women did think about could n't ever move .	those dolls that those women did n't think about could ever move .
this child who the man would know could n't ever have the bicycle .	this child who the man would n't know could ever have the bicycle .
the guys who had seen this hat can n't ever answer this person .	the guys who had n't seen this hat can ever answer this person .
those boys who had cleaned those forks had n't ever kept that bowl .	those boys who had n't cleaned those forks had ever kept that bowl .
this snake that could see this plate had n't ever grown .	this snake that could n't see this plate had ever grown .
these guys who had thought about that horse have n't ever lost that doctor .	these guys who had n't thought about that horse have ever lost that doctor .
those men who have noticed the candle had n't ever lost the dancer .	those men who have n't noticed the candle had ever lost the dancer .
these boats that these guys do talk about had n't ever broken that boat .	these boats that these guys do n't talk about had ever broken that boat .
that dentist who the person has heard has n't ever lost the shirt .	that dentist who the person has n't heard has ever lost the shirt .
that lady who could steal those boxes would n't ever sneeze .	that lady who could n't steal those boxes would ever sneeze .
the doctor who should bring these beds has n't ever heard the teachers .	the doctor who should n't bring these beds has ever heard the teachers .
that woman who had talked about the plate could n't ever hold that book .	that woman who had n't talked about the plate could ever hold that book .
the dogs that do grow did n't ever grow .	the dogs that do n't grow did ever grow .
that adult who had kept the bowl had n't ever talked about this queen .	that adult who had n't kept the bowl had ever talked about this queen .
that child who the guy had talked about did n't ever care for the lady .	that child who the guy had n't talked about did ever care for the lady .
that bowl that this king would take could n't ever roll away .	that bowl that this king would n't take could ever roll away .
the ladies that did eat would n't ever remember those chairs .	the ladies that did n't eat would ever remember those chairs .
that teacher who could drive to the school had n't ever kept that shirt .	that teacher who could n't drive to the school had ever kept that shirt .
those ladies who had walked through the rooms should n't ever take the bicycle .	those ladies who had n't walked through the rooms should ever take the bicycle .
that guy who this dentist can hear had n't ever dropped that hat .	that guy who this dentist can n't hear had ever dropped that hat .
these dogs that those children have heard had n't ever thought about the child .	these dogs that those children have n't heard had ever thought about the child .
that teacher who could whisper did n't ever buy the candle .	that teacher who could n't whisper did ever buy the candle .
this queen who had gone to these schools has n't ever brought that bicycle .	this queen who had n't gone to these schools has ever brought that bicycle .
the doors that had dropped had n't ever rolled away .	the doors that had n't dropped had ever rolled away .
that teacher who the king has talked about had n't ever brought the bottle .	that teacher who the king has n't talked about had ever brought the bottle .
this patient that this cat did remember does n't ever break that shirt .	this patient that this cat did n't remember does ever break that shirt .
these rings that the people can find had n't ever rolled away .	these rings that the people can n't find had ever rolled away .
the lady who did yell had n't ever found this car .	the lady who did n't yell had ever found this car .
this hamster that the patient has talked about would n't ever hate those trucks .	this hamster that the patient has n't talked about would ever hate those trucks .
this boy who this girl could know does n't ever bother the children .	this boy who this girl could n't know does ever bother the children .
the doctor who had painted could n't ever worry this queen .	the doctor who had n't painted could ever worry this queen .
the beds that the horses can love had n't ever broken the book .	the beds that the horses can n't love had ever broken the book .
these guys that those women have heard would n't ever learn .	these guys that those women have n't heard would ever learn .
the teacher who would love the books does n't ever win .	the teacher who would n't love the books does ever win .
this king that would sound like this cat did n't ever hate the chair .	this king that would n't sound like this cat did ever hate the chair .
these children who can notice the adult can n't ever praise that child .	these children who can n't notice the adult can ever praise that child .
this customer who this woman had heard had n't ever confused these teachers .	this customer who this woman had n't heard had ever confused these teachers .
these women that those children had talked about had n't ever eaten .	these women that those children had n't talked about had ever eaten .
this cup that could break has n't ever rolled away .	this cup that could n't break has ever rolled away .
that adult who this doctor would talk about had n't ever heard this man .	that adult who this doctor would n't talk about had ever heard this man .
the queen who did have this truck can n't ever keep the buttons .	the queen who did n't have this truck can ever keep the buttons .
those girls who have dropped these books can n't ever answer those people .	those girls who have n't dropped these books can ever answer those people .
these chairs that these people have thought about have n't ever moved .	these chairs that these people have n't thought about have ever moved .
those men who have kept these dishes should n't ever yell .	those men who have n't kept these dishes should ever yell .
that man who has won had n't ever kept the doll .	that man who has n't won had ever kept the doll .
the person who has talked about those rabbits has n't ever found the bottle .	the person who has n't talked about those rabbits has ever found the bottle .
this dancer who did keep that shirt can n't ever talk .	this dancer who did n't keep that shirt can ever talk .
those glasses that these children have lost had n't ever broken .	those glasses that these children have n't lost had ever broken .
the dancer who had thought about the car can n't ever scare those people .	the dancer who had n't thought about the car can ever scare those people .
that patient who this dentist has heard did n't ever work with the adult .	that patient who this dentist has n't heard did ever work with the adult .
the ladies who can look like those ladies can n't ever talk about these dishes .	the ladies who can n't look like those ladies can ever talk about these dishes .
those guys who did stretch could n't ever return to that museum .	those guys who did n't stretch could ever return to that museum .
the bowls that those horses should notice had n't ever dropped .	the bowls that those horses should n't notice had ever dropped .
the girl who had painted should n't ever lose this picture .	the girl who had n't painted should ever lose this picture .
this person who had brought the candle had n't ever lost these dolls .	this person who had n't brought the candle had ever lost these dolls .
this boy who had cried has n't ever cried .	this boy who had n't cried has ever cried .
this patient who has thought about that man could n't ever bring this cup .	this patient who has n't thought about that man could ever bring this cup .
the girl who has remembered this toy had n't ever talked about those crayons .	the girl who has n't remembered this toy had ever talked about those crayons .
that dish that this man had remembered had n't ever broken those cups .	that dish that this man had n't remembered had ever broken those cups .
that dancer who had heard the dog had n't ever talked .	that dancer who had n't heard the dog had ever talked .
the bowl that does break did n't ever roll away .	the bowl that does n't break did ever roll away .
this dentist who had dropped these pictures did n't ever lose .	this dentist who had n't dropped these pictures did ever lose .
the couch that this person does love did n't ever break that toy .	the couch that this person does n't love did ever break that toy .
those doctors who did talk about those teachers can n't ever cough .	those doctors who did n't talk about those teachers can ever cough .
these girls that did eat do n't ever love the ring .	these girls that did n't eat do ever love the ring .
the child who had seen these shoes has n't ever thrown that plane .	the child who had n't seen these shoes has ever thrown that plane .
the lady who could notice the crayons had n't ever passed this museum .	the lady who could n't notice the crayons had ever passed this museum .
this lady who had heard these people should n't ever look like those horses .	this lady who had n't heard these people should ever look like those horses .
these women that can sound like this dentist have n't ever thought about this hat .	these women that can n't sound like this dentist have ever thought about this hat .
these people who should look like these guys have n't ever found that plate .	these people who should n't look like these guys have ever found that plate .
the child who does shake the candle has n't ever thrown that spoon .	the child who does n't shake the candle has ever thrown that spoon .
that crayon that the woman has talked about has n't ever moved .	that crayon that the woman has n't talked about has ever moved .
those boys who did love this box can n't ever hold this book .	those boys who did n't love this box can ever hold this book .
this turtle that the patient has heard had n't ever seen that cup .	this turtle that the patient has n't heard had ever seen that cup .
the crayon that the adult does talk about can n't ever drop .	the crayon that the adult does n't talk about can ever drop .
the dentist who can sing could n't ever scream .	the dentist who can n't sing could ever scream .
the woman that had seen the shoes did n't ever learn .	the woman that had n't seen the shoes did ever learn .
that dancer who can notice the men had n't ever laughed .	that dancer who can n't notice the men had ever laughed .
this adult who can think about that crayon could n't ever steal that dish .	this adult who can n't think about that crayon could ever steal that dish .
the children who could stretch did n't ever find this box .	the children who could n't stretch did ever find this box .
these teachers who would like these spoons have n't ever helped the boys .	these teachers who would n't like these spoons have ever helped the boys .
the rabbit that did remember the adult could n't ever see that adult .	the rabbit that did n't remember the adult could ever see that adult .
that plate that this customer should talk about can n't ever break this cup .	that plate that this customer should n't talk about can ever break this cup .
that person who does return to this kitchen could n't ever listen to that king .	that person who does n't return to this kitchen could ever listen to that king .
the box that had rolled away should n't ever break .	the box that had n't rolled away should ever break .
that lady who has gone to the museum can n't ever know the girls .	that lady who has n't gone to the museum can ever know the girls .
this turtle that the man would talk about can n't ever grow .	this turtle that the man would n't talk about can ever grow .
the doctors that can forget that door have n't ever learned .	the doctors that can n't forget that door have ever learned .
this person who does wave had n't ever heard this patient .	this person who does n't wave had ever heard this patient .
this dentist that would grow has n't ever eaten .	this dentist that would n't grow has ever eaten .
the snakes that have grown had n't ever eaten .	the snakes that have n't grown had ever eaten .
those boys who should sneeze would n't ever buy this spoon .	those boys who should n't sneeze would ever buy this spoon .
those boys who have thought about those mice had n't ever cried .	those boys who have n't thought about those mice had ever cried .
those pictures that those women had seen had n't ever moved .	those pictures that those women had n't seen had ever moved .
the shirts that had rolled away had n't ever moved .	the shirts that had n't rolled away had ever moved .
that child who could see those pictures would n't ever have this box .	that child who could n't see those pictures would ever have this box .
those ladies who had found the boat have n't ever left that restaurant .	those ladies who had n't found the boat have ever left that restaurant .
these children that have noticed those people have n't ever seen the books .	these children that have n't noticed those people have ever seen the books .
the queen who has thought about that doll did n't ever understand the people .	the queen who has n't thought about that doll did ever understand the people .
the shoes that had broken can n't ever roll away .	the shoes that had n't broken can ever roll away .
the child who this king has talked about would n't ever worry the lady .	the child who this king has n't talked about would ever worry the lady .
that girl that had remembered the snakes would n't ever grow .	that girl that had n't remembered the snakes would ever grow .
the boy who had heard the men could n't ever move the bicycle .	the boy who had n't heard the men could ever move the bicycle .
the doctors who do like these mice have n't ever passed the school .	the doctors who do n't like these mice have ever passed the school .
the guys that can eat can n't ever eat .	the guys that can n't eat can ever eat .
the bottle that that queen had seen can n't ever roll away .	the bottle that that queen had n't seen can ever roll away .
this dentist that has seen the people had n't ever remembered that cup .	this dentist that has n't seen the people had ever remembered that cup .
the turtle that should run did n't ever think about the candles .	the turtle that should n't run did ever think about the candles .
that woman who did keep this book had n't ever dropped the pictures .	that woman who did n't keep this book had ever dropped the pictures .
these women who can scream had n't ever answered those guys .	these women who can n't scream had ever answered those guys .
this customer who this customer had talked about does n't ever smile .	this customer who this customer had n't talked about does ever smile .
the people that have noticed that woman had n't ever grown .	the people that have n't noticed that woman had ever grown .
that girl who would talk about this chair has n't ever found this person .	that girl who would n't talk about this chair has ever found this person .
the children that should eat have n't ever noticed those cars .	the children that should n't eat have ever noticed those cars .
that book that this guy has seen had n't ever broken those bowls .	that book that this guy has n't seen had ever broken those bowls .
the rocket that can drop should n't ever roll away .	the rocket that can n't drop should ever roll away .
those children who have heard the woman should n't ever laugh .	those children who have n't heard the woman should ever laugh .
the spoon that the driver had seen can n't ever break that toy .	the spoon that the driver had n't seen can ever break that toy .
the patient who can drop the toy can n't ever buy these spoons .	the patient who can n't drop the toy can ever buy these spoons .
that dentist who should return to the rooms had n't ever dropped these spoons .	that dentist who should n't return to the rooms had ever dropped these spoons .
those boys who would steal that plane have n't ever laughed .	those boys who would n't steal that plane have ever laughed .
these birds that should see the cups had n't ever learned .	these birds that should n't see the cups had ever learned .
these snakes that the teachers would talk about do n't ever learn .	these snakes that the teachers would n't talk about do ever learn .
the shoes that had moved could n't ever move .	the shoes that had n't moved could ever move .
this adult who did like the turtle had n't ever heard this adult .	this adult who did n't like the turtle had ever heard this adult .
that driver that the guy had noticed could n't ever break the dish .	that driver that the guy had n't noticed could ever break the dish .
the customer who the man does sound like does n't ever yell .	the customer who the man does n't sound like does ever yell .
the doors that those men have thought about have n't ever moved .	the doors that those men have n't thought about have ever moved .
that driver who can hear this king had n't ever brought the beds .	that driver who can n't hear this king had ever brought the beds .
these shoes that the children have noticed do n't ever break the spoons .	these shoes that the children have n't noticed do ever break the spoons .
this lady who had walked through the mall can n't ever teach these girls .	this lady who had n't walked through the mall can ever teach these girls .
the teacher who would look like these cats does n't ever yell .	the teacher who would n't look like these cats does ever yell .
the children that had thought about those bags do n't ever love this bottle .	the children that had n't thought about those bags do ever love this bottle .
that lady who has passed the hospital had n't ever helped this girl .	that lady who has n't passed the hospital had ever helped this girl .
this dancer that can know the teachers had n't ever eaten .	this dancer that can n't know the teachers had ever eaten .
this doctor who has remembered the bottle had n't ever worried that dancer .	this doctor who has n't remembered the bottle had ever worried that dancer .
those ladies who can return to this bank should n't ever take those shirts .	those ladies who can n't return to this bank should ever take those shirts .
these mice that have run have n't ever remembered that cat .	these mice that have n't run have ever remembered that cat .
the guys that have noticed this candle have n't ever thought about those bags .	the guys that have n't noticed this candle have ever thought about those bags .
those boys who did lose the trucks do n't ever cry .	those boys who did n't lose the trucks do ever cry .
the dentist who has run around the park can n't ever work with that girl .	the dentist who has n't run around the park can ever work with that girl .
those people who should sound like that dancer do n't ever buy that cup .	those people who should n't sound like that dancer do ever buy that cup .
this girl who had seen that crayon would n't ever practice .	this girl who had n't seen that crayon would ever practice .
those men who do return to that hospital can n't ever win .	those men who do n't return to that hospital can ever win .
this dog that had learned did n't ever like the plate .	this dog that had n't learned did ever like the plate .
the dancer that the patient could talk about has n't ever run .	the dancer that the patient could n't talk about has ever run .
the teacher who should sell the cars would n't ever buy this bag .	the teacher who should n't sell the cars would ever buy this bag .
these birds that those girls could hear had n't ever noticed the dish .	these birds that those girls could n't hear had ever noticed the dish .
that dog that does hear those dogs had n't ever noticed that book .	that dog that does n't hear those dogs had ever noticed that book .
the women that would notice these cars have n't ever eaten .	the women that would n't notice these cars have ever eaten .
the boys who would know the doctor did n't ever look like that guy .	the boys who would n't know the doctor did ever look like that guy .
this dentist who would hate those cars would n't ever whisper .	this dentist who would n't hate those cars would ever whisper .
these girls who had cleaned this doll can n't ever yell .	these girls who had n't cleaned this doll can ever yell .
this person who would lose has n't ever found this chair .	this person who would n't lose has ever found this chair .
these doctors who should love this man would n't ever whisper .	these doctors who should n't love this man would ever whisper .
this shirt that has broken does n't ever break .	this shirt that has n't broken does ever break .
these people who had made these dolls should n't ever praise those guys .	these people who had n't made these dolls should ever praise those guys .
that dentist who the teacher should sound like has n't ever bought this chair .	that dentist who the teacher should n't sound like has ever bought this chair .
the doctor who this dentist can sound like has n't ever helped this adult .	the doctor who this dentist can n't sound like has ever helped this adult .
this patient who this patient had talked about has n't ever moved the chair .	this patient who this patient had n't talked about has ever moved the chair .
the mice that could run had n't ever run .	the mice that could n't run had ever run .
this cup that the person would talk about has n't ever rolled away .	this cup that the person would n't talk about has ever rolled away .
the dancer who had thought about the book has n't ever visited that child .	the dancer who had n't thought about the book has ever visited that child .
that customer that had noticed that rocket has n't ever run .	that customer that had n't noticed that rocket has ever run .
the ladies who had noticed that man have n't ever worried that driver .	the ladies who had n't noticed that man have ever worried that driver .
the teachers that had remembered these doctors can n't ever like the queen .	the teachers that had n't remembered these doctors can ever like the queen .
the woman who had heard that customer has n't ever dropped the window .	the woman who had n't heard that customer has ever dropped the window .
that guy who that patient had talked about had n't ever taken that shirt .	that guy who that patient had n't talked about had ever taken that shirt .
those teachers who would remember the turtles would n't ever answer these ladies .	those teachers who would n't remember the turtles would ever answer these ladies .
the patient who that child does talk about should n't ever buy these boats .	the patient who that child does n't talk about should ever buy these boats .
those girls who had talked about these pictures would n't ever whisper .	those girls who had n't talked about these pictures would ever whisper .
that crayon that the snake has noticed had n't ever broken those toys .	that crayon that the snake has n't noticed had ever broken those toys .
these people who had yelled did n't ever lift this bowl .	these people who had n't yelled did ever lift this bowl .
this customer that this driver did see does n't ever break these cars .	this customer that this driver did n't see does ever break these cars .
the birds that those men had heard had n't ever noticed that glass .	the birds that those men had n't heard had ever noticed that glass .
the doctor who had heard these ladies had n't ever worked with those girls .	the doctor who had n't heard these ladies had ever worked with those girls .
the girls who have heard the lady should n't ever cry .	the girls who have n't heard the lady should ever cry .
this queen who had heard the girl has n't ever heard the girls .	this queen who had n't heard the girl has ever heard the girls .
the man who had talked about that rabbit did n't ever lose .	the man who had n't talked about that rabbit did ever lose .
that king who has heard the hamster did n't ever bring these bottles .	that king who has n't heard the hamster did ever bring these bottles .
that hamster that the girl has heard has n't ever learned .	that hamster that the girl has n't heard has ever learned .
this patient who could hear these dogs had n't ever yelled .	this patient who could n't hear these dogs had ever yelled .
the teachers who would sound like the teachers can n't ever cough .	the teachers who would n't sound like the teachers can ever cough .
this woman that has noticed this rabbit would n't ever grow .	this woman that has n't noticed this rabbit would ever grow .
that crayon that would break has n't ever moved .	that crayon that would n't break has ever moved .
those children who did like this king have n't ever lost these women .	those children who did n't like this king have ever lost these women .
those women who had talked about the snake can n't ever take that door .	those women who had n't talked about the snake can ever take that door .
the child who has thought about this window had n't ever fixed the bottles .	the child who has n't thought about this window had ever fixed the bottles .
this button that this child does keep did n't ever roll away .	this button that this child does n't keep did ever roll away .
that customer that this woman does talk about has n't ever thought about the bed .	that customer that this woman does n't talk about has ever thought about the bed .
the lady that had grown had n't ever noticed this boat .	the lady that had n't grown had ever noticed this boat .
that adult who could clean the bowls has n't ever cried .	that adult who could n't clean the bowls has ever cried .
these ladies that have heard this person should n't ever think about the dishes .	these ladies that have n't heard this person should ever think about the dishes .
that man who would think about this rabbit had n't ever won .	that man who would n't think about this rabbit had ever won .
the shoe that this mouse had thought about would n't ever drop .	the shoe that this mouse had n't thought about would ever drop .
that driver who has talked about the dogs has n't ever thrown these spoons .	that driver who has n't talked about the dogs has ever thrown these spoons .
this girl who can move that bag has n't ever worked with the king .	this girl who can n't move that bag has ever worked with the king .
the plates that these teachers have brought have n't ever moved .	the plates that these teachers have n't brought have ever moved .
that dentist who has left the park had n't ever worked with the person .	that dentist who has n't left the park had ever worked with the person .
the child who would talk about that mirror should n't ever run around that hospital .	the child who would n't talk about that mirror should ever run around that hospital .
the man who can sound like that person had n't ever found this girl .	the man who can n't sound like that person had ever found this girl .
these ladies who the teachers had heard did n't ever sing .	these ladies who the teachers had n't heard did ever sing .
this teacher who did hate this teacher does n't ever practice .	this teacher who did n't hate this teacher does ever practice .
the dog that had eaten has n't ever remembered those guys .	the dog that had n't eaten has ever remembered those guys .
that king who does drive to this mall should n't ever make that cup .	that king who does n't drive to this mall should ever make that cup .
that dancer that the person has seen would n't ever break that plane .	that dancer that the person has n't seen would ever break that plane .
the book that this lady could hold should n't ever roll away .	the book that this lady could n't hold should ever roll away .
these doctors that these children should know have n't ever grown .	these doctors that these children should n't know have ever grown .
the lady that the guy does talk about has n't ever grown .	the lady that the guy does n't talk about has ever grown .
the men who would remember that car have n't ever talked to these people .	the men who would n't remember that car have ever talked to these people .
that chair that this boy can hate should n't ever break those bowls .	that chair that this boy can n't hate should ever break those bowls .
the mouse that had heard this king has n't ever grown .	the mouse that had n't heard this king has ever grown .
that adult who had talked can n't ever worry these people .	that adult who had n't talked can ever worry these people .
the king who the child could talk about had n't ever gone to this room .	the king who the child could n't talk about had ever gone to this room .
those people who have painted have n't ever painted .	those people who have n't painted have ever painted .
this doctor who could sound like those women should n't ever keep these glasses .	this doctor who could n't sound like those women should ever keep these glasses .
the guys who have won have n't ever waved .	the guys who have n't won have ever waved .
the man who did hear the queen has n't ever made the car .	the man who did n't hear the queen has ever made the car .
the pictures that those girls have seen have n't ever moved .	the pictures that those girls have n't seen have ever moved .
the boys who have won had n't ever dropped the hats .	the boys who have n't won had ever dropped the hats .
this patient that has remembered this rocket can n't ever like these cats .	this patient that has n't remembered this rocket can ever like these cats .
that guy who this king had heard had n't ever cleaned this hat .	that guy who this king had n't heard had ever cleaned this hat .
these girls that do eat have n't ever run .	these girls that do n't eat have ever run .
this customer who could buy the books had n't ever held those shirts .	this customer who could n't buy the books had ever held those shirts .
those girls who did run around the library can n't ever have that bottle .	those girls who did n't run around the library can ever have that bottle .
those rabbits that have remembered this spoon have n't ever remembered this turtle .	those rabbits that have n't remembered this spoon have ever remembered this turtle .
the bird that this girl had seen has n't ever broken the window .	the bird that this girl had n't seen has ever broken the window .
the fork that could move had n't ever moved .	the fork that could n't move had ever moved .
the guy who has moved those forks has n't ever taken the doors .	the guy who has n't moved those forks has ever taken the doors .
this dog that had remembered these shirts had n't ever remembered those ladies .	this dog that had n't remembered these shirts had ever remembered those ladies .
that queen that can run would n't ever forget the books .	that queen that can n't run would ever forget the books .
that doctor who this person would look like did n't ever sell those bottles .	that doctor who this person would n't look like did ever sell those bottles .
this guy who can sound like this guy could n't ever sing .	this guy who can n't sound like this guy could ever sing .
the teachers who have laughed do n't ever know this dentist .	the teachers who have n't laughed do ever know this dentist .
these cars that the guys have noticed should n't ever drop .	these cars that the guys have n't noticed should ever drop .
the books that the men had thought about had n't ever broken .	the books that the men had n't thought about had ever broken .
that customer who would scream can n't ever bother the guy .	that customer who would n't scream can ever bother the guy .
the doctors who can make this truck have n't ever visited this teacher .	the doctors who can n't make this truck have ever visited this teacher .
these teachers that do run would n't ever hate the boat .	these teachers that do n't run would ever hate the boat .
the driver who had found the trucks has n't ever talked about the ship .	the driver who had n't found the trucks has ever talked about the ship .
these teachers that would know those people had n't ever seen that guy .	these teachers that would n't know those people had ever seen that guy .
those children who would exercise do n't ever bother this girl .	those children who would n't exercise do ever bother this girl .
that guy who has remembered the dogs can n't ever know this guy .	that guy who has n't remembered the dogs can ever know this guy .
those guys who the ladies should talk about had n't ever passed that hospital .	those guys who the ladies should n't talk about had ever passed that hospital .
these cars that the guys have fixed did n't ever drop .	these cars that the guys have n't fixed did ever drop .
that girl who had heard the girl would n't ever paint .	that girl who had n't heard the girl would ever paint .
that queen who has walked through the mall has n't ever made those bowls .	that queen who has n't walked through the mall has ever made those bowls .
the men who have seen the mice have n't ever worked with this girl .	the men who have n't seen the mice have ever worked with this girl .
these children who can make those glasses should n't ever teach the adult .	these children who can n't make those glasses should ever teach the adult .
the cup that the girl had thought about has n't ever broken the chairs .	the cup that the girl had n't thought about has ever broken the chairs .
those chairs that these children have seen had n't ever dropped .	those chairs that these children have n't seen had ever dropped .
these girls who would sound like the hamster should n't ever drive to the bank .	these girls who would n't sound like the hamster should ever drive to the bank .
the women who did buy the dishes have n't ever dropped that ship .	the women who did n't buy the dishes have ever dropped that ship .
that dancer who would lift those dishes has n't ever taken the cars .	that dancer who would n't lift those dishes has ever taken the cars .
that dentist who should sell the picture has n't ever left this school .	that dentist who should n't sell the picture has ever left this school .
those men who do look like this boy did n't ever sneeze .	those men who do n't look like this boy did ever sneeze .
the teachers who the people had heard have n't ever yelled .	the teachers who the people had n't heard have ever yelled .
the woman who would know the turtle had n't ever gone to those schools .	the woman who would n't know the turtle had ever gone to those schools .
the customer who had noticed that truck should n't ever wave .	the customer who had n't noticed that truck should ever wave .
that teacher who the customer has heard did n't ever steal the glass .	that teacher who the customer has n't heard did ever steal the glass .
this lady who had dropped this fork had n't ever talked about the books .	this lady who had n't dropped this fork had ever talked about the books .
that woman who has seen this ship had n't ever thrown these spoons .	that woman who has n't seen this ship had ever thrown these spoons .
the driver who had talked about those snakes does n't ever buy the box .	the driver who had n't talked about those snakes does ever buy the box .
the girl who that teacher would look like did n't ever scare this man .	the girl who that teacher would n't look like did ever scare this man .
the woman who has painted had n't ever brought these cars .	the woman who has n't painted had ever brought these cars .
this queen who would wave has n't ever dropped this book .	this queen who would n't wave has ever dropped this book .
the customer who has walked through those schools would n't ever lose the windows .	the customer who has n't walked through those schools would ever lose the windows .
this teacher that this doctor did talk about had n't ever seen this dentist .	this teacher that this doctor did n't talk about had ever seen this dentist .
this dancer that that girl can talk about had n't ever learned .	this dancer that that girl can n't talk about had ever learned .
the guys that have seen those doors had n't ever remembered this driver .	the guys that have n't seen those doors had ever remembered this driver .
the man who could talk about that shirt had n't ever won .	the man who could n't talk about that shirt had ever won .
those men who would cough had n't ever worked with the teachers .	those men who would n't cough had ever worked with the teachers .
the queen that can eat would n't ever eat .	the queen that can n't eat would ever eat .
the dancer who that dancer has talked about can n't ever drive to the kitchen .	the dancer who that dancer has n't talked about can ever drive to the kitchen .
this guy who has painted could n't ever fix this mirror .	this guy who has n't painted could ever fix this mirror .
that lady who did hear this woman did n't ever cry .	that lady who did n't hear this woman did ever cry .
this crayon that that person had talked about does n't ever break these dolls .	this crayon that that person had n't talked about does ever break these dolls .
these men who have held those spoons would n't ever look like the dancer .	these men who have n't held those spoons would ever look like the dancer .
those shirts that could roll away can n't ever drop .	those shirts that could n't roll away can ever drop .
the guys who had gone to the restaurant do n't ever sell those bags .	the guys who had n't gone to the restaurant do ever sell those bags .
the doctor who would talk about the crayons had n't ever confused the doctors .	the doctor who would n't talk about the crayons had ever confused the doctors .
those crayons that the turtles had remembered would n't ever move .	those crayons that the turtles had n't remembered would ever move .
the king who could throw that doll has n't ever talked .	the king who could n't throw that doll has ever talked .
this man who had seen those turtles would n't ever hold the door .	this man who had n't seen those turtles would ever hold the door .
the child that the girl had heard does n't ever see that customer .	the child that the girl had n't heard does ever see that customer .
the doctors that could remember the chairs can n't ever like that window .	the doctors that could n't remember the chairs can ever like that window .
the birds that those ladies did know should n't ever learn .	the birds that those ladies did n't know should ever learn .
this dentist who has lost those chairs can n't ever throw this picture .	this dentist who has n't lost those chairs can ever throw this picture .
the girls who have painted could n't ever teach this driver .	the girls who have n't painted could ever teach this driver .
that boy who had heard this bird has n't ever confused this driver .	that boy who had n't heard this bird has ever confused this driver .
this dish that the man did like has n't ever dropped .	this dish that the man did n't like has ever dropped .
the chairs that had moved could n't ever break .	the chairs that had n't moved could ever break .
this woman who had talked about those toys does n't ever throw the car .	this woman who had n't talked about those toys does ever throw the car .
that queen that had run did n't ever notice this button .	that queen that had n't run did ever notice this button .
those guys who these boys do hear did n't ever take that plate .	those guys who these boys do n't hear did ever take that plate .
the king that has remembered these teachers had n't ever remembered these doctors .	the king that has n't remembered these teachers had ever remembered these doctors .
this lady who did hate those dogs has n't ever passed these schools .	this lady who did n't hate those dogs has ever passed these schools .
the children that should run did n't ever think about those mice .	the children that should n't run did ever think about those mice .
the box that this rabbit does hate does n't ever break .	the box that this rabbit does n't hate does ever break .
that customer who does run around this park has n't ever lost .	that customer who does n't run around this park has ever lost .
this girl who this man has heard can n't ever worry the women .	this girl who this man has n't heard can ever worry the women .
this king who should see the driver should n't ever yell .	this king who should n't see the driver should ever yell .
that boy who has brought that door could n't ever win .	that boy who has n't brought that door could ever win .
the glass that this child can talk about has n't ever rolled away .	the glass that this child can n't talk about has ever rolled away .
this snake that had run has n't ever learned .	this snake that had n't run has ever learned .
the person who this teacher had talked about has n't ever lost those children .	the person who this teacher had n't talked about has ever lost those children .
these people who the guys do sound like could n't ever clean the boxes .	these people who the guys do n't sound like could ever clean the boxes .
that snake that this king would sound like has n't ever noticed these chairs .	that snake that this king would n't sound like has ever noticed these chairs .
those cats that can grow can n't ever hate those boats .	those cats that can n't grow can ever hate those boats .
the guy that had remembered those rabbits had n't ever seen the couch .	the guy that had n't remembered those rabbits had ever seen the couch .
this woman who had heard that mouse can n't ever praise these girls .	this woman who had n't heard that mouse can ever praise these girls .
that guy who should talk about the bag has n't ever cleaned these cars .	that guy who should n't talk about the bag has ever cleaned these cars .
this doctor who did see those people does n't ever lose .	this doctor who did n't see those people does ever lose .
the customer that that lady had talked about would n't ever forget the person .	the customer that that lady had n't talked about would ever forget the person .
those people who have cleaned that book would n't ever sing .	those people who have n't cleaned that book would ever sing .
that teacher that the dentist has talked about has n't ever grown .	that teacher that the dentist has n't talked about has ever grown .
these dogs that would learn did n't ever eat .	these dogs that would n't learn did ever eat .
the teacher who should take this plane had n't ever talked about those plates .	the teacher who should n't take this plane had ever talked about those plates .
that bicycle that this queen should remember has n't ever broken these books .	that bicycle that this queen should n't remember has ever broken these books .
these people that have heard this driver did n't ever notice that cat .	these people that have n't heard this driver did ever notice that cat .
that rabbit that that adult would hear had n't ever eaten .	that rabbit that that adult would n't hear had ever eaten .
the woman who does yell can n't ever know this guy .	the woman who does n't yell can ever know this guy .
that lady who had seen the spoon had n't ever answered these boys .	that lady who had n't seen the spoon had ever answered these boys .
the car that this horse would remember could n't ever break that mirror .	the car that this horse would n't remember could ever break that mirror .
that couch that has broken should n't ever roll away .	that couch that has n't broken should ever roll away .
this customer who that dentist had talked about has n't ever bothered the teacher .	this customer who that dentist had n't talked about has ever bothered the teacher .
that ring that the driver should remember should n't ever move .	that ring that the driver should n't remember should ever move .
that king who did paint can n't ever answer that girl .	that king who did n't paint can ever answer that girl .
that lady who has thought about those dogs would n't ever lift the bottles .	that lady who has n't thought about those dogs would ever lift the bottles .
the girls that do know those men should n't ever love the bags .	the girls that do n't know those men should ever love the bags .
this teacher who should think about this candle has n't ever painted .	this teacher who should n't think about this candle has ever painted .
these men who should see these horses have n't ever lost .	these men who should n't see these horses have ever lost .
this lady who had thrown the trucks has n't ever kept that book .	this lady who had n't thrown the trucks has ever kept that book .
that mouse that should hate those windows could n't ever learn .	that mouse that should n't hate those windows could ever learn .
these pictures that these guys have seen have n't ever broken .	these pictures that these guys have n't seen have ever broken .
this queen that should look like that dog has n't ever grown .	this queen that should n't look like that dog has ever grown .
that dentist that the dentist does talk about would n't ever break the book .	that dentist that the dentist does n't talk about would ever break the book .
this adult who has laughed had n't ever talked about that boat .	this adult who has n't laughed had ever talked about that boat .
that customer who does lie has n't ever lost .	that customer who does n't lie has ever lost .
that guy who had talked about this rocket can n't ever shake that car .	that guy who had n't talked about this rocket can ever shake that car .
the teachers who can hate this lady did n't ever work with the children .	the teachers who can n't hate this lady did ever work with the children .
that customer who could cry has n't ever walked through the schools .	that customer who could n't cry has ever walked through the schools .
that woman who had thought about the dancer can n't ever win .	that woman who had n't thought about the dancer can ever win .
this customer who has remembered that bottle had n't ever painted .	this customer who has n't remembered that bottle had ever painted .
this driver who had thought about this customer has n't ever made that book .	this driver who had n't thought about this customer has ever made that book .
this woman who should talk about the mirror had n't ever gone to the kitchen .	this woman who should n't talk about the mirror had ever gone to the kitchen .
the dentist that had run had n't ever eaten .	the dentist that had n't run had ever eaten .
the rabbit that had seen this box had n't ever noticed the hats .	the rabbit that had n't seen this box had ever noticed the hats .
these women who had walked through this room had n't ever visited this boy .	these women who had n't walked through this room had ever visited this boy .
that teacher who can go to those schools would n't ever drop those doors .	that teacher who can n't go to those schools would ever drop those doors .
the candles that the doctors had seen had n't ever broken .	the candles that the doctors had n't seen had ever broken .
the doctor who can talk about the rug can n't ever worry those men .	the doctor who can n't talk about the rug can ever worry those men .
these teachers who would look like the snakes have n't ever painted .	these teachers who would n't look like the snakes have ever painted .
this driver who has seen the child has n't ever heard this guy .	this driver who has n't seen the child has ever heard this guy .
this mirror that should move could n't ever move .	this mirror that should n't move could ever move .
these people who did shake those trucks have n't ever scared the driver .	these people who did n't shake those trucks have ever scared the driver .
this window that the man has kept would n't ever roll away .	this window that the man has n't kept would ever roll away .
the dancer who has bought that doll did n't ever scare the boy .	the dancer who has n't bought that doll did ever scare the boy .
that girl who had noticed the ship should n't ever buy the doors .	that girl who had n't noticed the ship should ever buy the doors .
this dentist that did notice these birds should n't ever love those forks .	this dentist that did n't notice these birds should ever love those forks .
that dentist who had noticed the children did n't ever praise this adult .	that dentist who had n't noticed the children did ever praise this adult .
the teachers who have lost the shirt would n't ever keep these shoes .	the teachers who have n't lost the shirt would ever keep these shoes .
these chairs that the boys should like have n't ever broken those bags .	these chairs that the boys should n't like have ever broken those bags .
the ship that the customer can remember has n't ever moved .	the ship that the customer can n't remember has ever moved .
those guys who would remember the lady had n't ever laughed .	those guys who would n't remember the lady had ever laughed .
the teacher who could look like these horses would n't ever lie .	the teacher who could n't look like these horses would ever lie .
the driver who has thought about these children would n't ever leave the school .	the driver who has n't thought about these children would ever leave the school .
that boy who could think about those girls had n't ever painted .	that boy who could n't think about those girls had ever painted .
the customer who has noticed those dolls could n't ever have those books .	the customer who has n't noticed those dolls could ever have those books .
that child that had run had n't ever seen the birds .	that child that had n't run had ever seen the birds .
this girl that the guy has talked about has n't ever broken these plates .	this girl that the guy has n't talked about has ever broken these plates .
those cars that had moved would n't ever move .	those cars that had n't moved would ever move .
that teacher who that doctor has talked about would n't ever teach this patient .	that teacher who that doctor has n't talked about would ever teach this patient .
these cups that would drop have n't ever broken .	these cups that would n't drop have ever broken .
this patient who had waved can n't ever laugh .	this patient who had n't waved can ever laugh .
that guy who that king has talked about had n't ever held those cars .	that guy who that king has n't talked about had ever held those cars .
the teachers who have passed those schools did n't ever talk .	the teachers who have n't passed those schools did ever talk .
the box that the man should like has n't ever dropped .	the box that the man should n't like has ever dropped .
the guys who did wave could n't ever sound like the rabbits .	the guys who did n't wave could ever sound like the rabbits .
that driver who should keep those bowls does n't ever appreciate this driver .	that driver who should n't keep those bowls does ever appreciate this driver .
this customer that can hear these birds would n't ever grow .	this customer that can n't hear these birds would ever grow .
this doctor who did lie does n't ever sell the doll .	this doctor who did n't lie does ever sell the doll .
