was that man talking about those turtles ?	were that man talking about those turtles ?
is n't the man painting ?	are n't the man painting ?
has the driver brought that car ?	have the driver brought that car ?
does n't that adult hear that doctor ?	do n't that adult hear that doctor ?
do the children whisper ?	does the children whisper ?
has this boy helped the teacher ?	have this boy helped the teacher ?
have n't the ladies worried that patient ?	has n't the ladies worried that patient ?
does n't the boy praise this patient ?	do n't the boy praise this patient ?
has n't this couch broken ?	have n't this couch broken ?
has that guy made these books ?	have that guy made these books ?
does the book roll away ?	do the book roll away ?
does that adult pass that library ?	do that adult pass that library ?
do those doctors win ?	does those doctors win ?
was n't the woman eating ?	were n't the woman eating ?
does this queen yell ?	do this queen yell ?
was n't that customer finding the bottle ?	were n't that customer finding the bottle ?
do the people hear the snakes ?	does the people hear the snakes ?
have n't the children painted ?	has n't the children painted ?
have these forks moved ?	has these forks moved ?
does n't that door break ?	do n't that door break ?
does that spoon drop ?	do that spoon drop ?
was this bowl rolling away ?	were this bowl rolling away ?
have n't those men held those bowls ?	has n't those men held those bowls ?
do the bags break ?	does the bags break ?
is that dancer thinking about this doctor ?	are that dancer thinking about this doctor ?
have n't the teachers lost the child ?	has n't the teachers lost the child ?
is the queen thinking about the doctors ?	are the queen thinking about the doctors ?
does that dentist grow ?	do that dentist grow ?
does this lady lose ?	do this lady lose ?
does n't the boy lose that candle ?	do n't the boy lose that candle ?
have n't these cats remembered the king ?	has n't these cats remembered the king ?
has that dentist bought the dolls ?	have that dentist bought the dolls ?
does that rocket move ?	do that rocket move ?
does n't that patient cry ?	do n't that patient cry ?
were n't the women leaving this school ?	was n't the women leaving this school ?
does n't that shoe break the spoon ?	do n't that shoe break the spoon ?
are these snakes growing ?	is these snakes growing ?
is the patient buying the books ?	are the patient buying the books ?
have n't the rabbits grown ?	has n't the rabbits grown ?
does this rocket break ?	do this rocket break ?
do the girls drop the book ?	does the girls drop the book ?
does n't that queen sell those rings ?	do n't that queen sell those rings ?
have those women walked through those rooms ?	has those women walked through those rooms ?
were n't these children keeping that plane ?	was n't these children keeping that plane ?
has that customer lost ?	have that customer lost ?
does the doctor listen to this doctor ?	do the doctor listen to this doctor ?
was the girl whispering ?	were the girl whispering ?
has this guy moved the dishes ?	have this guy moved the dishes ?
has n't this man broken that ship ?	have n't this man broken that ship ?
has n't the person helped the man ?	have n't the person helped the man ?
has the boy lost ?	have the boy lost ?
do n't those shoes break the bags ?	does n't those shoes break the bags ?
do the glasses break the glass ?	does the glasses break the glass ?
has this driver run ?	have this driver run ?
does n't the girl find this car ?	do n't the girl find this car ?
was n't this patient thinking about the bottle ?	were n't this patient thinking about the bottle ?
do n't those boys cry ?	does n't those boys cry ?
has n't the teacher held those rings ?	have n't the teacher held those rings ?
do n't those women talk to these people ?	does n't those women talk to these people ?
are those snakes breaking that picture ?	is those snakes breaking that picture ?
has that driver gone to that museum ?	have that driver gone to that museum ?
is the customer painting ?	are the customer painting ?
do the boys pass the library ?	does the boys pass the library ?
is this boy thinking about that king ?	are this boy thinking about that king ?
was n't the queen losing ?	were n't the queen losing ?
does that dancer scream ?	do that dancer scream ?
has the guy made that crayon ?	have the guy made that crayon ?
was n't that driver talking ?	were n't that driver talking ?
does n't this hat move ?	do n't this hat move ?
were these doctors talking to that person ?	was these doctors talking to that person ?
do n't those teachers grow ?	does n't those teachers grow ?
is the guy talking about that boy ?	are the guy talking about that boy ?
are the children losing this car ?	is the children losing this car ?
do n't these doctors know the snakes ?	does n't these doctors know the snakes ?
does n't the girl help the ladies ?	do n't the girl help the ladies ?
has n't the doctor noticed this shirt ?	have n't the doctor noticed this shirt ?
has n't the person dropped the shirt ?	have n't the person dropped the shirt ?
does that customer steal those cups ?	do that customer steal those cups ?
are those buttons breaking those dolls ?	is those buttons breaking those dolls ?
do n't the teachers scream ?	does n't the teachers scream ?
do n't those women love the doctors ?	does n't those women love the doctors ?
does n't the adult bring the chair ?	do n't the adult bring the chair ?
does n't that child see the spoon ?	do n't that child see the spoon ?
is n't the child learning ?	are n't the child learning ?
does the person clean the rings ?	do the person clean the rings ?
was the king working with the woman ?	were the king working with the woman ?
have n't these teachers heard the teachers ?	has n't these teachers heard the teachers ?
has n't the couch broken the spoon ?	have n't the couch broken the spoon ?
have n't these chairs dropped ?	has n't these chairs dropped ?
does n't that dancer understand this patient ?	do n't that dancer understand this patient ?
has n't that snake seen these boys ?	have n't that snake seen these boys ?
were the shoes breaking ?	was the shoes breaking ?
have n't these ladies thought about the picture ?	has n't these ladies thought about the picture ?
have those ladies noticed that dancer ?	has those ladies noticed that dancer ?
have those guys gone to the school ?	has those guys gone to the school ?
are these people talking to those women ?	is these people talking to those women ?
does n't the doctor whisper ?	do n't the doctor whisper ?
do n't these girls shake that dish ?	does n't these girls shake that dish ?
has this doctor lost ?	have this doctor lost ?
have those teachers thrown the windows ?	has those teachers thrown the windows ?
was n't that boy talking to the person ?	were n't that boy talking to the person ?
has this doctor eaten ?	have this doctor eaten ?
does this doctor make those cups ?	do this doctor make those cups ?
are these turtles breaking the forks ?	is these turtles breaking the forks ?
are n't those teachers waving ?	is n't those teachers waving ?
does the hamster forget that person ?	do the hamster forget that person ?
were n't those teachers leaving the park ?	was n't those teachers leaving the park ?
do n't these men listen to that driver ?	does n't these men listen to that driver ?
are the doctors learning ?	is the doctors learning ?
do n't these guys run around these schools ?	does n't these guys run around these schools ?
was n't this boy reading ?	were n't this boy reading ?
are these glasses rolling away ?	is these glasses rolling away ?
has that horse learned ?	have that horse learned ?
are these women finding these candles ?	is these women finding these candles ?
were n't those ladies finding those spoons ?	was n't those ladies finding those spoons ?
have those guys lost ?	has those guys lost ?
does n't this dentist help the boys ?	do n't this dentist help the boys ?
is the doctor thinking about these dolls ?	are the doctor thinking about these dolls ?
does this queen talk ?	do this queen talk ?
does the horse learn ?	do the horse learn ?
does n't this door move ?	do n't this door move ?
do these boys break this spoon ?	does these boys break this spoon ?
is n't this customer buying the cups ?	are n't this customer buying the cups ?
are the doctors losing ?	is the doctors losing ?
has the person heard those doctors ?	have the person heard those doctors ?
do these hats drop ?	does these hats drop ?
was the customer screaming ?	were the customer screaming ?
are n't these cats thinking about this plate ?	is n't these cats thinking about this plate ?
does that adult lose the window ?	do that adult lose the window ?
were these girls talking ?	was these girls talking ?
has n't that lady learned ?	have n't that lady learned ?
does this doctor scare those ladies ?	do this doctor scare those ladies ?
has n't this crayon rolled away ?	have n't this crayon rolled away ?
does n't that customer bother that teacher ?	do n't that customer bother that teacher ?
has the mirror dropped ?	have the mirror dropped ?
have n't the teachers yelled ?	has n't the teachers yelled ?
does n't the child read ?	do n't the child read ?
is the guy shaking these bowls ?	are the guy shaking these bowls ?
was this lady reading ?	were this lady reading ?
does n't that car drop ?	do n't that car drop ?
has n't this king heard the dog ?	have n't this king heard the dog ?
are those beds rolling away ?	is those beds rolling away ?
does the dancer buy this button ?	do the dancer buy this button ?
do those rabbits love the dancer ?	does those rabbits love the dancer ?
has n't this guy scared the girls ?	have n't this guy scared the girls ?
do n't the children help that doctor ?	does n't the children help that doctor ?
do those guys bring the rings ?	does those guys bring the rings ?
have n't those girls heard these rabbits ?	has n't those girls heard these rabbits ?
was this person finding that truck ?	were this person finding that truck ?
does that customer take that hat ?	do that customer take that hat ?
does n't the child look like that rabbit ?	do n't the child look like that rabbit ?
does this dancer fix these windows ?	do this dancer fix these windows ?
do n't the trucks roll away ?	does n't the trucks roll away ?
do those guys care for those doctors ?	does those guys care for those doctors ?
does n't the dentist see that plane ?	do n't the dentist see that plane ?
does n't the guy return to this kitchen ?	do n't the guy return to this kitchen ?
was n't that dancer thinking about the boy ?	were n't that dancer thinking about the boy ?
have these chairs broken the spoons ?	has these chairs broken the spoons ?
does n't the dancer stretch ?	do n't the dancer stretch ?
has this adult lost these men ?	have this adult lost these men ?
was n't this customer walking through this bank ?	were n't this customer walking through this bank ?
do those plates drop ?	does those plates drop ?
does this bottle break ?	do this bottle break ?
is n't this driver learning ?	are n't this driver learning ?
has n't the girl read ?	have n't the girl read ?
does the hamster love the boy ?	do the hamster love the boy ?
was n't that doctor crying ?	were n't that doctor crying ?
does the customer care for those people ?	do the customer care for those people ?
does n't this couch break that fork ?	do n't this couch break that fork ?
does n't the person sing ?	do n't the person sing ?
has n't that driver read ?	have n't that driver read ?
do n't the books break these toys ?	does n't the books break these toys ?
does n't this boy make these forks ?	do n't this boy make these forks ?
do the guys help that child ?	does the guys help that child ?
do those snakes eat ?	does those snakes eat ?
do the girls help this guy ?	does the girls help this guy ?
has this bottle rolled away ?	have this bottle rolled away ?
is that patient visiting the teachers ?	are that patient visiting the teachers ?
have these boys thought about those dolls ?	has these boys thought about those dolls ?
has this snake noticed that dancer ?	have this snake noticed that dancer ?
has n't this child visited the guys ?	have n't this child visited the guys ?
have n't those boats rolled away ?	has n't those boats rolled away ?
does the person visit the man ?	do the person visit the man ?
has n't this picture broken the couch ?	have n't this picture broken the couch ?
has n't this dentist confused this girl ?	have n't this dentist confused this girl ?
have these children cleaned the trucks ?	has these children cleaned the trucks ?
have n't these boys dropped the doll ?	has n't these boys dropped the doll ?
are n't these horses eating ?	is n't these horses eating ?
has this couch broken ?	have this couch broken ?
does this doctor run ?	do this doctor run ?
has this dancer painted ?	have this dancer painted ?
has the lady found this toy ?	have the lady found this toy ?
has n't the girl scared this boy ?	have n't the girl scared this boy ?
was n't that teacher cleaning the doors ?	were n't that teacher cleaning the doors ?
were these cars dropping ?	was these cars dropping ?
does the driver walk through this restaurant ?	do the driver walk through this restaurant ?
does n't the couch break these books ?	do n't the couch break these books ?
is that girl cleaning this fork ?	are that girl cleaning this fork ?
does n't the person have these hats ?	do n't the person have these hats ?
has this shirt moved ?	have this shirt moved ?
was this queen leaving this museum ?	were this queen leaving this museum ?
do n't the children find that bottle ?	does n't the children find that bottle ?
have the doctors worried this king ?	has the doctors worried this king ?
does that dentist have the dish ?	do that dentist have the dish ?
does that king have the toys ?	do that king have the toys ?
has n't that mouse eaten ?	have n't that mouse eaten ?
does the rabbit love the dog ?	do the rabbit love the dog ?
has n't the dentist walked through the hospital ?	have n't the dentist walked through the hospital ?
do these mice think about the children ?	does these mice think about the children ?
does n't that crayon roll away ?	do n't that crayon roll away ?
do n't these trucks roll away ?	does n't these trucks roll away ?
have the people gone to that library ?	has the people gone to that library ?
do n't these people make these cars ?	does n't these people make these cars ?
are n't the rings breaking those buttons ?	is n't the rings breaking those buttons ?
does n't this lady pass these rooms ?	do n't this lady pass these rooms ?
is the patient whispering ?	are the patient whispering ?
do these snakes break the book ?	does these snakes break the book ?
do n't those women sound like that cat ?	does n't those women sound like that cat ?
does n't that boy eat ?	do n't that boy eat ?
have those dogs broken that fork ?	has those dogs broken that fork ?
has n't this shoe moved ?	have n't this shoe moved ?
do n't those windows move ?	does n't those windows move ?
has the dancer gone to this park ?	have the dancer gone to this park ?
has n't that man read ?	have n't that man read ?
has n't that teacher run around these rooms ?	have n't that teacher run around these rooms ?
have those birds seen the crayon ?	has those birds seen the crayon ?
has the driver talked about this truck ?	have the driver talked about this truck ?
is n't the king cleaning the plates ?	are n't the king cleaning the plates ?
have those mice remembered the bottle ?	has those mice remembered the bottle ?
is n't the ring dropping ?	are n't the ring dropping ?
were the bowls breaking ?	was the bowls breaking ?
do n't the men sell that mirror ?	does n't the men sell that mirror ?
have n't the children found that queen ?	has n't the children found that queen ?
were n't these doctors thinking about these mice ?	was n't these doctors thinking about these mice ?
does n't that mirror break ?	do n't that mirror break ?
have the men lost that customer ?	has the men lost that customer ?
have those crayons moved ?	has those crayons moved ?
do the rabbits eat ?	does the rabbits eat ?
is n't that dancer breaking the pictures ?	are n't that dancer breaking the pictures ?
are n't these bottles breaking this toy ?	is n't these bottles breaking this toy ?
have these doctors cried ?	has these doctors cried ?
do n't those women pass those rooms ?	does n't those women pass those rooms ?
do the trucks move ?	does the trucks move ?
does this person bother the adult ?	do this person bother the adult ?
are these ladies talking ?	is these ladies talking ?
were these people shaking the cars ?	was these people shaking the cars ?
does n't the guy love the turtle ?	do n't the guy love the turtle ?
does n't the lady run around the kitchen ?	do n't the lady run around the kitchen ?
do n't the boys scare the dancer ?	does n't the boys scare the dancer ?
do n't these boats break ?	does n't these boats break ?
have n't those beds broken those books ?	has n't those beds broken those books ?
are n't the teachers bothering this king ?	is n't the teachers bothering this king ?
has n't that patient noticed the books ?	have n't that patient noticed the books ?
does n't that mouse like this couch ?	do n't that mouse like this couch ?
has this doctor confused these teachers ?	have this doctor confused these teachers ?
were n't these women learning ?	was n't these women learning ?
does n't that hamster notice this teacher ?	do n't that hamster notice this teacher ?
have n't these rings moved ?	has n't these rings moved ?
does n't the girl break this bicycle ?	do n't the girl break this bicycle ?
has n't the book broken the plane ?	have n't the book broken the plane ?
is n't the rocket dropping ?	are n't the rocket dropping ?
does n't this plate move ?	do n't this plate move ?
has n't this doctor bought the shirt ?	have n't this doctor bought the shirt ?
does that queen scare this child ?	do that queen scare this child ?
is n't that bed dropping ?	are n't that bed dropping ?
does n't that girl keep those chairs ?	do n't that girl keep those chairs ?
has that adult noticed that doctor ?	have that adult noticed that doctor ?
do the spoons break these glasses ?	does the spoons break these glasses ?
has n't the adult passed the museum ?	have n't the adult passed the museum ?
does n't this doctor find this plate ?	do n't this doctor find this plate ?
does this dentist lift those spoons ?	do this dentist lift those spoons ?
have n't those people lost ?	has n't those people lost ?
does that driver worry the dancer ?	do that driver worry the dancer ?
is this boy thinking about the shoe ?	are this boy thinking about the shoe ?
is n't that bed breaking these windows ?	are n't that bed breaking these windows ?
was the window rolling away ?	were the window rolling away ?
were n't the guys growing ?	was n't the guys growing ?
was the teacher practicing ?	were the teacher practicing ?
was n't the cat growing ?	were n't the cat growing ?
were those women laughing ?	was those women laughing ?
have these boys cleaned those rings ?	has these boys cleaned those rings ?
was this driver lying ?	were this driver lying ?
has n't this patient cried ?	have n't this patient cried ?
have n't these turtles eaten ?	has n't these turtles eaten ?
are those horses running ?	is those horses running ?
do n't these boys read ?	does n't these boys read ?
does the bicycle roll away ?	do the bicycle roll away ?
does the car drop ?	do the car drop ?
do these women keep these plates ?	does these women keep these plates ?
was this bicycle breaking ?	were this bicycle breaking ?
has n't the snake grown ?	have n't the snake grown ?
does n't that girl steal this shirt ?	do n't that girl steal this shirt ?
were these turtles learning ?	was these turtles learning ?
is n't that adult teaching these boys ?	are n't that adult teaching these boys ?
is n't that girl buying the ship ?	are n't that girl buying the ship ?
have these teachers taken those rings ?	has these teachers taken those rings ?
does n't this teacher worry the adult ?	do n't this teacher worry the adult ?
are n't the boats moving ?	is n't the boats moving ?
does n't this teacher hate the boxes ?	do n't this teacher hate the boxes ?
do n't those mice run ?	does n't those mice run ?
is n't the woman talking ?	are n't the woman talking ?
have n't those horses remembered the buttons ?	has n't those horses remembered the buttons ?
do those girls learn ?	does those girls learn ?
does n't the hat break ?	do n't the hat break ?
have n't the crayons dropped ?	has n't the crayons dropped ?
does that mouse run ?	do that mouse run ?
is this patient whispering ?	are this patient whispering ?
were these teachers running ?	was these teachers running ?
do the boys help this lady ?	does the boys help this lady ?
are n't the buttons dropping ?	is n't the buttons dropping ?
does the adult read ?	do the adult read ?
is this horse breaking the forks ?	are this horse breaking the forks ?
does n't that patient break that bottle ?	do n't that patient break that bottle ?
is n't the man laughing ?	are n't the man laughing ?
do these doctors scream ?	does these doctors scream ?
does n't that horse grow ?	do n't that horse grow ?
has n't this girl brought the spoons ?	have n't this girl brought the spoons ?
was that rabbit thinking about that woman ?	were that rabbit thinking about that woman ?
do the women sneeze ?	does the women sneeze ?
is n't the guy walking through that bank ?	are n't the guy walking through that bank ?
has n't that boy talked about the ring ?	have n't that boy talked about the ring ?
has n't this dancer read ?	have n't this dancer read ?
does n't this customer cough ?	do n't this customer cough ?
have those men thrown the books ?	has those men thrown the books ?
has n't the lady heard that dentist ?	have n't the lady heard that dentist ?
does this girl sing ?	do this girl sing ?
does n't this girl take these chairs ?	do n't this girl take these chairs ?
are those turtles learning ?	is those turtles learning ?
does n't that child look like the teachers ?	do n't that child look like the teachers ?
have the women scared these ladies ?	has the women scared these ladies ?
do n't those women work with the boy ?	does n't those women work with the boy ?
are those chairs dropping ?	is those chairs dropping ?
does that customer lie ?	do that customer lie ?
was that spoon rolling away ?	were that spoon rolling away ?
has the teacher found the mirror ?	have the teacher found the mirror ?
were those children shaking that box ?	was those children shaking that box ?
has this snake grown ?	have this snake grown ?
has n't the crayon dropped ?	have n't the crayon dropped ?
has n't that truck rolled away ?	have n't that truck rolled away ?
does n't the lady hear that teacher ?	do n't the lady hear that teacher ?
has the man brought this ring ?	have the man brought this ring ?
do those men fix these trucks ?	does those men fix these trucks ?
has n't that rabbit run ?	have n't that rabbit run ?
has this dentist answered that king ?	have this dentist answered that king ?
has this horse run ?	have this horse run ?
were these dogs running ?	was these dogs running ?
has that girl lost the doctor ?	have that girl lost the doctor ?
has n't the man broken the mirror ?	have n't the man broken the mirror ?
was the girl walking through that kitchen ?	were the girl walking through that kitchen ?
are n't these buttons rolling away ?	is n't these buttons rolling away ?
does n't this snake eat ?	do n't this snake eat ?
do n't these buttons move ?	does n't these buttons move ?
have n't those chairs broken ?	has n't those chairs broken ?
have n't the dishes rolled away ?	has n't the dishes rolled away ?
does n't the adult learn ?	do n't the adult learn ?
do those women lose ?	does those women lose ?
does the child throw these shirts ?	do the child throw these shirts ?
were these girls shaking the shoe ?	was these girls shaking the shoe ?
are the boys singing ?	is the boys singing ?
is this dancer helping the dentist ?	are this dancer helping the dentist ?
does this dentist sing ?	do this dentist sing ?
was that customer lying ?	were that customer lying ?
was n't this person walking through this room ?	were n't this person walking through this room ?
was n't this lady eating ?	were n't this lady eating ?
does n't that guy break that doll ?	do n't that guy break that doll ?
does this guy praise these women ?	do this guy praise these women ?
does the person scare the teachers ?	do the person scare the teachers ?
are n't the men growing ?	is n't the men growing ?
do n't the men run ?	does n't the men run ?
do n't those teachers run around that bank ?	does n't those teachers run around that bank ?
is that adult laughing ?	are that adult laughing ?
has the doctor talked about this woman ?	have the doctor talked about this woman ?
has this driver won ?	have this driver won ?
was n't this book moving ?	were n't this book moving ?
has this guy remembered that car ?	have this guy remembered that car ?
are the girls running around this museum ?	is the girls running around this museum ?
has the customer heard these men ?	have the customer heard these men ?
is the hat rolling away ?	are the hat rolling away ?
does n't this boy sound like the boy ?	do n't this boy sound like the boy ?
has n't this spoon rolled away ?	have n't this spoon rolled away ?
was this patient moving this dish ?	were this patient moving this dish ?
does that woman talk to this lady ?	do that woman talk to this lady ?
does n't this queen leave these schools ?	do n't this queen leave these schools ?
do the teachers appreciate this king ?	does the teachers appreciate this king ?
has n't this customer lost the adult ?	have n't this customer lost the adult ?
does n't that woman care for the boy ?	do n't that woman care for the boy ?
do n't these men lose ?	does n't these men lose ?
has n't that turtle learned ?	have n't that turtle learned ?
has n't that adult visited the teacher ?	have n't that adult visited the teacher ?
do the children fix the forks ?	does the children fix the forks ?
does n't that king cry ?	do n't that king cry ?
does n't this adult cry ?	do n't this adult cry ?
are n't these men working with this person ?	is n't these men working with this person ?
do these boys care for the men ?	does these boys care for the men ?
have n't these shirts rolled away ?	has n't these shirts rolled away ?
has the rocket moved ?	have the rocket moved ?
does n't the dancer take these bags ?	do n't the dancer take these bags ?
does n't this doctor smile ?	do n't this doctor smile ?
has that woman helped that queen ?	have that woman helped that queen ?
is the person listening to these ladies ?	are the person listening to these ladies ?
do n't the children praise the queen ?	does n't the children praise the queen ?
is the man shaking these bags ?	are the man shaking these bags ?
was this lady lying ?	were this lady lying ?
does that king scare this patient ?	do that king scare this patient ?
does that lady understand these boys ?	do that lady understand these boys ?
do the cars break that door ?	does the cars break that door ?
are n't the cars breaking those crayons ?	is n't the cars breaking those crayons ?
was this lady bringing those cups ?	were this lady bringing those cups ?
were n't those doors moving ?	was n't those doors moving ?
have n't these cats thought about the ship ?	has n't these cats thought about the ship ?
was that boy dropping that chair ?	were that boy dropping that chair ?
do n't the birds eat ?	does n't the birds eat ?
is n't the mouse thinking about that teacher ?	are n't the mouse thinking about that teacher ?
have those plates broken the fork ?	has those plates broken the fork ?
do these children notice that driver ?	does these children notice that driver ?
does this woman drop that shirt ?	do this woman drop that shirt ?
has this person laughed ?	have this person laughed ?
is this bag dropping ?	are this bag dropping ?
has the queen won ?	have the queen won ?
were those girls buying these cars ?	was those girls buying these cars ?
do n't these people shake this box ?	does n't these people shake this box ?
has this dancer noticed the couch ?	have this dancer noticed the couch ?
does this guy drive to the bank ?	do this guy drive to the bank ?
were n't the people driving to the school ?	was n't the people driving to the school ?
have those books broken that spoon ?	has those books broken that spoon ?
were n't those doors dropping ?	was n't those doors dropping ?
are the women running ?	is the women running ?
do n't the horses break the trucks ?	does n't the horses break the trucks ?
does the glass roll away ?	do the glass roll away ?
has n't that king brought that plane ?	have n't that king brought that plane ?
have n't these books rolled away ?	has n't these books rolled away ?
does that dentist think about the chairs ?	do that dentist think about the chairs ?
were those girls holding the dishes ?	was those girls holding the dishes ?
does that man notice this dancer ?	do that man notice this dancer ?
do n't these guys hate that boat ?	does n't these guys hate that boat ?
do those candles roll away ?	does those candles roll away ?
has the dentist heard this dog ?	have the dentist heard this dog ?
has this lady left that bank ?	have this lady left that bank ?
were n't these men bothering that person ?	was n't these men bothering that person ?
has n't that customer brought these glasses ?	have n't that customer brought these glasses ?
do n't the women exercise ?	does n't the women exercise ?
was n't this box breaking those dishes ?	were n't this box breaking those dishes ?
does the doctor move the shirt ?	do the doctor move the shirt ?
do n't those bottles break ?	does n't those bottles break ?
has n't the hamster eaten ?	have n't the hamster eaten ?
is this child laughing ?	are this child laughing ?
are the doctors finding the toy ?	is the doctors finding the toy ?
does this driver know these people ?	do this driver know these people ?
was the customer talking to this girl ?	were the customer talking to this girl ?
were n't the guys waving ?	was n't the guys waving ?
has this guy bothered these women ?	have this guy bothered these women ?
has n't this bird run ?	have n't this bird run ?
does n't this customer make these chairs ?	do n't this customer make these chairs ?
do n't the men keep those toys ?	does n't the men keep those toys ?
have n't the people broken the bowl ?	has n't the people broken the bowl ?
has the dog broken those forks ?	have the dog broken those forks ?
is that dentist yelling ?	are that dentist yelling ?
has n't that plane moved ?	have n't that plane moved ?
has n't this boat moved ?	have n't this boat moved ?
has that rug dropped ?	have that rug dropped ?
has the plane rolled away ?	have the plane rolled away ?
was that plane dropping ?	were that plane dropping ?
have n't these girls thrown this button ?	has n't these girls thrown this button ?
has that dancer talked about that girl ?	have that dancer talked about that girl ?
has n't that boy taken this plane ?	have n't that boy taken this plane ?
were those cats thinking about this bowl ?	was those cats thinking about this bowl ?
does n't this lady sneeze ?	do n't this lady sneeze ?
do n't the people drive to the museum ?	does n't the people drive to the museum ?
does the turtle hate those girls ?	do the turtle hate those girls ?
have n't these boys lost the book ?	has n't these boys lost the book ?
does n't the girl lie ?	do n't the girl lie ?
do these guys read ?	does these guys read ?
do n't those books break the forks ?	does n't those books break the forks ?
has n't that dancer fixed the windows ?	have n't that dancer fixed the windows ?
do n't these chairs roll away ?	does n't these chairs roll away ?
do the windows move ?	does the windows move ?
is n't the dentist running ?	are n't the dentist running ?
have these children thrown the crayon ?	has these children thrown the crayon ?
have n't these teachers read ?	has n't these teachers read ?
is the teacher laughing ?	are the teacher laughing ?
were those chairs breaking ?	was those chairs breaking ?
have these doctors left the rooms ?	has these doctors left the rooms ?
are n't the snakes eating ?	is n't the snakes eating ?
does this boat break the bowl ?	do this boat break the bowl ?
were the pictures breaking that book ?	was the pictures breaking that book ?
do those people know this patient ?	does those people know this patient ?
do n't those ladies go to those schools ?	does n't those ladies go to those schools ?
has n't that picture broken those hats ?	have n't that picture broken those hats ?
does n't that customer wave ?	do n't that customer wave ?
were n't the ladies losing ?	was n't the ladies losing ?
is that teacher listening to the child ?	are that teacher listening to the child ?
was n't this dentist running ?	were n't this dentist running ?
have n't the dogs noticed that cup ?	has n't the dogs noticed that cup ?
does n't this bird forget this rocket ?	do n't this bird forget this rocket ?
has n't that customer left this kitchen ?	have n't that customer left this kitchen ?
is n't this person running ?	are n't this person running ?
does that girl answer this person ?	do that girl answer this person ?
is n't the queen thinking about those boys ?	are n't the queen thinking about those boys ?
is n't that ship dropping ?	are n't that ship dropping ?
does n't that dancer bother this woman ?	do n't that dancer bother this woman ?
is that toy breaking these pictures ?	are that toy breaking these pictures ?
were the guys talking about the birds ?	was the guys talking about the birds ?
has n't the bag moved ?	have n't the bag moved ?
does this book break ?	do this book break ?
have n't these teachers broken the crayons ?	has n't these teachers broken the crayons ?
were these snakes running ?	was these snakes running ?
does n't the boy break the candles ?	do n't the boy break the candles ?
does n't the guy cry ?	do n't the guy cry ?
does n't this dentist throw the shirt ?	do n't this dentist throw the shirt ?
have those children read ?	has those children read ?
does this hat drop ?	do this hat drop ?
have these plates broken these pictures ?	has these plates broken these pictures ?
is n't the chair dropping ?	are n't the chair dropping ?
does n't that patient run around this library ?	do n't that patient run around this library ?
were n't those windows rolling away ?	was n't those windows rolling away ?
does n't that rabbit love that book ?	do n't that rabbit love that book ?
does this bird love these windows ?	do this bird love these windows ?
was that bag breaking these hats ?	were that bag breaking these hats ?
has the driver talked about these teachers ?	have the driver talked about these teachers ?
is n't the woman buying this box ?	are n't the woman buying this box ?
do those boxes break these dolls ?	does those boxes break these dolls ?
have those girls run ?	has those girls run ?
is n't that dish rolling away ?	are n't that dish rolling away ?
do n't these ladies grow ?	does n't these ladies grow ?
does the man grow ?	do the man grow ?
is n't this woman growing ?	are n't this woman growing ?
is n't the customer cleaning the bottles ?	are n't the customer cleaning the bottles ?
has n't this king won ?	have n't this king won ?
were n't those boys reading ?	was n't those boys reading ?
are n't the guys eating ?	is n't the guys eating ?
does that child hear the horses ?	do that child hear the horses ?
does that child sing ?	do that child sing ?
was the woman holding the door ?	were the woman holding the door ?
does the plane break the couch ?	do the plane break the couch ?
were n't these children dropping the bags ?	was n't these children dropping the bags ?
are n't those birds growing ?	is n't those birds growing ?
were the doctors visiting the driver ?	was the doctors visiting the driver ?
are n't the women fixing the rug ?	is n't the women fixing the rug ?
was that crayon breaking this bed ?	were that crayon breaking this bed ?
do these bags break the toys ?	does these bags break the toys ?
have n't those doctors read ?	has n't those doctors read ?
has this queen learned ?	have this queen learned ?
does n't that teacher learn ?	do n't that teacher learn ?
do those doctors run ?	does those doctors run ?
is n't that teacher bringing the shoes ?	are n't that teacher bringing the shoes ?
was the man talking about these bottles ?	were the man talking about these bottles ?
has that doctor lost these bags ?	have that doctor lost these bags ?
do those buttons break those cars ?	does those buttons break those cars ?
does n't that teacher buy the ship ?	do n't that teacher buy the ship ?
has n't this queen lost ?	have n't this queen lost ?
does n't this dish break these rings ?	do n't this dish break these rings ?
have those boys bought the bags ?	has those boys bought the bags ?
have n't these men heard the snakes ?	has n't these men heard the snakes ?
is that customer running ?	are that customer running ?
has n't the book broken ?	have n't the book broken ?
does n't the lady find this glass ?	do n't the lady find this glass ?
was n't the girl holding the rocket ?	were n't the girl holding the rocket ?
do these boys fix the car ?	does these boys fix the car ?
has n't that boy brought this spoon ?	have n't that boy brought this spoon ?
does that adult go to those schools ?	do that adult go to those schools ?
has the doctor kept those chairs ?	have the doctor kept those chairs ?
do n't those birds break the dolls ?	does n't those birds break the dolls ?
is the cup moving ?	are the cup moving ?
have n't the guys found this queen ?	has n't the guys found this queen ?
does n't that cup break those shoes ?	do n't that cup break those shoes ?
does n't the queen lift this rocket ?	do n't the queen lift this rocket ?
does n't the person eat ?	do n't the person eat ?
has that car broken ?	have that car broken ?
are n't the doctors losing ?	is n't the doctors losing ?
does this bottle roll away ?	do this bottle roll away ?
are n't these boys visiting the doctor ?	is n't these boys visiting the doctor ?
does n't the dentist grow ?	do n't the dentist grow ?
have these children left that hospital ?	has these children left that hospital ?
is that patient learning ?	are that patient learning ?
do these guys lose the bags ?	does these guys lose the bags ?
do n't these women find that shoe ?	does n't these women find that shoe ?
was that boy listening to this dancer ?	were that boy listening to this dancer ?
has n't this doll broken ?	have n't this doll broken ?
were n't these ladies cleaning these bowls ?	was n't these ladies cleaning these bowls ?
does that lady cough ?	do that lady cough ?
was n't that woman breaking this dish ?	were n't that woman breaking this dish ?
have n't these children painted ?	has n't these children painted ?
do the books drop ?	does the books drop ?
is n't this dentist buying these buttons ?	are n't this dentist buying these buttons ?
does n't the adult look like the teachers ?	do n't the adult look like the teachers ?
was n't that ring breaking that toy ?	were n't that ring breaking that toy ?
are n't these turtles running ?	is n't these turtles running ?
does that book drop ?	do that book drop ?
have n't those boys dropped this rocket ?	has n't those boys dropped this rocket ?
has the woman thought about the bottles ?	have the woman thought about the bottles ?
has n't this patient run ?	have n't this patient run ?
has n't the boy found this lady ?	have n't the boy found this lady ?
is n't the bed moving ?	are n't the bed moving ?
does n't this doctor break this book ?	do n't this doctor break this book ?
is this driver throwing the bag ?	are this driver throwing the bag ?
do n't these men stretch ?	does n't these men stretch ?
do those ladies cough ?	does those ladies cough ?
were these ladies walking through this restaurant ?	was these ladies walking through this restaurant ?
has the cat seen that horse ?	have the cat seen that horse ?
has the lady brought this glass ?	have the lady brought this glass ?
has n't the girl broken these candles ?	have n't the girl broken these candles ?
has this man walked through that museum ?	have this man walked through that museum ?
has that child broken that truck ?	have that child broken that truck ?
does the mouse forget those snakes ?	do the mouse forget those snakes ?
is n't this customer lying ?	are n't this customer lying ?
was this person practicing ?	were this person practicing ?
are these girls bringing these cups ?	is these girls bringing these cups ?
is n't this hamster breaking that bowl ?	are n't this hamster breaking that bowl ?
was n't the king making those rings ?	were n't the king making those rings ?
do n't those pictures break this chair ?	does n't those pictures break this chair ?
has n't this customer learned ?	have n't this customer learned ?
does that king move this mirror ?	do that king move this mirror ?
does the king cry ?	do the king cry ?
is this lady thinking about this boat ?	are this lady thinking about this boat ?
have those men lost this truck ?	has those men lost this truck ?
has that doctor heard those ladies ?	have that doctor heard those ladies ?
has n't that driver dropped the cars ?	have n't that driver dropped the cars ?
was this boy learning ?	were this boy learning ?
do n't those teachers steal the hat ?	does n't those teachers steal the hat ?
has this doctor learned ?	have this doctor learned ?
has the bird noticed the plane ?	have the bird noticed the plane ?
does n't the boy find this ship ?	do n't the boy find this ship ?
is n't that dentist holding that dish ?	are n't that dentist holding that dish ?
is n't the man waving ?	are n't the man waving ?
do those boys go to this museum ?	does those boys go to this museum ?
does the dentist help this girl ?	do the dentist help this girl ?
do n't these ladies laugh ?	does n't these ladies laugh ?
does n't this person talk ?	do n't this person talk ?
were those girls thinking about the spoons ?	was those girls thinking about the spoons ?
have n't those boxes rolled away ?	has n't those boxes rolled away ?
were n't these boys teaching that man ?	was n't these boys teaching that man ?
is that turtle breaking the car ?	are that turtle breaking the car ?
do n't those doctors win ?	does n't those doctors win ?
does n't this guy answer the guy ?	do n't this guy answer the guy ?
was n't this cat thinking about that book ?	were n't this cat thinking about that book ?
has the ship broken this dish ?	have the ship broken this dish ?
was that car breaking ?	were that car breaking ?
is this queen eating ?	are this queen eating ?
were n't those dogs eating ?	was n't those dogs eating ?
have the teachers worried that teacher ?	has the teachers worried that teacher ?
is the person shaking this hat ?	are the person shaking this hat ?
do n't the men worry the teachers ?	does n't the men worry the teachers ?
does this person remember these candles ?	do this person remember these candles ?
does the child read ?	do the child read ?
does n't the girl yell ?	do n't the girl yell ?
have n't these doctors held that shirt ?	has n't these doctors held that shirt ?
is the dancer eating ?	are the dancer eating ?
have n't those rabbits broken these windows ?	has n't those rabbits broken these windows ?
does n't the teacher worry that dentist ?	do n't the teacher worry that dentist ?
has that teacher broken these windows ?	have that teacher broken these windows ?
was that rocket dropping ?	were that rocket dropping ?
has this guy noticed this crayon ?	have this guy noticed this crayon ?
has n't that girl held those books ?	have n't that girl held those books ?
has that patient worried those teachers ?	have that patient worried those teachers ?
does the woman leave that kitchen ?	do the woman leave that kitchen ?
have those men remembered those doors ?	has those men remembered those doors ?
was this child losing the boat ?	were this child losing the boat ?
were those boxes breaking ?	was those boxes breaking ?
do n't the birds grow ?	does n't the birds grow ?
does that lady visit the doctors ?	do that lady visit the doctors ?
were n't those horses eating ?	was n't those horses eating ?
was n't this driver reading ?	were n't this driver reading ?
does this horse think about those cups ?	do this horse think about those cups ?
do the horses break these forks ?	does the horses break these forks ?
is n't that teacher eating ?	are n't that teacher eating ?
does the crayon move ?	do the crayon move ?
are the ladies crying ?	is the ladies crying ?
was n't this customer buying the glass ?	were n't this customer buying the glass ?
has n't that patient talked ?	have n't that patient talked ?
do those guys practice ?	does those guys practice ?
does this customer wave ?	do this customer wave ?
does that man bring that spoon ?	do that man bring that spoon ?
do n't those men fix those buttons ?	does n't those men fix those buttons ?
do n't these ladies stretch ?	does n't these ladies stretch ?
do n't these people appreciate the woman ?	does n't these people appreciate the woman ?
does this patient love that guy ?	do this patient love that guy ?
do n't those girls wave ?	does n't those girls wave ?
do the shirts roll away ?	does the shirts roll away ?
has n't this driver worked with the patient ?	have n't this driver worked with the patient ?
are these teachers losing the dishes ?	is these teachers losing the dishes ?
does that patient lose ?	do that patient lose ?
has n't that girl moved this door ?	have n't that girl moved this door ?
were n't these chairs dropping ?	was n't these chairs dropping ?
does this person hate the plane ?	do this person hate the plane ?
were the rabbits running ?	was the rabbits running ?
has n't that king run around the mall ?	have n't that king run around the mall ?
is this boy finding the couch ?	are this boy finding the couch ?
do n't these doctors eat ?	does n't these doctors eat ?
do n't those boys run ?	does n't those boys run ?
was the bed breaking those candles ?	were the bed breaking those candles ?
do the toys roll away ?	does the toys roll away ?
is n't this teacher breaking the box ?	are n't this teacher breaking the box ?
does that cup break this spoon ?	do that cup break this spoon ?
do those boys help the boy ?	does those boys help the boy ?
was that dentist screaming ?	were that dentist screaming ?
does that customer have this dish ?	do that customer have this dish ?
are these shoes breaking the chairs ?	is these shoes breaking the chairs ?
are n't those dolls breaking that spoon ?	is n't those dolls breaking that spoon ?
does n't the man leave that school ?	do n't the man leave that school ?
does that child return to the schools ?	do that child return to the schools ?
was the cat learning ?	were the cat learning ?
has that doctor thrown the hat ?	have that doctor thrown the hat ?
has the book rolled away ?	have the book rolled away ?
does n't the boy eat ?	do n't the boy eat ?
are those crayons moving ?	is those crayons moving ?
have the teachers cleaned this bicycle ?	has the teachers cleaned this bicycle ?
has that doctor confused the boys ?	have that doctor confused the boys ?
does the picture break ?	do the picture break ?
were these doctors cleaning this car ?	was these doctors cleaning this car ?
does n't that guy lose this shirt ?	do n't that guy lose this shirt ?
do the women hate those teachers ?	does the women hate those teachers ?
has that plane rolled away ?	have that plane rolled away ?
does n't that doctor win ?	do n't that doctor win ?
does this doctor yell ?	do this doctor yell ?
are these ladies smiling ?	is these ladies smiling ?
has n't this doctor scared these men ?	have n't this doctor scared these men ?
were these forks breaking that chair ?	was these forks breaking that chair ?
do these horses notice the child ?	does these horses notice the child ?
is this rocket rolling away ?	are this rocket rolling away ?
has n't that lady lost ?	have n't that lady lost ?
has the lady won ?	have the lady won ?
does this lady teach the people ?	do this lady teach the people ?
does the lady leave this restaurant ?	do the lady leave this restaurant ?
were these men crying ?	was these men crying ?
were these hats breaking the shirts ?	was these hats breaking the shirts ?
are these mice breaking these glasses ?	is these mice breaking these glasses ?
were these bowls rolling away ?	was these bowls rolling away ?
do n't the candles roll away ?	does n't the candles roll away ?
has the man cried ?	have the man cried ?
do these guys bother that woman ?	does these guys bother that woman ?
was n't that rocket dropping ?	were n't that rocket dropping ?
have these men run around the rooms ?	has these men run around the rooms ?
has n't the patient answered these girls ?	have n't the patient answered these girls ?
has this customer broken this glass ?	have this customer broken this glass ?
does n't the girl throw the car ?	do n't the girl throw the car ?
have those children eaten ?	has those children eaten ?
does n't that dancer buy the bicycle ?	do n't that dancer buy the bicycle ?
was n't that adult leaving that museum ?	were n't that adult leaving that museum ?
does n't the adult pass that room ?	do n't the adult pass that room ?
was the lady breaking this ship ?	were the lady breaking this ship ?
is n't this lady helping these guys ?	are n't this lady helping these guys ?
was the king running around this school ?	were the king running around this school ?
are n't the doctors visiting those women ?	is n't the doctors visiting those women ?
does n't the rabbit notice that king ?	do n't the rabbit notice that king ?
has the dish rolled away ?	have the dish rolled away ?
has this child thrown this shoe ?	have this child thrown this shoe ?
is n't that couch dropping ?	are n't that couch dropping ?
have n't these ladies gone to this restaurant ?	has n't these ladies gone to this restaurant ?
has n't this woman remembered those snakes ?	have n't this woman remembered those snakes ?
is n't this plane breaking ?	are n't this plane breaking ?
is that truck moving ?	are that truck moving ?
does the child learn ?	do the child learn ?
does the woman paint ?	do the woman paint ?
does that dancer keep this bowl ?	do that dancer keep this bowl ?
was n't this dog growing ?	were n't this dog growing ?
has n't the teacher bothered these men ?	have n't the teacher bothered these men ?
does that horse grow ?	do that horse grow ?
were n't those ladies holding those books ?	was n't those ladies holding those books ?
does n't the cat learn ?	do n't the cat learn ?
does that queen think about those dolls ?	do that queen think about those dolls ?
has this button broken this ship ?	have this button broken this ship ?
has n't the dentist learned ?	have n't the dentist learned ?
does that king whisper ?	do that king whisper ?
has n't this driver grown ?	have n't this driver grown ?
have these shirts dropped ?	has these shirts dropped ?
was the mouse breaking these bottles ?	were the mouse breaking these bottles ?
has n't this dentist taken the shoe ?	have n't this dentist taken the shoe ?
do n't the men sneeze ?	does n't the men sneeze ?
was the boy smiling ?	were the boy smiling ?
has n't the candle dropped ?	have n't the candle dropped ?
has that woman heard the rabbits ?	have that woman heard the rabbits ?
were n't those men talking to those children ?	was n't those men talking to those children ?
has that girl worried those children ?	have that girl worried those children ?
does n't the child talk ?	do n't the child talk ?
has n't the boy remembered these cars ?	have n't the boy remembered these cars ?
does n't the lady steal the window ?	do n't the lady steal the window ?
do n't these turtles break that door ?	does n't these turtles break that door ?
were these chairs moving ?	was these chairs moving ?
do those men sing ?	does those men sing ?
does this child grow ?	do this child grow ?
were n't the books dropping ?	was n't the books dropping ?
is this dentist going to that room ?	are this dentist going to that room ?
does this dancer answer this woman ?	do this dancer answer this woman ?
does this ring roll away ?	do this ring roll away ?
was this person buying these trucks ?	were this person buying these trucks ?
has that ring moved ?	have that ring moved ?
have the snakes eaten ?	has the snakes eaten ?
do n't the teachers leave those schools ?	does n't the teachers leave those schools ?
are those ladies losing these forks ?	is those ladies losing these forks ?
has n't the bird remembered those bowls ?	have n't the bird remembered those bowls ?
do n't the doctors smile ?	does n't the doctors smile ?
has n't this glass dropped ?	have n't this glass dropped ?
has n't this doctor found this teacher ?	have n't this doctor found this teacher ?
is that dog thinking about that dog ?	are that dog thinking about that dog ?
have n't those people helped those women ?	has n't those people helped those women ?
was n't the person laughing ?	were n't the person laughing ?
do these doctors leave the school ?	does these doctors leave the school ?
was this adult working with this child ?	were this adult working with this child ?
were the people shaking this hat ?	was the people shaking this hat ?
does n't the bird think about this button ?	do n't the bird think about this button ?
does that doctor have that fork ?	do that doctor have that fork ?
does n't this girl break the door ?	do n't this girl break the door ?
has n't the candle moved ?	have n't the candle moved ?
have those snakes grown ?	has those snakes grown ?
does n't this plane move ?	do n't this plane move ?
does n't that doctor sing ?	do n't that doctor sing ?
does this man steal these cars ?	do this man steal these cars ?
was n't this woman keeping that bowl ?	were n't this woman keeping that bowl ?
does that king look like that girl ?	do that king look like that girl ?
has this picture broken that glass ?	have this picture broken that glass ?
has n't this queen waved ?	have n't this queen waved ?
was n't the dentist singing ?	were n't the dentist singing ?
is n't this boy leaving that museum ?	are n't this boy leaving that museum ?
are n't those boys moving this car ?	is n't those boys moving this car ?
has n't that king won ?	have n't that king won ?
have these spoons broken those candles ?	has these spoons broken those candles ?
do those people find the crayons ?	does those people find the crayons ?
has the child yelled ?	have the child yelled ?
does n't the driver cry ?	do n't the driver cry ?
has the teacher lost the cars ?	have the teacher lost the cars ?
do n't those people sound like this patient ?	does n't those people sound like this patient ?
are n't these people cleaning this book ?	is n't these people cleaning this book ?
does n't that boy bring the couch ?	do n't that boy bring the couch ?
were n't the horses eating ?	was n't the horses eating ?
were n't those boats breaking ?	was n't those boats breaking ?
does the lady shake these buttons ?	do the lady shake these buttons ?
do these girls cry ?	does these girls cry ?
has this boy made that toy ?	have this boy made that toy ?
does n't the dog love this woman ?	do n't the dog love this woman ?
do those hats break the plane ?	does those hats break the plane ?
does n't the dentist sound like this dancer ?	do n't the dentist sound like this dancer ?
does n't this shoe move ?	do n't this shoe move ?
does n't that boy appreciate this customer ?	do n't that boy appreciate this customer ?
are the boys losing ?	is the boys losing ?
is this mirror moving ?	are this mirror moving ?
has n't the driver heard the doctors ?	have n't the driver heard the doctors ?
were those boys dropping the car ?	was those boys dropping the car ?
does the girl run around the rooms ?	do the girl run around the rooms ?
does n't this car roll away ?	do n't this car roll away ?
do n't these crayons roll away ?	does n't these crayons roll away ?
are these men thinking about these shoes ?	is these men thinking about these shoes ?
has the glass rolled away ?	have the glass rolled away ?
is the boy running ?	are the boy running ?
does this child smile ?	do this child smile ?
do n't those teachers sound like those teachers ?	does n't those teachers sound like those teachers ?
was the boy yelling ?	were the boy yelling ?
was the button breaking ?	were the button breaking ?
do those children throw that plate ?	does those children throw that plate ?
do n't these boys practice ?	does n't these boys practice ?
have the doctors thought about the snakes ?	has the doctors thought about the snakes ?
were those girls talking ?	was those girls talking ?
do n't the children talk about this toy ?	does n't the children talk about this toy ?
were these doors breaking that couch ?	was these doors breaking that couch ?
is n't the guy talking to this doctor ?	are n't the guy talking to this doctor ?
does this adult laugh ?	do this adult laugh ?
has n't the shoe dropped ?	have n't the shoe dropped ?
does this plane move ?	do this plane move ?
do the horses forget the ship ?	does the horses forget the ship ?
has n't that woman heard the lady ?	have n't that woman heard the lady ?
do n't those snakes notice that man ?	does n't those snakes notice that man ?
have those children painted ?	has those children painted ?
does n't this patient worry that boy ?	do n't this patient worry that boy ?
are the cats thinking about those glasses ?	is the cats thinking about those glasses ?
does n't that dentist sound like these girls ?	do n't that dentist sound like these girls ?
do the guys talk ?	does the guys talk ?
does n't the lady know the teacher ?	do n't the lady know the teacher ?
does that dentist lose ?	do that dentist lose ?
does that woman think about the button ?	do that woman think about the button ?
was n't this woman talking to that guy ?	were n't this woman talking to that guy ?
is this teacher bothering the person ?	are this teacher bothering the person ?
is n't the bag dropping ?	are n't the bag dropping ?
does n't that person care for that driver ?	do n't that person care for that driver ?
has n't the hat broken that mirror ?	have n't the hat broken that mirror ?
has n't this lady moved the boat ?	have n't this lady moved the boat ?
has n't that customer run ?	have n't that customer run ?
has that crayon rolled away ?	have that crayon rolled away ?
do n't these guys practice ?	does n't these guys practice ?
is this bed breaking the shirt ?	are this bed breaking the shirt ?
do n't the people eat ?	does n't the people eat ?
do the children throw the plane ?	does the children throw the plane ?
has n't the man heard this boy ?	have n't the man heard this boy ?
does n't that teacher bother these guys ?	do n't that teacher bother these guys ?
is n't the dentist making those cars ?	are n't the dentist making those cars ?
are n't the buttons breaking the spoons ?	is n't the buttons breaking the spoons ?
has n't that snake thought about the dolls ?	have n't that snake thought about the dolls ?
has the patient confused this driver ?	have the patient confused this driver ?
does n't this boy talk to these men ?	do n't this boy talk to these men ?
does n't this adult return to that kitchen ?	do n't this adult return to that kitchen ?
do those women sing ?	does those women sing ?
does this cat eat ?	do this cat eat ?
do n't the boys visit the child ?	does n't the boys visit the child ?
is n't this woman reading ?	are n't this woman reading ?
was that king buying those crayons ?	were that king buying those crayons ?
is this bottle rolling away ?	are this bottle rolling away ?
was the adult fixing this mirror ?	were the adult fixing this mirror ?
are n't these teachers reading ?	is n't these teachers reading ?
has the king broken the dish ?	have the king broken the dish ?
does that truck roll away ?	do that truck roll away ?
have n't the books broken ?	has n't the books broken ?
does the book break ?	do the book break ?
does n't this queen bring the glass ?	do n't this queen bring the glass ?
does n't this girl steal these boxes ?	do n't this girl steal these boxes ?
does n't the adult run ?	do n't the adult run ?
was n't this child reading ?	were n't this child reading ?
has that cat eaten ?	have that cat eaten ?
has the woman helped the guys ?	have the woman helped the guys ?
has n't that guy run around the room ?	have n't that guy run around the room ?
does that fork break that doll ?	do that fork break that doll ?
is n't this doctor laughing ?	are n't this doctor laughing ?
was n't the lady reading ?	were n't the lady reading ?
does n't that dancer know this snake ?	do n't that dancer know this snake ?
have n't the dishes moved ?	has n't the dishes moved ?
has n't the car broken these crayons ?	have n't the car broken these crayons ?
have n't those people confused the boys ?	has n't those people confused the boys ?
does n't the bird think about that truck ?	do n't the bird think about that truck ?
have the chairs broken the book ?	has the chairs broken the book ?
was the patient running around those rooms ?	were the patient running around those rooms ?
have n't these people found the book ?	has n't these people found the book ?
has that dancer confused that guy ?	have that dancer confused that guy ?
has this doctor fixed this book ?	have this doctor fixed this book ?
does this window drop ?	do this window drop ?
has that adult remembered those cars ?	have that adult remembered those cars ?
do n't those men cough ?	does n't those men cough ?
does n't the teacher hate that person ?	do n't the teacher hate that person ?
has this dentist talked to this king ?	have this dentist talked to this king ?
was n't this box dropping ?	were n't this box dropping ?
has n't the person yelled ?	have n't the person yelled ?
was this boat breaking ?	were this boat breaking ?
were n't these women walking through those schools ?	was n't these women walking through those schools ?
does n't this queen listen to the driver ?	do n't this queen listen to the driver ?
was n't the book breaking those buttons ?	were n't the book breaking those buttons ?
does the child sing ?	do the child sing ?
does n't that girl fix those boats ?	do n't that girl fix those boats ?
was the girl fixing the boat ?	were the girl fixing the boat ?
have n't the doctors yelled ?	has n't the doctors yelled ?
have the people left that school ?	has the people left that school ?
is n't that rug breaking that window ?	are n't that rug breaking that window ?
does n't the rug drop ?	do n't the rug drop ?
were the doors dropping ?	was the doors dropping ?
does n't that woman move the glasses ?	do n't that woman move the glasses ?
was n't the dancer singing ?	were n't the dancer singing ?
have those dogs eaten ?	has those dogs eaten ?
do n't the people bring those spoons ?	does n't the people bring those spoons ?
does this plate roll away ?	do this plate roll away ?
has this cat grown ?	have this cat grown ?
has this guy thrown this truck ?	have this guy thrown this truck ?
has the patient worked with that lady ?	have the patient worked with that lady ?
has that guy won ?	have that guy won ?
are those trucks breaking that glass ?	is those trucks breaking that glass ?
has n't the turtle broken the candles ?	have n't the turtle broken the candles ?
does that bag drop ?	do that bag drop ?
were n't these boys running ?	was n't these boys running ?
are n't those shoes breaking this window ?	is n't those shoes breaking this window ?
does n't this patient exercise ?	do n't this patient exercise ?
does n't this driver bother these doctors ?	do n't this driver bother these doctors ?
has the teacher won ?	have the teacher won ?
does n't the girl take that door ?	do n't the girl take that door ?
do n't those spoons drop ?	does n't those spoons drop ?
is the customer keeping this bottle ?	are the customer keeping this bottle ?
do the teachers find these dishes ?	does the teachers find these dishes ?
does that adult find this plane ?	do that adult find this plane ?
is n't the patient making these hats ?	are n't the patient making these hats ?
have n't the toys dropped ?	has n't the toys dropped ?
do n't the candles move ?	does n't the candles move ?
were these boys making the boats ?	was these boys making the boats ?
has this picture rolled away ?	have this picture rolled away ?
was n't this shoe breaking ?	were n't this shoe breaking ?
do n't these rabbits grow ?	does n't these rabbits grow ?
does that queen drive to the rooms ?	do that queen drive to the rooms ?
has n't this guy yelled ?	have n't this guy yelled ?
has this driver held this doll ?	have this driver held this doll ?
has n't the king dropped those windows ?	have n't the king dropped those windows ?
does this person lose that shoe ?	do this person lose that shoe ?
is n't the guy thinking about that doll ?	are n't the guy thinking about that doll ?
do the teachers talk about the queen ?	does the teachers talk about the queen ?
are n't those glasses moving ?	is n't those glasses moving ?
is the child eating ?	are the child eating ?
have n't the doctors won ?	has n't the doctors won ?
do n't the boys cough ?	does n't the boys cough ?
are those hats moving ?	is those hats moving ?
were n't these guys cleaning those spoons ?	was n't these guys cleaning those spoons ?
were n't these girls dropping those forks ?	was n't these girls dropping those forks ?
does the fork drop ?	do the fork drop ?
was n't that book moving ?	were n't that book moving ?
were these boys fixing these shoes ?	was these boys fixing these shoes ?
has the man bought that hat ?	have the man bought that hat ?
does n't that patient exercise ?	do n't that patient exercise ?
has that chair rolled away ?	have that chair rolled away ?
does this patient like the cars ?	do this patient like the cars ?
were n't those women dropping that bag ?	was n't those women dropping that bag ?
does n't that driver drop those windows ?	do n't that driver drop those windows ?
does the patient walk through that bank ?	do the patient walk through that bank ?
do these women go to that museum ?	does these women go to that museum ?
is that hamster growing ?	are that hamster growing ?
do n't those bowls drop ?	does n't those bowls drop ?
does n't the woman think about the dancer ?	do n't the woman think about the dancer ?
have the ladies lost that glass ?	has the ladies lost that glass ?
do those turtles break the bowl ?	does those turtles break the bowl ?
does n't that patient hate the boats ?	do n't that patient hate the boats ?
have these women answered those teachers ?	has these women answered those teachers ?
