the doctor does n't talk .	the doctors does n't talk .
the people are eating .	the person are eating .
the mouse has remembered this snake .	the mice has remembered this snake .
the girl has thought about that bag .	the girls has thought about that bag .
the girls have n't cried .	the girl have n't cried .
the lady is n't waving .	the ladies is n't waving .
the teachers do stretch .	the teacher do stretch .
the woman does teach this woman .	the women does teach this woman .
the children have n't thrown these cars .	the child have n't thrown these cars .
the girls were fixing the fork .	the girl were fixing the fork .
the person was n't breaking this cup .	the people was n't breaking this cup .
the teacher has passed these rooms .	the teachers has passed these rooms .
the mouse has n't eaten .	the mice has n't eaten .
the box was rolling away .	the boxes was rolling away .
the lady does paint .	the ladies does paint .
the boy is running around this hospital .	the boys is running around this hospital .
the car does move .	the cars does move .
the children have n't remembered the door .	the child have n't remembered the door .
the children do n't paint .	the child do n't paint .
the guy has won .	the guys has won .
the woman does n't listen to this guy .	the women does n't listen to this guy .
the women have n't heard these cats .	the woman have n't heard these cats .
the boys do notice those toys .	the boy do notice those toys .
the guy has n't thought about that person .	the guys has n't thought about that person .
the person does move those bowls .	the people does move those bowls .
the cat does forget this dog .	the cats does forget this dog .
the woman was learning .	the women was learning .
the teachers do n't move that bed .	the teacher do n't move that bed .
the turtle has n't remembered the children .	the turtles has n't remembered the children .
the ring is n't rolling away .	the rings is n't rolling away .
the woman does n't talk .	the women does n't talk .
the door does n't move .	the doors does n't move .
the bags are dropping .	the bag are dropping .
the girls do run .	the girl do run .
the woman is n't making those bags .	the women is n't making those bags .
the ring was n't moving .	the rings was n't moving .
the doctor does n't care for the boys .	the doctors does n't care for the boys .
the man was n't holding the shirts .	the men was n't holding the shirts .
the man does n't worry the girls .	the men does n't worry the girls .
the dogs do eat .	the dog do eat .
the teachers do n't appreciate these children .	the teacher do n't appreciate these children .
the rabbits are n't learning .	the rabbit are n't learning .
the man was bothering the king .	the men was bothering the king .
the doctors have run .	the doctor have run .
the boys have grown .	the boy have grown .
the people do n't praise this man .	the person do n't praise this man .
the bowls have n't rolled away .	the bowl have n't rolled away .
the teachers have n't confused the boy .	the teacher have n't confused the boy .
the people have remembered these rings .	the person have remembered these rings .
the boy does n't leave the museum .	the boys does n't leave the museum .
the lady does n't look like the driver .	the ladies does n't look like the driver .
the bed has dropped .	the beds has dropped .
the boy was n't listening to the man .	the boys was n't listening to the man .
the ladies do n't bring this spoon .	the lady do n't bring this spoon .
the person has n't talked .	the people has n't talked .
the guys were n't reading .	the guy were n't reading .
the guys are n't moving the trucks .	the guy are n't moving the trucks .
the bowls are breaking those dishes .	the bowl are breaking those dishes .
the child has n't waved .	the children has n't waved .
the rabbit has remembered that person .	the rabbits has remembered that person .
the pictures do n't move .	the picture do n't move .
the doll does roll away .	the dolls does roll away .
the doctors were n't thinking about the patient .	the doctor were n't thinking about the patient .
the guy does n't sell those dolls .	the guys does n't sell those dolls .
the person has n't walked through this restaurant .	the people has n't walked through this restaurant .
the ring was n't breaking .	the rings was n't breaking .
the teacher does run around the museum .	the teachers does run around the museum .
the doll was n't moving .	the dolls was n't moving .
the guy is breaking that bowl .	the guys is breaking that bowl .
the people have taught the customer .	the person have taught the customer .
the girl does grow .	the girls does grow .
the people do remember these cars .	the person do remember these cars .
the lady has n't worried that guy .	the ladies has n't worried that guy .
the ring does break .	the rings does break .
the rabbits do n't see the shirt .	the rabbit do n't see the shirt .
the people do n't notice that book .	the person do n't notice that book .
the lady has learned .	the ladies has learned .
the doctors were taking the spoons .	the doctor were taking the spoons .
the girl does eat .	the girls does eat .
the girl has n't confused these boys .	the girls has n't confused these boys .
the boy is buying these books .	the boys is buying these books .
the snake does remember this ship .	the snakes does remember this ship .
the teacher does n't cough .	the teachers does n't cough .
the girl has n't eaten .	the girls has n't eaten .
the teacher does n't move the picture .	the teachers does n't move the picture .
the cups do break .	the cup do break .
the girl has thought about these bags .	the girls has thought about these bags .
the men do lie .	the man do lie .
the dogs have n't grown .	the dog have n't grown .
the bags were n't rolling away .	the bag were n't rolling away .
the doctor does run around the bank .	the doctors does run around the bank .
the window was n't breaking .	the windows was n't breaking .
the lady has n't won .	the ladies has n't won .
the window has n't broken the bowls .	the windows has n't broken the bowls .
the lady has n't worried this lady .	the ladies has n't worried this lady .
the boys are n't talking about those doors .	the boy are n't talking about those doors .
the books have n't broken the window .	the book have n't broken the window .
the teacher is n't painting .	the teachers is n't painting .
the man does eat .	the men does eat .
the pictures do break .	the picture do break .
the door has n't dropped .	the doors has n't dropped .
the people do know these horses .	the person do know these horses .
the boys have n't lost the cups .	the boy have n't lost the cups .
the man has lost that adult .	the men has lost that adult .
the girl does throw that hat .	the girls does throw that hat .
the shoe does break .	the shoes does break .
the girls have worried that customer .	the girl have worried that customer .
the chairs do break .	the chair do break .
the lady does visit this customer .	the ladies does visit this customer .
the girls do n't win .	the girl do n't win .
the person does n't hear the lady .	the people does n't hear the lady .
the people are making the dishes .	the person are making the dishes .
the doctor does n't cough .	the doctors does n't cough .
the rings are breaking this bicycle .	the ring are breaking this bicycle .
the turtles have n't learned .	the turtle have n't learned .
the women have run around these rooms .	the woman have run around these rooms .
the dogs are n't breaking these bags .	the dog are n't breaking these bags .
the teachers are shaking those pictures .	the teacher are shaking those pictures .
the doctor has dropped these doors .	the doctors has dropped these doors .
the forks have n't dropped .	the fork have n't dropped .
the dish is n't dropping .	the dishes is n't dropping .
the doctor is reading .	the doctors is reading .
the man is n't visiting the men .	the men is n't visiting the men .
the doctor is waving .	the doctors is waving .
the teachers have n't talked about that person .	the teacher have n't talked about that person .
the boys do run around this kitchen .	the boy do run around this kitchen .
the person does hear those women .	the people does hear those women .
the women have eaten .	the woman have eaten .
the ladies have n't fixed those spoons .	the lady have n't fixed those spoons .
the snake is thinking about that guy .	the snakes is thinking about that guy .
the woman does n't sneeze .	the women does n't sneeze .
the girls have n't thought about this crayon .	the girl have n't thought about this crayon .
the lady has taught the women .	the ladies has taught the women .
the toy was moving .	the toys was moving .
the girl has brought those windows .	the girls has brought those windows .
the boys do help the child .	the boy do help the child .
the women do bother the doctors .	the woman do bother the doctors .
the guy does look like the driver .	the guys does look like the driver .
the people have n't worked with that doctor .	the person have n't worked with that doctor .
the ladies are driving to those rooms .	the lady are driving to those rooms .
the hat does n't break the ring .	the hats does n't break the ring .
the man is n't dropping the plates .	the men is n't dropping the plates .
the bed has moved .	the beds has moved .
the candles have broken .	the candle have broken .
the children do n't look like those teachers .	the child do n't look like those teachers .
the mouse has noticed the rocket .	the mice has noticed the rocket .
the bowl has n't broken the crayon .	the bowls has n't broken the crayon .
the people were n't singing .	the person were n't singing .
the man has passed that hospital .	the men has passed that hospital .
the door does n't break this bottle .	the doors does n't break this bottle .
the boxes do move .	the box do move .
the mice do forget those bags .	the mouse do forget those bags .
the children have found that book .	the child have found that book .
the teachers were n't losing that bicycle .	the teacher were n't losing that bicycle .
the guys have n't made this plane .	the guy have n't made this plane .
the lady was n't lying .	the ladies was n't lying .
the guy has n't kept those boxes .	the guys has n't kept those boxes .
the crayons do n't move .	the crayon do n't move .
the child has n't walked through the kitchen .	the children has n't walked through the kitchen .
the teacher does visit that person .	the teachers does visit that person .
the rabbits have n't thought about the windows .	the rabbit have n't thought about the windows .
the teachers do answer that queen .	the teacher do answer that queen .
the man does n't walk through the kitchen .	the men does n't walk through the kitchen .
the trucks have n't broken this chair .	the truck have n't broken this chair .
the ladies do bother the lady .	the lady do bother the lady .
the turtle does notice the dog .	the turtles does notice the dog .
the man does n't keep these candles .	the men does n't keep these candles .
the guys are n't talking .	the guy are n't talking .
the people were n't talking .	the person were n't talking .
the girls do n't scream .	the girl do n't scream .
the ladies do cry .	the lady do cry .
the girls do exercise .	the girl do exercise .
the shirt was breaking these beds .	the shirts was breaking these beds .
the cups do n't break those shoes .	the cup do n't break those shoes .
the girl has answered the patient .	the girls has answered the patient .
the bed does move .	the beds does move .
the window does break .	the windows does break .
the bird does n't grow .	the birds does n't grow .
the fork has n't broken those bottles .	the forks has n't broken those bottles .
the button is breaking the book .	the buttons is breaking the book .
the men were n't screaming .	the man were n't screaming .
the turtle was eating .	the turtles was eating .
the mice have thought about that toy .	the mouse have thought about that toy .
the girls have talked about these beds .	the girl have talked about these beds .
the boys are n't losing that bowl .	the boy are n't losing that bowl .
the man was losing .	the men was losing .
the girls do appreciate this teacher .	the girl do appreciate this teacher .
the people do n't notice the man .	the person do n't notice the man .
the truck does n't break .	the trucks does n't break .
the man does n't scream .	the men does n't scream .
the crayon has rolled away .	the crayons has rolled away .
the trucks do n't drop .	the truck do n't drop .
the snake does n't run .	the snakes does n't run .
the men do n't sneeze .	the man do n't sneeze .
the man does know that king .	the men does know that king .
the men do n't remember those shirts .	the man do n't remember those shirts .
the plates do roll away .	the plate do roll away .
the dog has n't seen that book .	the dogs has n't seen that book .
the children have n't kept the shirt .	the child have n't kept the shirt .
the guy has n't talked about the birds .	the guys has n't talked about the birds .
the dogs do n't break the spoon .	the dog do n't break the spoon .
the guy has n't found the child .	the guys has n't found the child .
the guys do n't hear these people .	the guy do n't hear these people .
the boys do appreciate this doctor .	the boy do appreciate this doctor .
the teachers do n't pass the bank .	the teacher do n't pass the bank .
the doors are breaking this doll .	the door are breaking this doll .
the guy does remember the book .	the guys does remember the book .
the children have run .	the child have run .
the ladies have run .	the lady have run .
the rabbit does n't love these candles .	the rabbits does n't love these candles .
the people were n't whispering .	the person were n't whispering .
the forks do n't drop .	the fork do n't drop .
the boy does n't bring those boxes .	the boys does n't bring those boxes .
the boys have thought about the button .	the boy have thought about the button .
the guy was waving .	the guys was waving .
the people do n't buy the pictures .	the person do n't buy the pictures .
the rings do drop .	the ring do drop .
the forks are rolling away .	the fork are rolling away .
the horses do break the crayon .	the horse do break the crayon .
the dishes have n't rolled away .	the dish have n't rolled away .
the turtle does n't think about the doctor .	the turtles does n't think about the doctor .
the people do n't lift that candle .	the person do n't lift that candle .
the doctor does n't practice .	the doctors does n't practice .
the mice were n't eating .	the mouse were n't eating .
the horse has n't seen this rabbit .	the horses has n't seen this rabbit .
the boy is running .	the boys is running .
the toys are breaking those glasses .	the toy are breaking those glasses .
the teacher was n't practicing .	the teachers was n't practicing .
the women are throwing the books .	the woman are throwing the books .
the teachers do laugh .	the teacher do laugh .
the child does n't clean this bottle .	the children does n't clean this bottle .
the bird does n't break these doors .	the birds does n't break these doors .
the mouse does n't think about the queen .	the mice does n't think about the queen .
the guys were n't shaking these chairs .	the guy were n't shaking these chairs .
the doctors were cleaning that box .	the doctor were cleaning that box .
the doctors do steal these pictures .	the doctor do steal these pictures .
the book is moving .	the books is moving .
the doctors do n't learn .	the doctor do n't learn .
the boys do n't eat .	the boy do n't eat .
the child does n't understand these teachers .	the children does n't understand these teachers .
the boats have n't moved .	the boat have n't moved .
the boys do think about that rug .	the boy do think about that rug .
the horses are n't eating .	the horse are n't eating .
the child does laugh .	the children does laugh .
the child has seen this door .	the children has seen this door .
the people have n't noticed the ship .	the person have n't noticed the ship .
the teachers have fixed that dish .	the teacher have fixed that dish .
the doctor has broken the buttons .	the doctors has broken the buttons .
the boys do n't move that car .	the boy do n't move that car .
the man does keep that car .	the men does keep that car .
the people do n't see this shoe .	the person do n't see this shoe .
the child has waved .	the children has waved .
the beds do break .	the bed do break .
the bird is growing .	the birds is growing .
the cars have broken that dish .	the car have broken that dish .
the man does lift these spoons .	the men does lift these spoons .
the guys are n't singing .	the guy are n't singing .
the man was working with this teacher .	the men was working with this teacher .
the candles do n't move .	the candle do n't move .
the guy is cleaning those shoes .	the guys is cleaning those shoes .
the forks were n't breaking this doll .	the fork were n't breaking this doll .
the bed has broken this plane .	the beds has broken this plane .
the person was learning .	the people was learning .
the doctors are losing those bags .	the doctor are losing those bags .
the person has run .	the people has run .
the doctors have confused that teacher .	the doctor have confused that teacher .
the children do n't answer the driver .	the child do n't answer the driver .
the ladies were n't moving that cup .	the lady were n't moving that cup .
the child does listen to that driver .	the children does listen to that driver .
the person does cry .	the people does cry .
the turtles have n't grown .	the turtle have n't grown .
the horses are running .	the horse are running .
the girl was n't smiling .	the girls was n't smiling .
the children do n't look like the snakes .	the child do n't look like the snakes .
the girl does n't learn .	the girls does n't learn .
the guy has thrown that shirt .	the guys has thrown that shirt .
the chair is n't dropping .	the chairs is n't dropping .
the child does forget the books .	the children does forget the books .
the bed is n't dropping .	the beds is n't dropping .
the guy does answer those girls .	the guys does answer those girls .
the children do n't throw the beds .	the child do n't throw the beds .
the teachers do n't find this plane .	the teacher do n't find this plane .
the ladies were visiting the doctor .	the lady were visiting the doctor .
the people are n't visiting the lady .	the person are n't visiting the lady .
the car has n't dropped .	the cars has n't dropped .
the women do steal the button .	the woman do steal the button .
the girl does n't yell .	the girls does n't yell .
the snakes were learning .	the snake were learning .
the pictures have n't broken .	the picture have n't broken .
the boy does n't run .	the boys does n't run .
the child does hate the bed .	the children does hate the bed .
the men have dropped that shirt .	the man have dropped that shirt .
the woman has n't grown .	the women has n't grown .
the glass does n't break this picture .	the glasses does n't break this picture .
the boy does paint .	the boys does paint .
the spoon does break .	the spoons does break .
the buttons have n't rolled away .	the button have n't rolled away .
the dolls are breaking .	the doll are breaking .
the dog has eaten .	the dogs has eaten .
the shoes do n't break these plates .	the shoe do n't break these plates .
the people have n't thrown the button .	the person have n't thrown the button .
the girls are n't learning .	the girl are n't learning .
the women were screaming .	the woman were screaming .
the guys have n't moved that boat .	the guy have n't moved that boat .
the men do throw this shirt .	the man do throw this shirt .
the lady does take that ship .	the ladies does take that ship .
the ladies are eating .	the lady are eating .
the shirts are breaking .	the shirt are breaking .
the man does laugh .	the men does laugh .
the people do n't grow .	the person do n't grow .
the doctors were n't running .	the doctor were n't running .
the horse does learn .	the horses does learn .
the shoes do n't break .	the shoe do n't break .
the person is n't thinking about that doll .	the people is n't thinking about that doll .
the snakes are thinking about that book .	the snake are thinking about that book .
the men do hold the picture .	the man do hold the picture .
the doctor does leave that park .	the doctors does leave that park .
the girls have taught the guys .	the girl have taught the guys .
the boy does n't whisper .	the boys does n't whisper .
the ladies do stretch .	the lady do stretch .
the boys do n't love those dishes .	the boy do n't love those dishes .
the children have painted .	the child have painted .
the crayons were n't moving .	the crayon were n't moving .
the ladies have n't taken these buttons .	the lady have n't taken these buttons .
the boy has n't kept the cars .	the boys has n't kept the cars .
the snake has n't eaten .	the snakes has n't eaten .
the ladies are teaching the lady .	the lady are teaching the lady .
the boys have cried .	the boy have cried .
the teachers were n't running .	the teacher were n't running .
the people do run around that library .	the person do run around that library .
the plate has broken .	the plates has broken .
the windows were breaking .	the window were breaking .
the guys do n't drive to this restaurant .	the guy do n't drive to this restaurant .
the book does n't move .	the books does n't move .
the horses were n't breaking the buttons .	the horse were n't breaking the buttons .
the boys do win .	the boy do win .
the cars have broken that fork .	the car have broken that fork .
the girl does laugh .	the girls does laugh .
the horses do n't grow .	the horse do n't grow .
the doll does n't break .	the dolls does n't break .
the person was working with that teacher .	the people was working with that teacher .
the woman was n't reading .	the women was n't reading .
the plates were n't moving .	the plate were n't moving .
the child does hear these cats .	the children does hear these cats .
the people were n't practicing .	the person were n't practicing .
the candle does n't break this candle .	the candles does n't break this candle .
the teacher is learning .	the teachers is learning .
the women do n't lift the button .	the woman do n't lift the button .
the bottle has n't dropped .	the bottles has n't dropped .
the women do n't look like the snakes .	the woman do n't look like the snakes .
the guy does n't read .	the guys does n't read .
the doctors were crying .	the doctor were crying .
the man has cleaned these chairs .	the men has cleaned these chairs .
the children have answered the driver .	the child have answered the driver .
the teacher does n't smile .	the teachers does n't smile .
the person does buy these crayons .	the people does buy these crayons .
the horse has thought about this couch .	the horses has thought about this couch .
the shoes do move .	the shoe do move .
the rabbit does like that driver .	the rabbits does like that driver .
the boxes have n't dropped .	the box have n't dropped .
the book has n't broken .	the books has n't broken .
the rabbits do n't learn .	the rabbit do n't learn .
the window has n't dropped .	the windows has n't dropped .
the women do cry .	the woman do cry .
the boy does throw the plate .	the boys does throw the plate .
the forks have rolled away .	the fork have rolled away .
the fork was n't rolling away .	the forks was n't rolling away .
the children have thought about these boats .	the child have thought about these boats .
the candle was n't breaking .	the candles was n't breaking .
the man has confused the patient .	the men has confused the patient .
the boys do n't read .	the boy do n't read .
the ladies do n't talk to that dentist .	the lady do n't talk to that dentist .
the teachers do worry the women .	the teacher do worry the women .
the girl is running .	the girls is running .
the men have heard that dancer .	the man have heard that dancer .
the child does fix these boats .	the children does fix these boats .
the rabbits have thought about those pictures .	the rabbit have thought about those pictures .
the windows do n't move .	the window do n't move .
the lady has read .	the ladies has read .
the boys do sell those crayons .	the boy do sell those crayons .
the boy is breaking those spoons .	the boys is breaking those spoons .
the boxes do drop .	the box do drop .
the woman does n't run .	the women does n't run .
the guy was n't working with those guys .	the guys was n't working with those guys .
the man does n't sneeze .	the men does n't sneeze .
the boy was n't holding this bowl .	the boys was n't holding this bowl .
the boy has talked about these cars .	the boys has talked about these cars .
the ladies are dropping this button .	the lady are dropping this button .
the ring was rolling away .	the rings was rolling away .
the window does n't break this ring .	the windows does n't break this ring .
the book does break .	the books does break .
the beds have rolled away .	the bed have rolled away .
the people were keeping this spoon .	the person were keeping this spoon .
the dog is n't growing .	the dogs is n't growing .
the window was breaking .	the windows was breaking .
the ladies do talk about these teachers .	the lady do talk about these teachers .
the girls are yelling .	the girl are yelling .
the child does scream .	the children does scream .
the girls are bothering those men .	the girl are bothering those men .
the guys have n't eaten .	the guy have n't eaten .
the person does wave .	the people does wave .
the doctor does n't lose .	the doctors does n't lose .
the mice do n't think about that door .	the mouse do n't think about that door .
the car has broken .	the cars has broken .
the button does roll away .	the buttons does roll away .
the men do appreciate the doctors .	the man do appreciate the doctors .
the ladies are thinking about the driver .	the lady are thinking about the driver .
the doctors are breaking the bag .	the doctor are breaking the bag .
the shirts do n't break .	the shirt do n't break .
the teachers have eaten .	the teacher have eaten .
the men have laughed .	the man have laughed .
the guys are throwing these spoons .	the guy are throwing these spoons .
the man is n't cleaning that hat .	the men is n't cleaning that hat .
the cat was thinking about this window .	the cats was thinking about this window .
the shirt has n't broken .	the shirts has n't broken .
the horse does hate this glass .	the horses does hate this glass .
the children do learn .	the child do learn .
the teachers are n't lying .	the teacher are n't lying .
the ladies have confused these doctors .	the lady have confused these doctors .
the lady does n't scare this dancer .	the ladies does n't scare this dancer .
the car has n't broken .	the cars has n't broken .
the woman does n't grow .	the women does n't grow .
the teacher does appreciate that boy .	the teachers does appreciate that boy .
the turtle has n't noticed this chair .	the turtles has n't noticed this chair .
the rings do break that candle .	the ring do break that candle .
the bed is breaking those bags .	the beds is breaking those bags .
the shoes have n't rolled away .	the shoe have n't rolled away .
the children were dropping the ship .	the child were dropping the ship .
the guys have n't grown .	the guy have n't grown .
the teacher has found these ladies .	the teachers has found these ladies .
the boys do hold these toys .	the boy do hold these toys .
the bowls were dropping .	the bowl were dropping .
the girl does n't laugh .	the girls does n't laugh .
the lady was keeping this plate .	the ladies was keeping this plate .
the dish was n't breaking that glass .	the dishes was n't breaking that glass .
the person has heard the boys .	the people has heard the boys .
the child does n't cry .	the children does n't cry .
the toys were rolling away .	the toy were rolling away .
the bags have broken .	the bag have broken .
the men are n't shaking that bowl .	the man are n't shaking that bowl .
the cat has grown .	the cats has grown .
the doctor is n't shaking this bicycle .	the doctors is n't shaking this bicycle .
the boat does n't move .	the boats does n't move .
the lady is n't painting .	the ladies is n't painting .
the toys have n't broken this bowl .	the toy have n't broken this bowl .
the car is moving .	the cars is moving .
the plate does drop .	the plates does drop .
the ladies do n't sing .	the lady do n't sing .
the boys do n't help the people .	the boy do n't help the people .
the boys were talking about the window .	the boy were talking about the window .
the child has passed that park .	the children has passed that park .
the doctor was keeping that crayon .	the doctors was keeping that crayon .
the people are keeping these buttons .	the person are keeping these buttons .
the person was n't bringing that button .	the people was n't bringing that button .
the turtle has n't grown .	the turtles has n't grown .
the snakes have remembered the children .	the snake have remembered the children .
the teachers have n't dropped these shirts .	the teacher have n't dropped these shirts .
the teacher does have these cups .	the teachers does have these cups .
the snakes do n't learn .	the snake do n't learn .
the people are n't breaking this box .	the person are n't breaking this box .
the girl was n't losing .	the girls was n't losing .
the ladies were waving .	the lady were waving .
the boy is throwing the shirt .	the boys is throwing the shirt .
the bottles were n't rolling away .	the bottle were n't rolling away .
the guys do n't understand those doctors .	the guy do n't understand those doctors .
the crayon does n't roll away .	the crayons does n't roll away .
the lady has won .	the ladies has won .
the guys were n't talking to these boys .	the guy were n't talking to these boys .
the ladies do n't know that queen .	the lady do n't know that queen .
the girl does n't drive to this bank .	the girls does n't drive to this bank .
the men do praise the dentist .	the man do praise the dentist .
the lady is singing .	the ladies is singing .
the chairs do break the toys .	the chair do break the toys .
the ladies were throwing these toys .	the lady were throwing these toys .
the hats were breaking that rocket .	the hat were breaking that rocket .
the cars were n't dropping .	the car were n't dropping .
the teachers do n't clean those cars .	the teacher do n't clean those cars .
the girls do n't break that couch .	the girl do n't break that couch .
the lady has n't bought that dish .	the ladies has n't bought that dish .
the glasses do move .	the glass do move .
the guy does worry those guys .	the guys does worry those guys .
the door does n't break those cars .	the doors does n't break those cars .
the ladies have n't found the boat .	the lady have n't found the boat .
the guys were working with the people .	the guy were working with the people .
the fork was breaking that boat .	the forks was breaking that boat .
the spoons have n't rolled away .	the spoon have n't rolled away .
the truck has n't broken this doll .	the trucks has n't broken this doll .
the plates do move .	the plate do move .
the child does n't scream .	the children does n't scream .
the lady has taught that patient .	the ladies has taught that patient .
the women do go to the mall .	the woman do go to the mall .
the girls do n't sound like that rabbit .	the girl do n't sound like that rabbit .
the lady does n't make that chair .	the ladies does n't make that chair .
the guys do n't run .	the guy do n't run .
the teacher does n't drive to the schools .	the teachers does n't drive to the schools .
the girls do n't read .	the girl do n't read .
the woman is eating .	the women is eating .
the ladies have n't laughed .	the lady have n't laughed .
the dolls have n't dropped .	the doll have n't dropped .
the door has n't broken .	the doors has n't broken .
the person has heard the bird .	the people has heard the bird .
the children do n't know the turtles .	the child do n't know the turtles .
the child does n't take that bag .	the children does n't take that bag .
the doors were dropping .	the door were dropping .
the people have n't taught this woman .	the person have n't taught this woman .
the guys do walk through this school .	the guy do walk through this school .
the teacher does n't cry .	the teachers does n't cry .
the man has n't lost .	the men has n't lost .
the woman has n't laughed .	the women has n't laughed .
the woman has n't visited this man .	the women has n't visited this man .
the children are cleaning those shirts .	the child are cleaning those shirts .
the fork was n't moving .	the forks was n't moving .
the man was n't keeping that button .	the men was n't keeping that button .
the cats do n't learn .	the cat do n't learn .
the doll was n't breaking those dolls .	the dolls was n't breaking those dolls .
the toy has moved .	the toys has moved .
the man does shake these chairs .	the men does shake these chairs .
the man is crying .	the men is crying .
the doctor is bringing these bowls .	the doctors is bringing these bowls .
the doctor does teach these children .	the doctors does teach these children .
the mouse is eating .	the mice is eating .
the snakes have remembered that ship .	the snake have remembered that ship .
the truck is n't rolling away .	the trucks is n't rolling away .
the girls do n't break these boxes .	the girl do n't break these boxes .
the books do n't break .	the book do n't break .
the button was dropping .	the buttons was dropping .
the boy has worked with these ladies .	the boys has worked with these ladies .
the people are running around this library .	the person are running around this library .
the children were n't making these dishes .	the child were n't making these dishes .
the teacher has eaten .	the teachers has eaten .
the bed has n't broken the windows .	the beds has n't broken the windows .
the book has n't broken that ring .	the books has n't broken that ring .
the woman is buying these trucks .	the women is buying these trucks .
the snakes do see this button .	the snake do see this button .
the child was bothering this dancer .	the children was bothering this dancer .
the box has broken those dishes .	the boxes has broken those dishes .
the plate was n't breaking .	the plates was n't breaking .
the guy does bother the ladies .	the guys does bother the ladies .
the fork does roll away .	the forks does roll away .
the guy has n't thought about the plate .	the guys has n't thought about the plate .
the people have n't yelled .	the person have n't yelled .
the children are n't talking about the patient .	the child are n't talking about the patient .
the candle is moving .	the candles is moving .
the boy has talked to that dancer .	the boys has talked to that dancer .
the boy has n't kept the couch .	the boys has n't kept the couch .
the child has made this glass .	the children has made this glass .
the girl has n't run .	the girls has n't run .
the boy has lost this cup .	the boys has lost this cup .
the books have broken that chair .	the book have broken that chair .
the rabbit does see these cups .	the rabbits does see these cups .
the men do n't answer the person .	the man do n't answer the person .
the cat does n't think about the guy .	the cats does n't think about the guy .
the woman does n't scare the adult .	the women does n't scare the adult .
the guy is n't practicing .	the guys is n't practicing .
the girls have found the teachers .	the girl have found the teachers .
the books were moving .	the book were moving .
the dog was breaking these candles .	the dogs was breaking these candles .
the truck does n't drop .	the trucks does n't drop .
the women were yelling .	the woman were yelling .
the people are laughing .	the person are laughing .
the girls are n't throwing that cup .	the girl are n't throwing that cup .
the guy was n't walking through these rooms .	the guys was n't walking through these rooms .
the plate has n't rolled away .	the plates has n't rolled away .
the women do n't learn .	the woman do n't learn .
the dishes have n't broken that mirror .	the dish have n't broken that mirror .
the girl is n't bothering the women .	the girls is n't bothering the women .
the doctor has lost that driver .	the doctors has lost that driver .
the book was moving .	the books was moving .
the truck has n't broken that boat .	the trucks has n't broken that boat .
the person does laugh .	the people does laugh .
the bird does n't like the boy .	the birds does n't like the boy .
the girls are finding the door .	the girl are finding the door .
the men have talked .	the man have talked .
the guys have n't found this teacher .	the guy have n't found this teacher .
the spoon does break the crayon .	the spoons does break the crayon .
the women do n't find those spoons .	the woman do n't find those spoons .
the teachers were n't eating .	the teacher were n't eating .
the toy is breaking that window .	the toys is breaking that window .
the doctors have n't broken the shirts .	the doctor have n't broken the shirts .
the girls do see the toys .	the girl do see the toys .
the woman has left the restaurant .	the women has left the restaurant .
the children have won .	the child have won .
the men are painting .	the man are painting .
the lady is n't moving this boat .	the ladies is n't moving this boat .
the boy is n't talking about this guy .	the boys is n't talking about this guy .
the buttons have n't dropped .	the button have n't dropped .
the guy does n't talk to these men .	the guys does n't talk to these men .
the boats do n't break the book .	the boat do n't break the book .
the doctor has cleaned those pictures .	the doctors has cleaned those pictures .
the chairs have dropped .	the chair have dropped .
the boys have worried these guys .	the boy have worried these guys .
the doctor does drop the bicycle .	the doctors does drop the bicycle .
the hat was dropping .	the hats was dropping .
the boy has n't won .	the boys has n't won .
the doctors have n't run .	the doctor have n't run .
the chair was n't rolling away .	the chairs was n't rolling away .
the turtles do see the rabbit .	the turtle do see the rabbit .
the mice do see that doctor .	the mouse do see that doctor .
the people were driving to these schools .	the person were driving to these schools .
the doll has broken these bottles .	the dolls has broken these bottles .
the rabbits have run .	the rabbit have run .
the person has n't heard the doctor .	the people has n't heard the doctor .
the teachers have n't yelled .	the teacher have n't yelled .
the doctor has n't visited that dentist .	the doctors has n't visited that dentist .
the guy does n't hold that ship .	the guys does n't hold that ship .
the guy has n't painted .	the guys has n't painted .
the doctor is thinking about this mouse .	the doctors is thinking about this mouse .
the child does n't break this bicycle .	the children does n't break this bicycle .
the men have n't thought about this customer .	the man have n't thought about this customer .
the child was n't finding the boats .	the children was n't finding the boats .
the guy is n't smiling .	the guys is n't smiling .
the people do hate those chairs .	the person do hate those chairs .
the girls are helping the person .	the girl are helping the person .
the children have n't run .	the child have n't run .
the people do talk about those bowls .	the person do talk about those bowls .
the teacher does listen to these doctors .	the teachers does listen to these doctors .
the man is n't cleaning this picture .	the men is n't cleaning this picture .
the box has moved .	the boxes has moved .
the girls do hate the chair .	the girl do hate the chair .
the women do n't remember the ladies .	the woman do n't remember the ladies .
the doctor has scared those guys .	the doctors has scared those guys .
the woman does n't clean those shirts .	the women does n't clean those shirts .
the mice do grow .	the mouse do grow .
the bottles have rolled away .	the bottle have rolled away .
the woman was n't singing .	the women was n't singing .
the spoon has moved .	the spoons has moved .
the plates do drop .	the plate do drop .
the man was n't painting .	the men was n't painting .
the ladies do make those bowls .	the lady do make those bowls .
the boat has n't dropped .	the boats has n't dropped .
the shirts do drop .	the shirt do drop .
the boy does learn .	the boys does learn .
the men do know these snakes .	the man do know these snakes .
the woman does n't cough .	the women does n't cough .
the people have passed this room .	the person have passed this room .
the woman does buy this car .	the women does buy this car .
the boys do hear these children .	the boy do hear these children .
the bags were breaking this box .	the bag were breaking this box .
the boys have n't found the cup .	the boy have n't found the cup .
the lady does find those pictures .	the ladies does find those pictures .
the doll does n't roll away .	the dolls does n't roll away .
the man is n't breaking these books .	the men is n't breaking these books .
the bag does n't break .	the bags does n't break .
the teacher does n't learn .	the teachers does n't learn .
the truck was n't moving .	the trucks was n't moving .
the buttons do break .	the button do break .
the dishes do n't break the plates .	the dish do n't break the plates .
the women have n't thrown that ship .	the woman have n't thrown that ship .
the rabbits were growing .	the rabbit were growing .
the dolls do n't break .	the doll do n't break .
the girl was laughing .	the girls was laughing .
the rings are n't dropping .	the ring are n't dropping .
the boys do grow .	the boy do grow .
the boy does wave .	the boys does wave .
the chairs do move .	the chair do move .
the children do n't visit this woman .	the child do n't visit this woman .
the child does teach these ladies .	the children does teach these ladies .
the bowl has n't moved .	the bowls has n't moved .
the boys have n't grown .	the boy have n't grown .
the teachers do n't talk about that shirt .	the teacher do n't talk about that shirt .
the man has found that car .	the men has found that car .
the button was n't dropping .	the buttons was n't dropping .
the guy is yelling .	the guys is yelling .
the doctors have n't fixed these cars .	the doctor have n't fixed these cars .
the plate does roll away .	the plates does roll away .
the people are reading .	the person are reading .
the chair was n't breaking .	the chairs was n't breaking .
the woman has lost the boat .	the women has lost the boat .
the doctor does n't sing .	the doctors does n't sing .
the teacher has worked with that queen .	the teachers has worked with that queen .
the bag has n't broken that boat .	the bags has n't broken that boat .
the women do grow .	the woman do grow .
the plate was moving .	the plates was moving .
the guy does talk about these horses .	the guys does talk about these horses .
the man has n't heard this driver .	the men has n't heard this driver .
the ladies do talk to that doctor .	the lady do talk to that doctor .
the ring does n't break these cups .	the rings does n't break these cups .
the window does n't break .	the windows does n't break .
the boys have run .	the boy have run .
the window does move .	the windows does move .
the ladies were n't visiting the dentist .	the lady were n't visiting the dentist .
the lady does remember these doors .	the ladies does remember these doors .
the doctors do n't visit that boy .	the doctor do n't visit that boy .
the button was n't breaking .	the buttons was n't breaking .
the lady does n't lose .	the ladies does n't lose .
the boys are n't eating .	the boy are n't eating .
the shoe was breaking the cars .	the shoes was breaking the cars .
the girls do bother those men .	the girl do bother those men .
the women were going to this hospital .	the woman were going to this hospital .
the doctor does practice .	the doctors does practice .
the guys do pass those schools .	the guy do pass those schools .
the woman does n't go to that hospital .	the women does n't go to that hospital .
the dolls were breaking that book .	the doll were breaking that book .
the birds have n't learned .	the bird have n't learned .
the doctor does n't visit this man .	the doctors does n't visit this man .
the women have n't talked to this guy .	the woman have n't talked to this guy .
the bowls were n't breaking .	the bowl were n't breaking .
the birds were breaking that book .	the bird were breaking that book .
the girls do hold this chair .	the girl do hold this chair .
the ladies do n't break the trucks .	the lady do n't break the trucks .
the women were n't yelling .	the woman were n't yelling .
the girls do n't understand that adult .	the girl do n't understand that adult .
the man does hold this ring .	the men does hold this ring .
the mouse has eaten .	the mice has eaten .
the turtle does n't run .	the turtles does n't run .
the girl is working with those guys .	the girls is working with those guys .
the person has n't talked to that dentist .	the people has n't talked to that dentist .
the turtles were growing .	the turtle were growing .
the horses do n't break these boxes .	the horse do n't break these boxes .
the snakes have broken this couch .	the snake have broken this couch .
the cups are breaking these candles .	the cup are breaking these candles .
the women are n't breaking the dishes .	the woman are n't breaking the dishes .
the spoons do roll away .	the spoon do roll away .
the person has n't eaten .	the people has n't eaten .
the doctors do n't think about this adult .	the doctor do n't think about this adult .
the cat does forget the button .	the cats does forget the button .
the shirt has rolled away .	the shirts has rolled away .
the bags have n't dropped .	the bag have n't dropped .
the girls do scream .	the girl do scream .
the woman does paint .	the women does paint .
the person is singing .	the people is singing .
the woman was keeping these dishes .	the women was keeping these dishes .
the woman is n't helping that child .	the women is n't helping that child .
the books are breaking that bed .	the book are breaking that bed .
the boy was n't growing .	the boys was n't growing .
the bottles were n't moving .	the bottle were n't moving .
the doctors are whispering .	the doctor are whispering .
the cup has n't broken these cars .	the cups has n't broken these cars .
the men do clean those candles .	the man do clean those candles .
the bird has learned .	the birds has learned .
the guys were n't thinking about those glasses .	the guy were n't thinking about those glasses .
the bird does n't remember that doll .	the birds does n't remember that doll .
the bowls are breaking .	the bowl are breaking .
the plate was n't breaking these trucks .	the plates was n't breaking these trucks .
the ladies are making those shoes .	the lady are making those shoes .
the birds were n't eating .	the bird were n't eating .
the box has n't moved .	the boxes has n't moved .
the snakes are n't thinking about the chairs .	the snake are n't thinking about the chairs .
the doors were n't moving .	the door were n't moving .
the man was n't breaking that ring .	the men was n't breaking that ring .
the horse is running .	the horses is running .
the guy does n't bother this driver .	the guys does n't bother this driver .
the dog has learned .	the dogs has learned .
the child does break these cars .	the children does break these cars .
the car does n't move .	the cars does n't move .
the men are crying .	the man are crying .
the men have n't seen that dog .	the man have n't seen that dog .
the children were n't keeping the beds .	the child were n't keeping the beds .
the lady has found these boats .	the ladies has found these boats .
the box is breaking .	the boxes is breaking .
the toys do n't break this fork .	the toy do n't break this fork .
the guy does n't run around the library .	the guys does n't run around the library .
the girls have held this doll .	the girl have held this doll .
the pictures have n't dropped .	the picture have n't dropped .
the doctors do practice .	the doctor do practice .
the turtles have n't noticed that plane .	the turtle have n't noticed that plane .
the girl does exercise .	the girls does exercise .
the shirts were breaking this bottle .	the shirt were breaking this bottle .
the teachers do n't talk about this window .	the teacher do n't talk about this window .
the doctor is n't screaming .	the doctors is n't screaming .
the girl does talk about that picture .	the girls does talk about that picture .
the spoon does n't break .	the spoons does n't break .
the girls are breaking those dishes .	the girl are breaking those dishes .
the woman does n't break those rings .	the women does n't break those rings .
the people do n't walk through that school .	the person do n't walk through that school .
the girl was n't learning .	the girls was n't learning .
the boy does scream .	the boys does scream .
the girls are taking those shirts .	the girl are taking those shirts .
the books do roll away .	the book do roll away .
the boys have broken the shirt .	the boy have broken the shirt .
the men do drive to this hospital .	the man do drive to this hospital .
the doctors have n't remembered these boys .	the doctor have n't remembered these boys .
the boys have heard the king .	the boy have heard the king .
the child does n't hold those boxes .	the children does n't hold those boxes .
the spoons were breaking .	the spoon were breaking .
the doctor has bought that boat .	the doctors has bought that boat .
the cats have n't broken the hats .	the cat have n't broken the hats .
the teacher does n't shake the book .	the teachers does n't shake the book .
the cars are breaking the pictures .	the car are breaking the pictures .
the girl is n't taking those windows .	the girls is n't taking those windows .
the bowl does drop .	the bowls does drop .
the girls are breaking the bottles .	the girl are breaking the bottles .
the boys have n't learned .	the boy have n't learned .
the pictures do break this plane .	the picture do break this plane .
the boys were reading .	the boy were reading .
the guys do look like that driver .	the guy do look like that driver .
the women do n't worry the patient .	the woman do n't worry the patient .
the men are n't dropping these bags .	the man are n't dropping these bags .
the birds were learning .	the bird were learning .
the teachers are n't listening to those teachers .	the teacher are n't listening to those teachers .
the turtle has n't remembered the turtle .	the turtles has n't remembered the turtle .
the children do smile .	the child do smile .
the ladies do n't eat .	the lady do n't eat .
the child does cry .	the children does cry .
the doctor does sing .	the doctors does sing .
the child does n't teach this king .	the children does n't teach this king .
the boy does n't answer this person .	the boys does n't answer this person .
the guys do take this bowl .	the guy do take this bowl .
the horse has n't noticed the boys .	the horses has n't noticed the boys .
the teachers were talking to the queen .	the teacher were talking to the queen .
the toy has broken .	the toys has broken .
the lady has n't broken the bags .	the ladies has n't broken the bags .
the guy has lost that ship .	the guys has lost that ship .
the dish does n't roll away .	the dishes does n't roll away .
the people do lie .	the person do lie .
the lady does cough .	the ladies does cough .
the boys have bought that window .	the boy have bought that window .
the turtles do hate that boy .	the turtle do hate that boy .
the ladies have painted .	the lady have painted .
the doctor does sound like those boys .	the doctors does sound like those boys .
the people do n't practice .	the person do n't practice .
the car was breaking these crayons .	the cars was breaking these crayons .
the doctor has painted .	the doctors has painted .
the teachers have n't eaten .	the teacher have n't eaten .
the girl is n't buying this glass .	the girls is n't buying this glass .
the dog does forget the bowls .	the dogs does forget the bowls .
the teacher was thinking about those birds .	the teachers was thinking about those birds .
the rings do break .	the ring do break .
the candles do n't break the candle .	the candle do n't break the candle .
the dogs have eaten .	the dog have eaten .
the guy does have the box .	the guys does have the box .
the teacher was eating .	the teachers was eating .
the lady does sneeze .	the ladies does sneeze .
the teachers do smile .	the teacher do smile .
the rings do n't break .	the ring do n't break .
the girl is n't growing .	the girls is n't growing .
the men are n't taking this fork .	the man are n't taking this fork .
the shoes are n't dropping .	the shoe are n't dropping .
the ladies do lose that book .	the lady do lose that book .
the ladies do think about those books .	the lady do think about those books .
the bag has dropped .	the bags has dropped .
the people were eating .	the person were eating .
the teachers do n't break these cars .	the teacher do n't break these cars .
the woman does love the children .	the women does love the children .
the women do n't remember the woman .	the woman do n't remember the woman .
the teacher has n't bothered this girl .	the teachers has n't bothered this girl .
the lady does buy the spoon .	the ladies does buy the spoon .
the man does look like those doctors .	the men does look like those doctors .
the teachers were keeping these doors .	the teacher were keeping these doors .
the woman does n't practice .	the women does n't practice .
the people have walked through this school .	the person have walked through this school .
the teacher was waving .	the teachers was waving .
the cup is moving .	the cups is moving .
the rabbit does n't grow .	the rabbits does n't grow .
the women do n't win .	the woman do n't win .
the snake does n't eat .	the snakes does n't eat .
the cup has rolled away .	the cups has rolled away .
the guys do n't exercise .	the guy do n't exercise .
the women do n't visit that patient .	the woman do n't visit that patient .
the girls have scared the ladies .	the girl have scared the ladies .
the guy does n't exercise .	the guys does n't exercise .
the horse is learning .	the horses is learning .
the man does n't help these men .	the men does n't help these men .
the women are painting .	the woman are painting .
the people are n't breaking this crayon .	the person are n't breaking this crayon .
the cats are n't running .	the cat are n't running .
the teacher does learn .	the teachers does learn .
the horse has learned .	the horses has learned .
the doors have broken the spoon .	the door have broken the spoon .
the bed was moving .	the beds was moving .
the man does drop these windows .	the men does drop these windows .
the people have n't brought this bag .	the person have n't brought this bag .
the men have n't heard the king .	the man have n't heard the king .
the bowl does n't roll away .	the bowls does n't roll away .
the girls do move the plane .	the girl do move the plane .
the guys have n't kept the candles .	the guy have n't kept the candles .
the shirt does n't move .	the shirts does n't move .
the lady does n't listen to the dancer .	the ladies does n't listen to the dancer .
the mice do n't grow .	the mouse do n't grow .
the lady is screaming .	the ladies is screaming .
the shoes do break these beds .	the shoe do break these beds .
the doctor has n't thrown this dish .	the doctors has n't thrown this dish .
the lady has n't brought that shoe .	the ladies has n't brought that shoe .
the doors have broken .	the door have broken .
the guy does n't help the ladies .	the guys does n't help the ladies .
the men do n't hold those doors .	the man do n't hold those doors .
the horse does n't see these snakes .	the horses does n't see these snakes .
the person has read .	the people has read .
the teachers do n't learn .	the teacher do n't learn .
the person does n't lift those buttons .	the people does n't lift those buttons .
the shoe does n't roll away .	the shoes does n't roll away .
the window has broken .	the windows has broken .
the teacher has run around the school .	the teachers has run around the school .
the men have n't lost .	the man have n't lost .
the woman has n't brought the book .	the women has n't brought the book .
the teacher does exercise .	the teachers does exercise .
the teacher has n't noticed that bird .	the teachers has n't noticed that bird .
the boy has read .	the boys has read .
the guys have n't left these schools .	the guy have n't left these schools .
the bowl does n't move .	the bowls does n't move .
the boy has yelled .	the boys has yelled .
the girls do n't answer the lady .	the girl do n't answer the lady .
the guys are n't keeping the bag .	the guy are n't keeping the bag .
the birds do n't like that queen .	the bird do n't like that queen .
the girl does n't help that patient .	the girls does n't help that patient .
the boxes were rolling away .	the box were rolling away .
the people are n't breaking that bed .	the person are n't breaking that bed .
the plates were n't breaking those windows .	the plate were n't breaking those windows .
the books have rolled away .	the book have rolled away .
the doctors have n't talked .	the doctor have n't talked .
the dog was eating .	the dogs was eating .
the mice do learn .	the mouse do learn .
the guys have n't remembered these turtles .	the guy have n't remembered these turtles .
the person does n't run .	the people does n't run .
the bed does break that chair .	the beds does break that chair .
the snakes do hate that bicycle .	the snake do hate that bicycle .
the crayons were moving .	the crayon were moving .
the people have n't learned .	the person have n't learned .
the cars do n't break .	the car do n't break .
the children have found the box .	the child have found the box .
the children do n't lie .	the child do n't lie .
the teachers were n't thinking about this king .	the teacher were n't thinking about this king .
the girl does n't praise that dancer .	the girls does n't praise that dancer .
the boxes do n't move .	the box do n't move .
the child was bothering these people .	the children was bothering these people .
the guys were n't learning .	the guy were n't learning .
the horse was breaking those dishes .	the horses was breaking those dishes .
the women do have this plate .	the woman do have this plate .
the teacher has n't painted .	the teachers has n't painted .
the guys do talk about the woman .	the guy do talk about the woman .
the man was n't reading .	the men was n't reading .
the guys do n't forget these buttons .	the guy do n't forget these buttons .
the guys do n't lift these boats .	the guy do n't lift these boats .
the guys have n't talked about the bottles .	the guy have n't talked about the bottles .
the man does drive to these schools .	the men does drive to these schools .
the teachers have helped these children .	the teacher have helped these children .
the man does worry this woman .	the men does worry this woman .
the shoe has rolled away .	the shoes has rolled away .
the guys do n't whisper .	the guy do n't whisper .
the boy has walked through that restaurant .	the boys has walked through that restaurant .
the guys were n't cleaning the truck .	the guy were n't cleaning the truck .
the candle has rolled away .	the candles has rolled away .
the man has lost these dolls .	the men has lost these dolls .
the beds do break that chair .	the bed do break that chair .
the chair has broken that couch .	the chairs has broken that couch .
the teachers have heard those horses .	the teacher have heard those horses .
the doctor does hate this adult .	the doctors does hate this adult .
the truck does roll away .	the trucks does roll away .
the guys have n't lost this fork .	the guy have n't lost this fork .
the boats have broken this hat .	the boat have broken this hat .
the children have held those windows .	the child have held those windows .
the guys have n't held that door .	the guy have n't held that door .
the doctor has found that dancer .	the doctors has found that dancer .
the people do remember these horses .	the person do remember these horses .
the person does make this picture .	the people does make this picture .
the teacher was keeping this fork .	the teachers was keeping this fork .
the horse does n't notice this snake .	the horses does n't notice this snake .
the guy is n't whispering .	the guys is n't whispering .
the bed does break .	the beds does break .
the rabbits have learned .	the rabbit have learned .
the lady does n't smile .	the ladies does n't smile .
the boys have n't helped that guy .	the boy have n't helped that guy .
the shoe was moving .	the shoes was moving .
the people do practice .	the person do practice .
the door does drop .	the doors does drop .
the windows do break .	the window do break .
the cat has n't thought about the teacher .	the cats has n't thought about the teacher .
the man has found the dishes .	the men has found the dishes .
the candle was moving .	the candles was moving .
the girls have n't heard the man .	the girl have n't heard the man .
the buttons do n't roll away .	the button do n't roll away .
the bird has grown .	the birds has grown .
the dolls have n't broken this ship .	the doll have n't broken this ship .
the dish was rolling away .	the dishes was rolling away .
the guys do throw that toy .	the guy do throw that toy .
the girl has talked .	the girls has talked .
the men were n't crying .	the man were n't crying .
the teachers are helping that customer .	the teacher are helping that customer .
the trucks have n't rolled away .	the truck have n't rolled away .
the dog has n't eaten .	the dogs has n't eaten .
the girl does notice these people .	the girls does notice these people .
the guy does n't run around that restaurant .	the guys does n't run around that restaurant .
the woman has n't confused that driver .	the women has n't confused that driver .
the boys have n't scared that dentist .	the boy have n't scared that dentist .
the boats are breaking those rings .	the boat are breaking those rings .
the doctor does lie .	the doctors does lie .
the guys do read .	the guy do read .
the cars have n't broken these doors .	the car have n't broken these doors .
the spoon was n't moving .	the spoons was n't moving .
the teachers were n't keeping those doors .	the teacher were n't keeping those doors .
the doctors were n't holding those cups .	the doctor were n't holding those cups .
the child has n't gone to this bank .	the children has n't gone to this bank .
the bowls were breaking the button .	the bowl were breaking the button .
the men do n't shake this candle .	the man do n't shake this candle .
the girl has n't kept these plates .	the girls has n't kept these plates .
the girls do n't bother the girls .	the girl do n't bother the girls .
the doctors do n't know the dentist .	the doctor do n't know the dentist .
the man has found these boys .	the men has found these boys .
the person does shake these pictures .	the people does shake these pictures .
the cats do n't run .	the cat do n't run .
the children are n't teaching the person .	the child are n't teaching the person .
the children have made the cars .	the child have made the cars .
the cup is n't dropping .	the cups is n't dropping .
the men were smiling .	the man were smiling .
the shirt is rolling away .	the shirts is rolling away .
the child does n't whisper .	the children does n't whisper .
the men were talking to the lady .	the man were talking to the lady .
the doctors do n't cry .	the doctor do n't cry .
the doll has dropped .	the dolls has dropped .
the lady has thrown the plate .	the ladies has thrown the plate .
