she sent my doctor the hat .	my doctor sent the hat she .
she bought this boy the doll .	this boy bought the doll she .
she showed my mom the shoes .	my mom showed the shoes she .
she bought Tracy the beds .	Tracy bought the beds she .
they bought my teacher the windows .	my teacher bought the windows they .
she sent Kevin the crayon .	Kevin sent the crayon she .
he gave Gregory the trucks .	Gregory gave the trucks he .
I gave Gregory the rings .	Gregory gave the rings I .
I showed the customer the forks .	the customer showed the forks I .
I sent my doctor the cups .	my doctor sent the cups I .
she sent David the spoon .	David sent the spoon she .
she gave this lady the bottles .	this lady gave the bottles she .
he showed this king the bicycle .	this king showed the bicycle he .
they sent my dad the books .	my dad sent the books they .
we bought the boy the toy .	the boy bought the toy we .
we showed that girl the books .	that girl showed the books we .
I bought your dentist the pictures .	your dentist bought the pictures I .
she gave your brother the hat .	your brother gave the hat she .
we gave my boss the box .	my boss gave the box we .
I sent this queen the hat .	this queen sent the hat I .
he sent your wife the forks .	your wife sent the forks he .
we bought my mom the bowls .	my mom bought the bowls we .
we bought my mother the book .	my mother bought the book we .
they sent Allison the hat .	Allison sent the hat they .
she showed my father the forks .	my father showed the forks she .
I sent my daughter the box .	my daughter sent the box I .
I showed Alexander the crayon .	Alexander showed the crayon I .
she sent this guy the bed .	this guy sent the bed she .
we showed Joseph the beds .	Joseph showed the beds we .
they gave my teacher the doll .	my teacher gave the doll they .
she gave the queen the cars .	the queen gave the cars she .
we showed that man the book .	that man showed the book we .
he gave my dad the boats .	my dad gave the boats he .
they gave the customer the rings .	the customer gave the rings they .
she bought this man the couch .	this man bought the couch she .
he showed Sarah the bed .	Sarah showed the bed he .
they sent your friend the windows .	your friend sent the windows they .
they gave my son the boats .	my son gave the boats they .
he gave my son the bags .	my son gave the bags he .
he showed Thomas the car .	Thomas showed the car he .
they bought the driver the candles .	the driver bought the candles they .
they bought the woman the bed .	the woman bought the bed they .
she bought Stephanie the candles .	Stephanie bought the candles she .
I bought Carl the book .	Carl bought the book I .
I bought this guy the bags .	this guy bought the bags I .
she sent Jessica the bag .	Jessica sent the bag she .
he showed that person the car .	that person showed the car he .
we sent my mother the door .	my mother sent the door we .
I bought the king the forks .	the king bought the forks I .
we gave this girl the rocket .	this girl gave the rocket we .
we bought that customer the forks .	that customer bought the forks we .
he sent your mother the windows .	your mother sent the windows he .
she sent Kevin the window .	Kevin sent the window she .
I showed your son the rocket .	your son showed the rocket I .
she gave your father the button .	your father gave the button she .
she showed the queen the windows .	the queen showed the windows she .
she showed Nancy the candles .	Nancy showed the candles she .
I showed my daughter the doll .	my daughter showed the doll I .
he bought my teacher the rings .	my teacher bought the rings he .
she bought the queen the beds .	the queen bought the beds she .
she gave that queen the crayons .	that queen gave the crayons she .
he sent my wife the plates .	my wife sent the plates he .
they bought Michelle the glass .	Michelle bought the glass they .
she sent Kayla the cups .	Kayla sent the cups she .
he sent this woman the dishes .	this woman sent the dishes he .
we gave the girl the candle .	the girl gave the candle we .
we showed my mother the chair .	my mother showed the chair we .
they bought that patient the spoons .	that patient bought the spoons they .
she gave Laurie the button .	Laurie gave the button she .
he sent my husband the cars .	my husband sent the cars he .
she gave that adult the ring .	that adult gave the ring she .
we gave Patrick the ring .	Patrick gave the ring we .
she sent my doctor the forks .	my doctor sent the forks she .
we gave that man the toys .	that man gave the toys we .
she gave Jason the cars .	Jason gave the cars she .
we gave Deborah the buttons .	Deborah gave the buttons we .
he sent that queen the car .	that queen sent the car he .
I gave this lady the glasses .	this lady gave the glasses I .
I bought that man the book .	that man bought the book I .
they showed your brother the boats .	your brother showed the boats they .
he sent Thomas the bowl .	Thomas sent the bowl he .
they bought the customer the candles .	the customer bought the candles they .
he gave my son the plane .	my son gave the plane he .
he showed this doctor the truck .	this doctor showed the truck he .
we showed that queen the box .	that queen showed the box we .
I gave Guy the couch .	Guy gave the couch I .
I sent my wife the boats .	my wife sent the boats I .
she bought Amelia the shirt .	Amelia bought the shirt she .
we gave your dentist the crayon .	your dentist gave the crayon we .
they gave Jennifer the glass .	Jennifer gave the glass they .
I bought David the windows .	David bought the windows I .
they bought this man the bottle .	this man bought the bottle they .
I gave Steve the crayon .	Steve gave the crayon I .
I bought my doctor the spoon .	my doctor bought the spoon I .
I showed Joseph the shoes .	Joseph showed the shoes I .
we bought Carl the cars .	Carl bought the cars we .
we showed this driver the bowls .	this driver showed the bowls we .
he gave the king the rug .	the king gave the rug he .
she showed Amelia the door .	Amelia showed the door she .
we gave my mother the bowl .	my mother gave the bowl we .
they gave Donna the beds .	Donna gave the beds they .
they sent your dad the crayon .	your dad sent the crayon they .
we bought my wife the bicycle .	my wife bought the bicycle we .
I gave Eric the shirt .	Eric gave the shirt I .
they bought that adult the window .	that adult bought the window they .
she gave this customer the dish .	this customer gave the dish she .
she showed Nina the toys .	Nina showed the toys she .
I gave my brother the trucks .	my brother gave the trucks I .
they bought my mom the bottle .	my mom bought the bottle they .
we sent Sally the toys .	Sally sent the toys we .
they showed this king the rug .	this king showed the rug they .
I bought my mother the hats .	my mother bought the hats I .
I sent this dentist the bicycle .	this dentist sent the bicycle I .
we sent the queen the car .	the queen sent the car we .
I gave that dentist the book .	that dentist gave the book I .
we showed the guy the box .	the guy showed the box we .
we sent my sister the glass .	my sister sent the glass we .
we gave my boss the doll .	my boss gave the doll we .
we sent the king the glasses .	the king sent the glasses we .
he gave Michelle the rocket .	Michelle gave the rocket he .
I gave my wife the crayons .	my wife gave the crayons I .
they sent Jason the hats .	Jason sent the hats they .
we gave the queen the ring .	the queen gave the ring we .
he showed the king the bed .	the king showed the bed he .
we showed my sister the bowl .	my sister showed the bowl we .
he showed your husband the mirror .	your husband showed the mirror he .
they sent Tracy the bicycle .	Tracy sent the bicycle they .
she gave that boy the cup .	that boy gave the cup she .
they sent your dentist the rug .	your dentist sent the rug they .
they gave the girl the bag .	the girl gave the bag they .
she gave the lady the bicycle .	the lady gave the bicycle she .
I bought my teacher the ship .	my teacher bought the ship I .
they sent my mom the cars .	my mom sent the cars they .
they sent your cousin the mirror .	your cousin sent the mirror they .
they gave Jill the dish .	Jill gave the dish they .
they showed Lisa the cups .	Lisa showed the cups they .
they gave my grandmother the forks .	my grandmother gave the forks they .
we bought the boy the crayon .	the boy bought the crayon we .
I sent your dad the books .	your dad sent the books I .
she sent your father the bowls .	your father sent the bowls she .
I showed your grandmother the forks .	your grandmother showed the forks I .
she sent your son the mirror .	your son sent the mirror she .
she showed your boss the boxes .	your boss showed the boxes she .
we sent this woman the rug .	this woman sent the rug we .
I sent the woman the crayon .	the woman sent the crayon I .
she sent Jane the doors .	Jane sent the doors she .
she bought your father the shoes .	your father bought the shoes she .
they gave my boss the mirror .	my boss gave the mirror they .
she bought Wendy the plate .	Wendy bought the plate she .
they gave your brother the picture .	your brother gave the picture they .
they showed the girl the cup .	the girl showed the cup they .
I gave my friend the pictures .	my friend gave the pictures I .
I showed that adult the toys .	that adult showed the toys I .
he gave my doctor the candle .	my doctor gave the candle he .
we bought Marie the shirt .	Marie bought the shirt we .
we bought Deborah the doll .	Deborah bought the doll we .
they showed your friend the pictures .	your friend showed the pictures they .
I bought Cindy the couch .	Cindy bought the couch I .
we bought the woman the rings .	the woman bought the rings we .
she sent my grandmother the box .	my grandmother sent the box she .
he showed Jessica the candle .	Jessica showed the candle he .
she sent Judy the bottle .	Judy sent the bottle she .
he gave my sister the spoons .	my sister gave the spoons he .
we bought Melissa the pictures .	Melissa bought the pictures we .
they showed Frank the car .	Frank showed the car they .
she sent that queen the books .	that queen sent the books she .
she bought my son the hat .	my son bought the hat she .
I sent this patient the truck .	this patient sent the truck I .
we gave my daughter the ring .	my daughter gave the ring we .
he gave that boy the shoe .	that boy gave the shoe he .
they sent David the rug .	David sent the rug they .
she sent Robert the spoons .	Robert sent the spoons she .
he gave April the cars .	April gave the cars he .
we showed Christopher the bowl .	Christopher showed the bowl we .
I gave your grandmother the button .	your grandmother gave the button I .
I bought Eric the bowl .	Eric bought the bowl I .
he gave the boy the forks .	the boy gave the forks he .
she showed your brother the car .	your brother showed the car she .
he sent Stephanie the plane .	Stephanie sent the plane he .
she gave Linda the book .	Linda gave the book she .
we showed your mom the spoons .	your mom showed the spoons we .
they sent Julia the car .	Julia sent the car they .
he bought your father the cars .	your father bought the cars he .
we showed your boss the chair .	your boss showed the chair we .
we bought my dad the shirt .	my dad bought the shirt we .
I showed the woman the books .	the woman showed the books I .
we showed this person the ring .	this person showed the ring we .
he bought this driver the rocket .	this driver bought the rocket he .
she sent David the hat .	David sent the hat she .
he showed my daughter the spoon .	my daughter showed the spoon he .
we showed my cousin the crayons .	my cousin showed the crayons we .
we bought your grandmother the cups .	your grandmother bought the cups we .
they bought your son the bag .	your son bought the bag they .
they bought my boss the shirt .	my boss bought the shirt they .
they bought the woman the chair .	the woman bought the chair they .
they bought the king the button .	the king bought the button they .
she gave Jerry the hats .	Jerry gave the hats she .
he sent this king the chair .	this king sent the chair he .
they sent my son the plates .	my son sent the plates they .
they gave your daughter the cars .	your daughter gave the cars they .
they gave this person the shoes .	this person gave the shoes they .
we showed my dentist the plates .	my dentist showed the plates we .
he bought the driver the bags .	the driver bought the bags he .
we gave the king the car .	the king gave the car we .
he sent your dad the shoes .	your dad sent the shoes he .
he bought the girl the pictures .	the girl bought the pictures he .
he showed my teacher the crayons .	my teacher showed the crayons he .
they showed the woman the ring .	the woman showed the ring they .
he gave my brother the mirror .	my brother gave the mirror he .
I gave Carol the hats .	Carol gave the hats I .
he bought Emily the hats .	Emily bought the hats he .
they sent your daughter the crayons .	your daughter sent the crayons they .
they gave your cousin the trucks .	your cousin gave the trucks they .
I bought your teacher the rocket .	your teacher bought the rocket I .
they sent that boy the mirror .	that boy sent the mirror they .
we showed that queen the buttons .	that queen showed the buttons we .
she showed this girl the buttons .	this girl showed the buttons she .
we bought this man the toy .	this man bought the toy we .
we gave my daughter the dolls .	my daughter gave the dolls we .
we sent Frank the trucks .	Frank sent the trucks we .
he bought Marie the rings .	Marie bought the rings he .
I bought your dad the dish .	your dad bought the dish I .
we showed Jason the bags .	Jason showed the bags we .
they showed your father the crayon .	your father showed the crayon they .
I showed Timothy the shirt .	Timothy showed the shirt I .
he bought the boy the buttons .	the boy bought the buttons he .
they gave that teacher the hat .	that teacher gave the hat they .
we gave my mom the doll .	my mom gave the doll we .
he showed the lady the couch .	the lady showed the couch he .
he gave Jessica the rocket .	Jessica gave the rocket he .
we gave the king the boats .	the king gave the boats we .
she gave Renee the dish .	Renee gave the dish she .
I bought that queen the shoes .	that queen bought the shoes I .
I sent this person the beds .	this person sent the beds I .
they sent Alice the glass .	Alice sent the glass they .
he gave Jill the book .	Jill gave the book he .
I gave the man the plate .	the man gave the plate I .
they showed your sister the trucks .	your sister showed the trucks they .
he showed Julie the car .	Julie showed the car he .
we sent Julie the forks .	Julie sent the forks we .
we showed your son the door .	your son showed the door we .
she showed your doctor the pictures .	your doctor showed the pictures she .
he sent that man the spoon .	that man sent the spoon he .
we gave Jill the cups .	Jill gave the cups we .
she gave that girl the chair .	that girl gave the chair she .
they showed your sister the toy .	your sister showed the toy they .
I sent the girl the bags .	the girl sent the bags I .
I sent Jill the bags .	Jill sent the bags I .
we gave your father the trucks .	your father gave the trucks we .
he showed Nicole the plane .	Nicole showed the plane he .
we sent Wendy the dolls .	Wendy sent the dolls we .
she gave this girl the buttons .	this girl gave the buttons she .
we gave that queen the bag .	that queen gave the bag we .
he bought Thomas the doors .	Thomas bought the doors he .
we showed my cousin the door .	my cousin showed the door we .
they gave your friend the bowl .	your friend gave the bowl they .
we bought my father the toy .	my father bought the toy we .
she sent that king the dolls .	that king sent the dolls she .
we bought your wife the toy .	your wife bought the toy we .
she showed that man the truck .	that man showed the truck she .
he gave April the bottles .	April gave the bottles he .
we bought Alice the book .	Alice bought the book we .
I bought my sister the hat .	my sister bought the hat I .
he gave this man the glasses .	this man gave the glasses he .
we bought that boy the spoon .	that boy bought the spoon we .
I bought Janet the shoe .	Janet bought the shoe I .
he gave Donna the chairs .	Donna gave the chairs he .
he gave Erin the book .	Erin gave the book he .
she showed your father the plates .	your father showed the plates she .
they showed my doctor the buttons .	my doctor showed the buttons they .
I bought Jessica the boats .	Jessica bought the boats I .
I gave the king the truck .	the king gave the truck I .
she gave my dentist the plate .	my dentist gave the plate she .
they showed Kristen the crayons .	Kristen showed the crayons they .
they gave Thomas the bag .	Thomas gave the bag they .
I gave your sister the boat .	your sister gave the boat I .
he gave that dentist the shirt .	that dentist gave the shirt he .
they showed Donald the glass .	Donald showed the glass they .
they showed Julie the car .	Julie showed the car they .
he showed Sally the crayons .	Sally showed the crayons he .
they bought James the hat .	James bought the hat they .
we sent this dancer the bags .	this dancer sent the bags we .
he sent George the picture .	George sent the picture he .
she gave your father the plates .	your father gave the plates she .
I gave Kristen the pictures .	Kristen gave the pictures I .
we showed the queen the spoons .	the queen showed the spoons we .
we sent Todd the crayon .	Todd sent the crayon we .
I sent Patrick the cars .	Patrick sent the cars I .
she sent this patient the doors .	this patient sent the doors she .
I gave that queen the ship .	that queen gave the ship I .
they gave this king the windows .	this king gave the windows they .
we showed my doctor the plane .	my doctor showed the plane we .
I bought the girl the window .	the girl bought the window I .
she bought this woman the car .	this woman bought the car she .
we gave Scott the beds .	Scott gave the beds we .
he showed my doctor the books .	my doctor showed the books he .
he showed Renee the fork .	Renee showed the fork he .
they sent my mom the doll .	my mom sent the doll they .
she sent Amelia the books .	Amelia sent the books she .
we sent this doctor the picture .	this doctor sent the picture we .
he showed my sister the beds .	my sister showed the beds he .
he bought your mother the candle .	your mother bought the candle he .
she gave the adult the boat .	the adult gave the boat she .
I showed my dad the plate .	my dad showed the plate I .
we sent that boy the crayons .	that boy sent the crayons we .
I sent the boy the spoons .	the boy sent the spoons I .
they showed Brett the cars .	Brett showed the cars they .
they showed your dentist the bottle .	your dentist showed the bottle they .
she gave my teacher the shirts .	my teacher gave the shirts she .
we bought Rachel the book .	Rachel bought the book we .
I gave my friend the toy .	my friend gave the toy I .
he bought Brett the car .	Brett bought the car he .
they showed your son the bowl .	your son showed the bowl they .
I bought your boss the fork .	your boss bought the fork I .
she sent your wife the box .	your wife sent the box she .
she sent your friend the spoons .	your friend sent the spoons she .
they gave your dentist the dish .	your dentist gave the dish they .
they bought Travis the crayons .	Travis bought the crayons they .
I sent that man the glasses .	that man sent the glasses I .
they showed this child the glasses .	this child showed the glasses they .
he sent this lady the boats .	this lady sent the boats he .
they sent Donald the window .	Donald sent the window they .
we sent that child the rocket .	that child sent the rocket we .
they gave your husband the doll .	your husband gave the doll they .
they gave John the books .	John gave the books they .
I showed that boy the bicycle .	that boy showed the bicycle I .
we sent your father the glass .	your father sent the glass we .
he gave Kevin the plates .	Kevin gave the plates he .
she showed Sally the chair .	Sally showed the chair she .
they showed Vanessa the chair .	Vanessa showed the chair they .
we gave your cousin the shirts .	your cousin gave the shirts we .
they gave Gregory the buttons .	Gregory gave the buttons they .
we gave that lady the toy .	that lady gave the toy we .
I sent your father the boats .	your father sent the boats I .
we gave my son the boats .	my son gave the boats we .
she bought my mother the fork .	my mother bought the fork she .
she bought Michael the button .	Michael bought the button she .
she bought my father the cups .	my father bought the cups she .
he bought Bill the bowls .	Bill bought the bowls he .
he showed your grandmother the toy .	your grandmother showed the toy he .
she gave that king the shirts .	that king gave the shirts she .
we sent your doctor the bags .	your doctor sent the bags we .
they showed the dentist the bags .	the dentist showed the bags they .
we sent Mary the doll .	Mary sent the doll we .
she showed Mark the forks .	Mark showed the forks she .
she bought the guy the shirt .	the guy bought the shirt she .
she showed this queen the shoe .	this queen showed the shoe she .
I gave my doctor the glass .	my doctor gave the glass I .
he sent this queen the cup .	this queen sent the cup he .
she sent your daughter the rocket .	your daughter sent the rocket she .
she showed that doctor the books .	that doctor showed the books she .
they gave the king the fork .	the king gave the fork they .
we gave my brother the ring .	my brother gave the ring we .
we gave the teacher the ship .	the teacher gave the ship we .
he gave Donna the plates .	Donna gave the plates he .
he gave your sister the fork .	your sister gave the fork he .
we sent William the shoe .	William sent the shoe we .
she sent your brother the crayons .	your brother sent the crayons she .
we showed Todd the forks .	Todd showed the forks we .
they sent Marie the couch .	Marie sent the couch they .
they gave the driver the glass .	the driver gave the glass they .
he gave the girl the chairs .	the girl gave the chairs he .
we bought my doctor the rings .	my doctor bought the rings we .
we bought Julia the rug .	Julia bought the rug we .
I bought your mother the truck .	your mother bought the truck I .
we gave Joseph the chairs .	Joseph gave the chairs we .
they gave Sandra the plate .	Sandra gave the plate they .
we showed that man the fork .	that man showed the fork we .
I gave that boy the cups .	that boy gave the cups I .
she bought this king the plates .	this king bought the plates she .
she showed that child the plane .	that child showed the plane she .
they gave this woman the rings .	this woman gave the rings they .
she gave Steven the hats .	Steven gave the hats she .
we showed this adult the glass .	this adult showed the glass we .
he showed Jerry the buttons .	Jerry showed the buttons he .
they showed your mom the book .	your mom showed the book they .
he sent Nina the buttons .	Nina sent the buttons he .
we sent the woman the dolls .	the woman sent the dolls we .
we sent my sister the pictures .	my sister sent the pictures we .
she bought this boy the mirror .	this boy bought the mirror she .
she gave your son the bag .	your son gave the bag she .
I bought that boy the books .	that boy bought the books I .
he sent Joseph the fork .	Joseph sent the fork he .
she bought this teacher the couch .	this teacher bought the couch she .
she bought John the trucks .	John bought the trucks she .
we sent David the boat .	David sent the boat we .
they bought this boy the books .	this boy bought the books they .
she showed the lady the dolls .	the lady showed the dolls she .
I gave Todd the button .	Todd gave the button I .
he sent this boy the dish .	this boy sent the dish he .
she showed the king the bottle .	the king showed the bottle she .
she sent my friend the fork .	my friend sent the fork she .
they bought that guy the rocket .	that guy bought the rocket they .
she sent Michael the buttons .	Michael sent the buttons she .
she sent my friend the glass .	my friend sent the glass she .
we gave this dentist the books .	this dentist gave the books we .
I bought Rebecca the car .	Rebecca bought the car I .
we showed my friend the truck .	my friend showed the truck we .
he gave Thomas the cars .	Thomas gave the cars he .
she gave my friend the couch .	my friend gave the couch she .
he gave your brother the chair .	your brother gave the chair he .
she bought your teacher the forks .	your teacher bought the forks she .
we bought my sister the boxes .	my sister bought the boxes we .
she gave your mom the bowl .	your mom gave the bowl she .
I gave Scott the bottle .	Scott gave the bottle I .
I sent Scott the cars .	Scott sent the cars I .
they sent your father the spoons .	your father sent the spoons they .
they gave your dad the car .	your dad gave the car they .
I gave your father the plates .	your father gave the plates I .
she showed Richard the chairs .	Richard showed the chairs she .
we sent my cousin the shirts .	my cousin sent the shirts we .
she showed my husband the dishes .	my husband showed the dishes she .
she gave Kayla the beds .	Kayla gave the beds she .
she showed your dad the shirt .	your dad showed the shirt she .
I gave my father the glasses .	my father gave the glasses I .
she bought this king the ring .	this king bought the ring she .
she bought my son the hats .	my son bought the hats she .
they bought my father the chairs .	my father bought the chairs they .
he gave Jerry the ring .	Jerry gave the ring he .
we sent that girl the dishes .	that girl sent the dishes we .
he sent this boy the truck .	this boy sent the truck he .
they showed your mom the cup .	your mom showed the cup they .
I bought your father the bowls .	your father bought the bowls I .
he sent Mark the bottle .	Mark sent the bottle he .
I bought this woman the books .	this woman bought the books I .
I showed Mark the mirror .	Mark showed the mirror I .
she gave Richard the ship .	Richard gave the ship she .
she bought my wife the candles .	my wife bought the candles she .
they showed my daughter the bicycle .	my daughter showed the bicycle they .
they gave your brother the shirt .	your brother gave the shirt they .
they bought that dentist the cars .	that dentist bought the cars they .
they sent my sister the fork .	my sister sent the fork they .
they sent your daughter the forks .	your daughter sent the forks they .
we showed this girl the button .	this girl showed the button we .
she showed your son the car .	your son showed the car she .
they gave your doctor the dishes .	your doctor gave the dishes they .
he gave my friend the toy .	my friend gave the toy he .
we gave Becky the glasses .	Becky gave the glasses we .
I showed your son the car .	your son showed the car I .
she gave Carl the crayon .	Carl gave the crayon she .
I showed Elizabeth the bottles .	Elizabeth showed the bottles I .
he bought my mother the rocket .	my mother bought the rocket he .
he sent your daughter the chair .	your daughter sent the chair he .
she gave Brett the chair .	Brett gave the chair she .
I sent Alexander the plates .	Alexander sent the plates I .
I sent your dentist the buttons .	your dentist sent the buttons I .
I showed this man the boat .	this man showed the boat I .
we sent Deborah the spoons .	Deborah sent the spoons we .
she showed Richard the glasses .	Richard showed the glasses she .
he sent Anna the shirt .	Anna sent the shirt he .
we sent Catherine the window .	Catherine sent the window we .
we showed this man the bottles .	this man showed the bottles we .
I sent that person the boxes .	that person sent the boxes I .
she sent Jerry the plate .	Jerry sent the plate she .
we sent this queen the shirts .	this queen sent the shirts we .
she bought your grandmother the buttons .	your grandmother bought the buttons she .
we bought Jessica the trucks .	Jessica bought the trucks we .
she gave Liam the beds .	Liam gave the beds she .
he showed your teacher the plates .	your teacher showed the plates he .
we showed Julie the dolls .	Julie showed the dolls we .
I bought Daniel the shoe .	Daniel bought the shoe I .
they sent my mother the bottle .	my mother sent the bottle they .
he bought Sarah the trucks .	Sarah bought the trucks he .
we showed that guy the book .	that guy showed the book we .
we showed this boy the chair .	this boy showed the chair we .
they bought my grandmother the cars .	my grandmother bought the cars they .
I gave my daughter the bags .	my daughter gave the bags I .
I sent Alice the crayon .	Alice sent the crayon I .
she bought my father the trucks .	my father bought the trucks she .
I gave Jason the bottles .	Jason gave the bottles I .
they sent Tracy the boxes .	Tracy sent the boxes they .
we showed that customer the books .	that customer showed the books we .
she bought that guy the button .	that guy bought the button she .
he bought Nancy the bowls .	Nancy bought the bowls he .
I gave Donald the ring .	Donald gave the ring I .
I bought Michael the couch .	Michael bought the couch I .
we gave your husband the beds .	your husband gave the beds we .
he bought Vanessa the ring .	Vanessa bought the ring he .
I showed my dad the boat .	my dad showed the boat I .
we gave that child the hat .	that child gave the hat we .
they bought the boy the hats .	the boy bought the hats they .
she gave Thomas the bowls .	Thomas gave the bowls she .
we bought Amy the truck .	Amy bought the truck we .
he showed that lady the cars .	that lady showed the cars he .
we bought Carl the mirror .	Carl bought the mirror we .
we showed the queen the candles .	the queen showed the candles we .
we bought your father the pictures .	your father bought the pictures we .
she gave Jill the car .	Jill gave the car she .
I gave my dentist the window .	my dentist gave the window I .
he bought my teacher the picture .	my teacher bought the picture he .
they showed my friend the couch .	my friend showed the couch they .
she gave Kristen the mirror .	Kristen gave the mirror she .
he sent my boss the shoe .	my boss sent the shoe he .
she sent the guy the bags .	the guy sent the bags she .
we showed that man the ring .	that man showed the ring we .
she gave my brother the ring .	my brother gave the ring she .
she bought my mom the cars .	my mom bought the cars she .
she bought the boy the picture .	the boy bought the picture she .
he showed this king the dolls .	this king showed the dolls he .
she sent my husband the book .	my husband sent the book she .
I showed Jill the chairs .	Jill showed the chairs I .
he sent my mom the door .	my mom sent the door he .
he bought this guy the bag .	this guy bought the bag he .
she sent the guy the bowl .	the guy sent the bowl she .
we sent my grandmother the door .	my grandmother sent the door we .
she showed that doctor the cup .	that doctor showed the cup she .
they showed my father the glasses .	my father showed the glasses they .
he bought the woman the dishes .	the woman bought the dishes he .
he gave my wife the windows .	my wife gave the windows he .
I gave Ronald the car .	Ronald gave the car I .
they bought Nicole the beds .	Nicole bought the beds they .
I sent my grandmother the book .	my grandmother sent the book I .
we showed Linda the crayons .	Linda showed the crayons we .
I sent Erin the bowl .	Erin sent the bowl I .
we showed Dan the bed .	Dan showed the bed we .
they sent your sister the candle .	your sister sent the candle they .
he showed that girl the shirt .	that girl showed the shirt he .
he bought Judy the bags .	Judy bought the bags he .
we bought Ronald the shirts .	Ronald bought the shirts we .
I showed your cousin the plate .	your cousin showed the plate I .
they sent the customer the candles .	the customer sent the candles they .
she gave the girl the shoe .	the girl gave the shoe she .
he sent Scott the candles .	Scott sent the candles he .
he gave Erin the rug .	Erin gave the rug he .
she sent this lady the door .	this lady sent the door she .
she showed this girl the bottles .	this girl showed the bottles she .
she sent this king the ring .	this king sent the ring she .
they gave your brother the trucks .	your brother gave the trucks they .
he bought this patient the shirts .	this patient bought the shirts he .
he sent Nina the dolls .	Nina sent the dolls he .
they sent Brian the glasses .	Brian sent the glasses they .
I bought this king the cars .	this king bought the cars I .
I sent my dentist the doors .	my dentist sent the doors I .
he gave my wife the ship .	my wife gave the ship he .
they gave my mother the toy .	my mother gave the toy they .
she showed the patient the shoe .	the patient showed the shoe she .
I gave that boy the bicycle .	that boy gave the bicycle I .
she sent this king the shoe .	this king sent the shoe she .
I bought Joseph the ship .	Joseph bought the ship I .
we showed your daughter the shirt .	your daughter showed the shirt we .
they gave the boy the bicycle .	the boy gave the bicycle they .
they bought my son the doll .	my son bought the doll they .
I gave Noah the shoe .	Noah gave the shoe I .
we bought Martin the spoons .	Martin bought the spoons we .
we gave that guy the pictures .	that guy gave the pictures we .
we showed my mom the bowl .	my mom showed the bowl we .
she gave my dad the boxes .	my dad gave the boxes she .
he gave Rachel the plane .	Rachel gave the plane he .
I bought that queen the shirts .	that queen bought the shirts I .
we gave the child the forks .	the child gave the forks we .
they gave Jennifer the book .	Jennifer gave the book they .
they sent Lisa the ring .	Lisa sent the ring they .
they showed the customer the windows .	the customer showed the windows they .
they sent this woman the window .	this woman sent the window they .
she sent that woman the book .	that woman sent the book she .
she bought the lady the shirts .	the lady bought the shirts she .
he sent this dentist the glass .	this dentist sent the glass he .
I gave Allison the button .	Allison gave the button I .
she sent my dentist the plates .	my dentist sent the plates she .
they sent that king the box .	that king sent the box they .
I gave Aaron the boat .	Aaron gave the boat I .
I bought Joseph the cars .	Joseph bought the cars I .
he sent Mary the bowl .	Mary sent the bowl he .
I gave Nicole the shoes .	Nicole gave the shoes I .
they gave this teacher the window .	this teacher gave the window they .
we sent this boy the ring .	this boy sent the ring we .
they showed Rebecca the forks .	Rebecca showed the forks they .
I sent Alexander the boats .	Alexander sent the boats I .
he bought this adult the dishes .	this adult bought the dishes he .
I sent Guy the doll .	Guy sent the doll I .
I bought my boss the boat .	my boss bought the boat I .
he bought Richard the plane .	Richard bought the plane he .
they bought this man the books .	this man bought the books they .
he showed Patrick the cars .	Patrick showed the cars he .
she bought that queen the candle .	that queen bought the candle she .
we showed your friend the windows .	your friend showed the windows we .
she gave Stephanie the ship .	Stephanie gave the ship she .
we sent my daughter the doll .	my daughter sent the doll we .
we bought the dentist the buttons .	the dentist bought the buttons we .
we bought the man the dish .	the man bought the dish we .
they sent Donna the bag .	Donna sent the bag they .
I bought my father the buttons .	my father bought the buttons I .
they showed Nancy the window .	Nancy showed the window they .
she gave your sister the doors .	your sister gave the doors she .
he gave my husband the forks .	my husband gave the forks he .
they sent your sister the toy .	your sister sent the toy they .
he sent your cousin the bottle .	your cousin sent the bottle he .
he gave my wife the bowl .	my wife gave the bowl he .
I gave this man the door .	this man gave the door I .
they sent my dad the doors .	my dad sent the doors they .
we showed Liam the crayons .	Liam showed the crayons we .
I sent Patrick the book .	Patrick sent the book I .
I bought my dad the hats .	my dad bought the hats I .
he showed Gregory the plates .	Gregory showed the plates he .
she gave this king the ship .	this king gave the ship she .
we gave your teacher the forks .	your teacher gave the forks we .
I showed the woman the spoon .	the woman showed the spoon I .
we showed Sally the car .	Sally showed the car we .
we sent this guy the beds .	this guy sent the beds we .
they bought the boy the bag .	the boy bought the bag they .
we showed Catherine the plate .	Catherine showed the plate we .
I bought your doctor the plane .	your doctor bought the plane I .
they sent the lady the rocket .	the lady sent the rocket they .
she showed that queen the chairs .	that queen showed the chairs she .
he showed your boss the bowls .	your boss showed the bowls he .
they sent Jane the beds .	Jane sent the beds they .
I gave Naomi the candles .	Naomi gave the candles I .
he gave Travis the shirt .	Travis gave the shirt he .
they sent my son the plate .	my son sent the plate they .
we showed my friend the pictures .	my friend showed the pictures we .
we bought my mom the plate .	my mom bought the plate we .
she showed my brother the trucks .	my brother showed the trucks she .
they gave my husband the doll .	my husband gave the doll they .
they gave Catherine the glass .	Catherine gave the glass they .
they gave the girl the door .	the girl gave the door they .
we bought that woman the fork .	that woman bought the fork we .
they gave that woman the beds .	that woman gave the beds they .
they sent the customer the bottle .	the customer sent the bottle they .
she gave your father the forks .	your father gave the forks she .
I gave my sister the candle .	my sister gave the candle I .
I showed that customer the bed .	that customer showed the bed I .
we showed Jane the bowl .	Jane showed the bowl we .
she showed Jerry the bowls .	Jerry showed the bowls she .
she bought Jennifer the hats .	Jennifer bought the hats she .
he gave my son the windows .	my son gave the windows he .
they gave your grandmother the trucks .	your grandmother gave the trucks they .
we bought that child the door .	that child bought the door we .
we bought this woman the buttons .	this woman bought the buttons we .
I sent Amelia the window .	Amelia sent the window I .
he showed my sister the dishes .	my sister showed the dishes he .
I showed that guy the dishes .	that guy showed the dishes I .
they sent Travis the shoe .	Travis sent the shoe they .
we bought Becca the doors .	Becca bought the doors we .
he gave George the boxes .	George gave the boxes he .
she gave the girl the dishes .	the girl gave the dishes she .
she bought that person the boxes .	that person bought the boxes she .
they sent John the plane .	John sent the plane they .
he sent your husband the crayon .	your husband sent the crayon he .
I sent that boy the candle .	that boy sent the candle I .
she showed Eric the button .	Eric showed the button she .
they gave Karen the doors .	Karen gave the doors they .
she bought that person the bowls .	that person bought the bowls she .
he showed Dan the doors .	Dan showed the doors he .
I showed your grandmother the cups .	your grandmother showed the cups I .
they sent my husband the bed .	my husband sent the bed they .
he bought my dad the bicycle .	my dad bought the bicycle he .
she bought your friend the boat .	your friend bought the boat she .
I gave Barbara the button .	Barbara gave the button I .
she showed your dentist the shoe .	your dentist showed the shoe she .
he showed my dad the car .	my dad showed the car he .
I gave Naomi the buttons .	Naomi gave the buttons I .
he showed your wife the crayons .	your wife showed the crayons he .
she sent my teacher the dolls .	my teacher sent the dolls she .
they gave Carl the cars .	Carl gave the cars they .
she gave that lady the boats .	that lady gave the boats she .
we gave Brian the bottle .	Brian gave the bottle we .
I sent my teacher the button .	my teacher sent the button I .
we showed my doctor the doll .	my doctor showed the doll we .
we showed my son the cars .	my son showed the cars we .
she gave your grandmother the shoe .	your grandmother gave the shoe she .
I showed Brett the crayons .	Brett showed the crayons I .
he showed this teacher the cars .	this teacher showed the cars he .
they bought your husband the windows .	your husband bought the windows they .
they gave my boss the cups .	my boss gave the cups they .
he gave Bill the plane .	Bill gave the plane he .
they gave my friend the shirts .	my friend gave the shirts they .
I sent your dentist the trucks .	your dentist sent the trucks I .
he gave this dentist the buttons .	this dentist gave the buttons he .
he gave your brother the bag .	your brother gave the bag he .
they showed the customer the dolls .	the customer showed the dolls they .
he bought your father the doll .	your father bought the doll he .
they bought Cindy the candle .	Cindy bought the candle they .
he gave your husband the boat .	your husband gave the boat he .
we gave my mom the pictures .	my mom gave the pictures we .
I gave my friend the ship .	my friend gave the ship I .
I gave my father the picture .	my father gave the picture I .
she sent your grandmother the fork .	your grandmother sent the fork she .
she sent this guy the shoes .	this guy sent the shoes she .
she gave Eric the books .	Eric gave the books she .
we bought your cousin the hat .	your cousin bought the hat we .
they sent my doctor the chairs .	my doctor sent the chairs they .
I gave this man the dishes .	this man gave the dishes I .
I sent your friend the cup .	your friend sent the cup I .
they sent this girl the hats .	this girl sent the hats they .
we gave the boy the toys .	the boy gave the toys we .
they bought your father the candle .	your father bought the candle they .
I gave your dentist the button .	your dentist gave the button I .
I gave that person the boats .	that person gave the boats I .
we gave the lady the shoes .	the lady gave the shoes we .
they showed that customer the couch .	that customer showed the couch they .
they showed your cousin the dish .	your cousin showed the dish they .
she sent your daughter the box .	your daughter sent the box she .
he showed your teacher the crayons .	your teacher showed the crayons he .
he showed your friend the plate .	your friend showed the plate he .
we sent Sara the fork .	Sara sent the fork we .
I gave Liam the truck .	Liam gave the truck I .
we sent Denise the bottles .	Denise sent the bottles we .
I showed Sara the truck .	Sara showed the truck I .
he gave Rebecca the door .	Rebecca gave the door he .
I sent Michael the rug .	Michael sent the rug I .
they showed Allison the car .	Allison showed the car they .
I showed the person the door .	the person showed the door I .
I bought that adult the candles .	that adult bought the candles I .
we bought your doctor the rocket .	your doctor bought the rocket we .
they showed that lady the dishes .	that lady showed the dishes they .
they gave Janet the bed .	Janet gave the bed they .
he bought my father the shoes .	my father bought the shoes he .
they bought that girl the button .	that girl bought the button they .
he showed your husband the truck .	your husband showed the truck he .
they bought that adult the shoe .	that adult bought the shoe they .
they sent Elizabeth the crayons .	Elizabeth sent the crayons they .
she gave Brett the cups .	Brett gave the cups she .
he sent your grandmother the boxes .	your grandmother sent the boxes he .
he gave Sandra the car .	Sandra gave the car he .
he showed Peter the plate .	Peter showed the plate he .
I gave this customer the bowl .	this customer gave the bowl I .
they gave Becky the door .	Becky gave the door they .
they sent Nina the shoes .	Nina sent the shoes they .
I bought Alexander the chairs .	Alexander bought the chairs I .
she sent that guy the boat .	that guy sent the boat she .
we gave my father the forks .	my father gave the forks we .
we bought your dad the bottles .	your dad bought the bottles we .
they showed Nina the book .	Nina showed the book they .
she sent your husband the pictures .	your husband sent the pictures she .
they gave your mother the bags .	your mother gave the bags they .
he sent David the books .	David sent the books he .
we sent that dentist the rocket .	that dentist sent the rocket we .
they sent that child the bowl .	that child sent the bowl they .
he gave Steven the bottle .	Steven gave the bottle he .
I sent Dan the cars .	Dan sent the cars I .
she bought your mother the chair .	your mother bought the chair she .
they bought that lady the rocket .	that lady bought the rocket they .
we showed your mom the books .	your mom showed the books we .
they gave that man the books .	that man gave the books they .
they gave my cousin the rings .	my cousin gave the rings they .
she sent my son the cars .	my son sent the cars she .
they sent my teacher the forks .	my teacher sent the forks they .
he gave Renee the spoons .	Renee gave the spoons he .
she sent your daughter the spoons .	your daughter sent the spoons she .
they showed the king the books .	the king showed the books they .
we gave the boy the candles .	the boy gave the candles we .
she bought that dentist the cups .	that dentist bought the cups she .
she sent Nicole the boats .	Nicole sent the boats she .
he gave that woman the door .	that woman gave the door he .
he showed the king the window .	the king showed the window he .
she sent that lady the pictures .	that lady sent the pictures she .
I showed Janet the mirror .	Janet showed the mirror I .
we sent Julia the hat .	Julia sent the hat we .
they showed the boy the mirror .	the boy showed the mirror they .
we sent this dentist the book .	this dentist sent the book we .
they showed my friend the book .	my friend showed the book they .
they showed Donald the plane .	Donald showed the plane they .
they showed your dentist the shirts .	your dentist showed the shirts they .
he showed the boy the buttons .	the boy showed the buttons he .
we sent Richard the cars .	Richard sent the cars we .
he sent Robert the ship .	Robert sent the ship he .
she gave Steven the dish .	Steven gave the dish she .
he bought Nicole the spoons .	Nicole bought the spoons he .
I showed my friend the shoe .	my friend showed the shoe I .
they gave Sandra the dolls .	Sandra gave the dolls they .
they showed Andrew the mirror .	Andrew showed the mirror they .
they bought James the shoe .	James bought the shoe they .
I bought the woman the forks .	the woman bought the forks I .
she showed that man the candles .	that man showed the candles she .
she showed my daughter the pictures .	my daughter showed the pictures she .
we showed your sister the hat .	your sister showed the hat we .
they sent your sister the book .	your sister sent the book they .
we gave that guy the shoe .	that guy gave the shoe we .
they sent your dad the beds .	your dad sent the beds they .
he bought that child the boats .	that child bought the boats he .
I showed this customer the glasses .	this customer showed the glasses I .
we gave Amy the bottle .	Amy gave the bottle we .
he bought the girl the books .	the girl bought the books he .
they gave that adult the book .	that adult gave the book they .
he bought my daughter the books .	my daughter bought the books he .
I sent Catherine the couch .	Catherine sent the couch I .
I sent Travis the hats .	Travis sent the hats I .
she showed this guy the hat .	this guy showed the hat she .
I showed Jessica the bowl .	Jessica showed the bowl I .
we gave this customer the ship .	this customer gave the ship we .
they showed the lady the plate .	the lady showed the plate they .
they bought your daughter the plate .	your daughter bought the plate they .
they bought my grandmother the boxes .	my grandmother bought the boxes they .
he showed your mother the dishes .	your mother showed the dishes he .
he gave this boy the door .	this boy gave the door he .
I sent that person the beds .	that person sent the beds I .
I sent Julie the boxes .	Julie sent the boxes I .
he gave Barbara the ship .	Barbara gave the ship he .
we bought my father the dish .	my father bought the dish we .
he gave Michael the pictures .	Michael gave the pictures he .
she showed Renee the candles .	Renee showed the candles she .
we showed Scott the fork .	Scott showed the fork we .
he showed your mom the books .	your mom showed the books he .
I gave Rachel the chairs .	Rachel gave the chairs I .
she sent Mark the shoes .	Mark sent the shoes she .
they sent Julia the candle .	Julia sent the candle they .
they bought the man the ship .	the man bought the ship they .
they showed Joseph the books .	Joseph showed the books they .
we sent Carol the doors .	Carol sent the doors we .
they bought your cousin the bag .	your cousin bought the bag they .
I sent that lady the plates .	that lady sent the plates I .
they showed Christopher the doors .	Christopher showed the doors they .
he bought Catherine the rug .	Catherine bought the rug he .
we sent Kristen the pictures .	Kristen sent the pictures we .
I bought Sandra the dishes .	Sandra bought the dishes I .
I bought John the pictures .	John bought the pictures I .
she sent Noah the mirror .	Noah sent the mirror she .
she sent my sister the crayon .	my sister sent the crayon she .
we sent that dancer the ring .	that dancer sent the ring we .
they gave your sister the bottles .	your sister gave the bottles they .
he gave this boy the dishes .	this boy gave the dishes he .
they bought my mom the beds .	my mom bought the beds they .
I bought that child the crayons .	that child bought the crayons I .
she gave that woman the cups .	that woman gave the cups she .
he sent my son the shoes .	my son sent the shoes he .
I gave this queen the rug .	this queen gave the rug I .
we showed your wife the picture .	your wife showed the picture we .
I showed my husband the bottle .	my husband showed the bottle I .
we bought that girl the bowl .	that girl bought the bowl we .
they bought that king the shirt .	that king bought the shirt they .
we sent your wife the plates .	your wife sent the plates we .
they bought Brett the dolls .	Brett bought the dolls they .
she bought Emily the windows .	Emily bought the windows she .
we bought your mother the candles .	your mother bought the candles we .
we bought the lady the button .	the lady bought the button we .
we showed Martin the car .	Martin showed the car we .
they bought that king the buttons .	that king bought the buttons they .
we gave this girl the dish .	this girl gave the dish we .
we showed the queen the car .	the queen showed the car we .
he bought Steve the shirts .	Steve bought the shirts he .
they bought that woman the boat .	that woman bought the boat they .
she bought Donald the candles .	Donald bought the candles she .
she sent this patient the chair .	this patient sent the chair she .
he sent my boss the pictures .	my boss sent the pictures he .
they bought that dancer the windows .	that dancer bought the windows they .
they bought my mother the bag .	my mother bought the bag they .
we showed Judy the boats .	Judy showed the boats we .
we gave your father the button .	your father gave the button we .
I showed your teacher the bed .	your teacher showed the bed I .
we bought that patient the crayon .	that patient bought the crayon we .
we sent Steve the rug .	Steve sent the rug we .
we showed Julia the bags .	Julia showed the bags we .
they gave Julie the toy .	Julie gave the toy they .
I bought my father the bowl .	my father bought the bowl I .
I bought the queen the forks .	the queen bought the forks I .
he showed Sara the glass .	Sara showed the glass he .
they bought Mary the bag .	Mary bought the bag they .
we showed the teacher the car .	the teacher showed the car we .
he bought that queen the rings .	that queen bought the rings he .
we sent Jason the spoons .	Jason sent the spoons we .
we bought Steven the bottle .	Steven bought the bottle we .
I gave Peter the dolls .	Peter gave the dolls I .
they showed Catherine the rings .	Catherine showed the rings they .
he sent your husband the box .	your husband sent the box he .
I showed the queen the ship .	the queen showed the ship I .
I showed my wife the bowls .	my wife showed the bowls I .
we bought this guy the beds .	this guy bought the beds we .
she sent that teacher the buttons .	that teacher sent the buttons she .
I gave Robert the chairs .	Robert gave the chairs I .
she showed that woman the door .	that woman showed the door she .
I sent this dancer the rug .	this dancer sent the rug I .
she sent Kristen the toy .	Kristen sent the toy she .
I showed this girl the crayons .	this girl showed the crayons I .
we showed my wife the candles .	my wife showed the candles we .
he sent this teacher the rings .	this teacher sent the rings he .
we bought the child the trucks .	the child bought the trucks we .
they showed my wife the bed .	my wife showed the bed they .
they gave your husband the dishes .	your husband gave the dishes they .
I showed this dancer the door .	this dancer showed the door I .
we bought your wife the hat .	your wife bought the hat we .
he bought Laurie the shirts .	Laurie bought the shirts he .
she gave Carol the dish .	Carol gave the dish she .
she bought that queen the button .	that queen bought the button she .
she sent my dad the picture .	my dad sent the picture she .
he sent the girl the doll .	the girl sent the doll he .
they gave the queen the books .	the queen gave the books they .
we gave Barbara the doll .	Barbara gave the doll we .
I gave your son the trucks .	your son gave the trucks I .
she gave your father the ring .	your father gave the ring she .
he sent that customer the books .	that customer sent the books he .
she showed the girl the boats .	the girl showed the boats she .
I showed that king the forks .	that king showed the forks I .
he sent Anna the shoe .	Anna sent the shoe he .
we sent your cousin the glasses .	your cousin sent the glasses we .
I gave my sister the plates .	my sister gave the plates I .
they bought your dad the cups .	your dad bought the cups they .
they gave your boss the pictures .	your boss gave the pictures they .
we sent Becca the bottle .	Becca sent the bottle we .
they showed Jerry the toy .	Jerry showed the toy they .
we gave Aaron the glass .	Aaron gave the glass we .
he gave that customer the door .	that customer gave the door he .
I gave that king the hats .	that king gave the hats I .
he sent the boy the ship .	the boy sent the ship he .
he sent your brother the plane .	your brother sent the plane he .
he gave your teacher the pictures .	your teacher gave the pictures he .
we showed that lady the bottle .	that lady showed the bottle we .
he gave Donald the shoe .	Donald gave the shoe he .
I bought the man the boat .	the man bought the boat I .
we showed this guy the boat .	this guy showed the boat we .
I sent your brother the bowl .	your brother sent the bowl I .
I showed the boy the bottles .	the boy showed the bottles I .
they showed Laura the truck .	Laura showed the truck they .
we sent that guy the couch .	that guy sent the couch we .
he showed your daughter the bowls .	your daughter showed the bowls he .
they sent your dad the toy .	your dad sent the toy they .
he gave that woman the candle .	that woman gave the candle he .
I bought Todd the box .	Todd bought the box I .
I showed Frank the candle .	Frank showed the candle I .
they gave the girl the bottles .	the girl gave the bottles they .
he sent John the bowl .	John sent the bowl he .
I gave George the car .	George gave the car I .
we sent Cindy the books .	Cindy sent the books we .
they bought your sister the doll .	your sister bought the doll they .
she showed Lisa the crayon .	Lisa showed the crayon she .
I bought that customer the spoon .	that customer bought the spoon I .
I gave that boy the plate .	that boy gave the plate I .
they sent that teacher the fork .	that teacher sent the fork they .
they sent this person the glasses .	this person sent the glasses they .
they showed your teacher the rings .	your teacher showed the rings they .
she gave Carl the crayons .	Carl gave the crayons she .
she showed Catherine the bowls .	Catherine showed the bowls she .
he bought Judy the chair .	Judy bought the chair he .
he bought Scott the candles .	Scott bought the candles he .
they gave that dancer the picture .	that dancer gave the picture they .
they sent your doctor the books .	your doctor sent the books they .
I sent this lady the trucks .	this lady sent the trucks I .
he bought this woman the car .	this woman bought the car he .
she bought your boss the boats .	your boss bought the boats she .
they showed Donald the dolls .	Donald showed the dolls they .
I gave Martin the truck .	Martin gave the truck I .
they bought Karen the buttons .	Karen bought the buttons they .
I bought this man the picture .	this man bought the picture I .
he showed the dentist the bags .	the dentist showed the bags he .
we sent your father the plate .	your father sent the plate we .
she gave your father the book .	your father gave the book she .
they bought the guy the book .	the guy bought the book they .
he gave your boss the toys .	your boss gave the toys he .
I gave the lady the ship .	the lady gave the ship I .
we showed your friend the boats .	your friend showed the boats we .
we bought the dentist the shirt .	the dentist bought the shirt we .
she gave that lady the rocket .	that lady gave the rocket she .
I gave my father the ring .	my father gave the ring I .
we showed Steve the glass .	Steve showed the glass we .
I bought Nancy the shoe .	Nancy bought the shoe I .
we showed my husband the books .	my husband showed the books we .
she gave this child the candle .	this child gave the candle she .
they gave Amelia the candle .	Amelia gave the candle they .
we bought Janet the bowl .	Janet bought the bowl we .
we showed your daughter the car .	your daughter showed the car we .
they bought the girl the pictures .	the girl bought the pictures they .
they gave this guy the box .	this guy gave the box they .
we gave Dan the hats .	Dan gave the hats we .
she gave Thomas the book .	Thomas gave the book she .
they showed that queen the pictures .	that queen showed the pictures they .
we bought your brother the car .	your brother bought the car we .
they gave Julia the bottles .	Julia gave the bottles they .
he gave this queen the boats .	this queen gave the boats he .
I gave Martin the window .	Martin gave the window I .
they gave my dad the toy .	my dad gave the toy they .
he showed the girl the pictures .	the girl showed the pictures he .
they sent this queen the book .	this queen sent the book they .
she bought your boss the bowls .	your boss bought the bowls she .
they showed Jane the boxes .	Jane showed the boxes they .
we sent your sister the cars .	your sister sent the cars we .
I sent my son the trucks .	my son sent the trucks I .
I sent Daniel the door .	Daniel sent the door I .
he gave my wife the books .	my wife gave the books he .
she bought your mother the hat .	your mother bought the hat she .
he sent Kayla the spoons .	Kayla sent the spoons he .
she showed my teacher the spoons .	my teacher showed the spoons she .
he bought that customer the ring .	that customer bought the ring he .
he showed the adult the books .	the adult showed the books he .
we gave Renee the windows .	Renee gave the windows we .
she gave that lady the window .	that lady gave the window she .
we showed the boy the hat .	the boy showed the hat we .
he bought your wife the candles .	your wife bought the candles he .
I bought that king the door .	that king bought the door I .
she bought my dentist the beds .	my dentist bought the beds she .
we sent your doctor the bicycle .	your doctor sent the bicycle we .
they sent Leslie the bags .	Leslie sent the bags they .
she gave Brett the doors .	Brett gave the doors she .
I bought Thomas the crayons .	Thomas bought the crayons I .
they showed that teacher the toys .	that teacher showed the toys they .
he sent Becca the bicycle .	Becca sent the bicycle he .
I bought my son the window .	my son bought the window I .
I showed my son the candles .	my son showed the candles I .
she sent Anna the dishes .	Anna sent the dishes she .
we sent that king the ring .	that king sent the ring we .
he showed my son the bowls .	my son showed the bowls he .
I bought that king the picture .	that king bought the picture I .
we showed your teacher the car .	your teacher showed the car we .
we showed that child the shirts .	that child showed the shirts we .
we sent your son the bags .	your son sent the bags we .
they bought my son the crayons .	my son bought the crayons they .
he sent the girl the boat .	the girl sent the boat he .
they showed Jessica the toy .	Jessica showed the toy they .
we gave the woman the hat .	the woman gave the hat we .
she sent the boy the picture .	the boy sent the picture she .
I showed your mother the forks .	your mother showed the forks I .
he sent Mark the toys .	Mark sent the toys he .
