those people may see the turtles that these children who these guys were n't talking about had heard .	those people may see what these children who these guys were n't talking about had heard the turtles .
your friends would n't forget those children who these men who win had talked about .	your friends would n't forget who these men who win had talked about those children .
those people had remembered this bowl that the ladies that wo n't hear those dogs should love .	those people had remembered what the ladies that wo n't hear those dogs should love this bowl .
that boy could n't forget the shirts that that girl that eats must see .	that boy could n't forget what that girl that eats must see the shirts .
my cousins may remember that plane that this teacher who thinks about this bowl talks about .	my cousins may remember what this teacher who thinks about this bowl talks about that plane .
your friends had seen that patient who that man who this patient sounded like taught .	your friends had seen who that man who this patient sounded like taught that patient .
your sister has n't remembered this boat that that doctor who does n't find that plate has brought .	your sister has n't remembered what that doctor who does n't find that plate has brought this boat .
these children may remember this hat that these teachers who should run around these schools talk about .	these children may remember what these teachers who should run around these schools talk about this hat .
my cousins should forget the lady who those men who keep these chairs are helping .	my cousins should forget who those men who keep these chairs are helping the lady .
this king has known these dishes that these snakes that saw the mirror would n't hate .	this king has known what these snakes that saw the mirror would n't hate these dishes .
my cousins have noticed this lady who these boys who remember those rabbits were n't visiting .	my cousins have noticed who these boys who remember those rabbits were n't visiting this lady .
these people have noticed this dancer who the driver who wo n't shake the bowl talked to .	these people have noticed who the driver who wo n't shake the bowl talked to this dancer .
Jill did n't remember the customer who that dentist who had n't talked about this doll talked about .	Jill did n't remember who that dentist who had n't talked about this doll talked about the customer .
those teachers had seen this school that that lady who moves the door had walked through .	those teachers had seen where that lady who moves the door had walked through this school .
the doctors had n't noticed those women that that adult who those children talk about has heard .	the doctors had n't noticed what that adult who those children talk about has heard those women .
the teachers would n't remember those shirts that that dancer who holds the beds talked about .	the teachers would n't remember what that dancer who holds the beds talked about those shirts .
your sister has remembered this window that this customer that will run can see .	your sister has remembered what this customer that will run can see this window .
these teachers might forget the shoe that this dancer who goes to this hospital talks about .	these teachers might forget what this dancer who goes to this hospital talks about the shoe .
your doctors did n't forget those windows that those men who sound like the adult fix .	your doctors did n't forget what those men who sound like the adult fix those windows .
these people have n't noticed the patient that that doctor who went to the school hears .	these people have n't noticed what that doctor who went to the school hears the patient .
the woman does n't remember this lady who the people who were n't cleaning this book look like .	the woman does n't remember who the people who were n't cleaning this book look like this lady .
your cousins must remember that museum that that person who would sound like the snake passed .	your cousins must remember where that person who would sound like the snake passed that museum .
my friends had remembered the boxes that this person who has cleaned this car is fixing .	my friends had remembered what this person who has cleaned this car is fixing the boxes .
Paul should n't remember this toy that that person that may hear those dogs could n't forget .	Paul should n't remember what that person that may hear those dogs could n't forget this toy .
your friends wo n't notice those plates that this driver that is n't growing noticed .	your friends wo n't notice what this driver that is n't growing noticed those plates .
your friends had n't remembered those forks that this guy who could sound like the dancer cleaned .	your friends had n't remembered what this guy who could sound like the dancer cleaned those forks .
my friends could n't forget these buttons that the doctors who do n't paint talk about .	my friends could n't forget what the doctors who do n't paint talk about these buttons .
my teachers had known this girl who this person who sees the cat heard .	my teachers had known who this person who sees the cat heard this girl .
your husband might remember the book that that boy who these women can sound like keeps .	your husband might remember what that boy who these women can sound like keeps the book .
the guy can see those pictures that these turtles that the children heard remembered .	the guy can see what these turtles that the children heard remembered those pictures .
my friends should n't notice the bowl that the teachers that grow had n't thought about .	my friends should n't notice what the teachers that grow had n't thought about the bowl .
that king would know the doll that the people who did n't drive to these rooms talk about .	that king would know what the people who did n't drive to these rooms talk about the doll .
the children do n't forget the shirts that these people who this adult looked like should n't shake .	the children do n't forget what these people who this adult looked like should n't shake the shirts .
these teachers had n't seen that mirror that that lady that can eat has n't thought about .	these teachers had n't seen what that lady that can eat has n't thought about that mirror .
your cousins have remembered those bags that this king that was thinking about the birds thought about .	your cousins have remembered what this king that was thinking about the birds thought about those bags .
the queen should n't see that plate that those horses that noticed these people would n't remember .	the queen should n't see what those horses that noticed these people would n't remember that plate .
those children do n't remember that rug that that doctor who thinks about this dentist was talking about .	those children do n't remember what that doctor who thinks about this dentist was talking about that rug .
these people have n't remembered that glass that the ladies who were n't bringing this bed have talked about .	these people have n't remembered what the ladies who were n't bringing this bed have talked about that glass .
my cousins have n't noticed that doctor who these ladies who that dancer may hear sound like .	my cousins have n't noticed who these ladies who that dancer may hear sound like that doctor .
Eric should n't remember those candles that this king that had run thinks about .	Eric should n't remember what this king that had run thinks about those candles .
those people might see those bowls that the woman who those men may look like would clean .	those people might see what the woman who those men may look like would clean those bowls .
these children had seen this mall that that driver who drives to this museum did n't run around .	these children had seen where that driver who drives to this museum did n't run around this mall .
your daughter had noticed the doors that those women who did n't look like the dancer were talking about .	your daughter had noticed what those women who did n't look like the dancer were talking about the doors .
Susan had known the bicycle that this driver who has talked about the cats should drop .	Susan had known what this driver who has talked about the cats should drop the bicycle .
those teachers had known this museum that these men who sounded like this hamster had n't left .	those teachers had known where these men who sounded like this hamster had n't left this museum .
the people do n't notice the shoes that those dogs that have noticed that dentist like .	the people do n't notice what those dogs that have noticed that dentist like the shoes .
my sister might forget these rooms that the driver who that king had n't talked about can n't leave .	my sister might forget where the driver who that king had n't talked about can n't leave these rooms .
the children have noticed this dentist that those boys who knew the doctor are talking about .	the children have noticed what those boys who knew the doctor are talking about this dentist .
my friends had remembered that boy that the girl who remembered those windows has n't talked about .	my friends had remembered what the girl who remembered those windows has n't talked about that boy .
the woman has remembered this driver who this king who talked will talk about .	the woman has remembered who this king who talked will talk about this driver .
my doctors should forget those shoes that that king who could n't look like this customer cleaned .	my doctors should forget what that king who could n't look like this customer cleaned those shoes .
those doctors have n't noticed these cups that those doctors who would n't know those girls threw .	those doctors have n't noticed what those doctors who would n't know those girls threw these cups .
my cousins wo n't forget this child that that lady that those women look like does n't think about .	my cousins wo n't forget what that lady that those women look like does n't think about this child .
my friends should n't see this spoon that that cat that must forget those men thinks about .	my friends should n't see what that cat that must forget those men thinks about this spoon .
your sister had seen that king who that boy who does n't hate this hat talks to .	your sister had seen who that boy who does n't hate this hat talks to that king .
your daughter might forget this king who these ladies who this person sounds like talk about .	your daughter might forget who these ladies who this person sounds like talk about this king .
my doctors could n't see that dancer who that person who the guy talks about talks about .	my doctors could n't see who that person who the guy talks about talks about that dancer .
Jill has noticed that crayon that this child who was keeping that button had lost .	Jill has noticed what this child who was keeping that button had lost that crayon .
the lady has n't noticed these ladies who that adult who will cry does n't talk about .	the lady has n't noticed who that adult who will cry does n't talk about these ladies .
my doctors did n't notice these boys who this teacher who left that room should look like .	my doctors did n't notice who this teacher who left that room should look like these boys .
Robert may remember the horses that the birds that hear the doctors will like .	Robert may remember what the birds that hear the doctors will like the horses .
my teachers would n't forget those crayons that the dogs that ate might think about .	my teachers would n't forget what the dogs that ate might think about those crayons .
that queen has known the person who the doctor who sounds like this woman looks like .	that queen has known who the doctor who sounds like this woman looks like the person .
this lady will forget that guy who these guys who should n't lift the couch have heard .	this lady will forget who these guys who should n't lift the couch have heard that guy .
your cousins would n't know the bottles that the girls who had passed this park steal .	your cousins would n't know what the girls who had passed this park steal the bottles .
my wife may remember these bags that this boy that those ladies have heard could hate .	my wife may remember what this boy that those ladies have heard could hate these bags .
my dad has noticed that driver who that guy who talks about the cat has n't talked about .	my dad has noticed who that guy who talks about the cat has n't talked about that driver .
the girl wo n't know the customer who the men who would n't go to this room were n't listening to .	the girl wo n't know who the men who would n't go to this room were n't listening to the customer .
my teachers have known the ship that the queen who is n't thinking about this car has made .	my teachers have known what the queen who is n't thinking about this car has made the ship .
your friends do n't know those buttons that the cats that have n't seen that candle should n't notice .	your friends do n't know what the cats that have n't seen that candle should n't notice those buttons .
Michelle may forget that bowl that that customer that that child can n't hear forgot .	Michelle may forget what that customer that that child can n't hear forgot that bowl .
Susan would know this person who the boy who this dentist wo n't talk about sounded like .	Susan would know who the boy who this dentist wo n't talk about sounded like this person .
your daughter might notice the library that the guy who is n't going to that library left .	your daughter might notice where the guy who is n't going to that library left the library .
that boy did n't remember these horses that those children who were n't painting have n't talked about .	that boy did n't remember what those children who were n't painting have n't talked about these horses .
your mom wo n't see these hats that that guy who can n't return to this hospital is n't holding .	your mom wo n't see what that guy who can n't return to this hospital is n't holding these hats .
my husband should n't see the ladies who those men who are n't driving to these schools worked with .	my husband should n't see who those men who are n't driving to these schools worked with the ladies .
those teachers have noticed these cars that those children that noticed the girl can hate .	those teachers have noticed what those children that noticed the girl can hate these cars .
my cousins have noticed this car that that doctor that learned has n't noticed .	my cousins have noticed what that doctor that learned has n't noticed this car .
your son should notice these doctors who the guy who this person is talking about has n't worried .	your son should notice who the guy who this person is talking about has n't worried these doctors .
those doctors have noticed those rabbits that this adult who wo n't return to that restaurant sounds like .	those doctors have noticed what this adult who wo n't return to that restaurant sounds like those rabbits .
your cousins may see this lady who these children who clean those books had talked to .	your cousins may see who these children who clean those books had talked to this lady .
Karen wo n't notice this park that that doctor who was n't painting walks through .	Karen wo n't notice where that doctor who was n't painting walks through this park .
Eric would n't know the lady who the customer who has won sounded like .	Eric would n't know who the customer who has won sounded like the lady .
your brother has n't remembered this boy who that dancer who has n't talked about this patient looks like .	your brother has n't remembered who that dancer who has n't talked about this patient looks like this boy .
my son had known the museum that that patient who the man might talk about is n't leaving .	my son had known where that patient who the man might talk about is n't leaving the museum .
my sister can see this chair that that child that could n't know those men has n't remembered .	my sister can see what that child that could n't know those men has n't remembered this chair .
those children do n't see that shirt that the person who can n't notice the cup was n't talking about .	those children do n't see what the person who can n't notice the cup was n't talking about that shirt .
that woman has seen these glasses that the turtles that the ladies look like remember .	that woman has seen what the turtles that the ladies look like remember these glasses .
Steve had n't noticed the hats that the doctors that could n't eat love .	Steve had n't noticed what the doctors that could n't eat love the hats .
Carol must notice this adult that this boy who sang might talk about .	Carol must notice what this boy who sang might talk about this adult .
my doctors will remember the fork that this queen who thought about those toys moved .	my doctors will remember what this queen who thought about those toys moved the fork .
your husband has n't seen that car that those rabbits that this boy talked about think about .	your husband has n't seen what those rabbits that this boy talked about think about that car .
your cousins wo n't notice these toys that this patient that the ladies are talking about had n't remembered .	your cousins wo n't notice what this patient that the ladies are talking about had n't remembered these toys .
those children had noticed those buttons that that adult that thinks about the girls did n't forget .	those children had noticed what that adult that thinks about the girls did n't forget those buttons .
Kristen has n't seen these chairs that the person who the child sounded like should lift .	Kristen has n't seen what the person who the child sounded like should lift these chairs .
my doctors could remember these cars that that snake that that child had n't talked about loves .	my doctors could remember what that snake that that child had n't talked about loves these cars .
this girl has n't known that driver who those girls who the man talks about could n't talk about .	this girl has n't known who those girls who the man talks about could n't talk about that driver .
your teachers had n't seen this adult who the woman who dropped these bottles talks about .	your teachers had n't seen who the woman who dropped these bottles talks about this adult .
those children had n't seen these ladies who that king who that girl sounded like scares .	those children had n't seen who that king who that girl sounded like scares these ladies .
those teachers should forget this dentist that this woman who holds that car sounds like .	those teachers should forget what this woman who holds that car sounds like this dentist .
your son should know the beds that this adult that this woman has talked about remembered .	your son should know what this adult that this woman has talked about remembered the beds .
your cousins do n't see this man who that lady who thought about those dolls was n't listening to .	your cousins do n't see who that lady who thought about those dolls was n't listening to this man .
those teachers will see these teachers that the boy that must sound like that lady saw .	those teachers will see what the boy that must sound like that lady saw these teachers .
those people have n't known this boy who the women who must keep the dish could listen to .	those people have n't known who the women who must keep the dish could listen to this boy .
your teachers wo n't see the cups that that patient who looked like this king was n't fixing .	your teachers wo n't see what that patient who looked like this king was n't fixing the cups .
that guy will notice these ladies who that patient who is losing knew .	that guy will notice who that patient who is losing knew these ladies .
my teachers will remember the rings that the customer who cried threw .	my teachers will remember what the customer who cried threw the rings .
those children might notice the mall that these doctors who can talk about the turtle walked through .	those children might notice where these doctors who can talk about the turtle walked through the mall .
my friends wo n't remember those boys who those guys who lost are talking about .	my friends wo n't remember who those guys who lost are talking about those boys .
these teachers have n't remembered the glass that these girls who the doctors are talking about move .	these teachers have n't remembered what these girls who the doctors are talking about move the glass .
James had known those glasses that this teacher that the girl looked like has remembered .	James had known what this teacher that the girl looked like has remembered those glasses .
Judy could n't notice those teachers who this child who thinks about these people had n't talked to .	Judy could n't notice who this child who thinks about these people had n't talked to those teachers .
those children could n't know the teacher who the dentist who has n't lost that plane understands .	those children could n't know who the dentist who has n't lost that plane understands the teacher .
my friends could n't remember that bag that that person who had n't left this school is talking about .	my friends could n't remember what that person who had n't left this school is talking about that bag .
William wo n't know the shoe that that horse that would n't think about this truck did n't notice .	William wo n't know what that horse that would n't think about this truck did n't notice the shoe .
those doctors will remember the shoes that those dogs that the teacher hears thought about .	those doctors will remember what those dogs that the teacher hears thought about the shoes .
the doctors should n't see these girls that those guys who are lying have heard .	the doctors should n't see what those guys who are lying have heard these girls .
this king must remember the glass that the king who can n't talk about the cars threw .	this king must remember what the king who can n't talk about the cars threw the glass .
your son can know that bowl that those people who this person can n't talk about are n't keeping .	your son can know what those people who this person can n't talk about are n't keeping that bowl .
your mom had seen that guy that those men who do n't go to this school know .	your mom had seen what those men who do n't go to this school know that guy .
that queen has known the ring that the doctors who are n't bringing these forks can buy .	that queen has known what the doctors who are n't bringing these forks can buy the ring .
my teachers had n't remembered that woman who the boys who exercise bother .	my teachers had n't remembered who the boys who exercise bother that woman .
these children can n't forget that book that the guy who this man had heard holds .	these children can n't forget what the guy who this man had heard holds that book .
your teachers have n't known the rug that this person that these people talk about had seen .	your teachers have n't known what this person that these people talk about had seen the rug .
that king should know this school that that lady who talks about that boy had n't left .	that king should know where that lady who talks about that boy had n't left this school .
your friends would n't forget these cars that this driver that that teacher has n't talked about loved .	your friends would n't forget what this driver that that teacher has n't talked about loved these cars .
those doctors have known that woman that this dentist who was thinking about these rabbits sounds like .	those doctors have known what this dentist who was thinking about these rabbits sounds like that woman .
Wendy might forget the women who that customer who holds these cups had n't talked about .	Wendy might forget who that customer who holds these cups had n't talked about the women .
that woman could see the teacher who the doctor who goes to this bank is talking about .	that woman could see who the doctor who goes to this bank is talking about the teacher .
my doctors must know that doctor who these doctors who like this shirt should n't praise .	my doctors must know who these doctors who like this shirt should n't praise that doctor .
these teachers could notice this mouse that the mice that have n't grown hate .	these teachers could notice what the mice that have n't grown hate this mouse .
Liam has n't remembered these rabbits that the girl that has heard the horses would see .	Liam has n't remembered what the girl that has heard the horses would see these rabbits .
these children should n't forget the ladies who those teachers who love those women must talk about .	these children should n't forget who those teachers who love those women must talk about the ladies .
Gregory did n't remember this queen who this child who that queen is n't talking about sounds like .	Gregory did n't remember who this child who that queen is n't talking about sounds like this queen .
Brett had noticed this child who this teacher who dropped this bowl must hear .	Brett had noticed who this teacher who dropped this bowl must hear this child .
this woman can notice this man who these guys who the driver sounded like have n't taught .	this woman can notice who these guys who the driver sounded like have n't taught this man .
this man should n't remember that teacher who the ladies who have dropped the dolls have worried .	this man should n't remember who the ladies who have dropped the dolls have worried that teacher .
my cousins had known the forks that this customer who does n't remember the doll has n't talked about .	my cousins had known what this customer who does n't remember the doll has n't talked about the forks .
those children had seen the books that that king that thinks about the books forgot .	those children had seen what that king that thinks about the books forgot the books .
James wo n't remember the mouse that the guy who would shake these bowls had n't heard .	James wo n't remember what the guy who would shake these bowls had n't heard the mouse .
these doctors do n't know that adult that this adult who forgot those shirts heard .	these doctors do n't know what this adult who forgot those shirts heard that adult .
your mom would forget these cars that the women that loved this bicycle saw .	your mom would forget what the women that loved this bicycle saw these cars .
your doctors should n't notice the guys who those doctors who forget these cats would hear .	your doctors should n't notice who those doctors who forget these cats would hear the guys .
the children may see this mirror that the doctors that were eating should n't see .	the children may see what the doctors that were eating should n't see this mirror .
the children had known the glass that those dogs that had n't grown may remember .	the children had known what those dogs that had n't grown may remember the glass .
your sister had n't noticed this lady who the boys who would n't practice talk about .	your sister had n't noticed who the boys who would n't practice talk about this lady .
your doctors do n't notice the guy who the men who take this shoe had talked about .	your doctors do n't notice who the men who take this shoe had talked about the guy .
your doctors did n't forget those books that those turtles that might learn were thinking about .	your doctors did n't forget what those turtles that might learn were thinking about those books .
your wife had remembered this ring that the boys who talked about the dish held .	your wife had remembered what the boys who talked about the dish held this ring .
those people had n't seen these glasses that the boys who that guy sounds like were finding .	those people had n't seen what the boys who that guy sounds like were finding these glasses .
my mom could see that bicycle that that adult that did n't forget these bags is thinking about .	my mom could see what that adult that did n't forget these bags is thinking about that bicycle .
Ronald should remember this bicycle that this dog that these guys are n't talking about is n't thinking about .	Ronald should remember what this dog that these guys are n't talking about is n't thinking about this bicycle .
my doctors may know the plates that those boys that hate the bowl forgot .	my doctors may know what those boys that hate the bowl forgot the plates .
this boy did n't see the chair that the girl who knew the man does n't fix .	this boy did n't see what the girl who knew the man does n't fix the chair .
your cousins did n't notice those windows that the people who these men sound like do n't sell .	your cousins did n't notice what the people who these men sound like do n't sell those windows .
Peter could n't see this book that that king who had run around this park cleaned .	Peter could n't see what that king who had run around this park cleaned this book .
my mom must remember these dishes that these snakes that this person sounded like liked .	my mom must remember what these snakes that this person sounded like liked these dishes .
Emily may see these men that the teacher who has n't left the room will look like .	Emily may see what the teacher who has n't left the room will look like these men .
these people have n't known these rings that these boys who lost lift .	these people have n't known what these boys who lost lift these rings .
Jill had n't seen that driver that these teachers who could n't love the customer have talked about .	Jill had n't seen what these teachers who could n't love the customer have talked about that driver .
this lady has seen this toy that these horses that that dentist talked about do n't hate .	this lady has seen what these horses that that dentist talked about do n't hate this toy .
George had noticed this chair that the king who would n't buy that mirror has n't talked about .	George had noticed what the king who would n't buy that mirror has n't talked about this chair .
this guy may forget those glasses that that person who looks like this bird shakes .	this guy may forget what that person who looks like this bird shakes those glasses .
these doctors may see those guys who the ladies who had thought about those mice should n't worry .	these doctors may see who the ladies who had thought about those mice should n't worry those guys .
your wife would know these mice that that man that these teachers have heard thought about .	your wife would know what that man that these teachers have heard thought about these mice .
the doctors will notice the queen who that girl who that boy hears talks about .	the doctors will notice who that girl who that boy hears talks about the queen .
your friends have n't seen this spoon that this woman that would sound like the rabbit likes .	your friends have n't seen what this woman that would sound like the rabbit likes this spoon .
the guy could forget the bed that this doctor that could sound like those children does n't like .	the guy could forget what this doctor that could sound like those children does n't like the bed .
the guy would forget this button that the cats that could remember the lady hate .	the guy would forget what the cats that could remember the lady hate this button .
those teachers could n't know the person who that lady who must pass that school could sound like .	those teachers could n't know who that lady who must pass that school could sound like the person .
these teachers have known that book that that dentist that knows that king is n't thinking about .	these teachers have known what that dentist that knows that king is n't thinking about that book .
Samantha can know those books that the customer that eats sees .	Samantha can know what the customer that eats sees those books .
the teachers have n't seen the ship that this doctor that has remembered the picture will see .	the teachers have n't seen what this doctor that has remembered the picture will see the ship .
your doctors have remembered that bottle that the customer who thought about that book has n't talked about .	your doctors have remembered what the customer who thought about that book has n't talked about that bottle .
your cousins should notice the cups that that person who made that mirror holds .	your cousins should notice what that person who made that mirror holds the cups .
this king might forget that queen who those boys who can n't walk through that museum are n't talking about .	this king might forget who those boys who can n't walk through that museum are n't talking about that queen .
my doctors wo n't see this picture that those children that should run would forget .	my doctors wo n't see what those children that should run would forget this picture .
my teachers can know that adult who the children who those doctors heard had n't heard .	my teachers can know who the children who those doctors heard had n't heard that adult .
those teachers may notice this doctor who those boys who are buying the toys help .	those teachers may notice who those boys who are buying the toys help this doctor .
Bill would n't know the picture that that lady who was n't talking about this woman brought .	Bill would n't know what that lady who was n't talking about this woman brought the picture .
the children can remember the doors that the children who look like these turtles should n't make .	the children can remember what the children who look like these turtles should n't make the doors .
my doctors have n't seen those boxes that the boys that do n't run have remembered .	my doctors have n't seen what the boys that do n't run have remembered those boxes .
the man had n't noticed these candles that the lady that had learned saw .	the man had n't noticed what the lady that had learned saw these candles .
the boy has n't remembered the truck that the guys that should like this door could n't forget .	the boy has n't remembered what the guys that should like this door could n't forget the truck .
the children have n't noticed those plates that this lady who talks about that doll was fixing .	the children have n't noticed what this lady who talks about that doll was fixing those plates .
my friends had noticed the boys who these women who are n't yelling look like .	my friends had noticed who these women who are n't yelling look like the boys .
your son should know these children that the man who was n't losing this candle has heard .	your son should know what the man who was n't losing this candle has heard these children .
my friends have n't noticed those doctors who the people who those girls talked about could sound like .	my friends have n't noticed who the people who those girls talked about could sound like those doctors .
David can remember those ladies who the girl who had noticed those doctors can scare .	David can remember who the girl who had noticed those doctors can scare those ladies .
Jason did n't forget that bed that the man who left the school would find .	Jason did n't forget what the man who left the school would find that bed .
your grandmother may notice those boys who the people who fixed this candle look like .	your grandmother may notice who the people who fixed this candle look like those boys .
my doctors could know this toy that that guy who might talk about the cat brings .	my doctors could know what that guy who might talk about the cat brings this toy .
my grandmother had noticed those shirts that the turtles that liked that driver had n't thought about .	my grandmother had noticed what the turtles that liked that driver had n't thought about those shirts .
this girl had noticed this picture that these girls who forgot those bags have n't talked about .	this girl had noticed what these girls who forgot those bags have n't talked about this picture .
my grandmother has noticed the children who the teachers who lost heard .	my grandmother has noticed who the teachers who lost heard the children .
Christopher has n't noticed the women who the men who might practice could n't know .	Christopher has n't noticed who the men who might practice could n't know the women .
your friends could n't remember the boxes that the horse that is n't eating had n't seen .	your friends could n't remember what the horse that is n't eating had n't seen the boxes .
my doctors would know these crayons that this teacher that did n't eat loved .	my doctors would know what this teacher that did n't eat loved these crayons .
Kristen should see the hat that this adult that is learning has remembered .	Kristen should see what this adult that is learning has remembered the hat .
your teachers had n't remembered this couch that those children who should throw the cars bought .	your teachers had n't remembered what those children who should throw the cars bought this couch .
those doctors could n't see the restaurant that that doctor who has n't held these windows is n't going to .	those doctors could n't see where that doctor who has n't held these windows is n't going to the restaurant .
your cousins had n't seen the children that the driver who has n't bought that truck has n't heard .	your cousins had n't seen what the driver who has n't bought that truck has n't heard the children .
Aaron had seen that hospital that this customer who must clean those boxes has n't left .	Aaron had seen where this customer who must clean those boxes has n't left that hospital .
this queen had n't remembered those doors that the guys who laugh wo n't talk about .	this queen had n't remembered what the guys who laugh wo n't talk about those doors .
your doctors do n't notice the bags that that customer who makes the book has n't bought .	your doctors do n't notice what that customer who makes the book has n't bought the bags .
my doctors had n't seen those men that that doctor who that customer has n't talked about has talked about .	my doctors had n't seen what that doctor who that customer has n't talked about has talked about those men .
Alexander would remember those teachers who the queen who is throwing this door knew .	Alexander would remember who the queen who is throwing this door knew those teachers .
your friends had noticed the car that that dog that this teacher could talk about had n't remembered .	your friends had noticed what that dog that this teacher could talk about had n't remembered the car .
your teachers can see this rocket that those ladies who leave that school did n't talk about .	your teachers can see what those ladies who leave that school did n't talk about this rocket .
your friends do n't remember this doctor that those people who would n't sneeze might talk about .	your friends do n't remember what those people who would n't sneeze might talk about this doctor .
your brother has remembered these bowls that the ladies that can n't run like .	your brother has remembered what the ladies that can n't run like these bowls .
my cousins would n't remember that dancer that the women who drove to the schools knew .	my cousins would n't remember what the women who drove to the schools knew that dancer .
my wife may see that adult who these doctors who looked like these snakes heard .	my wife may see who these doctors who looked like these snakes heard that adult .
Laurie could n't know that rug that this guy who that dancer wo n't sound like wo n't fix .	Laurie could n't know what this guy who that dancer wo n't sound like wo n't fix that rug .
this girl might notice the trucks that that woman who remembered that woman fixed .	this girl might notice what that woman who remembered that woman fixed the trucks .
my friends had n't remembered this truck that these people that thought about the doctors love .	my friends had n't remembered what these people that thought about the doctors love this truck .
these teachers can n't forget that museum that that queen who found the plates wo n't drive to .	these teachers can n't forget where that queen who found the plates wo n't drive to that museum .
your dad has known those dolls that that king who has lost had brought .	your dad has known what that king who has lost had brought those dolls .
Kayla may remember that truck that that king who would n't lift those buttons kept .	Kayla may remember what that king who would n't lift those buttons kept that truck .
Michael must remember those men who the woman who throws the cars could n't understand .	Michael must remember who the woman who throws the cars could n't understand those men .
the lady had n't remembered those men who these people who must hear that adult could n't talk about .	the lady had n't remembered who these people who must hear that adult could n't talk about those men .
Renee must know the driver who that person who must talk about the spoons found .	Renee must know who that person who must talk about the spoons found the driver .
John should n't know these bags that these horses that the guy talks about are thinking about .	John should n't know what these horses that the guy talks about are thinking about these bags .
my mother must forget the children who these ladies who drop those buttons may listen to .	my mother must forget who these ladies who drop those buttons may listen to the children .
this man wo n't know the cats that these doctors who talk about this bed had n't talked about .	this man wo n't know what these doctors who talk about this bed had n't talked about the cats .
your doctors would notice those beds that those men who threw the picture have n't talked about .	your doctors would notice what those men who threw the picture have n't talked about those beds .
my doctors had n't noticed those rings that that man who read can hold .	my doctors had n't noticed what that man who read can hold those rings .
these children have known that shoe that that child that runs does n't see .	these children have known what that child that runs does n't see that shoe .
your cousins have seen this car that the women who remember the adult did n't talk about .	your cousins have seen what the women who remember the adult did n't talk about this car .
those doctors would remember this turtle that the queen who may go to that park hears .	those doctors would remember what the queen who may go to that park hears this turtle .
these doctors had remembered the book that this driver that runs had seen .	these doctors had remembered what this driver that runs had seen the book .
my daughter had n't noticed these boxes that the queen who had yelled can n't sell .	my daughter had n't noticed what the queen who had yelled can n't sell these boxes .
those children do n't notice these beds that these ladies that think about the cup see .	those children do n't notice what these ladies that think about the cup see these beds .
Jennifer could n't know these boxes that the ladies who can n't exercise fix .	Jennifer could n't know what the ladies who can n't exercise fix these boxes .
that man has n't remembered the truck that this turtle that did n't sound like that cat saw .	that man has n't remembered what this turtle that did n't sound like that cat saw the truck .
those people could n't remember those trucks that this customer that ate thought about .	those people could n't remember what this customer that ate thought about those trucks .
the teachers can n't remember the guys who the woman who had remembered those candles talks to .	the teachers can n't remember who the woman who had remembered those candles talks to the guys .
my friends can n't see the forks that this patient that is n't eating has n't noticed .	my friends can n't see what this patient that is n't eating has n't noticed the forks .
my daughter has known the car that this woman who cleaned the bed throws .	my daughter has known what this woman who cleaned the bed throws the car .
your father may see the rug that these rabbits that that dentist wo n't look like can n't notice .	your father may see what these rabbits that that dentist wo n't look like can n't notice the rug .
your teachers have noticed those dolls that the girls who would win take .	your teachers have noticed what the girls who would win take those dolls .
the teachers would n't see this mall that these guys who had n't noticed those toys can n't return to .	the teachers would n't see where these guys who had n't noticed those toys can n't return to this mall .
this girl may know the men who those boys who might look like the man could n't sound like .	this girl may know who those boys who might look like the man could n't sound like the men .
April had remembered those teachers who this patient who was walking through that library talks about .	April had remembered who this patient who was walking through that library talks about those teachers .
your doctors did n't remember those glasses that this woman who had thought about those bags does n't lift .	your doctors did n't remember what this woman who had thought about those bags does n't lift those glasses .
my dad had n't seen the shoe that the snakes that thought about that plate thought about .	my dad had n't seen what the snakes that thought about that plate thought about the shoe .
these children had n't remembered the crayons that the customer who is screaming was making .	these children had n't remembered what the customer who is screaming was making the crayons .
that woman has noticed the hats that those girls that should think about these boats forget .	that woman has noticed what those girls that should think about these boats forget the hats .
those people wo n't forget the lady that that customer who shook that doll should look like .	those people wo n't forget what that customer who shook that doll should look like the lady .
those children did n't know the dogs that this guy that had n't thought about the customer had n't thought about .	those children did n't know what this guy that had n't thought about the customer had n't thought about the dogs .
Catherine can remember these spoons that the girl who would n't talk about those toys talked about .	Catherine can remember what the girl who would n't talk about those toys talked about these spoons .
Daniel had remembered these spoons that these birds that these people know were n't thinking about .	Daniel had remembered what these birds that these people know were n't thinking about these spoons .
your mom would n't see that window that the man who talked about the mouse fixed .	your mom would n't see what the man who talked about the mouse fixed that window .
those teachers have seen those schools that these people who are thinking about the children may drive to .	those teachers have seen where these people who are thinking about the children may drive to those schools .
the children have n't known that glass that this person who had talked about the men bought .	the children have n't known what this person who had talked about the men bought that glass .
the people had noticed the windows that this dog that hears that dog thinks about .	the people had noticed what this dog that hears that dog thinks about the windows .
that guy had seen these boats that this dog that that lady looked like remembered .	that guy had seen what this dog that that lady looked like remembered these boats .
your friends would forget these trucks that the women who this guy does n't hear talk about .	your friends would forget what the women who this guy does n't hear talk about these trucks .
those people do n't notice that dentist who these people who fixed those doors talk about .	those people do n't notice who these people who fixed those doors talk about that dentist .
those children had known those bottles that the customer who had talked about that box should n't throw .	those children had known what the customer who had talked about that box should n't throw those bottles .
those people have noticed the driver who that boy who that dentist looked like knows .	those people have noticed who that boy who that dentist looked like knows the driver .
these doctors did n't forget that bowl that those rabbits that that guy had n't heard have n't noticed .	these doctors did n't forget what those rabbits that that guy had n't heard have n't noticed that bowl .
Julia has noticed these crayons that this doctor who these people would n't look like was throwing .	Julia has noticed what this doctor who these people would n't look like was throwing these crayons .
your teachers have n't seen these boys who that guy who was n't talking about those men scared .	your teachers have n't seen who that guy who was n't talking about those men scared these boys .
my friends might see the chairs that that guy who did n't talk about this patient stole .	my friends might see what that guy who did n't talk about this patient stole the chairs .
these people have n't seen these beds that that customer who looked like the child was n't fixing .	these people have n't seen what that customer who looked like the child was n't fixing these beds .
my doctors had n't noticed the person that this driver who would n't look like these women hears .	my doctors had n't noticed what this driver who would n't look like these women hears the person .
these doctors should remember these boys who this customer who would n't talk looks like .	these doctors should remember who this customer who would n't talk looks like these boys .
your brother can see the library that these people who should n't wave do n't pass .	your brother can see where these people who should n't wave do n't pass the library .
your daughter did n't see this plate that that dog that must run likes .	your daughter did n't see what that dog that must run likes this plate .
your cousins should notice that glass that the man who the customer would n't look like would talk about .	your cousins should notice what the man who the customer would n't look like would talk about that glass .
Steven would n't see that mall that those ladies who run around this mall went to .	Steven would n't see where those ladies who run around this mall went to that mall .
Linda should n't forget the rings that this lady that could n't run sees .	Linda should n't forget what this lady that could n't run sees the rings .
the girl had known the door that these women who may drop these forks will talk about .	the girl had known what these women who may drop these forks will talk about the door .
the teachers have noticed the shirt that the patient who moves the car should n't keep .	the teachers have noticed what the patient who moves the car should n't keep the shirt .
your brother had n't seen these books that that horse that grew had noticed .	your brother had n't seen what that horse that grew had noticed these books .
those people would forget the buttons that the adult who these guys sound like bought .	those people would forget what the adult who these guys sound like bought the buttons .
Linda can n't forget that crayon that those children that the woman has n't talked about remembered .	Linda can n't forget what those children that the woman has n't talked about remembered that crayon .
that woman should n't notice the dish that this boy that this man will look like was thinking about .	that woman should n't notice what this boy that this man will look like was thinking about the dish .
your teachers have known that guy who those ladies who painted bother .	your teachers have known who those ladies who painted bother that guy .
these doctors would n't see this doll that these men who painted are keeping .	these doctors would n't see what these men who painted are keeping this doll .
your grandmother had n't noticed those girls that those guys who the driver knew have n't heard .	your grandmother had n't noticed what those guys who the driver knew have n't heard those girls .
this queen can notice the dolls that the customer who had n't heard this person cleaned .	this queen can notice what the customer who had n't heard this person cleaned the dolls .
my brother had n't seen those plates that this person who knew those boys had brought .	my brother had n't seen what this person who knew those boys had brought those plates .
my sister would forget the girl who those doctors who did n't sneeze were n't talking about .	my sister would forget who those doctors who did n't sneeze were n't talking about the girl .
my son could n't notice the doll that this man that ran remembered .	my son could n't notice what this man that ran remembered the doll .
Christopher has n't noticed this driver that the teachers who were shaking the dishes were n't talking about .	Christopher has n't noticed what the teachers who were shaking the dishes were n't talking about this driver .
the people have n't known this girl who those teachers who are shaking those doors were talking to .	the people have n't known who those teachers who are shaking those doors were talking to this girl .
my friends can know the doors that the teachers who were n't laughing have n't fixed .	my friends can know what the teachers who were n't laughing have n't fixed the doors .
your teachers did n't know this toy that the snakes that knew the teachers wo n't remember .	your teachers did n't know what the snakes that knew the teachers wo n't remember this toy .
my mom did n't see the forks that these snakes that that man would n't hear had n't seen .	my mom did n't see what these snakes that that man would n't hear had n't seen the forks .
the girl could remember this person who that driver who sounded like the rabbit had n't found .	the girl could remember who that driver who sounded like the rabbit had n't found this person .
that girl has n't known the teachers who those teachers who talk about the driver have n't taught .	that girl has n't known who those teachers who talk about the driver have n't taught the teachers .
those children have known these boys who that man who did n't make that plane would hear .	those children have known who that man who did n't make that plane would hear these boys .
that king must remember that glass that the people that do n't run hate .	that king must remember what the people that do n't run hate that glass .
that king can n't see that driver who these teachers who sounded like these rabbits are n't bothering .	that king can n't see who these teachers who sounded like these rabbits are n't bothering that driver .
that guy has seen the guy who this teacher who was fixing that button visited .	that guy has seen who this teacher who was fixing that button visited the guy .
my sister would notice the bank that the women who could n't talk go to .	my sister would notice where the women who could n't talk go to the bank .
those children have remembered this dentist who the king who saw the rings should n't talk to .	those children have remembered who the king who saw the rings should n't talk to this dentist .
my sister can notice the schools that this king who had this couch walked through .	my sister can notice where this king who had this couch walked through the schools .
these people would n't see that guy who this doctor who would take those dolls might understand .	these people would n't see who this doctor who would take those dolls might understand that guy .
Martin has remembered this adult who the dancer who is n't losing was n't talking to .	Martin has remembered who the dancer who is n't losing was n't talking to this adult .
Christopher can n't see those children who the girl who makes the books did n't look like .	Christopher can n't see who the girl who makes the books did n't look like those children .
your friends must notice that girl who that woman who was n't buying the plates has worked with .	your friends must notice who that woman who was n't buying the plates has worked with that girl .
your mom had n't known the mice that the dancer that had n't run had n't thought about .	your mom had n't known what the dancer that had n't run had n't thought about the mice .
Aaron has remembered that truck that the hamster that had n't seen the king has noticed .	Aaron has remembered what the hamster that had n't seen the king has noticed that truck .
my cousins had seen this couch that that driver who should think about the mirror was taking .	my cousins had seen what that driver who should think about the mirror was taking this couch .
these people had seen that person who that girl who was whispering has n't heard .	these people had seen who that girl who was whispering has n't heard that person .
these teachers have known the buttons that this horse that was growing could n't forget .	these teachers have known what this horse that was growing could n't forget the buttons .
the people have seen that driver who that doctor who could n't lose helps .	the people have seen who that doctor who could n't lose helps that driver .
Kevin must see the plates that these snakes that have run like .	Kevin must see what these snakes that have run like the plates .
my teachers should see that bicycle that those dogs that this boy sounds like noticed .	my teachers should see what those dogs that this boy sounds like noticed that bicycle .
those children have n't known the button that the hamster that will sound like this customer is thinking about .	those children have n't known what the hamster that will sound like this customer is thinking about the button .
my cousins must see the lady who that woman who talks about these women knows .	my cousins must see who that woman who talks about these women knows the lady .
my father had n't known those bowls that the driver that learned had seen .	my father had n't known what the driver that learned had seen those bowls .
your doctors may know the glasses that that dancer that may hate this bowl has thought about .	your doctors may know what that dancer that may hate this bowl has thought about the glasses .
these doctors must forget this shoe that those boys that these teachers talked about are thinking about .	these doctors must forget what those boys that these teachers talked about are thinking about this shoe .
that lady has seen this hamster that those boys that had eaten had n't thought about .	that lady has seen what those boys that had eaten had n't thought about this hamster .
your husband does n't forget these cars that that adult who drops these forks talks about .	your husband does n't forget what that adult who drops these forks talks about these cars .
your teachers did n't forget these teachers who that teacher who may stretch could work with .	your teachers did n't forget who that teacher who may stretch could work with these teachers .
your friends do n't remember that queen who the dentist who has remembered that doctor looked like .	your friends do n't remember who the dentist who has remembered that doctor looked like that queen .
Jessica had n't noticed this plate that this adult that is n't running has n't thought about .	Jessica had n't noticed what this adult that is n't running has n't thought about this plate .
the people do n't remember this king who the child who this driver has talked about sounded like .	the people do n't remember who the child who this driver has talked about sounded like this king .
the guy may know these guys who this adult who walked through this school does n't sound like .	the guy may know who this adult who walked through this school does n't sound like these guys .
my doctors have n't noticed these pictures that the lady who was n't leaving this kitchen could n't make .	my doctors have n't noticed what the lady who was n't leaving this kitchen could n't make these pictures .
your cousins have remembered these chairs that that dentist that runs thought about .	your cousins have remembered what that dentist that runs thought about these chairs .
those doctors could n't remember the ladies who those ladies who keep that bowl might know .	those doctors could n't remember who those ladies who keep that bowl might know the ladies .
your mother can n't know those forks that the man that noticed the driver has n't seen .	your mother can n't know what the man that noticed the driver has n't seen those forks .
that king would n't know that person who the boy who could n't yell talks about .	that king would n't know who the boy who could n't yell talks about that person .
the teachers had noticed this crayon that this child who did n't know that customer talked about .	the teachers had noticed what this child who did n't know that customer talked about this crayon .
your friends have n't remembered this cup that those teachers who this dentist sounds like are taking .	your friends have n't remembered what those teachers who this dentist sounds like are taking this cup .
that queen will forget that bottle that the man that the man is talking about noticed .	that queen will forget what the man that the man is talking about noticed that bottle .
the children had n't known that room that this driver who could take those cars wo n't run around .	the children had n't known where this driver who could take those cars wo n't run around that room .
these people must notice those crayons that this driver who can n't clean the glass was talking about .	these people must notice what this driver who can n't clean the glass was talking about those crayons .
the queen has known the girl who the lady who sounded like this guy answered .	the queen has known who the lady who sounded like this guy answered the girl .
your doctors have n't seen that rug that this person who might steal this bottle made .	your doctors have n't seen what this person who might steal this bottle made that rug .
Brian has noticed that restaurant that these men who should n't make the bowls were n't walking through .	Brian has noticed where these men who should n't make the bowls were n't walking through that restaurant .
Leslie has n't seen that chair that these doctors who should n't remember that truck are n't talking about .	Leslie has n't seen what these doctors who should n't remember that truck are n't talking about that chair .
my doctors would n't forget those bottles that the person who talks about those dogs shakes .	my doctors would n't forget what the person who talks about those dogs shakes those bottles .
that queen could notice those buttons that these women that grow saw .	that queen could notice what these women that grow saw those buttons .
the doctors did n't forget the book that that dentist who is walking through the mall takes .	the doctors did n't forget what that dentist who is walking through the mall takes the book .
your teachers might see that bicycle that these people that love these crayons do n't hate .	your teachers might see what these people that love these crayons do n't hate that bicycle .
these people had seen the doctors who this king who holds that boat was talking to .	these people had seen who this king who holds that boat was talking to the doctors .
my cousins had known these ladies who that patient who drives to the kitchen talked about .	my cousins had known who that patient who drives to the kitchen talked about these ladies .
my husband might forget that spoon that the person who that man talked about can n't find .	my husband might forget what the person who that man talked about can n't find that spoon .
the guy had n't remembered the truck that those guys that had learned had n't remembered .	the guy had n't remembered what those guys that had learned had n't remembered the truck .
the boy had n't known this girl who the children who passed the park may talk about .	the boy had n't known who the children who passed the park may talk about this girl .
the children have known that driver that the girl who this patient talks about should n't hear .	the children have known what the girl who this patient talks about should n't hear that driver .
Sally has n't remembered those doctors who the ladies who are n't whispering visit .	Sally has n't remembered who the ladies who are n't whispering visit those doctors .
my friends have n't noticed the car that these mice that did n't remember this rabbit think about .	my friends have n't noticed what these mice that did n't remember this rabbit think about the car .
your teachers had n't noticed that mall that that driver who had n't lost went to .	your teachers had n't noticed where that driver who had n't lost went to that mall .
those doctors had n't noticed the glasses that the dog that has heard the teacher does n't remember .	those doctors had n't noticed what the dog that has heard the teacher does n't remember the glasses .
the queen has known this fork that that guy who that lady knows moves .	the queen has known what that guy who that lady knows moves this fork .
the teachers had n't remembered this toy that this woman who had n't cried has n't talked about .	the teachers had n't remembered what this woman who had n't cried has n't talked about this toy .
Peter has seen the door that that person that this customer had heard has seen .	Peter has seen what that person that this customer had heard has seen the door .
those children had n't seen the pictures that that cat that sounded like the men should remember .	those children had n't seen what that cat that sounded like the men should remember the pictures .
that girl has n't known that doctor who that dancer who will talk about those chairs will appreciate .	that girl has n't known who that dancer who will talk about those chairs will appreciate that doctor .
these doctors did n't see the snakes that this boy who was cleaning those beds has heard .	these doctors did n't see what this boy who was cleaning those beds has heard the snakes .
the king might remember this teacher who that doctor who the girl heard talks about .	the king might remember who that doctor who the girl heard talks about this teacher .
my friends wo n't know the bags that that woman that this lady has n't talked about can hate .	my friends wo n't know what that woman that this lady has n't talked about can hate the bags .
these people have seen the rooms that these guys who were moving that dish are running around .	these people have seen where these guys who were moving that dish are running around the rooms .
my doctors have n't noticed the ladies who these teachers who bring that rocket hear .	my doctors have n't noticed who these teachers who bring that rocket hear the ladies .
my cousins can know the woman who these girls who could n't find this door talked to .	my cousins can know who these girls who could n't find this door talked to the woman .
my father may remember the lady who the doctor who these men look like had n't heard .	my father may remember who the doctor who these men look like had n't heard the lady .
your doctors had n't known this person who the ladies who can n't hate this dentist can n't work with .	your doctors had n't known who the ladies who can n't hate this dentist can n't work with this person .
your brother has remembered the woman that that customer who was waving can hear .	your brother has remembered what that customer who was waving can hear the woman .
your mom has remembered this book that that turtle that runs liked .	your mom has remembered what that turtle that runs liked this book .
your teachers might remember the teacher who the dancer who loved these rings was talking about .	your teachers might remember who the dancer who loved these rings was talking about the teacher .
the queen has noticed that ring that the driver who looks like these women had fixed .	the queen has noticed what the driver who looks like these women had fixed that ring .
Melissa must remember those dolls that this woman who would n't know this patient cleaned .	Melissa must remember what this woman who would n't know this patient cleaned those dolls .
these people have remembered the ship that that rabbit that those ladies would n't look like saw .	these people have remembered what that rabbit that those ladies would n't look like saw the ship .
the teachers had noticed the boxes that the doctor who had bought the cups lost .	the teachers had noticed what the doctor who had bought the cups lost the boxes .
my cousins should remember the bicycle that this snake that the person has n't talked about likes .	my cousins should remember what this snake that the person has n't talked about likes the bicycle .
that lady has n't seen these trucks that those people who do n't smile are n't making .	that lady has n't seen what those people who do n't smile are n't making these trucks .
my mother had noticed those bowls that the adult that that king is talking about loved .	my mother had noticed what the adult that that king is talking about loved those bowls .
your cousins wo n't remember these people who this boy who had n't thought about that girl will answer .	your cousins wo n't remember who this boy who had n't thought about that girl will answer these people .
those people had n't remembered the windows that this turtle that had n't seen this truck sees .	those people had n't remembered what this turtle that had n't seen this truck sees the windows .
Alice has remembered these children who that person who knows the horses talks about .	Alice has remembered who that person who knows the horses talks about these children .
that man had seen the person who those people who took the truck knew .	that man had seen who those people who took the truck knew the person .
Adam had n't remembered that spoon that the children who the man talked about talk about .	Adam had n't remembered what the children who the man talked about talk about that spoon .
the people may see this couch that the mouse that noticed those books remembered .	the people may see what the mouse that noticed those books remembered this couch .
Martin can know these boats that these dogs that that dentist does n't look like have noticed .	Martin can know what these dogs that that dentist does n't look like have noticed these boats .
those teachers will see the bank that that boy who talks about that woman is n't going to .	those teachers will see where that boy who talks about that woman is n't going to the bank .
the people have n't remembered those children that the child who did n't hear the driver hears .	the people have n't remembered what the child who did n't hear the driver hears those children .
that lady could see the cups that those women who might talk about that crayon were buying .	that lady could see what those women who might talk about that crayon were buying the cups .
your brother has n't seen the woman who this woman who is talking about that snake may sound like .	your brother has n't seen who this woman who is talking about that snake may sound like the woman .
your daughter has seen that doctor that the woman that saw the couch loves .	your daughter has seen what the woman that saw the couch loves that doctor .
April would n't notice the cup that the driver that had noticed these rings had thought about .	April would n't notice what the driver that had noticed these rings had thought about the cup .
this boy would n't know that box that these boys who would think about those trucks had cleaned .	this boy would n't know what these boys who would think about those trucks had cleaned that box .
the queen will remember these boats that this driver that that person talked about had noticed .	the queen will remember what this driver that that person talked about had noticed these boats .
those doctors must remember this turtle that the people who do n't lift these shirts must talk about .	those doctors must remember what the people who do n't lift these shirts must talk about this turtle .
your cousins must notice the hamster that these boys who keep this picture look like .	your cousins must notice what these boys who keep this picture look like the hamster .
the king should n't notice the woman who these doctors who should walk through that mall would n't care for .	the king should n't notice who these doctors who should walk through that mall would n't care for the woman .
your teachers could notice the shirts that this lady that thinks about that bottle has seen .	your teachers could notice what this lady that thinks about that bottle has seen the shirts .
this guy can remember the person who that boy who laughed has talked to .	this guy can remember who that boy who laughed has talked to the person .
that girl can n't forget the guy that this patient who is n't driving to those schools talked about .	that girl can n't forget what this patient who is n't driving to those schools talked about the guy .
your cousins have n't known those pictures that that girl that that dentist may talk about has n't seen .	your cousins have n't known what that girl that that dentist may talk about has n't seen those pictures .
my daughter had seen these crayons that these people who were n't going to the hospital can n't lose .	my daughter had seen what these people who were n't going to the hospital can n't lose these crayons .
Denise did n't forget that fork that the customer who had walked through that mall has n't found .	Denise did n't forget what the customer who had walked through that mall has n't found that fork .
the children have noticed the people who the patient who those girls are n't talking about talks about .	the children have noticed who the patient who those girls are n't talking about talks about the people .
this queen should notice those rooms that that king who that person looked like is n't going to .	this queen should notice where that king who that person looked like is n't going to those rooms .
my doctors should n't forget the ship that this person who can n't keep this bicycle did n't steal .	my doctors should n't forget what this person who can n't keep this bicycle did n't steal the ship .
the children had n't noticed this driver who the women who might remember this girl had talked about .	the children had n't noticed who the women who might remember this girl had talked about this driver .
Amelia had known the fork that this customer who can n't bring this ring drops .	Amelia had known what this customer who can n't bring this ring drops the fork .
Jennifer may notice those doctors who these guys who had kept these pictures can n't look like .	Jennifer may notice who these guys who had kept these pictures can n't look like those doctors .
Leslie could forget this guy that this adult who has talked about the ring must know .	Leslie could forget what this adult who has talked about the ring must know this guy .
Joseph must notice this plate that the dancer that looks like this doctor saw .	Joseph must notice what the dancer that looks like this doctor saw this plate .
your brother would n't remember the girl who the women who yell should n't know .	your brother would n't remember who the women who yell should n't know the girl .
the doctors might notice that window that that customer that might remember the driver will like .	the doctors might notice what that customer that might remember the driver will like that window .
my daughter could n't know the couch that the man who could pass the mall wo n't throw .	my daughter could n't know what the man who could pass the mall wo n't throw the couch .
Guy must see the pictures that this dentist that was n't learning loves .	Guy must see what this dentist that was n't learning loves the pictures .
my father could know that king that this king who the women wo n't know talked about .	my father could know what this king who the women wo n't know talked about that king .
my cousins can n't know that boat that that teacher who this person looks like is n't buying .	my cousins can n't know what that teacher who this person looks like is n't buying that boat .
your doctors can know the girls who the boy who might remember the boxes would know .	your doctors can know who the boy who might remember the boxes would know the girls .
that lady has n't seen those buttons that the dentist that loves the boxes noticed .	that lady has n't seen what the dentist that loves the boxes noticed those buttons .
your cousins have n't known this driver who those people who are n't cleaning this doll can look like .	your cousins have n't known who those people who are n't cleaning this doll can look like this driver .
your doctors might see these guys who that girl who sang could hear .	your doctors might see who that girl who sang could hear these guys .
my husband could forget that crayon that the person that eats had remembered .	my husband could forget what the person that eats had remembered that crayon .
those people must know that park that the customer who remembered that truck was running around .	those people must know where the customer who remembered that truck was running around that park .
that girl has n't remembered those men who these women who can talk worry .	that girl has n't remembered who these women who can talk worry those men .
this woman may remember these rings that those doctors who would love this spoon lift .	this woman may remember what those doctors who would love this spoon lift these rings .
Thomas has noticed this car that those children who had yelled had lost .	Thomas has noticed what those children who had yelled had lost this car .
those people would notice this window that the teachers that did n't learn would love .	those people would notice what the teachers that did n't learn would love this window .
these teachers wo n't see the cars that that queen that sounds like the turtle is n't thinking about .	these teachers wo n't see what that queen that sounds like the turtle is n't thinking about the cars .
your doctors have noticed this spoon that that queen who should go to the bank was n't talking about .	your doctors have noticed what that queen who should go to the bank was n't talking about this spoon .
my sister has known these doctors who those men who remember that window were n't talking about .	my sister has known who those men who remember that window were n't talking about these doctors .
the guy does n't notice the forks that the person who that child looks like was shaking .	the guy does n't notice what the person who that child looks like was shaking the forks .
my teachers will forget that window that this dentist who had n't held these crayons was making .	my teachers will forget what this dentist who had n't held these crayons was making that window .
my doctors might forget the girl who the people who must think about that bird had n't visited .	my doctors might forget who the people who must think about that bird had n't visited the girl .
your cousins may notice this picture that those girls who steal this bed may talk about .	your cousins may notice what those girls who steal this bed may talk about this picture .
Liam could know the shoe that those men that are n't thinking about that cup remembered .	Liam could know what those men that are n't thinking about that cup remembered the shoe .
these teachers had remembered the chair that those girls that eat have n't noticed .	these teachers had remembered what those girls that eat have n't noticed the chair .
Vanessa did n't know this ship that this customer who has painted must shake .	Vanessa did n't know what this customer who has painted must shake this ship .
my husband should know the plate that the doctors who can scream are making .	my husband should know what the doctors who can scream are making the plate .
those doctors had n't remembered this patient who these people who yell talked to .	those doctors had n't remembered who these people who yell talked to this patient .
those teachers had noticed the window that this dog that is n't growing can n't love .	those teachers had noticed what this dog that is n't growing can n't love the window .
that girl must notice the girls who the customer who has n't read wo n't talk about .	that girl must notice who the customer who has n't read wo n't talk about the girls .
Timothy should see those bags that that customer who sounds like this adult did n't take .	Timothy should see what that customer who sounds like this adult did n't take those bags .
the people could n't notice that kitchen that this customer who had n't noticed that ship has n't gone to .	the people could n't notice where this customer who had n't noticed that ship has n't gone to that kitchen .
that queen could n't see this shirt that those guys that have n't noticed the women have seen .	that queen could n't see what those guys that have n't noticed the women have seen this shirt .
my teachers could n't notice the mirror that the teacher who talked about this doll cleaned .	my teachers could n't notice what the teacher who talked about this doll cleaned the mirror .
Becca had n't remembered these spoons that these women who must fix these dishes bought .	Becca had n't remembered what these women who must fix these dishes bought these spoons .
your wife might see that rocket that the ladies who remember this cat keep .	your wife might see what the ladies who remember this cat keep that rocket .
your husband should see the king that these snakes that will think about those cats see .	your husband should see what these snakes that will think about those cats see the king .
your doctors may remember this boy who these boys who may have the spoon knew .	your doctors may remember who these boys who may have the spoon knew this boy .
my dad will know those children who these teachers who noticed those plates sound like .	my dad will know who these teachers who noticed those plates sound like those children .
this woman had seen the bags that this person that looked like this hamster had n't remembered .	this woman had seen what this person that looked like this hamster had n't remembered the bags .
my friends must notice this person who the girl who is singing has worked with .	my friends must notice who the girl who is singing has worked with this person .
that lady might remember that rocket that that adult who the customer sounds like talks about .	that lady might remember what that adult who the customer sounds like talks about that rocket .
my teachers do n't notice the adult who the customer who has heard this woman has worried .	my teachers do n't notice who the customer who has heard this woman has worried the adult .
my husband had n't known the bed that the girl who could cough talks about .	my husband had n't known what the girl who could cough talks about the bed .
these teachers do n't forget these men who this woman who leaves that museum hears .	these teachers do n't forget who this woman who leaves that museum hears these men .
your doctors do n't notice the truck that that driver who had talked about the button is n't cleaning .	your doctors do n't notice what that driver who had talked about the button is n't cleaning the truck .
Linda had seen these schools that that girl who this boy looks like is running around .	Linda had seen where that girl who this boy looks like is running around these schools .
your son has remembered the bed that that rabbit that can n't see the shoe remembered .	your son has remembered what that rabbit that can n't see the shoe remembered the bed .
your teachers had n't known those schools that those guys who were n't moving that button could pass .	your teachers had n't known where those guys who were n't moving that button could pass those schools .
Carl does n't see those bags that this dentist who brings those pictures is talking about .	Carl does n't see what this dentist who brings those pictures is talking about those bags .
the boy could n't notice these dolls that this dancer who can n't run around that park had n't taken .	the boy could n't notice what this dancer who can n't run around that park had n't taken these dolls .
Cindy would n't forget this picture that this horse that that queen wo n't talk about has n't noticed .	Cindy would n't forget what this horse that that queen wo n't talk about has n't noticed this picture .
this boy had n't noticed those women who this man who won wo n't talk about .	this boy had n't noticed who this man who won wo n't talk about those women .
those teachers should know this man that the ladies who were going to that bank might look like .	those teachers should know what the ladies who were going to that bank might look like this man .
that lady does n't see that child who those boys who talk about the toy talk about .	that lady does n't see who those boys who talk about the toy talk about that child .
Thomas has n't seen these candles that the lady who throws the forks talks about .	Thomas has n't seen what the lady who throws the forks talks about these candles .
my friends should n't forget the pictures that this boy who shakes that ring has n't fixed .	my friends should n't forget what this boy who shakes that ring has n't fixed the pictures .
your friends have noticed those toys that the guy who had made these boxes holds .	your friends have noticed what the guy who had made these boxes holds those toys .
the people wo n't know this bicycle that the women who have the cars should take .	the people wo n't know what the women who have the cars should take this bicycle .
your mother has n't remembered this boy who these guys who looked like this man have found .	your mother has n't remembered who these guys who looked like this man have found this boy .
Donald could notice the candle that that girl who can n't return to that restaurant had n't kept .	Donald could notice what that girl who can n't return to that restaurant had n't kept the candle .
these doctors can n't remember this cat that these birds that are running forget .	these doctors can n't remember what these birds that are running forget this cat .
those people might know the lady who the dancer who was taking these candles lost .	those people might know who the dancer who was taking these candles lost the lady .
your teachers have seen that museum that the driver who was n't going to this bank drove to .	your teachers have seen where the driver who was n't going to this bank drove to that museum .
your husband has n't noticed this fork that the boys who that man talks about are n't talking about .	your husband has n't noticed what the boys who that man talks about are n't talking about this fork .
Robert does n't know those plates that that guy that this guy does n't talk about is thinking about .	Robert does n't know what that guy that this guy does n't talk about is thinking about those plates .
Jennifer has noticed this ship that this dancer who fixed those trucks has n't thrown .	Jennifer has noticed what this dancer who fixed those trucks has n't thrown this ship .
my friends did n't know that rocket that the girls who laughed are n't moving .	my friends did n't know what the girls who laughed are n't moving that rocket .
your friends had noticed that car that these children that that lady would n't hear have thought about .	your friends had noticed what these children that that lady would n't hear have thought about that car .
Kristen had noticed this guy who this customer who the teachers talk about had talked about .	Kristen had noticed who this customer who the teachers talk about had talked about this guy .
your teachers should n't forget the pictures that those girls who talked were n't taking .	your teachers should n't forget what those girls who talked were n't taking the pictures .
my doctors must see these bags that that mouse that wo n't forget this girl could n't love .	my doctors must see what that mouse that wo n't forget this girl could n't love these bags .
your doctors must notice these rooms that the doctors who are thinking about the rabbits return to .	your doctors must notice where the doctors who are thinking about the rabbits return to these rooms .
the people wo n't remember the boxes that those children who the child knew talk about .	the people wo n't remember what those children who the child knew talk about the boxes .
your teachers should n't notice these children who these guys who heard the turtle sounded like .	your teachers should n't notice who these guys who heard the turtle sounded like these children .
Becky should n't see that button that the patient who sees the horse would n't talk about .	Becky should n't see what the patient who sees the horse would n't talk about that button .
my friends had n't seen the bottles that those people who drop these candles may find .	my friends had n't seen what those people who drop these candles may find the bottles .
my teachers had remembered this mirror that those snakes that had n't seen the man were thinking about .	my teachers had remembered what those snakes that had n't seen the man were thinking about this mirror .
those doctors can remember the driver who the girl who has cried will know .	those doctors can remember who the girl who has cried will know the driver .
those teachers have known this dish that these people that forgot this fork love .	those teachers have known what these people that forgot this fork love this dish .
that woman will know the plate that those girls who may hold that glass would talk about .	that woman will know what those girls who may hold that glass would talk about the plate .
the man had known these ladies who that man who could talk about this snake can answer .	the man had known who that man who could talk about this snake can answer these ladies .
my grandmother could notice that candle that these people that would see the boy did n't like .	my grandmother could notice what these people that would see the boy did n't like that candle .
this lady does n't know these pictures that that customer that was n't growing was n't thinking about .	this lady does n't know what that customer that was n't growing was n't thinking about these pictures .
your mother may forget those shirts that the children that that lady wo n't talk about loved .	your mother may forget what the children that that lady wo n't talk about loved those shirts .
these children had n't known this shirt that that person who would n't look like that snake held .	these children had n't known what that person who would n't look like that snake held this shirt .
that man had known this chair that that lady that had heard those horses noticed .	that man had known what that lady that had heard those horses noticed this chair .
your grandmother had noticed those plates that the snake that is learning will remember .	your grandmother had noticed what the snake that is learning will remember those plates .
the guy had n't seen that plane that this woman who had n't heard those turtles had n't talked about .	the guy had n't seen what this woman who had n't heard those turtles had n't talked about that plane .
these teachers should n't know that turtle that this person that learned thinks about .	these teachers should n't know what this person that learned thinks about that turtle .
my grandmother can n't forget the rings that this man who looks like the cats does n't have .	my grandmother can n't forget what this man who looks like the cats does n't have the rings .
your cousins should n't remember that bowl that the dentist who lost these toys talked about .	your cousins should n't remember what the dentist who lost these toys talked about that bowl .
the girl has remembered those forks that the dogs that must eat might love .	the girl has remembered what the dogs that must eat might love those forks .
Michelle can remember that door that this woman who the dancer hears brings .	Michelle can remember what this woman who the dancer hears brings that door .
that guy has noticed this book that this boy who has kept the button was n't cleaning .	that guy has noticed what this boy who has kept the button was n't cleaning this book .
the doctors had n't seen the dancer who this driver who could n't hear those ladies was n't talking to .	the doctors had n't seen who this driver who could n't hear those ladies was n't talking to the dancer .
the man might forget those pictures that this teacher that this woman does n't hear should hate .	the man might forget what this teacher that this woman does n't hear should hate those pictures .
my friends had seen these boxes that the woman who likes that mouse is n't taking .	my friends had seen what the woman who likes that mouse is n't taking these boxes .
my doctors had n't remembered that book that this woman who that queen talks about had n't bought .	my doctors had n't remembered what this woman who that queen talks about had n't bought that book .
my doctors can see that child who these doctors who could n't look like this customer have n't heard .	my doctors can see who these doctors who could n't look like this customer have n't heard that child .
your teachers have n't remembered that driver that those women who might like this shirt are talking about .	your teachers have n't remembered what those women who might like this shirt are talking about that driver .
your brother had n't known this girl who these women who talk have n't visited .	your brother had n't known who these women who talk have n't visited this girl .
my teachers had n't seen the plane that these children that notice the cats love .	my teachers had n't seen what these children that notice the cats love the plane .
Anna has seen the chair that this king who has n't remembered those books is talking about .	Anna has seen what this king who has n't remembered those books is talking about the chair .
these children had remembered that box that the queen who knows the guy talks about .	these children had remembered what the queen who knows the guy talks about that box .
this king would forget those teachers who the doctors who buy these glasses are talking about .	this king would forget who the doctors who buy these glasses are talking about those teachers .
the children might know this boy who those men who talked about this dish talked about .	the children might know who those men who talked about this dish talked about this boy .
this man would see the candle that this turtle that the teachers heard had seen .	this man would see what this turtle that the teachers heard had seen the candle .
Kevin can notice those horses that these boys who cleaned this book have n't talked about .	Kevin can notice what these boys who cleaned this book have n't talked about those horses .
your doctors had noticed the hamster that that bird that would think about this man could n't hate .	your doctors had noticed what that bird that would think about this man could n't hate the hamster .
your cousins had remembered that picture that that queen who had bought the book talks about .	your cousins had remembered what that queen who had bought the book talks about that picture .
these children would n't know that bottle that that dentist that ran saw .	these children would n't know what that dentist that ran saw that bottle .
Laurie did n't forget that patient who the person who is n't yelling would talk about .	Laurie did n't forget who the person who is n't yelling would talk about that patient .
this man had known this dentist who these men who can talk about those rabbits were bothering .	this man had known who these men who can talk about those rabbits were bothering this dentist .
this guy did n't know the chair that the men who should n't talk found .	this guy did n't know what the men who should n't talk found the chair .
the guy had remembered the snake that this driver who the queen would n't talk about has heard .	the guy had remembered what this driver who the queen would n't talk about has heard the snake .
that guy can notice the rug that this woman who that doctor did n't hear may throw .	that guy can notice what this woman who that doctor did n't hear may throw the rug .
those teachers should see this toy that these men who passed that school keep .	those teachers should see what these men who passed that school keep this toy .
that guy had known the doctor that those doctors who love this dentist are n't talking about .	that guy had known what those doctors who love this dentist are n't talking about the doctor .
this boy must know the women who the queen who bought the doors heard .	this boy must know who the queen who bought the doors heard the women .
Donna can n't remember that fork that this king that is running remembered .	Donna can n't remember what this king that is running remembered that fork .
those doctors have n't remembered the shoe that that guy who is walking through that park keeps .	those doctors have n't remembered what that guy who is walking through that park keeps the shoe .
my friends would n't notice the car that the children who these boys talk about drop .	my friends would n't notice what the children who these boys talk about drop the car .
your teachers must see this bowl that this customer who has n't talked shakes .	your teachers must see what this customer who has n't talked shakes this bowl .
your mom had noticed these trucks that the lady who might leave these rooms talked about .	your mom had noticed what the lady who might leave these rooms talked about these trucks .
your mother had n't seen these dolls that that girl who has walked through those schools talks about .	your mother had n't seen what that girl who has walked through those schools talks about these dolls .
Carl did n't see these plates that the boys who these teachers had heard can n't make .	Carl did n't see what the boys who these teachers had heard can n't make these plates .
Thomas could n't remember this picture that this rabbit that that girl looks like was thinking about .	Thomas could n't remember what this rabbit that that girl looks like was thinking about this picture .
John has n't seen this library that the person who had talked about this turtle ran around .	John has n't seen where the person who had talked about this turtle ran around this library .
those people had n't known that car that these doctors that sounded like those ladies forgot .	those people had n't known what these doctors that sounded like those ladies forgot that car .
my sister must remember those shirts that the dancer who could n't go to that restaurant would throw .	my sister must remember what the dancer who could n't go to that restaurant would throw those shirts .
my teachers had n't seen these windows that this snake that had heard those ladies may notice .	my teachers had n't seen what this snake that had heard those ladies may notice these windows .
my cousins have n't remembered these windows that the ladies that sound like those cats do n't see .	my cousins have n't remembered what the ladies that sound like those cats do n't see these windows .
your dad could n't remember these snakes that that teacher that the doctor knew should like .	your dad could n't remember what that teacher that the doctor knew should like these snakes .
that guy could notice the children who the child who had remembered that child sounds like .	that guy could notice who the child who had remembered that child sounds like the children .
your teachers would n't notice the glass that those ladies who were talking about these bottles talked about .	your teachers would n't notice what those ladies who were talking about these bottles talked about the glass .
Lisa has n't remembered those children who these men who could n't read sounded like .	Lisa has n't remembered who these men who could n't read sounded like those children .
your husband had known those birds that these girls that have remembered those cups had remembered .	your husband had known what these girls that have remembered those cups had remembered those birds .
my sister has noticed this car that the customer who the man does n't talk about may throw .	my sister has noticed what the customer who the man does n't talk about may throw this car .
these teachers do n't see these shoes that the men who keep these shirts have fixed .	these teachers do n't see what the men who keep these shirts have fixed these shoes .
the boy has n't noticed the dish that the men that notice those horses noticed .	the boy has n't noticed what the men that notice those horses noticed the dish .
Mark might see that hat that that guy who could laugh must find .	Mark might see what that guy who could laugh must find that hat .
your friends might notice the bottle that the dancer that the customer talked about liked .	your friends might notice what the dancer that the customer talked about liked the bottle .
the queen can n't see this glass that that snake that eats has n't seen .	the queen can n't see what that snake that eats has n't seen this glass .
that woman has remembered the truck that the ladies who had dropped the bicycle find .	that woman has remembered what the ladies who had dropped the bicycle find the truck .
James had known the guy that the guys that sounded like those children have n't remembered .	James had known what the guys that sounded like those children have n't remembered the guy .
Elizabeth has seen the guy that the customer who has n't talked about these mice talks about .	Elizabeth has seen what the customer who has n't talked about these mice talks about the guy .
your cousins had remembered this rug that those boys that hear these women hate .	your cousins had remembered what those boys that hear these women hate this rug .
the teachers had noticed the car that the doctor that can n't think about the man liked .	the teachers had noticed what the doctor that can n't think about the man liked the car .
your doctors do n't forget these crayons that the bird that this dancer must sound like had n't thought about .	your doctors do n't forget what the bird that this dancer must sound like had n't thought about these crayons .
your cousins do n't notice those trucks that this adult who has n't painted moved .	your cousins do n't notice what this adult who has n't painted moved those trucks .
these people can n't see those men who this man who is bringing the plane sounds like .	these people can n't see who this man who is bringing the plane sounds like those men .
your daughter has known these windows that the queen who talks about these books was losing .	your daughter has known what the queen who talks about these books was losing these windows .
your teachers had remembered those children who the boy who is n't talking about these ladies sounds like .	your teachers had remembered who the boy who is n't talking about these ladies sounds like those children .
my teachers could remember the truck that the men that could eat would n't think about .	my teachers could remember what the men that could eat would n't think about the truck .
my father should see the women who that girl who had gone to the mall hears .	my father should see who that girl who had gone to the mall hears the women .
Mark could n't know the lady who those children who had n't heard the dancer looked like .	Mark could n't know who those children who had n't heard the dancer looked like the lady .
those children have known this bicycle that this king that did n't know the mice saw .	those children have known what this king that did n't know the mice saw this bicycle .
my grandmother had n't known those plates that the person who is n't thinking about this patient would n't hold .	my grandmother had n't known what the person who is n't thinking about this patient would n't hold those plates .
your grandmother would see the people who that driver who must sneeze has found .	your grandmother would see who that driver who must sneeze has found the people .
Rachel has n't seen those people who those teachers who ran around that kitchen are helping .	Rachel has n't seen who those teachers who ran around that kitchen are helping those people .
these people could n't see the doctors who the women who hear the bird understand .	these people could n't see who the women who hear the bird understand the doctors .
this boy should n't forget the shirt that that lady who does n't talk about that truck talks about .	this boy should n't forget what that lady who does n't talk about that truck talks about the shirt .
my grandmother may forget those shoes that this child who had n't cleaned the ring will talk about .	my grandmother may forget what this child who had n't cleaned the ring will talk about those shoes .
my cousins have noticed the boy who this boy who thought about this child did n't sound like .	my cousins have noticed who this boy who thought about this child did n't sound like the boy .
those doctors should n't forget these trucks that those horses that had n't noticed the rings loved .	those doctors should n't forget what those horses that had n't noticed the rings loved these trucks .
my daughter can n't see that book that this girl who the girls heard found .	my daughter can n't see what this girl who the girls heard found that book .
my friends had remembered those beds that this turtle that likes that spoon saw .	my friends had remembered what this turtle that likes that spoon saw those beds .
the queen can notice this rocket that this teacher who forgot that bicycle talked about .	the queen can notice what this teacher who forgot that bicycle talked about this rocket .
this queen may forget the window that these women that should n't grow have thought about .	this queen may forget what these women that should n't grow have thought about the window .
those children could know this shirt that this lady who sees this adult makes .	those children could know what this lady who sees this adult makes this shirt .
my friends might know that couch that the snake that loves the mouse thought about .	my friends might know what the snake that loves the mouse thought about that couch .
these doctors must notice this hat that that patient who had n't made the bicycle talked about .	these doctors must notice what that patient who had n't made the bicycle talked about this hat .
my teachers had n't remembered the hat that the cats that grew remember .	my teachers had n't remembered what the cats that grew remember the hat .
Richard will forget the button that that boy who lost the spoons brings .	Richard will forget what that boy who lost the spoons brings the button .
my mom had n't remembered that child that this doctor that had n't seen this truck likes .	my mom had n't remembered what this doctor that had n't seen this truck likes that child .
Jason had n't noticed the children who the driver who should hate those dogs had visited .	Jason had n't noticed who the driver who should hate those dogs had visited the children .
my son would n't notice the adult who these women who those men had n't heard might sound like .	my son would n't notice who these women who those men had n't heard might sound like the adult .
my doctors had n't known the lady who this queen who is n't bringing that truck talked about .	my doctors had n't known who this queen who is n't bringing that truck talked about the lady .
the children have remembered the dolls that that man who this person is n't talking about talks about .	the children have remembered what that man who this person is n't talking about talks about the dolls .
my friends would n't forget the rabbit that those men who had heard the lady had n't heard .	my friends would n't forget what those men who had heard the lady had n't heard the rabbit .
those teachers should notice the customer who those guys who these children sound like were n't talking about .	those teachers should notice who those guys who these children sound like were n't talking about the customer .
your mother has noticed those boxes that that doctor who liked this couch might talk about .	your mother has noticed what that doctor who liked this couch might talk about those boxes .
George has n't remembered these teachers who that teacher who would n't think about the horse is n't visiting .	George has n't remembered who that teacher who would n't think about the horse is n't visiting these teachers .
the boy does n't know that spoon that the girl who keeps the dishes is n't losing .	the boy does n't know what the girl who keeps the dishes is n't losing that spoon .
Mark would know those windows that the teachers who could stretch were n't keeping .	Mark would know what the teachers who could stretch were n't keeping those windows .
the people can n't see this plate that that king that was learning had noticed .	the people can n't see what that king that was learning had noticed this plate .
your doctors had n't remembered that cup that those people that are n't running noticed .	your doctors had n't remembered what those people that are n't running noticed that cup .
the lady has n't known that adult who these ladies who had n't moved that spoon answered .	the lady has n't known who these ladies who had n't moved that spoon answered that adult .
your brother could n't know that bank that the dancer who was n't yelling passed .	your brother could n't know where the dancer who was n't yelling passed that bank .
your friends have n't seen this guy who this woman who should n't leave these rooms has n't heard .	your friends have n't seen who this woman who should n't leave these rooms has n't heard this guy .
the doctors must notice the men who this boy who was n't talking about those cups knew .	the doctors must notice who this boy who was n't talking about those cups knew the men .
your cousins could remember this dancer who the men who the lady talks about look like .	your cousins could remember who the men who the lady talks about look like this dancer .
the guy had n't noticed those doctors that those ladies who had n't talked had heard .	the guy had n't noticed what those ladies who had n't talked had heard those doctors .
the boy had known that car that these horses that grew noticed .	the boy had known what these horses that grew noticed that car .
my mother could see those boys who this dentist who had n't kept the trucks was n't talking about .	my mother could see who this dentist who had n't kept the trucks was n't talking about those boys .
my son had seen that king that this adult who noticed this teacher could n't know .	my son had seen what this adult who noticed this teacher could n't know that king .
my dad had remembered that bottle that that boy who those girls heard brought .	my dad had remembered what that boy who those girls heard brought that bottle .
those doctors can n't know the window that that queen that remembered this driver remembered .	those doctors can n't know what that queen that remembered this driver remembered the window .
my cousins had seen that customer who that child who would love this lady can hear .	my cousins had seen who that child who would love this lady can hear that customer .
those teachers can n't forget the bed that these boys who had walked through this room had n't found .	those teachers can n't forget what these boys who had walked through this room had n't found the bed .
Kayla had n't noticed these boxes that this queen who those women could know talked about .	Kayla had n't noticed what this queen who those women could know talked about these boxes .
Jessica wo n't forget the dentist who those ladies who talk about this queen talked about .	Jessica wo n't forget who those ladies who talk about this queen talked about the dentist .
that girl had noticed those beds that that person that sees that picture does n't notice .	that girl had noticed what that person that sees that picture does n't notice those beds .
that boy should n't know that book that those people who have n't heard that girl are cleaning .	that boy should n't know what those people who have n't heard that girl are cleaning that book .
the king has n't seen the teachers who the person who is n't walking through these schools looked like .	the king has n't seen who the person who is n't walking through these schools looked like the teachers .
this man must forget that snake that this man who the doctors look like can look like .	this man must forget what this man who the doctors look like can look like that snake .
your cousins had n't known these rooms that those people who were bringing the button are driving to .	your cousins had n't known where those people who were bringing the button are driving to these rooms .
Carl had noticed the bowl that those girls that the man knew wo n't remember .	Carl had noticed what those girls that the man knew wo n't remember the bowl .
this man has n't noticed that spoon that the rabbits that think about this door thought about .	this man has n't noticed what the rabbits that think about this door thought about that spoon .
the people can n't remember the park that those teachers who that dentist talked about left .	the people can n't remember where those teachers who that dentist talked about left the park .
your teachers have seen those pictures that that snake that the woman talks about loved .	your teachers have seen what that snake that the woman talks about loved those pictures .
that boy would n't remember the forks that that queen who does n't talk about the toys was holding .	that boy would n't remember what that queen who does n't talk about the toys was holding the forks .
these children could n't forget these doctors who this woman who was n't lying must talk about .	these children could n't forget who this woman who was n't lying must talk about these doctors .
that woman has noticed this crayon that these women who should talk about that queen do n't talk about .	that woman has noticed what these women who should talk about that queen do n't talk about this crayon .
your mom might see that lady who the children who should lose do n't know .	your mom might see who the children who should lose do n't know that lady .
the girl would n't forget the library that this customer who should wave runs around .	the girl would n't forget where this customer who should wave runs around the library .
this girl might know that teacher who this adult who could hear the cats was teaching .	this girl might know who this adult who could hear the cats was teaching that teacher .
my dad had seen that driver who that dancer who may love these bags has worked with .	my dad had seen who that dancer who may love these bags has worked with that driver .
my doctors could n't notice that hat that that customer who moved the ship found .	my doctors could n't notice what that customer who moved the ship found that hat .
David had n't remembered that doll that the ladies who had thought about the turtles fix .	David had n't remembered what the ladies who had thought about the turtles fix that doll .
Michelle can n't see this dog that that girl that hears those turtles liked .	Michelle can n't see what that girl that hears those turtles liked this dog .
your teachers may remember these people who the boy who has won understands .	your teachers may remember who the boy who has won understands these people .
this lady may see that bottle that the adult who must stretch is n't talking about .	this lady may see what the adult who must stretch is n't talking about that bottle .
my father has n't known these guys who this boy who would n't hate that car looked like .	my father has n't known who this boy who would n't hate that car looked like these guys .
these teachers can remember these rooms that the boys who might whisper did n't drive to .	these teachers can remember where the boys who might whisper did n't drive to these rooms .
your husband wo n't know the hamster that the hamster that had seen these boats might remember .	your husband wo n't know what the hamster that had seen these boats might remember the hamster .
the doctors must notice this girl who this driver who the people hear talks about .	the doctors must notice who this driver who the people hear talks about this girl .
Melissa can n't know these snakes that the hamster that has n't heard those snakes loved .	Melissa can n't know what the hamster that has n't heard those snakes loved these snakes .
this guy should remember those doctors who these ladies who can hear these birds answer .	this guy should remember who these ladies who can hear these birds answer those doctors .
my friends had noticed these women who those doctors who the guys knew knew .	my friends had noticed who those doctors who the guys knew knew these women .
Cindy could remember that bag that this driver that is running can like .	Cindy could remember what this driver that is running can like that bag .
the people had n't noticed those beds that the teachers who had n't found the beds lift .	the people had n't noticed what the teachers who had n't found the beds lift those beds .
my husband had n't remembered the teacher that the child who was holding the beds looked like .	my husband had n't remembered what the child who was holding the beds looked like the teacher .
this girl has n't noticed those bowls that the rabbits that the patient talked about may notice .	this girl has n't noticed what the rabbits that the patient talked about may notice those bowls .
Samantha did n't forget this doll that these women that had n't seen the glass should like .	Samantha did n't forget what these women that had n't seen the glass should like this doll .
this man can n't know the pictures that these snakes that like the chairs think about .	this man can n't know what these snakes that like the chairs think about the pictures .
my cousins should n't know this hamster that this dentist who walked through this school is n't talking about .	my cousins should n't know what this dentist who walked through this school is n't talking about this hamster .
your friends have n't seen the teachers that the cats that know this hamster forget .	your friends have n't seen what the cats that know this hamster forget the teachers .
your doctors have n't remembered that mall that that dentist who has n't seen this truck had n't passed .	your doctors have n't remembered where that dentist who has n't seen this truck had n't passed that mall .
those people would see the books that these teachers who this boy could n't look like talk about .	those people would see what these teachers who this boy could n't look like talk about the books .
these teachers had n't seen that doctor who that dentist who that person was talking about has taught .	these teachers had n't seen who that dentist who that person was talking about has taught that doctor .
my friends have n't noticed this bowl that those snakes that that woman heard thought about .	my friends have n't noticed what those snakes that that woman heard thought about this bowl .
your wife can n't see that rug that the birds that ran saw .	your wife can n't see what the birds that ran saw that rug .
Steven could remember the ring that this boy who brought the bottle would drop .	Steven could remember what this boy who brought the bottle would drop the ring .
these doctors do n't notice the bottle that the adult who cried cleaned .	these doctors do n't notice what the adult who cried cleaned the bottle .
the queen had seen that girl who this teacher who has n't noticed the dancer may bother .	the queen had seen who this teacher who has n't noticed the dancer may bother that girl .
my friends had n't seen that boy who the customer who may notice those snakes did n't look like .	my friends had n't seen who the customer who may notice those snakes did n't look like that boy .
your doctors can n't remember this door that the boys who laugh could n't take .	your doctors can n't remember what the boys who laugh could n't take this door .
those teachers would n't know this boy that the teachers who saw this car sounded like .	those teachers would n't know what the teachers who saw this car sounded like this boy .
the doctors could n't know the teachers who this patient who that doctor hears was talking about .	the doctors could n't know who this patient who that doctor hears was talking about the teachers .
this guy would n't forget the bottle that this queen that noticed those ladies had thought about .	this guy would n't forget what this queen that noticed those ladies had thought about the bottle .
your doctors may see that plate that those women who forget the man could n't drop .	your doctors may see what those women who forget the man could n't drop that plate .
that woman should n't forget this child who the girls who had heard that person visit .	that woman should n't forget who the girls who had heard that person visit this child .
Allison had seen the hats that that customer who is n't throwing the windows can n't make .	Allison had seen what that customer who is n't throwing the windows can n't make the hats .
my teachers can remember the schools that that girl who looked like those doctors can walk through .	my teachers can remember where that girl who looked like those doctors can walk through the schools .
your teachers had n't known the cups that this person that eats liked .	your teachers had n't known what this person that eats liked the cups .
these children could know that hamster that this adult who was n't laughing was n't talking about .	these children could know what this adult who was n't laughing was n't talking about that hamster .
this king had noticed that dentist who the boys who had the forks were bothering .	this king had noticed who the boys who had the forks were bothering that dentist .
the teachers would n't forget these candles that the ladies who cried steal .	the teachers would n't forget what the ladies who cried steal these candles .
this boy should n't forget this door that the patient who is walking through that hospital brought .	this boy should n't forget what the patient who is walking through that hospital brought this door .
my teachers could remember the rabbit that the man who talked about this snake sounded like .	my teachers could remember what the man who talked about this snake sounded like the rabbit .
my doctors might see the truck that the dentist who will clean these beds would n't throw .	my doctors might see what the dentist who will clean these beds would n't throw the truck .
this king could forget this couch that these boys that think about the cars did n't like .	this king could forget what these boys that think about the cars did n't like this couch .
the teachers could know these turtles that this driver that has heard those dogs had seen .	the teachers could know what this driver that has heard those dogs had seen these turtles .
my cousins had n't noticed the mall that the children who are walking through these schools could leave .	my cousins had n't noticed where the children who are walking through these schools could leave the mall .
April could remember that truck that the boys who should n't notice the trucks talked about .	April could remember what the boys who should n't notice the trucks talked about that truck .
the doctors had noticed that queen that those boys that the dancer has heard love .	the doctors had noticed what those boys that the dancer has heard love that queen .
these teachers had n't seen this window that this customer who talks moved .	these teachers had n't seen what this customer who talks moved this window .
Michael has n't known these pictures that the dentist who has n't noticed the pictures moved .	Michael has n't known what the dentist who has n't noticed the pictures moved these pictures .
those children have seen these girls who the customer who will talk about this bowl has worried .	those children have seen who the customer who will talk about this bowl has worried these girls .
my husband can know the crayons that the boys who fix this plate are talking about .	my husband can know what the boys who fix this plate are talking about the crayons .
your mom would n't know these books that the girls that the boy hears have n't noticed .	your mom would n't know what the girls that the boy hears have n't noticed these books .
those teachers had n't noticed those teachers who the guys who may talk about that shoe worried .	those teachers had n't noticed who the guys who may talk about that shoe worried those teachers .
my friends have n't known the dish that these teachers that the girl talked about think about .	my friends have n't known what these teachers that the girl talked about think about the dish .
these children had n't noticed the shirt that these birds that look like those turtles do n't love .	these children had n't noticed what these birds that look like those turtles do n't love the shirt .
these people have known this driver who the girl who looked like those doctors has visited .	these people have known who the girl who looked like those doctors has visited this driver .
my teachers have n't remembered that hat that that guy that this lady hears would hate .	my teachers have n't remembered what that guy that this lady hears would hate that hat .
the man could forget this picture that this man who looks like that person threw .	the man could forget what this man who looks like that person threw this picture .
Carol had n't remembered the glasses that this child that the guy hears noticed .	Carol had n't remembered what this child that the guy hears noticed the glasses .
those children do n't know that king who this woman who the teacher talked about would n't talk about .	those children do n't know who this woman who the teacher talked about would n't talk about that king .
the man can n't see that customer who the children who this man must sound like taught .	the man can n't see who the children who this man must sound like taught that customer .
the children will see this adult who the customer who talks is n't talking about .	the children will see who the customer who talks is n't talking about this adult .
my doctors may notice these rooms that that dancer who hears these boys was driving to .	my doctors may notice where that dancer who hears these boys was driving to these rooms .
the teachers had noticed the boat that the man that had n't noticed that patient likes .	the teachers had noticed what the man that had n't noticed that patient likes the boat .
your sister had noticed the candle that those cats that run hate .	your sister had noticed what those cats that run hate the candle .
your husband has known the spoons that the girls who this customer will talk about are dropping .	your husband has known what the girls who this customer will talk about are dropping the spoons .
Alice could remember that window that the teacher who had remembered these mice had brought .	Alice could remember what the teacher who had remembered these mice had brought that window .
these doctors have n't remembered the dishes that the lady who is n't laughing talked about .	these doctors have n't remembered what the lady who is n't laughing talked about the dishes .
Daniel should n't notice that restaurant that that girl who runs around those rooms had run around .	Daniel should n't notice where that girl who runs around those rooms had run around that restaurant .
my doctors have n't remembered those boys who these boys who do n't run around the schools talked about .	my doctors have n't remembered who these boys who do n't run around the schools talked about those boys .
the queen does n't notice the room that that woman who would keep the glasses had n't walked through .	the queen does n't notice where that woman who would keep the glasses had n't walked through the room .
the queen would n't remember that girl who these boys who that patient looks like had visited .	the queen would n't remember who these boys who that patient looks like had visited that girl .
your daughter has n't remembered those cups that that horse that the lady looked like has n't noticed .	your daughter has n't remembered what that horse that the lady looked like has n't noticed those cups .
Steven has remembered that driver who those men who may remember this cat talk about .	Steven has remembered who those men who may remember this cat talk about that driver .
this queen has seen that mirror that this king that the dancer sounded like thinks about .	this queen has seen what this king that the dancer sounded like thinks about that mirror .
your doctors had noticed these books that this child who has n't made that book had n't moved .	your doctors had noticed what this child who has n't made that book had n't moved these books .
my grandmother did n't forget that boy who those men who have n't painted worked with .	my grandmother did n't forget who those men who have n't painted worked with that boy .
my doctors have n't noticed the boys who this child who has talked about these crayons knew .	my doctors have n't noticed who this child who has talked about these crayons knew the boys .
the teachers have seen this lady that those guys who hate those bowls look like .	the teachers have seen what those guys who hate those bowls look like this lady .
Daniel might see the door that that girl who had n't walked through that park talked about .	Daniel might see what that girl who had n't walked through that park talked about the door .
the girl had remembered those doctors who the teachers who wo n't know this customer have n't found .	the girl had remembered who the teachers who wo n't know this customer have n't found those doctors .
my cousins wo n't notice these schools that that man who liked the box went to .	my cousins wo n't notice where that man who liked the box went to these schools .
my brother should n't know the glass that this child that thinks about that mouse noticed .	my brother should n't know what this child that thinks about that mouse noticed the glass .
those people have seen those boys who the patient who the girls hear understands .	those people have seen who the patient who the girls hear understands those boys .
this boy has n't remembered that truck that those women who that queen had talked about are n't fixing .	this boy has n't remembered what those women who that queen had talked about are n't fixing that truck .
these doctors had seen those people who this lady who knows the children does n't sound like .	these doctors had seen who this lady who knows the children does n't sound like those people .
the children had n't known those teachers who this boy who has gone to that school could n't answer .	the children had n't known who this boy who has gone to that school could n't answer those teachers .
Janet will forget this dentist who those children who could move that car can talk about .	Janet will forget who those children who could move that car can talk about this dentist .
your son must see this dancer who those teachers who have yelled are n't talking to .	your son must see who those teachers who have yelled are n't talking to this dancer .
this boy had n't noticed the ladies who these children who yelled are n't talking about .	this boy had n't noticed who these children who yelled are n't talking about the ladies .
the children would n't remember this rocket that that doctor who had n't talked about the woman talks about .	the children would n't remember what that doctor who had n't talked about the woman talks about this rocket .
your dad should n't know that hospital that those men who talked about these cars return to .	your dad should n't know where those men who talked about these cars return to that hospital .
Anna wo n't know this woman who the men who knew these birds work with .	Anna wo n't know who the men who knew these birds work with this woman .
the teachers have n't remembered these boys who that patient who laughed had worried .	the teachers have n't remembered who that patient who laughed had worried these boys .
that boy should remember this crayon that the girls who the girls sound like had n't dropped .	that boy should remember what the girls who the girls sound like had n't dropped this crayon .
your dad would n't see these cups that the doctors who practice bring .	your dad would n't see what the doctors who practice bring these cups .
these children would n't remember this bed that the dentist who this king wo n't sound like was n't dropping .	these children would n't remember what the dentist who this king wo n't sound like was n't dropping this bed .
those teachers could remember these candles that those guys who have n't read fixed .	those teachers could remember what those guys who have n't read fixed these candles .
the doctors should forget that bank that that customer who sounded like the customer goes to .	the doctors should forget where that customer who sounded like the customer goes to that bank .
your doctors did n't know those boats that these ladies that those women might know had n't thought about .	your doctors did n't know what these ladies that those women might know had n't thought about those boats .
these people had n't remembered that car that the child that this guy was talking about loved .	these people had n't remembered what the child that this guy was talking about loved that car .
my friends will forget that fork that that queen that is growing liked .	my friends will forget what that queen that is growing liked that fork .
your father can notice the dolls that the dentist that ran remembered .	your father can notice what the dentist that ran remembered the dolls .
my daughter had remembered the men who this boy who could n't shake the glasses talked about .	my daughter had remembered who this boy who could n't shake the glasses talked about the men .
Nancy had remembered these doctors who this dentist who talks about the boys heard .	Nancy had remembered who this dentist who talks about the boys heard these doctors .
that girl should n't know the boats that that girl who is thinking about these trucks talks about .	that girl should n't know what that girl who is thinking about these trucks talks about the boats .
this girl may forget this queen who this child who talked about that teacher can sound like .	this girl may forget who this child who talked about that teacher can sound like this queen .
my grandmother does n't know this car that the doctor who knows this customer does n't drop .	my grandmother does n't know what the doctor who knows this customer does n't drop this car .
Amy has n't seen the car that that guy who did n't hear those women was n't talking about .	Amy has n't seen what that guy who did n't hear those women was n't talking about the car .
these doctors must forget this plane that the children who have won bought .	these doctors must forget what the children who have won bought this plane .
my teachers should notice those hats that that boy who had n't moved the spoon talks about .	my teachers should notice what that boy who had n't moved the spoon talks about those hats .
my teachers might know these ladies who the customer who can n't take that hat must know .	my teachers might know who the customer who can n't take that hat must know these ladies .
your teachers have seen these plates that these boys that saw this bowl had n't noticed .	your teachers have seen what these boys that saw this bowl had n't noticed these plates .
your brother must notice that window that those doctors who wo n't talk about this car fix .	your brother must notice what those doctors who wo n't talk about this car fix that window .
my cousins have noticed those dishes that this dentist who would n't cough is n't cleaning .	my cousins have noticed what this dentist who would n't cough is n't cleaning those dishes .
George had seen the book that those people who like the mouse would n't talk about .	George had seen what those people who like the mouse would n't talk about the book .
my doctors did n't see those plates that this person who was leaving this restaurant had n't thrown .	my doctors did n't see what this person who was leaving this restaurant had n't thrown those plates .
your grandmother has n't noticed the people who these children who have taken the plates have n't talked about .	your grandmother has n't noticed who these children who have taken the plates have n't talked about the people .
these people have n't known the woman who those children who did n't shake the truck worry .	these people have n't known who those children who did n't shake the truck worry the woman .
the doctors will forget the driver who this lady who should notice that dancer talks about .	the doctors will forget who this lady who should notice that dancer talks about the driver .
the doctors should n't know this woman who those guys who are painting heard .	the doctors should n't know who those guys who are painting heard this woman .
my friends should see these candles that the man who was singing is holding .	my friends should see what the man who was singing is holding these candles .
your brother could forget these dolls that those mice that love that candle would n't forget .	your brother could forget what those mice that love that candle would n't forget these dolls .
Brian has known that box that the boys who talk about this bowl threw .	Brian has known what the boys who talk about this bowl threw that box .
those teachers have n't known that rocket that those doctors who have brought these glasses are buying .	those teachers have n't known what those doctors who have brought these glasses are buying that rocket .
your dad did n't know those plates that that man that this man should n't know has n't thought about .	your dad did n't know what that man that this man should n't know has n't thought about those plates .
Eric has n't seen that bottle that these doctors that were learning forget .	Eric has n't seen what these doctors that were learning forget that bottle .
these children do n't know the bottle that those horses that had grown will like .	these children do n't know what those horses that had grown will like the bottle .
this girl has n't seen the king that the person who is whispering did n't sound like .	this girl has n't seen what the person who is whispering did n't sound like the king .
my doctors must notice this queen who this adult who stole the rocket was n't talking to .	my doctors must notice who this adult who stole the rocket was n't talking to this queen .
your doctors have n't seen these crayons that the ladies who have n't remembered that lady are n't shaking .	your doctors have n't seen what the ladies who have n't remembered that lady are n't shaking these crayons .
your cousins can know these chairs that the boys that will forget these plates were n't thinking about .	your cousins can know what the boys that will forget these plates were n't thinking about these chairs .
your teachers could n't notice that rug that the men who this doctor has talked about are moving .	your teachers could n't notice what the men who this doctor has talked about are moving that rug .
your dad had n't remembered these people who that dancer who loves that car has heard .	your dad had n't remembered who that dancer who loves that car has heard these people .
that boy should n't remember that person that the dentist who was dropping that shoe heard .	that boy should n't remember what the dentist who was dropping that shoe heard that person .
Michael can n't remember these bottles that the boy who has n't made the buttons is n't talking about .	Michael can n't remember what the boy who has n't made the buttons is n't talking about these bottles .
those people will forget the ring that the queen that has noticed the doors can think about .	those people will forget what the queen that has noticed the doors can think about the ring .
the lady had known the girls who the guys who thought about this dog had n't helped .	the lady had known who the guys who thought about this dog had n't helped the girls .
Donald will notice these dishes that these boys that have grown forgot .	Donald will notice what these boys that have grown forgot these dishes .
those children can know those windows that these guys that can n't run have n't remembered .	those children can know what these guys that can n't run have n't remembered those windows .
the children would see the plates that that queen who would n't sell those glasses should keep .	the children would see what that queen who would n't sell those glasses should keep the plates .
my friends could n't notice these rings that the cats that have n't run had n't thought about .	my friends could n't notice what the cats that have n't run had n't thought about these rings .
the woman may notice that adult who the dancer who had n't read talked to .	the woman may notice who the dancer who had n't read talked to that adult .
your wife would see that adult who that patient who knows these birds has n't heard .	your wife would see who that patient who knows these birds has n't heard that adult .
the girl should know these cups that this lady who has remembered that horse talks about .	the girl should know what this lady who has remembered that horse talks about these cups .
the lady had noticed these doctors who this adult who that person looks like lost .	the lady had noticed who this adult who that person looks like lost these doctors .
the lady should remember these rings that that child who had found this plane has n't made .	the lady should remember what that child who had found this plane has n't made these rings .
Steve has known the adult who that woman who has thrown that crayon talked about .	Steve has known who that woman who has thrown that crayon talked about the adult .
this boy can n't forget the toy that those mice that are n't learning like .	this boy can n't forget what those mice that are n't learning like the toy .
Steven had remembered the birds that that teacher who could hear the women has heard .	Steven had remembered what that teacher who could hear the women has heard the birds .
my husband has seen that person who this person who could n't have these cars lost .	my husband has seen who this person who could n't have these cars lost that person .
my friends had n't seen this dish that this guy that noticed the trucks remembered .	my friends had n't seen what this guy that noticed the trucks remembered this dish .
Elizabeth could notice this hat that that doctor who wo n't leave that library might drop .	Elizabeth could notice what that doctor who wo n't leave that library might drop this hat .
the people may forget these boxes that these girls that these doctors talked about should n't forget .	the people may forget what these girls that these doctors talked about should n't forget these boxes .
your teachers may know that car that these guys that saw this couch remember .	your teachers may know what these guys that saw this couch remember that car .
my wife has n't noticed the man who the girl who knew these people hears .	my wife has n't noticed who the girl who knew these people hears the man .
these people will know those girls who the teachers who have made those toys sound like .	these people will know who the teachers who have made those toys sound like those girls .
that lady has n't remembered that rabbit that the boy who left this kitchen heard .	that lady has n't remembered what the boy who left this kitchen heard that rabbit .
Noah has n't seen that bottle that that dancer who walks through that museum would sell .	Noah has n't seen what that dancer who walks through that museum would sell that bottle .
my cousins have n't known that driver who the child who can yell knows .	my cousins have n't known who the child who can yell knows that driver .
my brother must notice the queen that this lady who was n't talking about this couch knows .	my brother must notice what this lady who was n't talking about this couch knows the queen .
these children have n't known that spoon that the women who could forget these books were making .	these children have n't known what the women who could forget these books were making that spoon .
James should forget those shoes that that horse that thinks about those buttons liked .	James should forget what that horse that thinks about those buttons liked those shoes .
the man could n't see that man that these men who talk about that spoon would talk about .	the man could n't see what these men who talk about that spoon would talk about that man .
your brother wo n't forget those cars that that man who can think about the glasses shakes .	your brother wo n't forget what that man who can think about the glasses shakes those cars .
the doctors did n't forget those bottles that the child that has n't heard this bird has n't thought about .	the doctors did n't forget what the child that has n't heard this bird has n't thought about those bottles .
your teachers have seen that picture that the cats that would n't remember those toys can n't forget .	your teachers have seen what the cats that would n't remember those toys can n't forget that picture .
your doctors should n't remember these dishes that this adult that these ladies talk about noticed .	your doctors should n't remember what this adult that these ladies talk about noticed these dishes .
this man has n't known those shirts that this customer that that patient talks about does n't love .	this man has n't known what this customer that that patient talks about does n't love those shirts .
Noah has seen that couch that these girls who that dancer had n't talked about could n't find .	Noah has seen what these girls who that dancer had n't talked about could n't find that couch .
my teachers must forget this snake that the doctors who think about the hats would n't sound like .	my teachers must forget what the doctors who think about the hats would n't sound like this snake .
the woman did n't know the adult who these women who had dropped that button lost .	the woman did n't know who these women who had dropped that button lost the adult .
that boy had n't known this kitchen that the woman who ran around the rooms leaves .	that boy had n't known where the woman who ran around the rooms leaves this kitchen .
your son would forget the ladies that the girls who this dentist talks about sound like .	your son would forget what the girls who this dentist talks about sound like the ladies .
my mother has remembered the boy who those boys who loved the windows may visit .	my mother has remembered who those boys who loved the windows may visit the boy .
my friends had n't known that rocket that those women that remember this doctor had thought about .	my friends had n't known what those women that remember this doctor had thought about that rocket .
that man will see these boats that those women who yell have n't talked about .	that man will see what those women who yell have n't talked about these boats .
those teachers would forget these crayons that that customer who sees those pictures talked about .	those teachers would forget what that customer who sees those pictures talked about these crayons .
your friends might remember this bowl that that driver who those doctors talked about talks about .	your friends might remember what that driver who those doctors talked about talks about this bowl .
those people had known that window that the driver who had heard these girls was n't shaking .	those people had known what the driver who had heard these girls was n't shaking that window .
the people have noticed these hats that this girl that may grow had n't seen .	the people have noticed what this girl that may grow had n't seen these hats .
my teachers should n't notice that bird that this patient who talks about the boy had talked about .	my teachers should n't notice what this patient who talks about the boy had talked about that bird .
this queen had noticed this glass that the mice that forgot this child would n't forget .	this queen had noticed what the mice that forgot this child would n't forget this glass .
Patrick has n't remembered those books that that dancer that these teachers were talking about has n't remembered .	Patrick has n't remembered what that dancer that these teachers were talking about has n't remembered those books .
your brother can n't forget the guys that that woman who was n't running around the library looked like .	your brother can n't forget what that woman who was n't running around the library looked like the guys .
Eric might know that doctor who the girl who was n't throwing the crayon has talked about .	Eric might know who the girl who was n't throwing the crayon has talked about that doctor .
my daughter could n't see the people that the adult who was n't thinking about this girl sounds like .	my daughter could n't see what the adult who was n't thinking about this girl sounds like the people .
your friends had n't noticed the spoon that those boys who must hate the plate did n't move .	your friends had n't noticed what those boys who must hate the plate did n't move the spoon .
my son could n't see the bowls that that doctor who forgot the glasses had n't talked about .	my son could n't see what that doctor who forgot the glasses had n't talked about the bowls .
my son had remembered those men who those doctors who look like these ladies looked like .	my son had remembered who those doctors who look like these ladies looked like those men .
this queen would see this lady who the boy who thinks about that rug could n't understand .	this queen would see who the boy who thinks about that rug could n't understand this lady .
the people might know this ship that those snakes that wo n't remember the dog are thinking about .	the people might know what those snakes that wo n't remember the dog are thinking about this ship .
your father has noticed that king that those girls who can n't hear this girl talked about .	your father has noticed what those girls who can n't hear this girl talked about that king .
my dad had n't seen the crayon that this person that has n't thought about those cups should like .	my dad had n't seen what this person that has n't thought about those cups should like the crayon .
my grandmother could see the rocket that this guy that this driver talked about loved .	my grandmother could see what this guy that this driver talked about loved the rocket .
that girl could n't remember the windows that that guy who has n't bought this fork took .	that girl could n't remember what that guy who has n't bought this fork took the windows .
my teachers would n't notice those dogs that these children who were n't yelling are talking about .	my teachers would n't notice what these children who were n't yelling are talking about those dogs .
these doctors might see the museum that this customer who the adult knew passed .	these doctors might see where this customer who the adult knew passed the museum .
the teachers had n't remembered these pictures that the rabbits that can n't eat saw .	the teachers had n't remembered what the rabbits that can n't eat saw these pictures .
those teachers wo n't notice the dancer who those men who must notice those men know .	those teachers wo n't notice who those men who must notice those men know the dancer .
these doctors would n't notice that cup that those rabbits that were running should n't remember .	these doctors would n't notice what those rabbits that were running should n't remember that cup .
my dad may see those forks that that mouse that has remembered the hats forgot .	my dad may see what that mouse that has remembered the hats forgot those forks .
my cousins had n't known these girls who the person who forgot the forks is helping .	my cousins had n't known who the person who forgot the forks is helping these girls .
your father has noticed that woman who these people who return to that mall knew .	your father has noticed who these people who return to that mall knew that woman .
these teachers could remember this mirror that these mice that learn liked .	these teachers could remember what these mice that learn liked this mirror .
your teachers had n't remembered the rings that these dogs that this person will hear must love .	your teachers had n't remembered what these dogs that this person will hear must love the rings .
Linda has remembered that guy who those girls who sounded like this king could talk about .	Linda has remembered who those girls who sounded like this king could talk about that guy .
those people had n't known that hat that the men that have heard the horse hate .	those people had n't known what the men that have heard the horse hate that hat .
Sarah should forget these bowls that the lady who may think about those horses will lose .	Sarah should forget what the lady who may think about those horses will lose these bowls .
that queen had seen those toys that that rabbit that had n't seen this window may remember .	that queen had seen what that rabbit that had n't seen this window may remember those toys .
Scott has n't known those rings that these children that this driver had n't talked about did n't see .	Scott has n't known what these children that this driver had n't talked about did n't see those rings .
your doctors had n't remembered this candle that the men who talk about this plate had .	your doctors had n't remembered what the men who talk about this plate had this candle .
the king might know that adult who the doctors who won hear .	the king might know who the doctors who won hear that adult .
the woman had remembered these trucks that these teachers who that customer hears move .	the woman had remembered what these teachers who that customer hears move these trucks .
your doctors might know that adult who that queen who must hate the plane has n't helped .	your doctors might know who that queen who must hate the plane has n't helped that adult .
this guy did n't remember the men who this patient who threw the book has heard .	this guy did n't remember who this patient who threw the book has heard the men .
my teachers may know this ship that the guys that remember this book had n't seen .	my teachers may know what the guys that remember this book had n't seen this ship .
Nicole could n't remember the bowl that those snakes that wo n't notice the child are thinking about .	Nicole could n't remember what those snakes that wo n't notice the child are thinking about the bowl .
your husband can n't remember that glass that these ladies who were n't going to that school talk about .	your husband can n't remember what these ladies who were n't going to that school talk about that glass .
Jason has noticed the girls who that driver who that guy was n't talking about has n't heard .	Jason has noticed who that driver who that guy was n't talking about has n't heard the girls .
Laurie has n't remembered those books that those boys who talk about this lady had n't talked about .	Laurie has n't remembered what those boys who talk about this lady had n't talked about those books .
Dan wo n't see these buttons that these men who can n't think about that dog bring .	Dan wo n't see what these men who can n't think about that dog bring these buttons .
my teachers would notice the doctor who that person who does n't love the turtles knew .	my teachers would notice who that person who does n't love the turtles knew the doctor .
this woman will remember this plate that those doctors who go to that park had talked about .	this woman will remember what those doctors who go to that park had talked about this plate .
Jennifer did n't notice this book that the customer that has noticed that woman had n't seen .	Jennifer did n't notice what the customer that has noticed that woman had n't seen this book .
my doctors may remember this truck that the guy who these doctors might look like talks about .	my doctors may remember what the guy who these doctors might look like talks about this truck .
my teachers could n't forget that girl that that queen who may talk about this doctor wo n't know .	my teachers could n't forget what that queen who may talk about this doctor wo n't know that girl .
the king must know the books that those guys who the lady may hear could n't sell .	the king must know what those guys who the lady may hear could n't sell the books .
your cousins will know those horses that that adult who likes that bird sounds like .	your cousins will know what that adult who likes that bird sounds like those horses .
my friends do n't know these boxes that those people that this child has n't heard notice .	my friends do n't know what those people that this child has n't heard notice these boxes .
your husband should remember these toys that this doctor who had n't thrown that picture is n't fixing .	your husband should remember what this doctor who had n't thrown that picture is n't fixing these toys .
those people would n't forget the boy who these men who that man sounded like sounded like .	those people would n't forget who these men who that man sounded like sounded like the boy .
Dan had n't remembered the teacher who these people who looked like that cat bother .	Dan had n't remembered who these people who looked like that cat bother the teacher .
this queen can notice the toy that that man who could n't talk about those women talks about .	this queen can notice what that man who could n't talk about those women talks about the toy .
my teachers might notice this man who that patient who has n't talked about the couch helped .	my teachers might notice who that patient who has n't talked about the couch helped this man .
those people must forget this person who those doctors who like these dolls helped .	those people must forget who those doctors who like these dolls helped this person .
my friends had seen that hat that these men who have noticed those boys wo n't drop .	my friends had seen what these men who have noticed those boys wo n't drop that hat .
the children have seen that ring that the dancer that would know this mouse likes .	the children have seen what the dancer that would know this mouse likes that ring .
these people will see the dentist who the patient who was n't practicing talked about .	these people will see who the patient who was n't practicing talked about the dentist .
my cousins had noticed the shirt that the boy that ate had n't seen .	my cousins had noticed what the boy that ate had n't seen the shirt .
these doctors have known those shirts that these boys that are thinking about that button had n't seen .	these doctors have known what these boys that are thinking about that button had n't seen those shirts .
your sister can n't know the horse that this lady who sounds like the rabbit talked about .	your sister can n't know what this lady who sounds like the rabbit talked about the horse .
my husband had known the boat that the people that those men sounded like loved .	my husband had known what the people that those men sounded like loved the boat .
your son has seen these plates that this king who walks through the kitchen made .	your son has seen what this king who walks through the kitchen made these plates .
those doctors had remembered the dish that those boys who were moving that bottle moved .	those doctors had remembered what those boys who were moving that bottle moved the dish .
your teachers might remember those teachers who those boys who talk about these forks worry .	your teachers might remember who those boys who talk about these forks worry those teachers .
the doctors had n't noticed the dolls that those men who have passed the schools hold .	the doctors had n't noticed what those men who have passed the schools hold the dolls .
these children did n't notice the child who this queen who could paint understands .	these children did n't notice who this queen who could paint understands the child .
that boy can know those rabbits that these guys who might exercise talked about .	that boy can know what these guys who might exercise talked about those rabbits .
Judy might remember the girl who this dentist who had won heard .	Judy might remember who this dentist who had won heard the girl .
Amelia may notice the schools that this driver who has fixed the dishes leaves .	Amelia may notice where this driver who has fixed the dishes leaves the schools .
your doctors had noticed the rooms that these guys who the girls know had n't passed .	your doctors had noticed where these guys who the girls know had n't passed the rooms .
my doctors wo n't forget those books that those people that would n't run should n't notice .	my doctors wo n't forget what those people that would n't run should n't notice those books .
John can remember this patient who that customer who should sound like that man looks like .	John can remember who that customer who should sound like that man looks like this patient .
my cousins can know the door that the horses that had n't run had n't remembered .	my cousins can know what the horses that had n't run had n't remembered the door .
the people had noticed the hats that those birds that see the bicycle remember .	the people had noticed what those birds that see the bicycle remember the hats .
your teachers can n't forget that queen who this person who could think about this person has n't heard .	your teachers can n't forget who this person who could think about this person has n't heard that queen .
those doctors have n't noticed these cars that the mice that those men must look like loved .	those doctors have n't noticed what the mice that those men must look like loved these cars .
my doctors have n't remembered this hospital that the boys who saw the car walk through .	my doctors have n't remembered where the boys who saw the car walk through this hospital .
the people had remembered the car that that girl who that boy talked about wo n't hold .	the people had remembered what that girl who that boy talked about wo n't hold the car .
those teachers could n't forget the bank that those boys who these women have n't talked about wo n't return to .	those teachers could n't forget where those boys who these women have n't talked about wo n't return to the bank .
your son may see the dishes that this guy that eats can n't love .	your son may see what this guy that eats can n't love the dishes .
my husband has seen those boys who this man who the woman should n't talk about looks like .	my husband has seen who this man who the woman should n't talk about looks like those boys .
that girl has n't known the girl who this person who was n't running around the kitchen is n't bothering .	that girl has n't known who this person who was n't running around the kitchen is n't bothering the girl .
my son will see this toy that this patient who wo n't sound like the girls has n't made .	my son will see what this patient who wo n't sound like the girls has n't made this toy .
my wife had noticed those dolls that the doctors that had n't learned are thinking about .	my wife had noticed what the doctors that had n't learned are thinking about those dolls .
your cousins will know the car that the driver who paints has n't talked about .	your cousins will know what the driver who paints has n't talked about the car .
Mark had noticed that hospital that the teachers who walk through these schools go to .	Mark had noticed where the teachers who walk through these schools go to that hospital .
the girl should n't notice those boxes that those children who will walk through this school have talked about .	the girl should n't notice what those children who will walk through this school have talked about those boxes .
the king has known those glasses that that dancer that remembered this shirt has n't seen .	the king has known what that dancer that remembered this shirt has n't seen those glasses .
the lady does n't remember the dancer who the boys who walked through the park help .	the lady does n't remember who the boys who walked through the park help the dancer .
my father can see that plane that the king who the child looks like can n't talk about .	my father can see what the king who the child looks like can n't talk about that plane .
the doctors have n't noticed the patient who this doctor who has talked about the dolls lost .	the doctors have n't noticed who this doctor who has talked about the dolls lost the patient .
the boy must forget this bicycle that that queen who left that kitchen did n't hold .	the boy must forget what that queen who left that kitchen did n't hold this bicycle .
those doctors have n't noticed this queen who the patient who should sound like the man has n't worked with .	those doctors have n't noticed who the patient who should sound like the man has n't worked with this queen .
my dad has n't noticed this glass that this child who was holding those chairs has talked about .	my dad has n't noticed what this child who was holding those chairs has talked about this glass .
your friends can n't remember the teacher who this doctor who may read looked like .	your friends can n't remember who this doctor who may read looked like the teacher .
my teachers had remembered these books that the king that can think about the dancer had remembered .	my teachers had remembered what the king that can think about the dancer had remembered these books .
the children had noticed that child who the woman who could lie might talk about .	the children had noticed who the woman who could lie might talk about that child .
that girl had known those beds that this woman who passed that library had n't talked about .	that girl had known what this woman who passed that library had n't talked about those beds .
your teachers have known that customer that these men who might fix that plate talk about .	your teachers have known what these men who might fix that plate talk about that customer .
your cousins had n't remembered these trucks that the snake that has n't learned had noticed .	your cousins had n't remembered what the snake that has n't learned had noticed these trucks .
that queen has n't known this chair that that customer that ran saw .	that queen has n't known what that customer that ran saw this chair .
those children have remembered the patient who the woman who dropped those bags must visit .	those children have remembered who the woman who dropped those bags must visit the patient .
the man had n't noticed the school that the ladies who this guy could n't know were running around .	the man had n't noticed where the ladies who this guy could n't know were running around the school .
your friends may notice that plate that that driver that grows remembered .	your friends may notice what that driver that grows remembered that plate .
this girl had n't noticed this teacher that this lady who has brought that dish should n't know .	this girl had n't noticed what this lady who has brought that dish should n't know this teacher .
your doctors had noticed that book that that person who should n't think about this shoe talked about .	your doctors had noticed what that person who should n't think about this shoe talked about that book .
Joseph had n't known the bottle that those men who would n't talk about these shirts should shake .	Joseph had n't known what those men who would n't talk about these shirts should shake the bottle .
those teachers have known the customer who that man who was thinking about that woman scares .	those teachers have known who that man who was thinking about that woman scares the customer .
those children would forget that school that this queen who would fix these bags runs around .	those children would forget where this queen who would fix these bags runs around that school .
my mom had seen those cars that those people that are n't running notice .	my mom had seen what those people that are n't running notice those cars .
these children might remember these cups that the driver that liked this bicycle forgot .	these children might remember what the driver that liked this bicycle forgot these cups .
the woman had seen this person who this guy who will sound like the cat should talk about .	the woman had seen who this guy who will sound like the cat should talk about this person .
your grandmother had known this hat that the men that have n't grown will remember .	your grandmother had known what the men that have n't grown will remember this hat .
your friends had seen the adult who those people who would n't hold this plane were n't helping .	your friends had seen who those people who would n't hold this plane were n't helping the adult .
your doctors had seen the ring that this horse that the men might look like was n't thinking about .	your doctors had seen what this horse that the men might look like was n't thinking about the ring .
the man could see the doctor who this dancer who sounds like those rabbits had heard .	the man could see who this dancer who sounds like those rabbits had heard the doctor .
these people can n't see this shirt that the birds that can remember those chairs would notice .	these people can n't see what the birds that can remember those chairs would notice this shirt .
your daughter will know these trucks that this customer who did n't fix this toy could shake .	your daughter will know what this customer who did n't fix this toy could shake these trucks .
David might forget this king who the man who will shake the plane has heard .	David might forget who the man who will shake the plane has heard this king .
the man had n't seen that dentist who the king who left this park has confused .	the man had n't seen who the king who left this park has confused that dentist .
my doctors had seen the hamster that these teachers who that doctor can n't know will know .	my doctors had seen what these teachers who that doctor can n't know will know the hamster .
the children might remember those boats that these people that this patient should hear forgot .	the children might remember what these people that this patient should hear forgot those boats .
Anne will remember these cars that this driver that may sound like these cats would love .	Anne will remember what this driver that may sound like these cats would love these cars .
the lady has seen this door that the woman who brings that hat makes .	the lady has seen what the woman who brings that hat makes this door .
my doctors can see the ladies who that woman who was n't fixing this bottle did n't work with .	my doctors can see who that woman who was n't fixing this bottle did n't work with the ladies .
my teachers should n't know these bottles that these children who had n't waved wo n't throw .	my teachers should n't know what these children who had n't waved wo n't throw these bottles .
the king had remembered the windows that the dentist who has cried had talked about .	the king had remembered what the dentist who has cried had talked about the windows .
the girl can see that toy that the birds that might hear those men could n't remember .	the girl can see what the birds that might hear those men could n't remember that toy .
Becky has seen this horse that that woman who the dancer looked like sounds like .	Becky has seen what that woman who the dancer looked like sounds like this horse .
the doctors have n't known these birds that the guys who sounded like that lady had talked about .	the doctors have n't known what the guys who sounded like that lady had talked about these birds .
Catherine would n't see those chairs that this child who that doctor talked about talked about .	Catherine would n't see what this child who that doctor talked about talked about those chairs .
your doctors should n't know these rooms that that guy who might talk about these rings runs around .	your doctors should n't know where that guy who might talk about these rings runs around these rooms .
my cousins will notice that bowl that that driver that sounded like the doctor should n't like .	my cousins will notice what that driver that sounded like the doctor should n't like that bowl .
those doctors can n't see that crayon that this child that those ladies did n't look like sees .	those doctors can n't see what this child that those ladies did n't look like sees that crayon .
those teachers had n't noticed the spoons that those men that eat could hate .	those teachers had n't noticed what those men that eat could hate the spoons .
Nicole can n't remember this fork that the children that have seen that shoe can n't forget .	Nicole can n't remember what the children that have seen that shoe can n't forget this fork .
the teachers should n't know the cup that that boy who left this restaurant may move .	the teachers should n't know what that boy who left this restaurant may move the cup .
my brother can know this mirror that that rabbit that sounds like the men had thought about .	my brother can know what that rabbit that sounds like the men had thought about this mirror .
the king wo n't see those toys that this bird that loves those crayons had thought about .	the king wo n't see what this bird that loves those crayons had thought about those toys .
my mother may notice the dolls that the king that has grown can notice .	my mother may notice what the king that has grown can notice the dolls .
your wife wo n't forget that boy who that boy who knew that patient had talked to .	your wife wo n't forget who that boy who knew that patient had talked to that boy .
the doctors should remember this bag that the lady who was bringing that boat was shaking .	the doctors should remember what the lady who was bringing that boat was shaking this bag .
Carl had n't seen that candle that the driver who can n't walk through that restaurant makes .	Carl had n't seen what the driver who can n't walk through that restaurant makes that candle .
my grandmother could n't forget this bed that this driver who talked about this car may take .	my grandmother could n't forget what this driver who talked about this car may take this bed .
my friends would n't notice the teachers that this driver who forgot the cups knew .	my friends would n't notice what this driver who forgot the cups knew the teachers .
the man had n't remembered that teacher who the dancer who that customer will talk about sounded like .	the man had n't remembered who the dancer who that customer will talk about sounded like that teacher .
your father will see that rug that those ladies who the teacher has talked about have .	your father will see what those ladies who the teacher has talked about have that rug .
these children did n't notice these spoons that these turtles that might love that dog will love .	these children did n't notice what these turtles that might love that dog will love these spoons .
the people could n't see the pictures that that adult who has n't walked through the museum could buy .	the people could n't see what that adult who has n't walked through the museum could buy the pictures .
Steven did n't notice that school that that dancer who must pass this restaurant does n't go to .	Steven did n't notice where that dancer who must pass this restaurant does n't go to that school .
your doctors had n't known the teachers that this guy who makes those boats looks like .	your doctors had n't known what this guy who makes those boats looks like the teachers .
these children have n't seen that bottle that those people who the child sounded like talk about .	these children have n't seen what those people who the child sounded like talk about that bottle .
your mother should n't remember this book that this child who sings had talked about .	your mother should n't remember what this child who sings had talked about this book .
Linda would n't notice the bag that those mice that have remembered that toy had n't noticed .	Linda would n't notice what those mice that have remembered that toy had n't noticed the bag .
these teachers may know the woman who these ladies who look like these girls have n't helped .	these teachers may know who these ladies who look like these girls have n't helped the woman .
my doctors had n't known the candles that this girl who was n't thinking about this ring had n't found .	my doctors had n't known what this girl who was n't thinking about this ring had n't found the candles .
these children would notice the driver who this child who was crying had taught .	these children would notice who this child who was crying had taught the driver .
these teachers must forget the doctors who that child who loved those birds talked about .	these teachers must forget who that child who loved those birds talked about the doctors .
my friends did n't forget those beds that those teachers who do n't make these bags have n't talked about .	my friends did n't forget what those teachers who do n't make these bags have n't talked about those beds .
these teachers had n't seen that bank that the man who has n't walked through the room was walking through .	these teachers had n't seen where the man who has n't walked through the room was walking through that bank .
this lady had remembered the toy that that snake that that driver must sound like should n't love .	this lady had remembered what that snake that that driver must sound like should n't love the toy .
your dad would remember these boys that the queen that had seen this toy had thought about .	your dad would remember what the queen that had seen this toy had thought about these boys .
your sister has seen that woman who that child who is n't painting had n't confused .	your sister has seen who that child who is n't painting had n't confused that woman .
this lady could remember the crayon that that queen who is n't practicing bought .	this lady could remember what that queen who is n't practicing bought the crayon .
those people had n't remembered this guy who this teacher who these people are n't talking about has n't scared .	those people had n't remembered who this teacher who these people are n't talking about has n't scared this guy .
your cousins did n't see that mall that the guy who those girls talked about goes to .	your cousins did n't see where the guy who those girls talked about goes to that mall .
those teachers should notice this chair that these boys who this man looks like talk about .	those teachers should notice what these boys who this man looks like talk about this chair .
your mother could see this school that this driver who could n't smile is leaving .	your mother could see where this driver who could n't smile is leaving this school .
my teachers might forget the lady who the men who cried had n't talked about .	my teachers might forget who the men who cried had n't talked about the lady .
Julia has n't noticed the shirts that this turtle that had n't heard this girl likes .	Julia has n't noticed what this turtle that had n't heard this girl likes the shirts .
my dad has noticed the chairs that that man who had remembered the adult is talking about .	my dad has noticed what that man who had remembered the adult is talking about the chairs .
those teachers will forget the shoes that this boy who talks dropped .	those teachers will forget what this boy who talks dropped the shoes .
my cousins do n't forget that dancer that that person who may pass this room sounded like .	my cousins do n't forget what that person who may pass this room sounded like that dancer .
your doctors must notice that dog that the snake that has run loved .	your doctors must notice what the snake that has run loved that dog .
that guy did n't see these women who this adult who had n't heard the customer has taught .	that guy did n't see who this adult who had n't heard the customer has taught these women .
that woman would know those men who the patient who passed the park knew .	that woman would know who the patient who passed the park knew those men .
the people had seen this mirror that that snake that had n't eaten likes .	the people had seen what that snake that had n't eaten likes this mirror .
the man had noticed these windows that this turtle that hears the bird will like .	the man had noticed what this turtle that hears the bird will like these windows .
Frank should see this bird that the doctors that grow have n't seen .	Frank should see what the doctors that grow have n't seen this bird .
Michelle might forget the spoon that the men who cough lose .	Michelle might forget what the men who cough lose the spoon .
your cousins have remembered these ladies who the girls who cough had heard .	your cousins have remembered who the girls who cough had heard these ladies .
my teachers would remember this customer who this queen who talked about the buttons worked with .	my teachers would remember who this queen who talked about the buttons worked with this customer .
those children had n't remembered the school that that person who heard this guy leaves .	those children had n't remembered where that person who heard this guy leaves the school .
my teachers had n't remembered the dolls that this child that those doctors know loved .	my teachers had n't remembered what this child that those doctors know loved the dolls .
this boy had n't seen those teachers who the child who was taking this hat worried .	this boy had n't seen who the child who was taking this hat worried those teachers .
these people have n't remembered the truck that those boys who talk about that window had n't talked about .	these people have n't remembered what those boys who talk about that window had n't talked about the truck .
Becca does n't notice this patient who this patient who could go to that library talked about .	Becca does n't notice who this patient who could go to that library talked about this patient .
the guy will remember this ship that these cats that knew the teacher like .	the guy will remember what these cats that knew the teacher like this ship .
your friends have n't noticed this truck that the mice that were running were n't thinking about .	your friends have n't noticed what the mice that were running were n't thinking about this truck .
your cousins had n't known that doll that this person who likes those crayons should n't talk about .	your cousins had n't known what this person who likes those crayons should n't talk about that doll .
