that guy might remember that that girl who is running around the schools confused the people .	that guy might remember who that girl who is running around the schools confused the people .
my son wo n't see that the doctor who can n't like that button will hate that doctor .	my son wo n't see who the doctor who can n't like that button will hate that doctor .
these teachers can n't realize that this dentist who fixed those plates must praise these ladies .	these teachers can n't realize who this dentist who fixed those plates must praise these ladies .
Dan should forget that the dancer who loved that bed could praise this patient .	Dan should forget who the dancer who loved that bed could praise this patient .
your father noticed that those girls who can n't know those doctors wo n't like that man .	your father noticed who those girls who can n't know those doctors wo n't like that man .
these children have n't seen that the men who were leaving those rooms should n't scare that boy .	these children have n't seen who the men who were leaving those rooms should n't scare that boy .
the people learned that this man who had seen the bowl had confused those men .	the people learned who this man who had seen the bowl had confused those men .
your doctors know that these people who cried liked this dentist .	your doctors know who these people who cried liked this dentist .
your father learned that that girl who talked about that candle would n't bother those teachers .	your father learned who that girl who talked about that candle would n't bother those teachers .
Catherine learned that the boys who are n't going to that library praise that teacher .	Catherine learned who the boys who are n't going to that library praise that teacher .
the teachers saw that that king who could shake the button will scare the ladies .	the teachers saw who that king who could shake the button will scare the ladies .
those children had learned that these girls who scream scare the dentist .	those children had learned who these girls who scream scare the dentist .
your father forgot that this driver who was n't keeping that box bothered this customer .	your father forgot who this driver who was n't keeping that box bothered this customer .
your doctors should n't forget that the doctor who leaves this school had bothered this boy .	your doctors should n't forget who the doctor who leaves this school had bothered this boy .
my brother has n't remembered that the children who talk praise this lady .	my brother has n't remembered who the children who talk praise this lady .
the people noticed that those ladies who knew this driver scared the driver .	the people noticed who those ladies who knew this driver scared the driver .
your doctors realized that that customer who would n't laugh does n't praise those boys .	your doctors realized who that customer who would n't laugh does n't praise those boys .
my doctors see that that adult who won scares the doctor .	my doctors see who that adult who won scares the doctor .
James saw that this king who the boys would look like will appreciate the guys .	James saw who this king who the boys would look like will appreciate the guys .
the children can realize that the dentist who sounds like those women likes that driver .	the children can realize who the dentist who sounds like those women likes that driver .
Denise may learn that the men who that customer talks about do n't hate this dentist .	Denise may learn who the men who that customer talks about do n't hate this dentist .
Kayla saw that these teachers who have talked about those cars bothered that child .	Kayla saw who these teachers who have talked about those cars bothered that child .
these people know that the king who leaves this school confused that man .	these people know who the king who leaves this school confused that man .
these teachers had seen that that person who had moved those books scared that king .	these teachers had seen who that person who had moved those books scared that king .
those doctors learn that the customer who can whisper wo n't like this boy .	those doctors learn who the customer who can whisper wo n't like this boy .
Vanessa remembered that these guys who do n't hate the button did n't hate these people .	Vanessa remembered who these guys who do n't hate the button did n't hate these people .
your friends learn that the child who is n't finding the beds has n't confused this teacher .	your friends learn who the child who is n't finding the beds has n't confused this teacher .
the king may remember that this dancer who must notice these boats liked those boys .	the king may remember who this dancer who must notice these boats liked those boys .
my cousins have seen that this patient who had n't cleaned the bags bothered that patient .	my cousins have seen who this patient who had n't cleaned the bags bothered that patient .
those people may forget that that dancer who left those rooms might like the king .	those people may forget who that dancer who left those rooms might like the king .
that woman wo n't realize that this child who talks about those rabbits will hate the king .	that woman wo n't realize who this child who talks about those rabbits will hate the king .
your daughter wo n't see that that teacher who would read likes those people .	your daughter wo n't see who that teacher who would read likes those people .
those people did n't realize that the person who those men did n't hear scares these guys .	those people did n't realize who the person who those men did n't hear scares these guys .
my doctors had n't remembered that this dentist who this woman would n't talk about has scared that guy .	my doctors had n't remembered who this dentist who this woman would n't talk about has scared that guy .
my cousins could n't learn that the man who talks about those bottles can n't appreciate this person .	my cousins could n't learn who the man who talks about those bottles can n't appreciate this person .
Michelle may see that those children who went to the museum may hate the king .	Michelle may see who those children who went to the museum may hate the king .
these teachers might notice that that man who cleaned that boat bothered that dentist .	these teachers might notice who that man who cleaned that boat bothered that dentist .
Lisa realized that the ladies who this doctor does n't talk about liked the person .	Lisa realized who the ladies who this doctor does n't talk about liked the person .
the people should forget that those guys who know the children may praise the women .	the people should forget who those guys who know the children may praise the women .
Naomi knows that that teacher who knows that person bothered this woman .	Naomi knows who that teacher who knows that person bothered this woman .
the people have n't noticed that the dentist who reads had bothered the men .	the people have n't noticed who the dentist who reads had bothered the men .
my doctors remembered that that king who forgot that chair bothered this patient .	my doctors remembered who that king who forgot that chair bothered this patient .
those doctors had known that that doctor who hears this girl was bothering the queen .	those doctors had known who that doctor who hears this girl was bothering the queen .
Vanessa remembered that that queen who that teacher sounded like scares those girls .	Vanessa remembered who that queen who that teacher sounded like scares those girls .
the doctors forgot that this driver who was n't yelling can n't appreciate that girl .	the doctors forgot who this driver who was n't yelling can n't appreciate that girl .
my cousins remembered that the woman who ran around this restaurant wo n't like those doctors .	my cousins remembered who the woman who ran around this restaurant wo n't like those doctors .
your father had n't remembered that those teachers who must like the bag confused this guy .	your father had n't remembered who those teachers who must like the bag confused this guy .
my friends learned that that woman who wo n't walk through that mall was n't bothering the women .	my friends learned who that woman who wo n't walk through that mall was n't bothering the women .
Michael has known that these women who are n't talking about those snakes can n't like the girl .	Michael has known who these women who are n't talking about those snakes can n't like the girl .
your doctors could n't know that these girls who are smiling have bothered the women .	your doctors could n't know who these girls who are smiling have bothered the women .
my doctors learned that the boys who the ladies wo n't know confused the men .	my doctors learned who the boys who the ladies wo n't know confused the men .
these doctors saw that these teachers who hate that turtle had liked the men .	these doctors saw who these teachers who hate that turtle had liked the men .
this queen had n't known that those doctors who move that plane liked that girl .	this queen had n't known who those doctors who move that plane liked that girl .
the teachers can n't learn that that woman who lost is n't bothering the teacher .	the teachers can n't learn who that woman who lost is n't bothering the teacher .
Adam wo n't remember that that dancer who threw this boat will bother this person .	Adam wo n't remember who that dancer who threw this boat will bother this person .
your mom had n't remembered that this woman who had n't remembered those cars likes those children .	your mom had n't remembered who this woman who had n't remembered those cars likes those children .
Becky noticed that this dentist who can n't talk about the snake did n't hate these boys .	Becky noticed who this dentist who can n't talk about the snake did n't hate these boys .
my teachers may notice that this girl who wo n't notice this toy likes the customer .	my teachers may notice who this girl who wo n't notice this toy likes the customer .
these doctors realize that those women who run around the mall had scared those children .	these doctors realize who those women who run around the mall had scared those children .
this queen has n't realized that these people who win hate these men .	this queen has n't realized who these people who win hate these men .
my friends have n't known that these children who this person hears might praise that man .	my friends have n't known who these children who this person hears might praise that man .
the doctors forgot that the king who talks about this adult scares those guys .	the doctors forgot who the king who talks about this adult scares those guys .
my teachers would know that the boy who will remember the doors would n't scare the guy .	my teachers would know who the boy who will remember the doors would n't scare the guy .
your doctors may notice that the man who sounded like those people has bothered the lady .	your doctors may notice who the man who sounded like those people has bothered the lady .
Michael had n't noticed that that guy who was talking about that door did n't hate the lady .	Michael had n't noticed who that guy who was talking about that door did n't hate the lady .
your cousins realized that these ladies who were keeping that bag scare those people .	your cousins realized who these ladies who were keeping that bag scare those people .
my friends had n't seen that this lady who had talked about the guy scared this driver .	my friends had n't seen who this lady who had talked about the guy scared this driver .
these teachers did n't learn that this boy who the doctor had n't heard was bothering these men .	these teachers did n't learn who this boy who the doctor had n't heard was bothering these men .
these teachers learned that those ladies who hear the teachers scared these children .	these teachers learned who those ladies who hear the teachers scared these children .
those children have n't noticed that the dentist who has heard those doctors bothered that lady .	those children have n't noticed who the dentist who has heard those doctors bothered that lady .
Joseph noticed that these teachers who could talk about this hamster will like the girls .	Joseph noticed who these teachers who could talk about this hamster will like the girls .
my cousins had n't learned that the customer who that woman had n't talked about scared that woman .	my cousins had n't learned who the customer who that woman had n't talked about scared that woman .
the children should n't see that those boys who talk about those pictures hate the person .	the children should n't see who those boys who talk about those pictures hate the person .
my friends may learn that those men who could fix that bowl wo n't appreciate the dentist .	my friends may learn who those men who could fix that bowl wo n't appreciate the dentist .
Michelle saw that this patient who those girls talked about liked that man .	Michelle saw who this patient who those girls talked about liked that man .
your mother knew that this lady who kept that crayon had bothered that lady .	your mother knew who this lady who kept that crayon had bothered that lady .
my doctors noticed that those men who lift the mirror scare the children .	my doctors noticed who those men who lift the mirror scare the children .
Paul forgot that the people who are n't cleaning the plates scare the doctor .	Paul forgot who the people who are n't cleaning the plates scare the doctor .
your doctors could n't realize that that person who has thrown that candle can n't bother these women .	your doctors could n't realize who that person who has thrown that candle can n't bother these women .
the king noticed that the people who have dropped that picture like the guys .	the king noticed who the people who have dropped that picture like the guys .
your teachers learn that those guys who are n't making that crayon are n't bothering the girl .	your teachers learn who those guys who are n't making that crayon are n't bothering the girl .
your teachers saw that the patient who can know those rabbits had confused the teacher .	your teachers saw who the patient who can know those rabbits had confused the teacher .
this boy realized that these children who like the horse are bothering this guy .	this boy realized who these children who like the horse are bothering this guy .
Nancy has n't learned that those people who were n't smiling appreciate this teacher .	Nancy has n't learned who those people who were n't smiling appreciate this teacher .
George has realized that that doctor who this woman knows had scared the lady .	George has realized who that doctor who this woman knows had scared the lady .
my teachers see that those ladies who were n't thinking about that patient have n't liked the dentist .	my teachers see who those ladies who were n't thinking about that patient have n't liked the dentist .
my mother should notice that this driver who the children knew bothered the boy .	my mother should notice who this driver who the children knew bothered the boy .
your friends forgot that the men who can go to those schools bothered that woman .	your friends forgot who the men who can go to those schools bothered that woman .
the children could know that those children who that person must talk about are bothering those people .	the children could know who those children who that person must talk about are bothering those people .
your teachers had n't remembered that that patient who can n't talk about the girl confused this child .	your teachers had n't remembered who that patient who can n't talk about the girl confused this child .
the king knows that the guys who have dropped this mirror confused the ladies .	the king knows who the guys who have dropped this mirror confused the ladies .
Erin saw that the patient who sees these books scares this teacher .	Erin saw who the patient who sees these books scares this teacher .
that guy had realized that those boys who wo n't lose that button had scared the man .	that guy had realized who those boys who wo n't lose that button had scared the man .
my teachers saw that those ladies who wo n't pass those schools are n't bothering these girls .	my teachers saw who those ladies who wo n't pass those schools are n't bothering these girls .
my sister wo n't know that this man who throws this plane could hate that girl .	my sister wo n't know who this man who throws this plane could hate that girl .
these people remembered that this boy who talks about those books does n't praise those guys .	these people remembered who this boy who talks about those books does n't praise those guys .
my son noticed that the guys who were n't smiling have n't bothered the dentist .	my son noticed who the guys who were n't smiling have n't bothered the dentist .
these doctors realize that that child who the person has talked about is n't bothering the guy .	these doctors realize who that child who the person has talked about is n't bothering the guy .
your doctors had n't seen that those people who had n't thought about that bowl will bother that girl .	your doctors had n't seen who those people who had n't thought about that bowl will bother that girl .
these doctors have realized that the person who thinks about these hats does n't praise this lady .	these doctors have realized who the person who thinks about these hats does n't praise this lady .
your cousins might notice that this adult who this boy does n't sound like confused the dentist .	your cousins might notice who this adult who this boy does n't sound like confused the dentist .
Ronald may learn that those women who remember the mice hate that adult .	Ronald may learn who those women who remember the mice hate that adult .
the lady had learned that this lady who was n't whispering did n't appreciate the guy .	the lady had learned who this lady who was n't whispering did n't appreciate the guy .
Guy could n't see that the queen who these girls hear will praise the child .	Guy could n't see who the queen who these girls hear will praise the child .
the people have learned that the boy who should hold those cars will like the man .	the people have learned who the boy who should hold those cars will like the man .
my cousins remembered that that dentist who will sound like this cat can like this doctor .	my cousins remembered who that dentist who will sound like this cat can like this doctor .
Daniel knows that these men who go to the schools would like this person .	Daniel knows who these men who go to the schools would like this person .
the doctors remembered that these people who were talking about the boats would n't scare that man .	the doctors remembered who these people who were talking about the boats would n't scare that man .
Travis has n't noticed that this girl who found these cars liked these girls .	Travis has n't noticed who this girl who found these cars liked these girls .
the lady noticed that these women who talked about those women have n't liked the woman .	the lady noticed who these women who talked about those women have n't liked the woman .
your cousins noticed that the patient who had n't noticed the snake can n't scare this dancer .	your cousins noticed who the patient who had n't noticed the snake can n't scare this dancer .
your doctors knew that that boy who that boy sounds like scared the people .	your doctors knew who that boy who that boy sounds like scared the people .
these doctors notice that these girls who lost did n't praise this guy .	these doctors notice who these girls who lost did n't praise this guy .
your doctors notice that those people who hold this window may like the teacher .	your doctors notice who those people who hold this window may like the teacher .
my grandmother knows that the guy who hears this patient wo n't hate this guy .	my grandmother knows who the guy who hears this patient wo n't hate this guy .
this queen must remember that those doctors who could n't leave those rooms could n't praise those ladies .	this queen must remember who those doctors who could n't leave those rooms could n't praise those ladies .
your cousins noticed that this child who thinks about this queen is bothering that driver .	your cousins noticed who this child who thinks about this queen is bothering that driver .
your teachers remembered that that adult who won does n't praise this woman .	your teachers remembered who that adult who won does n't praise this woman .
the woman might remember that the people who are running around those rooms can n't bother these guys .	the woman might remember who the people who are running around those rooms can n't bother these guys .
the doctors forget that those women who have n't fixed the cars can n't hate the children .	the doctors forget who those women who have n't fixed the cars can n't hate the children .
my doctors forgot that this dentist who those women were talking about should like the women .	my doctors forgot who this dentist who those women were talking about should like the women .
the doctors noticed that these women who have n't run around the school had n't liked this doctor .	the doctors noticed who these women who have n't run around the school had n't liked this doctor .
my doctors knew that the boys who did n't talk about the dogs have bothered this child .	my doctors knew who the boys who did n't talk about the dogs have bothered this child .
those children had learned that those people who had thought about this book could n't appreciate that child .	those children had learned who those people who had thought about this book could n't appreciate that child .
those doctors had n't known that the men who bring this book had confused that person .	those doctors had n't known who the men who bring this book had confused that person .
the children had realized that this girl who is lying had confused the woman .	the children had realized who this girl who is lying had confused the woman .
the king can learn that these children who yell do n't praise those guys .	the king can learn who these children who yell do n't praise those guys .
your teachers realized that those women who see this ring appreciate the woman .	your teachers realized who those women who see this ring appreciate the woman .
the children know that these ladies who this king has heard hate these guys .	the children know who these ladies who this king has heard hate these guys .
my teachers have learned that that driver who would n't drive to the museum would praise that person .	my teachers have learned who that driver who would n't drive to the museum would praise that person .
your mother does n't see that this lady who this king sounded like bothered the teacher .	your mother does n't see who this lady who this king sounded like bothered the teacher .
my teachers know that this doctor who was fixing the candles would bother this dancer .	my teachers know who this doctor who was fixing the candles would bother this dancer .
my husband does n't forget that this teacher who runs around the schools scared these people .	my husband does n't forget who this teacher who runs around the schools scared these people .
Susan might know that the king who had thrown this book would like the teachers .	Susan might know who the king who had thrown this book would like the teachers .
the teachers noticed that this dentist who talks about the windows did n't scare these people .	the teachers noticed who this dentist who talks about the windows did n't scare these people .
Jessica could see that that child who saw that child had n't bothered the lady .	Jessica could see who that child who saw that child had n't bothered the lady .
my son forgot that that person who was n't yelling had liked this lady .	my son forgot who that person who was n't yelling had liked this lady .
these children see that this teacher who would lift those dolls had scared these teachers .	these children see who this teacher who would lift those dolls had scared these teachers .
this woman sees that the patient who remembered these doctors had n't bothered the children .	this woman sees who the patient who remembered these doctors had n't bothered the children .
my doctors saw that the king who this king talks about could bother the teachers .	my doctors saw who the king who this king talks about could bother the teachers .
the people knew that this dentist who has heard that hamster might like those guys .	the people knew who this dentist who has heard that hamster might like those guys .
those children see that the lady who knows this driver is bothering that woman .	those children see who the lady who knows this driver is bothering that woman .
this lady realized that the teachers who liked this snake can n't appreciate the teachers .	this lady realized who the teachers who liked this snake can n't appreciate the teachers .
my friends can know that the adult who makes the dolls would hate the customer .	my friends can know who the adult who makes the dolls would hate the customer .
those children realized that this patient who had seen these books has n't scared that person .	those children realized who this patient who had seen these books has n't scared that person .
your husband should n't notice that this guy who could practice was n't bothering the ladies .	your husband should n't notice who this guy who could practice was n't bothering the ladies .
my teachers forgot that the guys who knew the horse will praise the woman .	my teachers forgot who the guys who knew the horse will praise the woman .
your friends wo n't remember that the ladies who could move that couch had n't bothered that adult .	your friends wo n't remember who the ladies who could move that couch had n't bothered that adult .
my friends may forget that this patient who had seen the snake has liked the patient .	my friends may forget who this patient who had seen the snake has liked the patient .
your cousins know that that guy who the children will talk about might scare these boys .	your cousins know who that guy who the children will talk about might scare these boys .
Jessica wo n't forget that that adult who is n't lying was n't bothering the man .	Jessica wo n't forget who that adult who is n't lying was n't bothering the man .
my doctors can know that the lady who knew that boy liked those ladies .	my doctors can know who the lady who knew that boy liked those ladies .
those teachers noticed that these boys who move those dishes would hate these people .	those teachers noticed who these boys who move those dishes would hate these people .
the boy would n't remember that the person who has kept the book might scare that queen .	the boy would n't remember who the person who has kept the book might scare that queen .
those teachers forget that these children who ran around this restaurant bother this lady .	those teachers forget who these children who ran around this restaurant bother this lady .
my son saw that that doctor who must return to the schools likes that dancer .	my son saw who that doctor who must return to the schools likes that dancer .
that queen may remember that the men who do n't think about the cat will appreciate these men .	that queen may remember who the men who do n't think about the cat will appreciate these men .
this girl knew that these men who could talk about the hamster bothered this teacher .	this girl knew who these men who could talk about the hamster bothered this teacher .
Steve realized that those ladies who this customer is talking about praise this guy .	Steve realized who those ladies who this customer is talking about praise this guy .
Michelle saw that these people who knew the dogs would n't scare the dentist .	Michelle saw who these people who knew the dogs would n't scare the dentist .
that lady has n't remembered that these people who are talking had confused those women .	that lady has n't remembered who these people who are talking had confused those women .
Julia knew that those men who find these forks praise this dancer .	Julia knew who those men who find these forks praise this dancer .
the doctors learn that that doctor who threw those boxes did n't praise those boys .	the doctors learn who that doctor who threw those boxes did n't praise those boys .
your teachers would know that the woman who is n't whispering scares that man .	your teachers would know who the woman who is n't whispering scares that man .
your teachers see that the person who forgot that guy bothered that child .	your teachers see who the person who forgot that guy bothered that child .
these doctors noticed that the dentist who sounds like the guy liked that child .	these doctors noticed who the dentist who sounds like the guy liked that child .
your friends realized that the woman who holds the car can n't bother the girl .	your friends realized who the woman who holds the car can n't bother the girl .
my cousins have seen that the king who this adult knew can n't hate this queen .	my cousins have seen who the king who this adult knew can n't hate this queen .
that king would n't notice that those men who make this plane can n't appreciate this person .	that king would n't notice who those men who make this plane can n't appreciate this person .
the queen sees that these guys who heard these girls have bothered the girl .	the queen sees who these guys who heard these girls have bothered the girl .
Aaron would n't see that the children who lie liked the teacher .	Aaron would n't see who the children who lie liked the teacher .
this king had n't realized that these people who are thinking about that horse have n't bothered the men .	this king had n't realized who these people who are thinking about that horse have n't bothered the men .
your friends realize that that doctor who had n't brought this book had scared that guy .	your friends realize who that doctor who had n't brought this book had scared that guy .
Laura realized that the girls who are n't bringing the fork had n't confused this woman .	Laura realized who the girls who are n't bringing the fork had n't confused this woman .
these teachers forget that those children who had won wo n't bother the men .	these teachers forget who those children who had won wo n't bother the men .
my daughter did n't know that the guys who these men talked about were n't bothering the queen .	my daughter did n't know who the guys who these men talked about were n't bothering the queen .
the children realized that those teachers who are n't thinking about this boat hate the queen .	the children realized who those teachers who are n't thinking about this boat hate the queen .
that queen has known that this doctor who those children sound like was n't bothering that dentist .	that queen has known who this doctor who those children sound like was n't bothering that dentist .
my wife had n't known that these guys who forgot those boys would n't praise that dancer .	my wife had n't known who these guys who forgot those boys would n't praise that dancer .
Christopher could remember that that driver who that queen talked about has bothered these doctors .	Christopher could remember who that driver who that queen talked about has bothered these doctors .
these teachers had noticed that these ladies who the customer would talk about have liked the men .	these teachers had noticed who these ladies who the customer would talk about have liked the men .
your dad remembered that those teachers who sound like those birds liked that patient .	your dad remembered who those teachers who sound like those birds liked that patient .
your friends forgot that the queen who will talk about that woman would scare this doctor .	your friends forgot who the queen who will talk about that woman would scare this doctor .
that woman remembered that the guys who that man hears have n't scared that teacher .	that woman remembered who the guys who that man hears have n't scared that teacher .
your wife remembered that this child who walked through this restaurant can bother that woman .	your wife remembered who this child who walked through this restaurant can bother that woman .
your dad has realized that those boys who hate this person like the person .	your dad has realized who those boys who hate this person like the person .
my doctors can forget that this man who took the bed did n't like this adult .	my doctors can forget who this man who took the bed did n't like this adult .
your cousins knew that this woman who drives to that room has scared that woman .	your cousins knew who this woman who drives to that room has scared that woman .
these children remember that these women who are n't talking appreciate the king .	these children remember who these women who are n't talking appreciate the king .
those doctors can n't notice that those children who see those bottles must scare those girls .	those doctors can n't notice who those children who see those bottles must scare those girls .
my brother had remembered that the child who bought this bicycle wo n't appreciate that woman .	my brother had remembered who the child who bought this bicycle wo n't appreciate that woman .
these children saw that these women who will yell can n't scare those ladies .	these children saw who these women who will yell can n't scare those ladies .
the children forgot that that child who these guys had heard bothered this driver .	the children forgot who that child who these guys had heard bothered this driver .
the children have n't remembered that those women who laughed were bothering that king .	the children have n't remembered who those women who laughed were bothering that king .
the teachers remember that these people who know the rabbit may scare the woman .	the teachers remember who these people who know the rabbit may scare the woman .
your teachers had remembered that these doctors who are n't talking about these rings may bother this adult .	your teachers had remembered who these doctors who are n't talking about these rings may bother this adult .
those teachers forget that those women who had n't laughed scare that dentist .	those teachers forget who those women who had n't laughed scare that dentist .
the people knew that the queen who the people talk about bothered the girl .	the people knew who the queen who the people talk about bothered the girl .
your doctors learn that those ladies who can n't steal that couch were n't bothering this customer .	your doctors learn who those ladies who can n't steal that couch were n't bothering this customer .
your doctors had n't noticed that these boys who hate the chairs do n't like that man .	your doctors had n't noticed who these boys who hate the chairs do n't like that man .
my cousins know that the person who had n't brought these rings liked the women .	my cousins know who the person who had n't brought these rings liked the women .
those doctors learned that that dentist who holds the spoon bothered the customer .	those doctors learned who that dentist who holds the spoon bothered the customer .
these people noticed that that boy who noticed that picture confused this dancer .	these people noticed who that boy who noticed that picture confused this dancer .
the people should see that that doctor who this person was n't talking about wo n't praise these ladies .	the people should see who that doctor who this person was n't talking about wo n't praise these ladies .
the children have realized that those guys who wo n't see that horse had confused this driver .	the children have realized who those guys who wo n't see that horse had confused this driver .
Cindy has n't remembered that the dancer who sounds like the men is bothering those teachers .	Cindy has n't remembered who the dancer who sounds like the men is bothering those teachers .
those teachers had seen that the boys who are n't losing that truck should n't praise this person .	those teachers had seen who the boys who are n't losing that truck should n't praise this person .
this man might know that that boy who paints can n't appreciate those ladies .	this man might know who that boy who paints can n't appreciate those ladies .
the guy realized that this person who this patient has talked about had scared the driver .	the guy realized who this person who this patient has talked about had scared the driver .
Eric has n't known that the girls who talk about the shoes appreciate this king .	Eric has n't known who the girls who talk about the shoes appreciate this king .
Allison must forget that those children who thought about those shirts liked that dentist .	Allison must forget who those children who thought about those shirts liked that dentist .
the girl has n't noticed that these people who have heard the horse should n't scare those ladies .	the girl has n't noticed who these people who have heard the horse should n't scare those ladies .
your doctors can n't see that those people who buy the crayon bothered these guys .	your doctors can n't see who those people who buy the crayon bothered these guys .
my teachers learn that that boy who brings the cars scared the driver .	my teachers learn who that boy who brings the cars scared the driver .
your friends forget that that dentist who waved was n't bothering the boys .	your friends forget who that dentist who waved was n't bothering the boys .
your cousins must know that the lady who the lady must know has confused this lady .	your cousins must know who the lady who the lady must know has confused this lady .
these doctors had n't remembered that these girls who look like these doctors did n't bother this teacher .	these doctors had n't remembered who these girls who look like these doctors did n't bother this teacher .
my doctors saw that that adult who held those cars scares the doctors .	my doctors saw who that adult who held those cars scares the doctors .
your friends must remember that these ladies who had remembered the hats praise that adult .	your friends must remember who these ladies who had remembered the hats praise that adult .
my sister could remember that the women who are fixing that doll bother the men .	my sister could remember who the women who are fixing that doll bother the men .
my cousins had remembered that those boys who hear this dentist liked that child .	my cousins had remembered who those boys who hear this dentist liked that child .
Peter sees that that king who loves the shoe could scare this boy .	Peter sees who that king who loves the shoe could scare this boy .
the doctors should n't learn that these guys who talked about the dolls bothered the king .	the doctors should n't learn who these guys who talked about the dolls bothered the king .
these teachers saw that this man who the children knew is bothering that man .	these teachers saw who this man who the children knew is bothering that man .
this boy can know that that queen who went to this school was bothering these people .	this boy can know who that queen who went to this school was bothering these people .
the lady realized that the dancer who that adult talked about has n't liked the king .	the lady realized who the dancer who that adult talked about has n't liked the king .
the doctors would n't notice that the doctor who waves has liked that child .	the doctors would n't notice who the doctor who waves has liked that child .
these people might realize that those men who were thinking about that boat liked this patient .	these people might realize who those men who were thinking about that boat liked this patient .
your friends learned that that teacher who lost these doors likes those guys .	your friends learned who that teacher who lost these doors likes those guys .
Jill could know that those children who the boys should n't hear confused these men .	Jill could know who those children who the boys should n't hear confused these men .
that boy realized that the men who found these cars might appreciate those ladies .	that boy realized who the men who found these cars might appreciate those ladies .
my friends would remember that this child who leaves this museum is n't bothering those girls .	my friends would remember who this child who leaves this museum is n't bothering those girls .
my cousins have n't learned that those guys who make these bowls wo n't like the boy .	my cousins have n't learned who those guys who make these bowls wo n't like the boy .
those doctors forget that that customer who is dropping this door scares the dentist .	those doctors forget who that customer who is dropping this door scares the dentist .
my teachers realize that the teacher who took that couch has bothered these ladies .	my teachers realize who the teacher who took that couch has bothered these ladies .
this woman realized that the children who must throw that candle can n't praise that doctor .	this woman realized who the children who must throw that candle can n't praise that doctor .
my teachers may see that the guys who were fixing the boats praise these men .	my teachers may see who the guys who were fixing the boats praise these men .
that woman forgot that the children who these girls did n't know bother that king .	that woman forgot who the children who these girls did n't know bother that king .
Sally has learned that the guy who does n't buy this couch is n't bothering that lady .	Sally has learned who the guy who does n't buy this couch is n't bothering that lady .
those people may notice that those guys who can shake the candles hate that driver .	those people may notice who those guys who can shake the candles hate that driver .
my wife knew that this boy who could n't buy the doll scared the woman .	my wife knew who this boy who could n't buy the doll scared the woman .
my son could see that the boy who sounded like those mice could appreciate that adult .	my son could see who the boy who sounded like those mice could appreciate that adult .
these doctors remembered that this dentist who looks like these horses had n't confused that patient .	these doctors remembered who this dentist who looks like these horses had n't confused that patient .
those people have n't realized that those doctors who passed this school should scare that dentist .	those people have n't realized who those doctors who passed this school should scare that dentist .
these children had learned that the patient who is whispering is bothering that person .	these children had learned who the patient who is whispering is bothering that person .
my friends saw that those doctors who had n't remembered these boys could n't scare the doctors .	my friends saw who those doctors who had n't remembered these boys could n't scare the doctors .
your sister can realize that that girl who is n't cleaning that box confused these boys .	your sister can realize who that girl who is n't cleaning that box confused these boys .
my doctors will notice that these ladies who will sell those boats may like that king .	my doctors will notice who these ladies who will sell those boats may like that king .
these doctors must know that the child who had left the schools has n't bothered the guy .	these doctors must know who the child who had left the schools has n't bothered the guy .
your cousins have noticed that the teachers who knew those cats hate this woman .	your cousins have noticed who the teachers who knew those cats hate this woman .
the people have n't learned that the children who think about this glass praise that customer .	the people have n't learned who the children who think about this glass praise that customer .
your cousins notice that the boys who look like the ladies have n't liked the men .	your cousins notice who the boys who look like the ladies have n't liked the men .
your mom has n't seen that the men who the women might talk about appreciate those children .	your mom has n't seen who the men who the women might talk about appreciate those children .
Renee saw that this driver who is leaving that school likes this king .	Renee saw who this driver who is leaving that school likes this king .
my husband had n't noticed that these ladies who will love those cups had liked the men .	my husband had n't noticed who these ladies who will love those cups had liked the men .
the people forget that the lady who looked like this horse has scared the teacher .	the people forget who the lady who looked like this horse has scared the teacher .
those children should n't know that this doctor who shakes those crayons has bothered those teachers .	those children should n't know who this doctor who shakes those crayons has bothered those teachers .
my teachers forget that those children who had n't taken the couch are bothering these teachers .	my teachers forget who those children who had n't taken the couch are bothering these teachers .
Catherine will see that the women who the girls were n't talking about do n't scare this man .	Catherine will see who the women who the girls were n't talking about do n't scare this man .
my friends have n't realized that the girl who looks like the cats bothered the child .	my friends have n't realized who the girl who looks like the cats bothered the child .
this woman knew that those doctors who that queen talks about are n't bothering the men .	this woman knew who those doctors who that queen talks about are n't bothering the men .
your teachers see that that boy who sounds like that patient confused the dancer .	your teachers see who that boy who sounds like that patient confused the dancer .
these teachers had seen that these men who scream are bothering these girls .	these teachers had seen who these men who scream are bothering these girls .
those teachers do n't realize that the ladies who talked about these cups had n't bothered the queen .	those teachers do n't realize who the ladies who talked about these cups had n't bothered the queen .
that girl realized that the dentist who was laughing has n't scared the men .	that girl realized who the dentist who was laughing has n't scared the men .
Lisa wo n't learn that the doctors who those guys hear have confused this guy .	Lisa wo n't learn who the doctors who those guys hear have confused this guy .
my doctors see that those men who will bring that spoon have bothered that person .	my doctors see who those men who will bring that spoon have bothered that person .
the woman forgot that this teacher who had n't thought about this truck liked this lady .	the woman forgot who this teacher who had n't thought about this truck liked this lady .
the boy has n't known that those ladies who should laugh like that customer .	the boy has n't known who those ladies who should laugh like that customer .
your dad has known that this dancer who will hate those books had n't scared that king .	your dad has known who this dancer who will hate those books had n't scared that king .
these teachers must know that the dentist who cried liked this woman .	these teachers must know who the dentist who cried liked this woman .
those doctors forget that this dentist who sounds like those doctors has liked this dentist .	those doctors forget who this dentist who sounds like those doctors has liked this dentist .
my friends would remember that these teachers who talked about the dishes liked these women .	my friends would remember who these teachers who talked about the dishes liked these women .
the doctors did n't learn that these people who would n't hear those birds were n't bothering that man .	the doctors did n't learn who these people who would n't hear those birds were n't bothering that man .
my doctors knew that that person who was n't talking about the rug can n't bother that woman .	my doctors knew who that person who was n't talking about the rug can n't bother that woman .
the teachers realize that that teacher who is cleaning those plates had n't bothered the boy .	the teachers realize who that teacher who is cleaning those plates had n't bothered the boy .
my teachers remember that these teachers who those teachers should n't know hate that man .	my teachers remember who these teachers who those teachers should n't know hate that man .
my teachers learn that this woman who has moved the toy scares the teachers .	my teachers learn who this woman who has moved the toy scares the teachers .
those doctors have n't learned that the people who hate that couch scared the man .	those doctors have n't learned who the people who hate that couch scared the man .
Sarah had seen that the customer who should know the turtles scares the boy .	Sarah had seen who the customer who should know the turtles scares the boy .
those people forget that that woman who has talked about these forks has n't scared those people .	those people forget who that woman who has talked about these forks has n't scared those people .
this girl realized that the boys who the women did n't sound like will appreciate the adult .	this girl realized who the boys who the women did n't sound like will appreciate the adult .
my friends had realized that the queen who had n't heard the cat bothered those guys .	my friends had realized who the queen who had n't heard the cat bothered those guys .
the king learned that this teacher who sounded like those men has bothered the girls .	the king learned who this teacher who sounded like those men has bothered the girls .
the people have learned that the ladies who know that girl were bothering this lady .	the people have learned who the ladies who know that girl were bothering this lady .
these teachers do n't learn that that man who brings these toys has n't confused this child .	these teachers do n't learn who that man who brings these toys has n't confused this child .
those doctors realize that this woman who was n't painting bothered that teacher .	those doctors realize who this woman who was n't painting bothered that teacher .
that queen had n't known that this boy who was n't talking about the dentist liked the child .	that queen had n't known who this boy who was n't talking about the dentist liked the child .
these doctors realized that the teachers who should n't talk about those birds scare these guys .	these doctors realized who the teachers who should n't talk about those birds scare these guys .
the people have n't realized that the guy who read could scare the men .	the people have n't realized who the guy who read could scare the men .
your cousins remembered that these ladies who smile scared that boy .	your cousins remembered who these ladies who smile scared that boy .
your teachers had realized that the boy who that queen could sound like does n't praise the woman .	your teachers had realized who the boy who that queen could sound like does n't praise the woman .
your grandmother can n't remember that these girls who liked those cars have n't liked the ladies .	your grandmother can n't remember who these girls who liked those cars have n't liked the ladies .
my teachers can n't remember that the women who loved that bag had n't scared these men .	my teachers can n't remember who the women who loved that bag had n't scared these men .
these doctors will see that the guys who talked about the box did n't appreciate this dancer .	these doctors will see who the guys who talked about the box did n't appreciate this dancer .
those people should n't see that the women who might talk about the hats like the customer .	those people should n't see who the women who might talk about the hats like the customer .
these children noticed that the ladies who were talking about this boat can n't like that guy .	these children noticed who the ladies who were talking about this boat can n't like that guy .
that queen saw that the people who have waved liked that man .	that queen saw who the people who have waved liked that man .
this boy has n't known that those doctors who this girl must hear should n't praise this driver .	this boy has n't known who those doctors who this girl must hear should n't praise this driver .
this woman realized that this boy who had n't heard these ladies has n't liked that adult .	this woman realized who this boy who had n't heard these ladies has n't liked that adult .
the doctors forgot that those guys who had n't remembered the girl would n't like these teachers .	the doctors forgot who those guys who had n't remembered the girl would n't like these teachers .
Frank knows that that man who had left those schools did n't like this child .	Frank knows who that man who had left those schools did n't like this child .
my mother noticed that that teacher who looked like these people had n't scared those boys .	my mother noticed who that teacher who looked like these people had n't scared those boys .
my cousins could n't know that the dentist who may talk about this customer has bothered the patient .	my cousins could n't know who the dentist who may talk about this customer has bothered the patient .
my teachers had n't realized that that girl who this driver heard can n't scare the person .	my teachers had n't realized who that girl who this driver heard can n't scare the person .
Dan can remember that this driver who left the schools had n't bothered that guy .	Dan can remember who this driver who left the schools had n't bothered that guy .
those children remember that those girls who had n't thought about those forks bother that person .	those children remember who those girls who had n't thought about those forks bother that person .
my teachers remembered that that person who this king talks about had n't scared these women .	my teachers remembered who that person who this king talks about had n't scared these women .
my mom noticed that this patient who is smiling liked the dancer .	my mom noticed who this patient who is smiling liked the dancer .
Brett had n't realized that the children who have n't lost would n't praise the man .	Brett had n't realized who the children who have n't lost would n't praise the man .
my wife can n't notice that the boys who sing do n't praise the dancer .	my wife can n't notice who the boys who sing do n't praise the dancer .
those people forgot that those doctors who do n't think about those people had bothered that patient .	those people forgot who those doctors who do n't think about those people had bothered that patient .
my cousins have realized that the doctor who the lady has n't heard will bother the customer .	my cousins have realized who the doctor who the lady has n't heard will bother the customer .
Christopher has seen that that dentist who might lie had scared those teachers .	Christopher has seen who that dentist who might lie had scared those teachers .
your grandmother has n't noticed that these girls who walk through the room had scared the teachers .	your grandmother has n't noticed who these girls who walk through the room had scared the teachers .
my doctors can n't forget that these doctors who would sneeze hate that patient .	my doctors can n't forget who these doctors who would sneeze hate that patient .
Martin does n't learn that this adult who has thought about this dish does n't praise that guy .	Martin does n't learn who this adult who has thought about this dish does n't praise that guy .
my friends saw that this king who is fixing these dishes wo n't bother those men .	my friends saw who this king who is fixing these dishes wo n't bother those men .
my wife knew that the girls who sneeze praise the woman .	my wife knew who the girls who sneeze praise the woman .
those doctors will realize that these girls who had n't bought the toy have confused that guy .	those doctors will realize who these girls who had n't bought the toy have confused that guy .
your son had n't remembered that these teachers who knew the driver praise those boys .	your son had n't remembered who these teachers who knew the driver praise those boys .
your doctors had realized that the lady who sang was n't bothering the children .	your doctors had realized who the lady who sang was n't bothering the children .
that queen learned that these women who would pass this library appreciate the driver .	that queen learned who these women who would pass this library appreciate the driver .
my teachers realize that these girls who drive to the bank should like this driver .	my teachers realize who these girls who drive to the bank should like this driver .
these children forgot that those doctors who have n't thought about that couch bother these guys .	these children forgot who those doctors who have n't thought about that couch bother these guys .
your cousins remember that that driver who has these dolls can praise those guys .	your cousins remember who that driver who has these dolls can praise those guys .
your doctors learned that this woman who is dropping those dishes was bothering that person .	your doctors learned who this woman who is dropping those dishes was bothering that person .
your doctors have remembered that the children who should forget these shoes could n't bother these people .	your doctors have remembered who the children who should forget these shoes could n't bother these people .
the queen sees that these children who see these teachers liked those teachers .	the queen sees who these children who see these teachers liked those teachers .
Bill knows that the girl who is n't talking about these rings scares the man .	Bill knows who the girl who is n't talking about these rings scares the man .
your husband had n't known that the people who these people had heard must hate the woman .	your husband had n't known who the people who these people had heard must hate the woman .
these people realize that those guys who knew that dentist were n't bothering the ladies .	these people realize who those guys who knew that dentist were n't bothering the ladies .
these children have n't noticed that that boy who sees the lady could n't bother the children .	these children have n't noticed who that boy who sees the lady could n't bother the children .
Daniel had realized that those doctors who do n't know these turtles scare this dentist .	Daniel had realized who those doctors who do n't know these turtles scare this dentist .
your husband should remember that that lady who had n't lost these forks is bothering this customer .	your husband should remember who that lady who had n't lost these forks is bothering this customer .
your cousins learn that these men who notice the couch like this patient .	your cousins learn who these men who notice the couch like this patient .
your cousins had known that the driver who is n't thinking about these girls had confused the dancer .	your cousins had known who the driver who is n't thinking about these girls had confused the dancer .
your friends notice that these men who would n't think about those bowls scared these men .	your friends notice who these men who would n't think about those bowls scared these men .
these teachers would n't remember that those guys who these people would talk about had confused the doctors .	these teachers would n't remember who those guys who these people would talk about had confused the doctors .
my doctors have n't realized that these girls who wo n't notice the couch praise the patient .	my doctors have n't realized who these girls who wo n't notice the couch praise the patient .
the queen noticed that these ladies who had n't cleaned that bowl scared those guys .	the queen noticed who these ladies who had n't cleaned that bowl scared those guys .
my brother sees that this man who sounds like this mouse was n't bothering those men .	my brother sees who this man who sounds like this mouse was n't bothering those men .
my friends remembered that these doctors who will make these books liked this lady .	my friends remembered who these doctors who will make these books liked this lady .
your mother would see that the girl who wo n't shake the cups has n't liked those ladies .	your mother would see who the girl who wo n't shake the cups has n't liked those ladies .
those children should n't notice that these women who that adult knows could n't hate the teachers .	those children should n't notice who these women who that adult knows could n't hate the teachers .
the queen could forget that this king who this dancer knew has bothered those people .	the queen could forget who this king who this dancer knew has bothered those people .
those people noticed that these teachers who have n't yelled can scare that adult .	those people noticed who these teachers who have n't yelled can scare that adult .
these people had n't known that the boys who looked like the children have n't bothered those doctors .	these people had n't known who the boys who looked like the children have n't bothered those doctors .
my daughter might forget that this woman who had n't yelled could n't scare the children .	my daughter might forget who this woman who had n't yelled could n't scare the children .
your cousins knew that those people who pass this museum like these ladies .	your cousins knew who those people who pass this museum like these ladies .
my friends learned that the lady who does n't paint scares the doctor .	my friends learned who the lady who does n't paint scares the doctor .
Frank learned that the people who forgot that couch could like that boy .	Frank learned who the people who forgot that couch could like that boy .
the people wo n't know that this adult who this child was talking about wo n't appreciate those people .	the people wo n't know who this adult who this child was talking about wo n't appreciate those people .
the doctors see that this king who will talk about the people would bother this teacher .	the doctors see who this king who will talk about the people would bother this teacher .
my cousins knew that these boys who did n't hold the plates bother these children .	my cousins knew who these boys who did n't hold the plates bother these children .
the children had n't known that this patient who that child knew bothered that driver .	the children had n't known who this patient who that child knew bothered that driver .
your teachers would n't remember that the teachers who thought about the pictures have n't bothered that dancer .	your teachers would n't remember who the teachers who thought about the pictures have n't bothered that dancer .
your teachers have known that these men who had left that restaurant bothered the girls .	your teachers have known who these men who had left that restaurant bothered the girls .
your friends could forget that this king who is n't thinking about that boy did n't appreciate the driver .	your friends could forget who this king who is n't thinking about that boy did n't appreciate the driver .
the boy sees that that man who would lie confused the doctor .	the boy sees who that man who would lie confused the doctor .
these doctors must learn that those teachers who have n't noticed the dogs could n't scare the men .	these doctors must learn who those teachers who have n't noticed the dogs could n't scare the men .
this woman sees that the boys who forget the guy have n't scared that dentist .	this woman sees who the boys who forget the guy have n't scared that dentist .
those teachers can know that that customer who the man talked about would bother that child .	those teachers can know who that customer who the man talked about would bother that child .
Gregory has n't seen that the doctors who are n't keeping the couch bothered these ladies .	Gregory has n't seen who the doctors who are n't keeping the couch bothered these ladies .
your doctors might notice that the guy who was n't talking about that doll may appreciate those girls .	your doctors might notice who the guy who was n't talking about that doll may appreciate those girls .
those doctors had learned that those men who liked this man scared those boys .	those doctors had learned who those men who liked this man scared those boys .
your friends realized that that woman who wo n't steal those dishes should bother the man .	your friends realized who that woman who wo n't steal those dishes should bother the man .
those doctors realize that those teachers who are cleaning those spoons bother this customer .	those doctors realize who those teachers who are cleaning those spoons bother this customer .
my friends notice that those children who had yelled had n't scared this adult .	my friends notice who those children who had yelled had n't scared this adult .
these teachers realized that the children who threw this truck bothered these men .	these teachers realized who the children who threw this truck bothered these men .
this guy should n't forget that this woman who is lying can n't scare those guys .	this guy should n't forget who this woman who is lying can n't scare those guys .
the teachers learned that the customer who had n't remembered the women has liked those women .	the teachers learned who the customer who had n't remembered the women has liked those women .
these doctors saw that the child who passed that park likes the guys .	these doctors saw who the child who passed that park likes the guys .
those teachers saw that these ladies who waved have scared this doctor .	those teachers saw who these ladies who waved have scared this doctor .
those people forgot that that driver who does n't like these forks scared this man .	those people forgot who that driver who does n't like these forks scared this man .
my doctors forget that the queen who did n't drop the books has n't scared this dancer .	my doctors forget who the queen who did n't drop the books has n't scared this dancer .
the people forgot that the dentist who lost the truck did n't like that dentist .	the people forgot who the dentist who lost the truck did n't like that dentist .
that queen would see that that dentist who can n't buy those boxes would like the ladies .	that queen would see who that dentist who can n't buy those boxes would like the ladies .
these doctors realize that the queen who bought this book must scare these women .	these doctors realize who the queen who bought this book must scare these women .
this king had noticed that this person who looks like these ladies had n't scared that adult .	this king had noticed who this person who looks like these ladies had n't scared that adult .
my doctors had n't known that this man who these ladies can n't talk about scared this dentist .	my doctors had n't known who this man who these ladies can n't talk about scared this dentist .
those doctors realized that this dentist who had talked about those shirts should n't bother those children .	those doctors realized who this dentist who had talked about those shirts should n't bother those children .
these doctors remember that this woman who saw this truck did n't hate the lady .	these doctors remember who this woman who saw this truck did n't hate the lady .
your teachers realize that this lady who must lose wo n't appreciate this king .	your teachers realize who this lady who must lose wo n't appreciate this king .
those children realized that the customer who should take these glasses confused the men .	those children realized who the customer who should take these glasses confused the men .
this boy knows that the person who should n't keep the couch scared this guy .	this boy knows who the person who should n't keep the couch scared this guy .
my teachers had n't noticed that this driver who these teachers sounded like scared this king .	my teachers had n't noticed who this driver who these teachers sounded like scared this king .
those children noticed that these men who had n't thought about the child scare the dancer .	those children noticed who these men who had n't thought about the child scare the dancer .
these people realize that that woman who that dancer knows would n't appreciate the patient .	these people realize who that woman who that dancer knows would n't appreciate the patient .
Renee has remembered that the people who could run around that school bothered the guys .	Renee has remembered who the people who could run around that school bothered the guys .
Paul learned that these guys who like the adult hate these doctors .	Paul learned who these guys who like the adult hate these doctors .
Wendy knew that that customer who did n't lose liked the driver .	Wendy knew who that customer who did n't lose liked the driver .
this lady has remembered that that woman who should leave these schools has liked this person .	this lady has remembered who that woman who should leave these schools has liked this person .
these teachers see that this child who was keeping the book has n't confused the guy .	these teachers see who this child who was keeping the book has n't confused the guy .
Ronald forgot that that adult who knows the turtle can n't hate these men .	Ronald forgot who that adult who knows the turtle can n't hate these men .
those doctors know that this driver who was n't talking bothered that dentist .	those doctors know who this driver who was n't talking bothered that dentist .
my cousins realize that that dentist who loves that hat would bother those men .	my cousins realize who that dentist who loves that hat would bother those men .
Patrick can forget that this woman who might move this doll had scared that dentist .	Patrick can forget who this woman who might move this doll had scared that dentist .
that boy wo n't learn that these ladies who these people knew may appreciate that king .	that boy wo n't learn who these ladies who these people knew may appreciate that king .
those teachers see that the boy who was throwing the door can n't like that customer .	those teachers see who the boy who was throwing the door can n't like that customer .
my teachers remember that those girls who will know these mice bother the lady .	my teachers remember who those girls who will know these mice bother the lady .
your daughter learned that that guy who is n't waving liked the guys .	your daughter learned who that guy who is n't waving liked the guys .
your teachers remembered that these men who held the ship would hate that lady .	your teachers remembered who these men who held the ship would hate that lady .
these doctors know that that child who the women have heard should n't appreciate the doctor .	these doctors know who that child who the women have heard should n't appreciate the doctor .
Becky should see that these boys who were n't losing will praise this queen .	Becky should see who these boys who were n't losing will praise this queen .
my dad sees that that teacher who saw those shirts must praise these children .	my dad sees who that teacher who saw those shirts must praise these children .
my cousins see that the dancer who will hate the forks scared those people .	my cousins see who the dancer who will hate the forks scared those people .
these doctors remember that those ladies who the boy talks about praise this girl .	these doctors remember who those ladies who the boy talks about praise this girl .
your doctors had known that these ladies who remember those bags confused this girl .	your doctors had known who these ladies who remember those bags confused this girl .
my teachers had n't realized that this child who this lady talks about can scare these doctors .	my teachers had n't realized who this child who this lady talks about can scare these doctors .
your dad has remembered that these children who talk about the bags are n't bothering this man .	your dad has remembered who these children who talk about the bags are n't bothering this man .
April saw that those women who can n't sell the book scared these people .	April saw who those women who can n't sell the book scared these people .
your mother has noticed that these guys who talked about these dishes were n't bothering the customer .	your mother has noticed who these guys who talked about these dishes were n't bothering the customer .
your teachers have n't noticed that the dentist who knew this boy does n't appreciate these people .	your teachers have n't noticed who the dentist who knew this boy does n't appreciate these people .
Julie forgot that the teachers who talked are bothering the teacher .	Julie forgot who the teachers who talked are bothering the teacher .
Jerry had remembered that the dentist who would buy this book could hate those children .	Jerry had remembered who the dentist who would buy this book could hate those children .
that lady has n't noticed that these children who cleaned those shoes scare those boys .	that lady has n't noticed who these children who cleaned those shoes scare those boys .
Guy will forget that the child who knew the women was n't bothering that lady .	Guy will forget who the child who knew the women was n't bothering that lady .
Guy realized that this king who had brought those plates is n't bothering those girls .	Guy realized who this king who had brought those plates is n't bothering those girls .
Eric has learned that these children who are losing hate those girls .	Eric has learned who these children who are losing hate those girls .
the people do n't know that the customer who this girl talked about can hate this queen .	the people do n't know who the customer who this girl talked about can hate this queen .
my friends forgot that that girl who was n't throwing these dolls likes that king .	my friends forgot who that girl who was n't throwing these dolls likes that king .
these doctors had n't seen that that child who has n't thought about these shoes does n't like that dancer .	these doctors had n't seen who that child who has n't thought about these shoes does n't like that dancer .
your husband remembered that that queen who has lost could n't scare the children .	your husband remembered who that queen who has lost could n't scare the children .
the people remembered that the people who can n't take that door confused these people .	the people remembered who the people who can n't take that door confused these people .
this woman should see that those girls who the woman sounded like bother the queen .	this woman should see who those girls who the woman sounded like bother the queen .
Naomi had remembered that the dentist who had n't heard that turtle would hate this king .	Naomi had remembered who the dentist who had n't heard that turtle would hate this king .
my doctors remembered that the person who should n't talk about the buttons liked the driver .	my doctors remembered who the person who should n't talk about the buttons liked the driver .
Stephanie did n't forget that the man who the boy can talk about scared the queen .	Stephanie did n't forget who the man who the boy can talk about scared the queen .
my friends see that the guys who smile bother these boys .	my friends see who the guys who smile bother these boys .
the teachers should notice that those people who lost do n't scare this queen .	the teachers should notice who those people who lost do n't scare this queen .
those people forgot that the dancer who has n't passed the kitchen is n't bothering those guys .	those people forgot who the dancer who has n't passed the kitchen is n't bothering those guys .
Eric wo n't learn that the guy who that customer had heard likes the man .	Eric wo n't learn who the guy who that customer had heard likes the man .
the teachers noticed that these men who had that chair praise those children .	the teachers noticed who these men who had that chair praise those children .
Susan may see that that child who this doctor must sound like liked those children .	Susan may see who that child who this doctor must sound like liked those children .
the teachers had n't remembered that this dancer who talks about these trucks had n't confused those people .	the teachers had n't remembered who this dancer who talks about these trucks had n't confused those people .
these people had n't realized that this girl who should n't find these glasses can n't like the lady .	these people had n't realized who this girl who should n't find these glasses can n't like the lady .
the doctors learned that the women who had n't held these forks could n't like the teachers .	the doctors learned who the women who had n't held these forks could n't like the teachers .
this guy realized that the men who that teacher is n't talking about might praise that doctor .	this guy realized who the men who that teacher is n't talking about might praise that doctor .
my daughter had learned that these girls who that girl had heard confused these doctors .	my daughter had learned who these girls who that girl had heard confused these doctors .
Aaron could n't see that that adult who talked about the cars may appreciate the queen .	Aaron could n't see who that adult who talked about the cars may appreciate the queen .
those doctors remembered that this boy who held the truck is n't bothering the customer .	those doctors remembered who this boy who held the truck is n't bothering the customer .
this boy has seen that those men who will look like the king could scare these teachers .	this boy has seen who those men who will look like the king could scare these teachers .
my cousins notice that this teacher who brought that box likes these girls .	my cousins notice who this teacher who brought that box likes these girls .
your cousins see that those teachers who this girl was talking about will bother this teacher .	your cousins see who those teachers who this girl was talking about will bother this teacher .
these teachers would n't remember that the doctor who will look like this hamster confused that queen .	these teachers would n't remember who the doctor who will look like this hamster confused that queen .
these doctors learned that these children who had n't fixed these glasses hate these girls .	these doctors learned who these children who had n't fixed these glasses hate these girls .
the queen could n't notice that this king who must throw these shoes had liked that dentist .	the queen could n't notice who this king who must throw these shoes had liked that dentist .
your cousins do n't know that the queen who had n't made the shirts had n't bothered that woman .	your cousins do n't know who the queen who had n't made the shirts had n't bothered that woman .
Richard has seen that that teacher who was n't laughing scares these boys .	Richard has seen who that teacher who was n't laughing scares these boys .
your sister forgot that this person who sounded like the snake could bother the people .	your sister forgot who this person who sounded like the snake could bother the people .
your son knows that the person who had heard this man scared that teacher .	your son knows who the person who had heard this man scared that teacher .
Steve knew that these women who those boys hear can like those men .	Steve knew who these women who those boys hear can like those men .
the teachers notice that that teacher who has n't walked through those rooms liked the girl .	the teachers notice who that teacher who has n't walked through those rooms liked the girl .
the king would learn that the teachers who have n't bought the fork may appreciate this king .	the king would learn who the teachers who have n't bought the fork may appreciate this king .
my teachers had noticed that the boy who this teacher is n't talking about had bothered the men .	my teachers had noticed who the boy who this teacher is n't talking about had bothered the men .
this lady had noticed that these men who are painting had liked this girl .	this lady had noticed who these men who are painting had liked this girl .
these teachers knew that those doctors who noticed those forks could like these men .	these teachers knew who those doctors who noticed those forks could like these men .
Noah sees that the people who have n't thrown these bowls had n't confused that teacher .	Noah sees who the people who have n't thrown these bowls had n't confused that teacher .
your grandmother could n't see that these men who had n't thought about these hats praise the patient .	your grandmother could n't see who these men who had n't thought about these hats praise the patient .
the doctors remember that those teachers who wo n't sound like this dancer should scare this person .	the doctors remember who those teachers who wo n't sound like this dancer should scare this person .
Alice noticed that these doctors who had seen those dogs are n't bothering the children .	Alice noticed who these doctors who had seen those dogs are n't bothering the children .
the doctors had n't remembered that these boys who hear the king should scare those teachers .	the doctors had n't remembered who these boys who hear the king should scare those teachers .
the people remembered that that woman who was talking about the crayon bothered the girls .	the people remembered who that woman who was talking about the crayon bothered the girls .
Robert can n't remember that the customer who sees the dishes liked these ladies .	Robert can n't remember who the customer who sees the dishes liked these ladies .
your doctors forgot that those people who are n't talking about these people were bothering the men .	your doctors forgot who those people who are n't talking about these people were bothering the men .
the queen must notice that those boys who this teacher had n't heard have liked those guys .	the queen must notice who those boys who this teacher had n't heard have liked those guys .
that boy wo n't realize that this woman who loved the shoe scared the customer .	that boy wo n't realize who this woman who loved the shoe scared the customer .
that king may forget that these teachers who that child is talking about praise the man .	that king may forget who these teachers who that child is talking about praise the man .
Sandra realized that this doctor who hears this dentist will appreciate the lady .	Sandra realized who this doctor who hears this dentist will appreciate the lady .
these people have n't realized that those children who were thinking about this dancer might appreciate the patient .	these people have n't realized who those children who were thinking about this dancer might appreciate the patient .
my teachers remembered that the child who this dancer hears may praise that adult .	my teachers remembered who the child who this dancer hears may praise that adult .
your cousins had remembered that that doctor who thinks about the rug likes those women .	your cousins had remembered who that doctor who thinks about the rug likes those women .
your grandmother did n't remember that these guys who wo n't sneeze have liked this dancer .	your grandmother did n't remember who these guys who wo n't sneeze have liked this dancer .
my friends have remembered that the women who did n't scream should hate these boys .	my friends have remembered who the women who did n't scream should hate these boys .
your father noticed that this adult who could n't notice this candle has n't bothered that dancer .	your father noticed who this adult who could n't notice this candle has n't bothered that dancer .
Elizabeth knows that those girls who had seen these birds bothered that adult .	Elizabeth knows who those girls who had seen these birds bothered that adult .
my cousins learned that the children who have heard that rabbit have scared that boy .	my cousins learned who the children who have heard that rabbit have scared that boy .
those children noticed that the guy who should sell the dishes bothered this driver .	those children noticed who the guy who should sell the dishes bothered this driver .
your doctors should n't forget that this lady who is n't talking is bothering the woman .	your doctors should n't forget who this lady who is n't talking is bothering the woman .
that girl must remember that the people who those guys talk about do n't hate this teacher .	that girl must remember who the people who those guys talk about do n't hate this teacher .
these teachers learn that the dentist who sees that lady has n't liked the children .	these teachers learn who the dentist who sees that lady has n't liked the children .
these teachers had n't noticed that those guys who these children could talk about bothered the man .	these teachers had n't noticed who those guys who these children could talk about bothered the man .
the teachers do n't notice that this guy who did n't run around that school has n't confused that lady .	the teachers do n't notice who this guy who did n't run around that school has n't confused that lady .
these children have n't learned that that man who would n't notice the dish does n't like that child .	these children have n't learned who that man who would n't notice the dish does n't like that child .
those children saw that these children who may look like that driver have bothered that girl .	those children saw who these children who may look like that driver have bothered that girl .
your cousins do n't learn that these doctors who can n't know this dog liked this person .	your cousins do n't learn who these doctors who can n't know this dog liked this person .
my wife had n't known that those girls who think about that person had n't bothered the lady .	my wife had n't known who those girls who think about that person had n't bothered the lady .
Elizabeth had remembered that these men who had n't cried praise that child .	Elizabeth had remembered who these men who had n't cried praise that child .
these doctors know that this adult who would forget that spoon can hate that person .	these doctors know who this adult who would forget that spoon can hate that person .
my friends realize that this doctor who had n't taken this button should n't scare the man .	my friends realize who this doctor who had n't taken this button should n't scare the man .
your sister has n't learned that the people who were cleaning the shoes have n't bothered the children .	your sister has n't learned who the people who were cleaning the shoes have n't bothered the children .
the teachers knew that the man who paints does n't bother that doctor .	the teachers knew who the man who paints does n't bother that doctor .
the children knew that that guy who knows the mice should scare the men .	the children knew who that guy who knows the mice should scare the men .
Andrew can n't learn that the child who those children knew liked those guys .	Andrew can n't learn who the child who those children knew liked those guys .
Ann does n't know that those ladies who did n't sound like that adult could bother this patient .	Ann does n't know who those ladies who did n't sound like that adult could bother this patient .
Jane realized that the men who that boy talked about praise these women .	Jane realized who the men who that boy talked about praise these women .
my cousins had n't known that this dancer who must steal this mirror must hate the children .	my cousins had n't known who this dancer who must steal this mirror must hate the children .
April had n't learned that that dancer who knew these birds likes the dancer .	April had n't learned who that dancer who knew these birds likes the dancer .
Ann had learned that this driver who holds this fork can n't appreciate this guy .	Ann had learned who this driver who holds this fork can n't appreciate this guy .
this guy saw that this driver who is n't bringing the dish had n't confused that queen .	this guy saw who this driver who is n't bringing the dish had n't confused that queen .
those people learn that that boy who looked like that cat confused this dentist .	those people learn who that boy who looked like that cat confused this dentist .
your teachers had learned that that customer who those people talked about will scare this woman .	your teachers had learned who that customer who those people talked about will scare this woman .
those doctors might remember that that man who may sing scared the teacher .	those doctors might remember who that man who may sing scared the teacher .
these doctors remembered that the ladies who have gone to that library liked those ladies .	these doctors remembered who the ladies who have gone to that library liked those ladies .
those people have learned that these doctors who may fix the boat liked these men .	those people have learned who these doctors who may fix the boat liked these men .
your friends see that this man who these ladies knew scares the doctor .	your friends see who this man who these ladies knew scares the doctor .
my doctors had remembered that the lady who was n't running around this hospital had n't confused the woman .	my doctors had remembered who the lady who was n't running around this hospital had n't confused the woman .
your sister had n't realized that this child who likes that bed has n't confused the guys .	your sister had n't realized who this child who likes that bed has n't confused the guys .
Travis could n't learn that the child who knew the doctors had bothered that adult .	Travis could n't learn who the child who knew the doctors had bothered that adult .
the doctors would remember that this dancer who would n't cry would hate that king .	the doctors would remember who this dancer who would n't cry would hate that king .
this woman has n't realized that these girls who those ladies did n't know do n't like that patient .	this woman has n't realized who these girls who those ladies did n't know do n't like that patient .
these children had n't realized that the customer who the teachers should talk about has n't scared these women .	these children had n't realized who the customer who the teachers should talk about has n't scared these women .
these doctors learned that the doctors who have talked about this woman confused the guy .	these doctors learned who the doctors who have talked about this woman confused the guy .
your sister could notice that the ladies who should sound like this dog hate the men .	your sister could notice who the ladies who should sound like this dog hate the men .
my doctors learned that those people who pass that school like the men .	my doctors learned who those people who pass that school like the men .
Tracy should notice that those boys who think about this girl can like the children .	Tracy should notice who those boys who think about this girl can like the children .
your friends forgot that the men who sounded like these boys wo n't appreciate the boys .	your friends forgot who the men who sounded like these boys wo n't appreciate the boys .
that woman can know that the child who knows these guys has n't bothered that teacher .	that woman can know who the child who knows these guys has n't bothered that teacher .
the people see that the children who had heard the ladies can like that guy .	the people see who the children who had heard the ladies can like that guy .
Nancy knew that the child who found the mirror could like that patient .	Nancy knew who the child who found the mirror could like that patient .
my friends saw that the doctors who passed that school will hate that doctor .	my friends saw who the doctors who passed that school will hate that doctor .
this lady would n't remember that that queen who was n't smiling had confused that patient .	this lady would n't remember who that queen who was n't smiling had confused that patient .
my brother sees that these girls who have n't left the schools scare the driver .	my brother sees who these girls who have n't left the schools scare the driver .
your sister remembered that the child who was n't singing may praise the ladies .	your sister remembered who the child who was n't singing may praise the ladies .
my grandmother saw that these guys who are painting have liked that dancer .	my grandmother saw who these guys who are painting have liked that dancer .
your sister has known that that guy who is throwing these bags bothered the lady .	your sister has known who that guy who is throwing these bags bothered the lady .
your brother knows that this girl who loves those bowls has scared that man .	your brother knows who this girl who loves those bowls has scared that man .
your doctors see that these girls who were n't practicing have n't confused that man .	your doctors see who these girls who were n't practicing have n't confused that man .
my teachers saw that that queen who dropped the rings has n't confused this man .	my teachers saw who that queen who dropped the rings has n't confused this man .
your mom learned that the customer who could n't hear this person has n't confused those ladies .	your mom learned who the customer who could n't hear this person has n't confused those ladies .
your husband had n't remembered that those doctors who do n't hate the box must appreciate that boy .	your husband had n't remembered who those doctors who do n't hate the box must appreciate that boy .
that man had learned that that person who ran around this school may like the man .	that man had learned who that person who ran around this school may like the man .
your son has n't remembered that the children who saw these spoons scare the girl .	your son has n't remembered who the children who saw these spoons scare the girl .
your cousins see that this driver who those children talked about has n't bothered the teachers .	your cousins see who this driver who those children talked about has n't bothered the teachers .
my cousins have n't learned that the children who buy the hats like this king .	my cousins have n't learned who the children who buy the hats like this king .
your friends had seen that the doctors who exercise appreciate these teachers .	your friends had seen who the doctors who exercise appreciate these teachers .
your doctors realize that these ladies who sneeze were bothering the man .	your doctors realize who these ladies who sneeze were bothering the man .
my brother learned that that dentist who could n't have the rocket had n't confused the doctors .	my brother learned who that dentist who could n't have the rocket had n't confused the doctors .
the woman did n't notice that the child who would n't forget the cat had bothered the adult .	the woman did n't notice who the child who would n't forget the cat had bothered the adult .
the queen must realize that those men who were n't leaving this museum scare this woman .	the queen must realize who those men who were n't leaving this museum scare this woman .
your friends forgot that these people who have noticed these crayons liked the girls .	your friends forgot who these people who have noticed these crayons liked the girls .
these children should n't see that those guys who could forget those dishes would n't scare that girl .	these children should n't see who those guys who could forget those dishes would n't scare that girl .
the teachers notice that these teachers who have n't seen this button confused that girl .	the teachers notice who these teachers who have n't seen this button confused that girl .
those people knew that those girls who the dentist has n't heard scared that queen .	those people knew who those girls who the dentist has n't heard scared that queen .
your mom did n't see that the ladies who wo n't talk about that chair scare the adult .	your mom did n't see who the ladies who wo n't talk about that chair scare the adult .
Ronald did n't learn that this man who wo n't see this door confused the women .	Ronald did n't learn who this man who wo n't see this door confused the women .
those people have n't remembered that these men who lost this dish might praise this boy .	those people have n't remembered who these men who lost this dish might praise this boy .
my doctors know that these people who this queen did n't look like appreciate this king .	my doctors know who these people who this queen did n't look like appreciate this king .
the woman has n't seen that the people who that king talks about must like that patient .	the woman has n't seen who the people who that king talks about must like that patient .
Janet should see that these men who knew those doctors could n't scare that guy .	Janet should see who these men who knew those doctors could n't scare that guy .
the lady has n't learned that the men who sound like the guys have bothered that teacher .	the lady has n't learned who the men who sound like the guys have bothered that teacher .
my mom has known that the people who hear the teacher had n't scared the queen .	my mom has known who the people who hear the teacher had n't scared the queen .
this lady saw that those boys who could talk about these bowls wo n't hate this man .	this lady saw who those boys who could talk about these bowls wo n't hate this man .
those people forget that the woman who went to this room does n't appreciate this dancer .	those people forget who the woman who went to this room does n't appreciate this dancer .
that king learned that the lady who likes the shoes could praise these women .	that king learned who the lady who likes the shoes could praise these women .
the guy had noticed that the ladies who those women can n't talk about must scare the customer .	the guy had noticed who the ladies who those women can n't talk about must scare the customer .
Alexander realized that these women who this man had n't talked about have n't confused these doctors .	Alexander realized who these women who this man had n't talked about have n't confused these doctors .
that girl has n't known that this person who is n't crying did n't hate that lady .	that girl has n't known who this person who is n't crying did n't hate that lady .
this king did n't notice that that patient who went to these schools likes the queen .	this king did n't notice who that patient who went to these schools likes the queen .
those children had n't seen that the guys who can notice the doctors could bother the dentist .	those children had n't seen who the guys who can notice the doctors could bother the dentist .
your mom knew that the people who would n't look like these children had n't confused the children .	your mom knew who the people who would n't look like these children had n't confused the children .
those teachers realize that those boys who remember that fork liked this lady .	those teachers realize who those boys who remember that fork liked this lady .
my teachers could remember that this girl who sounds like these dogs bothered this dentist .	my teachers could remember who this girl who sounds like these dogs bothered this dentist .
the guy should n't learn that that king who had talked liked those doctors .	the guy should n't learn who that king who had talked liked those doctors .
Rebecca might realize that the king who had seen that rabbit had n't scared this driver .	Rebecca might realize who the king who had seen that rabbit had n't scared this driver .
your mom has learned that the boys who had n't talked about this car are bothering these guys .	your mom has learned who the boys who had n't talked about this car are bothering these guys .
your teachers learned that this woman who was running around the kitchen may appreciate that guy .	your teachers learned who this woman who was running around the kitchen may appreciate that guy .
the guy realized that the men who fix this glass would n't bother this dancer .	the guy realized who the men who fix this glass would n't bother this dancer .
Joseph has n't seen that this queen who has gone to the mall would praise the men .	Joseph has n't seen who this queen who has gone to the mall would praise the men .
the man might forget that the woman who wo n't look like the dog scared that person .	the man might forget who the woman who wo n't look like the dog scared that person .
my father has realized that the teachers who this queen sounded like bother these girls .	my father has realized who the teachers who this queen sounded like bother these girls .
these people have realized that that lady who talked about that horse can hate this girl .	these people have realized who that lady who talked about that horse can hate this girl .
Eric realized that these men who sell those trucks had confused the queen .	Eric realized who these men who sell those trucks had confused the queen .
your cousins remember that these doctors who could sound like these snakes have n't liked that guy .	your cousins remember who these doctors who could sound like these snakes have n't liked that guy .
your father knows that that person who this doctor can hear liked the doctor .	your father knows who that person who this doctor can hear liked the doctor .
the teachers should remember that the woman who was whispering might appreciate that girl .	the teachers should remember who the woman who was whispering might appreciate that girl .
your friends realized that this queen who looked like that boy can hate the women .	your friends realized who this queen who looked like that boy can hate the women .
Janet remembered that this patient who must lose that hat has n't liked this woman .	Janet remembered who this patient who must lose that hat has n't liked this woman .
the children have realized that the person who would n't forget the mirror likes the children .	the children have realized who the person who would n't forget the mirror likes the children .
my doctors could n't realize that those girls who must like this doll scared the children .	my doctors could n't realize who those girls who must like this doll scared the children .
Todd knew that those guys who this king knows should n't scare this adult .	Todd knew who those guys who this king knows should n't scare this adult .
this lady may remember that this girl who would n't think about these cups had n't bothered the driver .	this lady may remember who this girl who would n't think about these cups had n't bothered the driver .
your brother has seen that those boys who had n't moved those crayons had liked these people .	your brother has seen who those boys who had n't moved those crayons had liked these people .
Adam did n't learn that this driver who these women talk about had n't confused the children .	Adam did n't learn who this driver who these women talk about had n't confused the children .
those children realize that the boys who notice these beds may praise this dancer .	those children realize who the boys who notice these beds may praise this dancer .
my cousins learned that the ladies who paint appreciate the customer .	my cousins learned who the ladies who paint appreciate the customer .
my brother noticed that the doctors who run around that kitchen scare the doctors .	my brother noticed who the doctors who run around that kitchen scare the doctors .
those people see that the man who forgot the plate would bother the driver .	those people see who the man who forgot the plate would bother the driver .
this man knew that these women who talked about this glass must bother this queen .	this man knew who these women who talked about this glass must bother this queen .
those doctors have n't seen that those boys who may bring these cars had n't scared the ladies .	those doctors have n't seen who those boys who may bring these cars had n't scared the ladies .
the queen has learned that the girls who will talk about the glass like this doctor .	the queen has learned who the girls who will talk about the glass like this doctor .
Sandra knows that the man who was n't talking about that ring likes that doctor .	Sandra knows who the man who was n't talking about that ring likes that doctor .
those people noticed that that dancer who the people have n't talked about scares the doctors .	those people noticed who that dancer who the people have n't talked about scares the doctors .
Liam might remember that these children who were n't talking about the cars like this person .	Liam might remember who these children who were n't talking about the cars like this person .
the woman sees that those people who were n't driving to the school had n't scared that king .	the woman sees who those people who were n't driving to the school had n't scared that king .
Nicole realized that those boys who yell bothered these children .	Nicole realized who those boys who yell bothered these children .
Timothy learned that those ladies who ran around this room scared that doctor .	Timothy learned who those ladies who ran around this room scared that doctor .
my doctors have learned that this queen who was n't throwing these books will appreciate these women .	my doctors have learned who this queen who was n't throwing these books will appreciate these women .
Cindy noticed that that dentist who the ladies were talking about has n't liked the teacher .	Cindy noticed who that dentist who the ladies were talking about has n't liked the teacher .
my mother will learn that that boy who the people know would n't like the person .	my mother will learn who that boy who the people know would n't like the person .
the boy would realize that the children who are n't smiling were bothering those teachers .	the boy would realize who the children who are n't smiling were bothering those teachers .
that guy does n't remember that this lady who might win scares the teachers .	that guy does n't remember who this lady who might win scares the teachers .
this king had n't learned that that man who can n't notice those dolls liked that boy .	this king had n't learned who that man who can n't notice those dolls liked that boy .
your cousins realize that that king who has read could n't hate that adult .	your cousins realize who that king who has read could n't hate that adult .
my cousins must realize that that woman who the men heard will like this king .	my cousins must realize who that woman who the men heard will like this king .
that queen saw that that customer who the customer was n't talking about did n't hate that boy .	that queen saw who that customer who the customer was n't talking about did n't hate that boy .
those teachers knew that the driver who forgot those boxes had n't scared that dentist .	those teachers knew who the driver who forgot those boxes had n't scared that dentist .
your wife forgot that that patient who had lost the candle would n't appreciate this driver .	your wife forgot who that patient who had lost the candle would n't appreciate this driver .
my friends realized that that person who has found those toys scares the king .	my friends realized who that person who has found those toys scares the king .
this man forgot that those women who forgot the horses did n't hate the children .	this man forgot who those women who forgot the horses did n't hate the children .
Martin sees that this dancer who was n't thinking about these spoons was n't bothering this doctor .	Martin sees who this dancer who was n't thinking about these spoons was n't bothering this doctor .
your teachers had n't realized that that doctor who is walking through that park had bothered the dentist .	your teachers had n't realized who that doctor who is walking through that park had bothered the dentist .
these children learned that the lady who has moved that bag could n't scare these boys .	these children learned who the lady who has moved that bag could n't scare these boys .
those teachers realize that this lady who would forget this dancer was bothering those children .	those teachers realize who this lady who would forget this dancer was bothering those children .
these teachers knew that these children who are n't screaming must scare those doctors .	these teachers knew who these children who are n't screaming must scare those doctors .
your father remembered that these guys who had this door like this woman .	your father remembered who these guys who had this door like this woman .
these doctors forget that those men who could love those crayons scared these teachers .	these doctors forget who those men who could love those crayons scared these teachers .
your cousins knew that this woman who drove to that hospital bothered that child .	your cousins knew who this woman who drove to that hospital bothered that child .
these doctors should n't learn that the king who has n't seen the mice scared that person .	these doctors should n't learn who the king who has n't seen the mice scared that person .
your friends notice that these men who run around the bank bother the dentist .	your friends notice who these men who run around the bank bother the dentist .
those people had n't noticed that that adult who had n't moved this plate had confused the women .	those people had n't noticed who that adult who had n't moved this plate had confused the women .
the teachers should n't know that that dancer who had left that library had n't liked these guys .	the teachers should n't know who that dancer who had left that library had n't liked these guys .
my friends can n't realize that these children who sounded like those ladies were n't bothering these teachers .	my friends can n't realize who these children who sounded like those ladies were n't bothering these teachers .
these people remember that those men who smile had n't scared that woman .	these people remember who those men who smile had n't scared that woman .
those teachers forget that this dancer who is n't losing these books would n't hate the women .	those teachers forget who this dancer who is n't losing these books would n't hate the women .
my doctors learn that the girls who hold the rug like that driver .	my doctors learn who the girls who hold the rug like that driver .
my son realized that these women who hate that truck hate this girl .	my son realized who these women who hate that truck hate this girl .
my brother had n't seen that this driver who was screaming scared that girl .	my brother had n't seen who this driver who was screaming scared that girl .
this woman has n't remembered that those ladies who read scare those people .	this woman has n't remembered who those ladies who read scare those people .
Laura saw that those doctors who wo n't forget the woman like that adult .	Laura saw who those doctors who wo n't forget the woman like that adult .
the doctors remember that that girl who loved these teachers had n't bothered the dentist .	the doctors remember who that girl who loved these teachers had n't bothered the dentist .
your father realized that this king who looked like the guys could n't scare this guy .	your father realized who this king who looked like the guys could n't scare this guy .
my doctors might learn that the boys who talk about these dogs appreciate the guy .	my doctors might learn who the boys who talk about these dogs appreciate the guy .
Catherine should n't see that these doctors who that woman talks about should n't scare the lady .	Catherine should n't see who these doctors who that woman talks about should n't scare the lady .
my doctors learn that this person who the patient talks about may bother the guy .	my doctors learn who this person who the patient talks about may bother the guy .
Noah learned that that child who could find those cars had bothered that doctor .	Noah learned who that child who could find those cars had bothered that doctor .
the woman has n't noticed that that doctor who leaves this room scared the dancer .	the woman has n't noticed who that doctor who leaves this room scared the dancer .
Frank realized that the guys who steal these bottles have n't scared that teacher .	Frank realized who the guys who steal these bottles have n't scared that teacher .
your sister does n't realize that the woman who had cried is bothering the boys .	your sister does n't realize who the woman who had cried is bothering the boys .
these doctors noticed that this boy who has those glasses likes this teacher .	these doctors noticed who this boy who has those glasses likes this teacher .
the children saw that the girl who talks about the chairs liked the king .	the children saw who the girl who talks about the chairs liked the king .
Becca knew that those women who bought the forks will like the teacher .	Becca knew who those women who bought the forks will like the teacher .
your mom saw that these girls who have n't lost this mirror praise the driver .	your mom saw who these girls who have n't lost this mirror praise the driver .
this king will know that the woman who was n't leaving these schools scared those boys .	this king will know who the woman who was n't leaving these schools scared those boys .
Brian should n't forget that this driver who had n't seen the doors has scared the woman .	Brian should n't forget who this driver who had n't seen the doors has scared the woman .
my friends should n't know that this lady who does n't talk about the book likes this child .	my friends should n't know who this lady who does n't talk about the book likes this child .
the people learn that that man who had seen this patient would scare that guy .	the people learn who that man who had seen this patient would scare that guy .
my grandmother forgot that that boy who did n't sell that plate had n't liked these women .	my grandmother forgot who that boy who did n't sell that plate had n't liked these women .
Laurie did n't see that the teacher who won scares those people .	Laurie did n't see who the teacher who won scares those people .
my cousins do n't know that those guys who are n't holding the button scared the man .	my cousins do n't know who those guys who are n't holding the button scared the man .
those teachers remember that the girls who have n't seen those children appreciate the dentist .	those teachers remember who the girls who have n't seen those children appreciate the dentist .
my friends realized that this patient who has thought about those men might bother this doctor .	my friends realized who this patient who has thought about those men might bother this doctor .
your cousins see that that child who had brought the dishes scares these ladies .	your cousins see who that child who had brought the dishes scares these ladies .
that guy noticed that the adult who likes those horses can n't hate those doctors .	that guy noticed who the adult who likes those horses can n't hate those doctors .
your husband noticed that the guys who threw this dish appreciate that adult .	your husband noticed who the guys who threw this dish appreciate that adult .
the man has known that those guys who remembered those books have n't confused this king .	the man has known who those guys who remembered those books have n't confused this king .
your doctors learned that that person who this patient will hear has bothered those people .	your doctors learned who that person who this patient will hear has bothered those people .
the children have remembered that these guys who walked through that bank will appreciate the driver .	the children have remembered who these guys who walked through that bank will appreciate the driver .
that woman does n't remember that that king who looked like the mouse was bothering this lady .	that woman does n't remember who that king who looked like the mouse was bothering this lady .
the children had n't learned that those teachers who might hate the book could n't bother this man .	the children had n't learned who those teachers who might hate the book could n't bother this man .
your wife did n't notice that that king who runs around this school is bothering that person .	your wife did n't notice who that king who runs around this school is bothering that person .
my cousins notice that these guys who should n't smile hate this child .	my cousins notice who these guys who should n't smile hate this child .
your friends see that these teachers who forget the snakes did n't scare the child .	your friends see who these teachers who forget the snakes did n't scare the child .
these teachers forget that the dancer who wo n't lose that bag has liked the driver .	these teachers forget who the dancer who wo n't lose that bag has liked the driver .
your friends remembered that that man who can walk through this museum does n't appreciate this dancer .	your friends remembered who that man who can walk through this museum does n't appreciate this dancer .
those doctors learned that the person who sounds like this dentist would n't scare those children .	those doctors learned who the person who sounds like this dentist would n't scare those children .
these people forgot that those boys who had n't heard the people confused the child .	these people forgot who those boys who had n't heard the people confused the child .
that girl remembered that this doctor who would n't sound like the teacher confused this dentist .	that girl remembered who this doctor who would n't sound like the teacher confused this dentist .
Dan saw that these people who the woman sounded like would n't scare the teachers .	Dan saw who these people who the woman sounded like would n't scare the teachers .
your doctors might forget that this teacher who saw that dog could n't like the dancer .	your doctors might forget who this teacher who saw that dog could n't like the dancer .
my friends should n't learn that those ladies who throw this rug have confused this king .	my friends should n't learn who those ladies who throw this rug have confused this king .
this queen did n't learn that this teacher who did n't shake that couch liked the people .	this queen did n't learn who this teacher who did n't shake that couch liked the people .
those people forget that the teachers who had n't talked about the rocket scared those children .	those people forget who the teachers who had n't talked about the rocket scared those children .
my cousins would remember that the person who will keep that candle would n't hate this boy .	my cousins would remember who the person who will keep that candle would n't hate this boy .
Gregory should know that this lady who should n't shake that bed will like the women .	Gregory should know who this lady who should n't shake that bed will like the women .
my mom remembered that the girls who the king has n't heard can n't praise those ladies .	my mom remembered who the girls who the king has n't heard can n't praise those ladies .
these doctors remembered that the child who the driver has talked about likes the person .	these doctors remembered who the child who the driver has talked about likes the person .
Sarah noticed that this boy who might talk confused that lady .	Sarah noticed who this boy who might talk confused that lady .
that lady had remembered that those girls who had n't heard that dancer have n't confused that woman .	that lady had remembered who those girls who had n't heard that dancer have n't confused that woman .
those teachers see that the boy who thinks about the teacher does n't scare that boy .	those teachers see who the boy who thinks about the teacher does n't scare that boy .
your father may see that this boy who the driver had talked about has n't liked this boy .	your father may see who this boy who the driver had talked about has n't liked this boy .
Nina should n't notice that that girl who has n't noticed that lady has n't bothered the woman .	Nina should n't notice who that girl who has n't noticed that lady has n't bothered the woman .
your friends remembered that that lady who has painted must like this dancer .	your friends remembered who that lady who has painted must like this dancer .
these people did n't realize that that teacher who forgot that bowl had liked those boys .	these people did n't realize who that teacher who forgot that bowl had liked those boys .
these teachers had realized that the women who think about that dancer would n't praise the customer .	these teachers had realized who the women who think about that dancer would n't praise the customer .
your teachers remembered that the ladies who are holding that mirror would n't like the guys .	your teachers remembered who the ladies who are holding that mirror would n't like the guys .
these doctors should n't see that the king who could n't look like the people bothered the customer .	these doctors should n't see who the king who could n't look like the people bothered the customer .
your doctors have n't seen that those men who the dancer knew confused these teachers .	your doctors have n't seen who those men who the dancer knew confused these teachers .
the people could n't see that those guys who sneeze liked that patient .	the people could n't see who those guys who sneeze liked that patient .
that woman can learn that these children who walked through the hospital could bother these guys .	that woman can learn who these children who walked through the hospital could bother these guys .
your friends learned that that guy who had n't seen the cups bothered the lady .	your friends learned who that guy who had n't seen the cups bothered the lady .
the doctors see that the girl who would n't remember that dancer has liked the man .	the doctors see who the girl who would n't remember that dancer has liked the man .
those teachers know that this boy who could n't have this crayon has liked that doctor .	those teachers know who this boy who could n't have this crayon has liked that doctor .
these teachers know that that patient who sang is bothering that doctor .	these teachers know who that patient who sang is bothering that doctor .
your mother should n't forget that that dentist who went to the schools may hate this teacher .	your mother should n't forget who that dentist who went to the schools may hate this teacher .
these doctors remembered that this girl who was finding those bottles likes that customer .	these doctors remembered who this girl who was finding those bottles likes that customer .
the doctors should n't learn that the men who these girls sounded like would n't like this adult .	the doctors should n't learn who the men who these girls sounded like would n't like this adult .
your wife learned that this boy who found those boxes scared those teachers .	your wife learned who this boy who found those boxes scared those teachers .
these children should n't see that that dancer who was n't crying did n't scare the boy .	these children should n't see who that dancer who was n't crying did n't scare the boy .
Paul can n't remember that that teacher who ran around this mall is n't bothering these men .	Paul can n't remember who that teacher who ran around this mall is n't bothering these men .
that boy has n't noticed that the adult who sounds like this queen is bothering that driver .	that boy has n't noticed who the adult who sounds like this queen is bothering that driver .
my doctors realize that this girl who had n't yelled liked the customer .	my doctors realize who this girl who had n't yelled liked the customer .
your son does n't know that this doctor who holds those doors would bother those guys .	your son does n't know who this doctor who holds those doors would bother those guys .
those people saw that these men who will sneeze have n't bothered those teachers .	those people saw who these men who will sneeze have n't bothered those teachers .
your husband did n't learn that these guys who sound like the mice wo n't appreciate these people .	your husband did n't learn who these guys who sound like the mice wo n't appreciate these people .
my doctors knew that these children who were practicing do n't like those women .	my doctors knew who these children who were practicing do n't like those women .
your wife saw that this customer who was n't reading scared the teacher .	your wife saw who this customer who was n't reading scared the teacher .
my friends would n't see that that queen who those women have heard has n't confused the child .	my friends would n't see who that queen who those women have heard has n't confused the child .
the children can realize that that patient who paints bothered that teacher .	the children can realize who that patient who paints bothered that teacher .
these teachers notice that the women who knew that guy like this boy .	these teachers notice who the women who knew that guy like this boy .
my teachers had n't seen that the driver who is dropping the chairs was n't bothering the boy .	my teachers had n't seen who the driver who is dropping the chairs was n't bothering the boy .
my doctors remembered that this adult who keeps those bowls could scare the person .	my doctors remembered who this adult who keeps those bowls could scare the person .
this boy must notice that the boys who have laughed bother that girl .	this boy must notice who the boys who have laughed bother that girl .
Wendy saw that the women who think about those buttons bothered this dentist .	Wendy saw who the women who think about those buttons bothered this dentist .
your son can n't realize that those guys who pass this hospital liked the adult .	your son can n't realize who those guys who pass this hospital liked the adult .
the queen did n't learn that these ladies who must make this spoon bothered that teacher .	the queen did n't learn who these ladies who must make this spoon bothered that teacher .
your teachers learned that the person who was n't bringing this couch might hate that dancer .	your teachers learned who the person who was n't bringing this couch might hate that dancer .
those doctors had n't realized that this dentist who was bringing this window confused this driver .	those doctors had n't realized who this dentist who was bringing this window confused this driver .
these children have n't learned that those girls who are making those toys can like the boy .	these children have n't learned who those girls who are making those toys can like the boy .
the people realized that that child who goes to the room has bothered these ladies .	the people realized who that child who goes to the room has bothered these ladies .
Samantha sees that those children who have n't talked about that button appreciate these people .	Samantha sees who those children who have n't talked about that button appreciate these people .
your brother might learn that that adult who can drive to this school can n't like the guy .	your brother might learn who that adult who can drive to this school can n't like the guy .
those doctors realize that the boy who was thinking about that turtle has n't liked those boys .	those doctors realize who the boy who was thinking about that turtle has n't liked those boys .
this girl had remembered that those boys who took the truck bother this king .	this girl had remembered who those boys who took the truck bother this king .
your cousins learn that these women who may hear this snake confused the people .	your cousins learn who these women who may hear this snake confused the people .
the girl has n't seen that the doctors who should whisper bothered this girl .	the girl has n't seen who the doctors who should whisper bothered this girl .
these doctors could notice that the dentist who loves these books can n't like this dentist .	these doctors could notice who the dentist who loves these books can n't like this dentist .
Laurie remembered that these women who scream liked that woman .	Laurie remembered who these women who scream liked that woman .
your doctors realized that that girl who could talk about that driver likes this queen .	your doctors realized who that girl who could talk about that driver likes this queen .
my teachers had realized that the teachers who shake those candles had confused those people .	my teachers had realized who the teachers who shake those candles had confused those people .
the teachers forget that the dancer who shook these cars liked that child .	the teachers forget who the dancer who shook these cars liked that child .
Brett learned that that adult who thought about the dolls has n't liked the doctor .	Brett learned who that adult who thought about the dolls has n't liked the doctor .
my friends have n't realized that this adult who had fixed these plates can hate the guys .	my friends have n't realized who this adult who had fixed these plates can hate the guys .
your teachers learn that that man who that doctor heard had liked the king .	your teachers learn who that man who that doctor heard had liked the king .
your husband would notice that this dancer who wo n't love this teacher may bother that lady .	your husband would notice who this dancer who wo n't love this teacher may bother that lady .
your doctors have seen that the girl who is thinking about that mirror scares these men .	your doctors have seen who the girl who is thinking about that mirror scares these men .
David saw that those people who can n't cough hate these doctors .	David saw who those people who can n't cough hate these doctors .
my teachers see that the teachers who brought these doors have confused these children .	my teachers see who the teachers who brought these doors have confused these children .
the people can n't realize that the driver who was moving that spoon may appreciate the guy .	the people can n't realize who the driver who was moving that spoon may appreciate the guy .
that woman has learned that the king who must run around this park scared the boys .	that woman has learned who the king who must run around this park scared the boys .
the lady has learned that that customer who was n't whispering liked the boys .	the lady has learned who that customer who was n't whispering liked the boys .
my friends learned that the doctor who had n't heard that dentist had n't confused that girl .	my friends learned who the doctor who had n't heard that dentist had n't confused that girl .
my dad should know that these women who stole these boats had bothered the teachers .	my dad should know who these women who stole these boats had bothered the teachers .
Patrick can remember that this customer who that woman must look like confused those ladies .	Patrick can remember who this customer who that woman must look like confused those ladies .
these children had realized that the woman who drives to that park confused the doctors .	these children had realized who the woman who drives to that park confused the doctors .
my cousins had n't noticed that the doctors who may notice those cups were n't bothering those teachers .	my cousins had n't noticed who the doctors who may notice those cups were n't bothering those teachers .
my doctors realized that these teachers who were n't making the bottles did n't like the patient .	my doctors realized who these teachers who were n't making the bottles did n't like the patient .
this boy remembered that that lady who had won had n't scared the girls .	this boy remembered who that lady who had won had n't scared the girls .
the people know that those boys who walk through these schools do n't appreciate the driver .	the people know who those boys who walk through these schools do n't appreciate the driver .
Dan will learn that this teacher who was smiling had n't scared that man .	Dan will learn who this teacher who was smiling had n't scared that man .
Marie had remembered that the guy who may think about those boxes might praise that lady .	Marie had remembered who the guy who may think about those boxes might praise that lady .
the queen should n't realize that these teachers who talk about those beds have n't scared that driver .	the queen should n't realize who these teachers who talk about those beds have n't scared that driver .
the woman can n't remember that the guy who should shake the doors scared this person .	the woman can n't remember who the guy who should shake the doors scared this person .
the people have seen that that woman who those guys talk about bothered this person .	the people have seen who that woman who those guys talk about bothered this person .
that queen knew that the teachers who are n't fixing these trucks may hate that child .	that queen knew who the teachers who are n't fixing these trucks may hate that child .
your son saw that that lady who would see these bottles can n't bother that customer .	your son saw who that lady who would see these bottles can n't bother that customer .
my doctors have n't noticed that that lady who this boy talked about confused the child .	my doctors have n't noticed who that lady who this boy talked about confused the child .
your friends saw that the men who do n't walk through that park would n't appreciate the doctor .	your friends saw who the men who do n't walk through that park would n't appreciate the doctor .
your teachers had remembered that that queen who should n't whisper scared these women .	your teachers had remembered who that queen who should n't whisper scared these women .
the children might know that the men who lost those doors had bothered this lady .	the children might know who the men who lost those doors had bothered this lady .
my mother had known that the children who are driving to the schools praise this girl .	my mother had known who the children who are driving to the schools praise this girl .
Timothy noticed that this child who has n't seen these books had n't confused the adult .	Timothy noticed who this child who has n't seen these books had n't confused the adult .
Michael has realized that the boy who had n't talked about this child would appreciate that driver .	Michael has realized who the boy who had n't talked about this child would appreciate that driver .
that girl saw that the dancer who drove to that bank can praise that man .	that girl saw who the dancer who drove to that bank can praise that man .
these people had noticed that the lady who was driving to this museum would n't like that adult .	these people had noticed who the lady who was driving to this museum would n't like that adult .
the children might remember that the woman who talked about the bicycle likes those teachers .	the children might remember who the woman who talked about the bicycle likes those teachers .
this queen has n't realized that the child who knew this girl may scare that guy .	this queen has n't realized who the child who knew this girl may scare that guy .
the children had n't seen that those women who would lose this rug should n't like that dentist .	the children had n't seen who those women who would lose this rug should n't like that dentist .
my doctors would n't know that this dancer who those children look like scared that person .	my doctors would n't know who this dancer who those children look like scared that person .
your friends notice that these boys who were n't talking about this lady would hate the ladies .	your friends notice who these boys who were n't talking about this lady would hate the ladies .
the doctors had n't noticed that the boy who those teachers had talked about might scare the customer .	the doctors had n't noticed who the boy who those teachers had talked about might scare the customer .
those doctors learn that those people who find the plate have liked the dancer .	those doctors learn who those people who find the plate have liked the dancer .
my cousins noticed that that queen who had n't seen that box has n't bothered that patient .	my cousins noticed who that queen who had n't seen that box has n't bothered that patient .
the lady has known that that child who has bought the truck was n't bothering the driver .	the lady has known who that child who has bought the truck was n't bothering the driver .
your friends do n't see that this dentist who had n't walked through that library will praise the people .	your friends do n't see who this dentist who had n't walked through that library will praise the people .
Rebecca sees that this lady who the women talk about scares the ladies .	Rebecca sees who this lady who the women talk about scares the ladies .
these children must see that this man who sees those doors scares those people .	these children must see who this man who sees those doors scares those people .
my doctors realized that that driver who could n't stretch bothered this doctor .	my doctors realized who that driver who could n't stretch bothered this doctor .
those people can notice that those people who that teacher is n't talking about bother the queen .	those people can notice who those people who that teacher is n't talking about bother the queen .
these children have known that this guy who is n't buying this doll has n't liked those doctors .	these children have known who this guy who is n't buying this doll has n't liked those doctors .
these teachers might see that these children who win will like the king .	these teachers might see who these children who win will like the king .
the teachers forgot that these men who forgot that rug have confused the doctors .	the teachers forgot who these men who forgot that rug have confused the doctors .
my daughter can n't see that the man who runs around the kitchen is n't bothering this queen .	my daughter can n't see who the man who runs around the kitchen is n't bothering this queen .
Jerry can n't forget that these children who cleaned this shirt bother that man .	Jerry can n't forget who these children who cleaned this shirt bother that man .
the children may forget that this queen who had dropped this bed scared this man .	the children may forget who this queen who had dropped this bed scared this man .
your friends have remembered that these children who that guy may talk about may appreciate the children .	your friends have remembered who these children who that guy may talk about may appreciate the children .
your doctors forget that the boys who practice had liked the boy .	your doctors forget who the boys who practice had liked the boy .
those teachers learned that the person who brought that crayon liked that man .	those teachers learned who the person who brought that crayon liked that man .
those teachers wo n't forget that the girls who hate the trucks bothered this driver .	those teachers wo n't forget who the girls who hate the trucks bothered this driver .
my dad realized that this teacher who would n't sneeze had bothered that driver .	my dad realized who this teacher who would n't sneeze had bothered that driver .
those teachers wo n't know that those people who remember these children praise those people .	those teachers wo n't know who those people who remember these children praise those people .
your grandmother may realize that the person who that driver could n't know is bothering these ladies .	your grandmother may realize who the person who that driver could n't know is bothering these ladies .
these children realized that this woman who was waving did n't like these teachers .	these children realized who this woman who was waving did n't like these teachers .
Sally sees that those girls who would n't hear that patient had n't bothered the lady .	Sally sees who those girls who would n't hear that patient had n't bothered the lady .
my friends learn that these ladies who had n't cleaned these trucks will praise the girl .	my friends learn who these ladies who had n't cleaned these trucks will praise the girl .
the people remembered that this teacher who sang liked the king .	the people remembered who this teacher who sang liked the king .
that lady should forget that the teachers who had n't bought this cup had n't confused the boys .	that lady should forget who the teachers who had n't bought this cup had n't confused the boys .
those people have seen that these guys who made the hat have confused this lady .	those people have seen who these guys who made the hat have confused this lady .
your dad saw that the girls who can remember those doors should n't hate those ladies .	your dad saw who the girls who can remember those doors should n't hate those ladies .
these teachers remember that this girl who must make that plate can n't hate this child .	these teachers remember who this girl who must make that plate can n't hate this child .
Barbara had n't known that those men who have talked about the candle hate that boy .	Barbara had n't known who those men who have talked about the candle hate that boy .
those teachers could forget that that guy who was throwing these boats is bothering that dentist .	those teachers could forget who that guy who was throwing these boats is bothering that dentist .
this lady might remember that the adult who may hear the turtles is n't bothering those people .	this lady might remember who the adult who may hear the turtles is n't bothering those people .
the woman can notice that those women who might like these rings are n't bothering this king .	the woman can notice who those women who might like these rings are n't bothering this king .
your doctors do n't notice that these guys who moved that bottle scare those guys .	your doctors do n't notice who these guys who moved that bottle scare those guys .
Donald sees that that boy who was practicing would n't appreciate these teachers .	Donald sees who that boy who was practicing would n't appreciate these teachers .
Steve can know that these children who that patient must talk about bothered this king .	Steve can know who these children who that patient must talk about bothered this king .
those teachers realize that those men who had n't fixed the toy would hate the child .	those teachers realize who those men who had n't fixed the toy would hate the child .
Judy had n't noticed that that queen who went to the museum had n't bothered that boy .	Judy had n't noticed who that queen who went to the museum had n't bothered that boy .
those children forget that that driver who this adult had talked about scares the lady .	those children forget who that driver who this adult had talked about scares the lady .
these teachers had n't seen that that boy who has n't cried confused that person .	these teachers had n't seen who that boy who has n't cried confused that person .
my teachers notice that this child who the king had heard scared those children .	my teachers notice who this child who the king had heard scared those children .
Sarah may remember that that boy who wo n't hate that bottle liked this girl .	Sarah may remember who that boy who wo n't hate that bottle liked this girl .
your teachers saw that that driver who wo n't sing scared these women .	your teachers saw who that driver who wo n't sing scared these women .
my doctors have n't noticed that this lady who runs around that park will scare these guys .	my doctors have n't noticed who this lady who runs around that park will scare these guys .
your teachers have n't learned that this driver who sounds like that snake should n't hate the people .	your teachers have n't learned who this driver who sounds like that snake should n't hate the people .
my son would n't know that this driver who would n't leave the rooms confused that driver .	my son would n't know who this driver who would n't leave the rooms confused that driver .
this lady sees that the queen who will have those buttons would praise those ladies .	this lady sees who the queen who will have those buttons would praise those ladies .
those people must notice that that dancer who walks through those schools must hate the man .	those people must notice who that dancer who walks through those schools must hate the man .
Noah can realize that that guy who was n't talking about these cars has n't bothered the guy .	Noah can realize who that guy who was n't talking about these cars has n't bothered the guy .
these children see that that person who has n't noticed this rabbit is bothering the man .	these children see who that person who has n't noticed this rabbit is bothering the man .
the people know that the queen who lost scared this person .	the people know who the queen who lost scared this person .
Cindy remembered that these doctors who had held those dishes scare these women .	Cindy remembered who these doctors who had held those dishes scare these women .
Marie knew that these doctors who think about those books scare the woman .	Marie knew who these doctors who think about those books scare the woman .
the teachers saw that the boys who left that hospital scare this lady .	the teachers saw who the boys who left that hospital scare this lady .
my doctors did n't see that the child who had n't cried could like these boys .	my doctors did n't see who the child who had n't cried could like these boys .
these doctors had realized that these men who should n't go to the schools had scared this dancer .	these doctors had realized who these men who should n't go to the schools had scared this dancer .
this queen knows that the girls who are talking about that child had n't confused that lady .	this queen knows who the girls who are talking about that child had n't confused that lady .
Kayla has n't seen that those ladies who should think about that boat like this woman .	Kayla has n't seen who those ladies who should think about that boat like this woman .
your son had known that the children who could n't like the shoe could n't like the dentist .	your son had known who the children who could n't like the shoe could n't like the dentist .
those children notice that that patient who must walk through this school was n't bothering the teachers .	those children notice who that patient who must walk through this school was n't bothering the teachers .
my mom forgot that these teachers who would n't forget that window scare the woman .	my mom forgot who these teachers who would n't forget that window scare the woman .
my daughter must see that these children who found these crayons might praise this doctor .	my daughter must see who these children who found these crayons might praise this doctor .
my doctors would n't notice that that man who hears those teachers liked these ladies .	my doctors would n't notice who that man who hears those teachers liked these ladies .
my mom would remember that the lady who the men had heard has n't scared that queen .	my mom would remember who the lady who the men had heard has n't scared that queen .
these children had seen that this queen who had remembered the turtle scares these ladies .	these children had seen who this queen who had remembered the turtle scares these ladies .
this queen has n't seen that these girls who remember that window had confused this dentist .	this queen has n't seen who these girls who remember that window had confused this dentist .
my son saw that the dancer who may love those rings has liked those teachers .	my son saw who the dancer who may love those rings has liked those teachers .
my wife has n't known that the driver who is yelling had liked this lady .	my wife has n't known who the driver who is yelling had liked this lady .
those people remembered that that patient who the girl might sound like could n't like those teachers .	those people remembered who that patient who the girl might sound like could n't like those teachers .
my cousins wo n't know that that teacher who had thought about this man bothered the dentist .	my cousins wo n't know who that teacher who had thought about this man bothered the dentist .
your doctors learn that those children who this child looks like will appreciate this child .	your doctors learn who those children who this child looks like will appreciate this child .
your cousins notice that that king who was moving that mirror would n't bother that girl .	your cousins notice who that king who was moving that mirror would n't bother that girl .
my cousins notice that these teachers who this patient hears scare the women .	my cousins notice who these teachers who this patient hears scare the women .
your cousins do n't remember that these doctors who sound like that snake might bother the teacher .	your cousins do n't remember who these doctors who sound like that snake might bother the teacher .
your cousins could n't see that that woman who was n't talking should like the children .	your cousins could n't see who that woman who was n't talking should like the children .
my doctors did n't remember that this king who the women had n't heard should hate the doctor .	my doctors did n't remember who this king who the women had n't heard should hate the doctor .
your teachers noticed that those men who go to the rooms were bothering the doctors .	your teachers noticed who those men who go to the rooms were bothering the doctors .
your teachers saw that these girls who the queen will hear hate the men .	your teachers saw who these girls who the queen will hear hate the men .
the queen can notice that the adult who may know this turtle scared that king .	the queen can notice who the adult who may know this turtle scared that king .
the lady forgot that the lady who this guy wo n't know likes these girls .	the lady forgot who the lady who this guy wo n't know likes these girls .
the man noticed that those guys who return to this school bother that queen .	the man noticed who those guys who return to this school bother that queen .
those doctors wo n't learn that the dancer who was n't shaking the dish scared the boys .	those doctors wo n't learn who the dancer who was n't shaking the dish scared the boys .
that lady forgot that that man who has heard this lady does n't appreciate the doctor .	that lady forgot who that man who has heard this lady does n't appreciate the doctor .
those doctors might remember that the boys who forgot the doors appreciate that patient .	those doctors might remember who the boys who forgot the doors appreciate that patient .
those children have known that the children who drove to this library could n't scare the people .	those children have known who the children who drove to this library could n't scare the people .
the teachers had n't seen that these children who cough had bothered these doctors .	the teachers had n't seen who these children who cough had bothered these doctors .
Frank did n't forget that the adult who cries has confused those doctors .	Frank did n't forget who the adult who cries has confused those doctors .
my teachers may see that the man who forgot this bicycle had n't bothered the king .	my teachers may see who the man who forgot this bicycle had n't bothered the king .
my doctors remembered that those boys who were throwing those shoes have bothered the boy .	my doctors remembered who those boys who were throwing those shoes have bothered the boy .
Stephanie learned that this patient who yelled could praise this queen .	Stephanie learned who this patient who yelled could praise this queen .
your friends remembered that the lady who is n't whispering had n't scared those people .	your friends remembered who the lady who is n't whispering had n't scared those people .
your teachers would n't remember that the women who liked that plate scared the boys .	your teachers would n't remember who the women who liked that plate scared the boys .
this boy remembered that that girl who talks about the customer liked the women .	this boy remembered who that girl who talks about the customer liked the women .
the queen has n't learned that these children who have painted hate that adult .	the queen has n't learned who these children who have painted hate that adult .
your friends do n't forget that that teacher who liked these bowls might praise that child .	your friends do n't forget who that teacher who liked these bowls might praise that child .
my cousins realize that the girls who could n't lift the books may hate these women .	my cousins realize who the girls who could n't lift the books may hate these women .
those children have n't learned that the guys who this man may talk about did n't scare the dancer .	those children have n't learned who the guys who this man may talk about did n't scare the dancer .
your wife has n't seen that these women who are n't holding the chair did n't like this child .	your wife has n't seen who these women who are n't holding the chair did n't like this child .
my father would n't forget that those people who this dentist must talk about may appreciate the guys .	my father would n't forget who those people who this dentist must talk about may appreciate the guys .
these children know that this man who has n't walked through this museum might hate this driver .	these children know who this man who has n't walked through this museum might hate this driver .
the guy sees that this guy who the boy was talking about scares this guy .	the guy sees who this guy who the boy was talking about scares this guy .
my cousins did n't realize that this lady who had n't thought about that book did n't appreciate those boys .	my cousins did n't realize who this lady who had n't thought about that book did n't appreciate those boys .
your cousins forgot that this king who looked like the girls likes this adult .	your cousins forgot who this king who looked like the girls likes this adult .
your cousins knew that this doctor who cried should hate those men .	your cousins knew who this doctor who cried should hate those men .
these people may know that the adult who wo n't sing is bothering that customer .	these people may know who the adult who wo n't sing is bothering that customer .
your friends wo n't remember that these women who might laugh like these women .	your friends wo n't remember who these women who might laugh like these women .
Karen sees that this girl who will stretch confused that doctor .	Karen sees who this girl who will stretch confused that doctor .
my grandmother did n't learn that the boy who loved that plane liked the king .	my grandmother did n't learn who the boy who loved that plane liked the king .
these people notice that this customer who had n't talked about the guy confused the boy .	these people notice who this customer who had n't talked about the guy confused the boy .
the lady learned that the king who was n't talking about these women confused the adult .	the lady learned who the king who was n't talking about these women confused the adult .
your doctors see that this queen who is n't driving to those schools had liked the men .	your doctors see who this queen who is n't driving to those schools had liked the men .
that king has n't learned that the man who looked like the dog must praise this king .	that king has n't learned who the man who looked like the dog must praise this king .
these doctors had seen that the queen who talked about the turtles had bothered that queen .	these doctors had seen who the queen who talked about the turtles had bothered that queen .
Gregory must realize that the queen who sounded like the patient has n't liked the children .	Gregory must realize who the queen who sounded like the patient has n't liked the children .
my doctors do n't forget that that teacher who has n't thought about those trucks has confused those girls .	my doctors do n't forget who that teacher who has n't thought about those trucks has confused those girls .
Noah noticed that this adult who should n't leave the museum could like this dentist .	Noah noticed who this adult who should n't leave the museum could like this dentist .
these teachers saw that the children who can think about these boxes did n't praise the customer .	these teachers saw who the children who can think about these boxes did n't praise the customer .
my father did n't notice that the boys who return to that mall liked that boy .	my father did n't notice who the boys who return to that mall liked that boy .
the guy realized that these people who had held that ring did n't bother this woman .	the guy realized who these people who had held that ring did n't bother this woman .
your teachers learn that that guy who the doctor knew liked those girls .	your teachers learn who that guy who the doctor knew liked those girls .
these doctors should realize that these boys who passed that mall have n't liked these men .	these doctors should realize who these boys who passed that mall have n't liked these men .
those people remembered that the lady who should look like the teachers must hate these guys .	those people remembered who the lady who should look like the teachers must hate these guys .
your brother knows that those teachers who brought this spoon would n't bother this person .	your brother knows who those teachers who brought this spoon would n't bother this person .
that lady learned that these men who have seen this glass are bothering this doctor .	that lady learned who these men who have seen this glass are bothering this doctor .
those children realized that these girls who drove to this bank hate that adult .	those children realized who these girls who drove to this bank hate that adult .
these children knew that this customer who might lift the glass has confused these doctors .	these children knew who this customer who might lift the glass has confused these doctors .
this girl sees that this lady who ran around the rooms is bothering this queen .	this girl sees who this lady who ran around the rooms is bothering this queen .
Amelia had remembered that the dancer who paints has confused this person .	Amelia had remembered who the dancer who paints has confused this person .
Laura remembered that these girls who have n't read were bothering that woman .	Laura remembered who these girls who have n't read were bothering that woman .
my friends had noticed that the lady who those people look like had confused those teachers .	my friends had noticed who the lady who those people look like had confused those teachers .
your doctors learned that the woman who heard the driver has n't liked the teachers .	your doctors learned who the woman who heard the driver has n't liked the teachers .
my doctors noticed that the person who dropped that rug must bother these ladies .	my doctors noticed who the person who dropped that rug must bother these ladies .
my mom forgot that the queen who was leaving the room would n't scare the person .	my mom forgot who the queen who was leaving the room would n't scare the person .
these teachers realize that the women who talked about those ladies scared the guys .	these teachers realize who the women who talked about those ladies scared the guys .
my mom knows that the person who painted was n't bothering this dentist .	my mom knows who the person who painted was n't bothering this dentist .
the king would n't know that that person who those men would talk about would n't bother the doctors .	the king would n't know who that person who those men would talk about would n't bother the doctors .
the teachers realized that these children who could n't pass the schools appreciate the doctors .	the teachers realized who these children who could n't pass the schools appreciate the doctors .
Vanessa sees that that lady who will practice had liked the ladies .	Vanessa sees who that lady who will practice had liked the ladies .
these children should forget that those people who do n't leave this museum did n't appreciate these boys .	these children should forget who those people who do n't leave this museum did n't appreciate these boys .
Judy has n't realized that this dentist who has n't painted will praise these people .	Judy has n't realized who this dentist who has n't painted will praise these people .
my sister has remembered that that queen who was crying does n't hate this customer .	my sister has remembered who that queen who was crying does n't hate this customer .
my cousins knew that this woman who talks about this boy had n't scared the king .	my cousins knew who this woman who talks about this boy had n't scared the king .
these teachers saw that that guy who could n't sound like the men has n't bothered the customer .	these teachers saw who that guy who could n't sound like the men has n't bothered the customer .
Nancy has n't realized that those girls who are n't keeping the boats have n't scared this person .	Nancy has n't realized who those girls who are n't keeping the boats have n't scared this person .
the children had realized that the women who do n't sound like these women had bothered that customer .	the children had realized who the women who do n't sound like these women had bothered that customer .
those children would remember that the teachers who the people have heard had n't liked this guy .	those children would remember who the teachers who the people have heard had n't liked this guy .
the people did n't see that these children who were n't smiling had bothered this girl .	the people did n't see who these children who were n't smiling had bothered this girl .
those children knew that this boy who had n't thought about those shirts was n't bothering these women .	those children knew who this boy who had n't thought about those shirts was n't bothering these women .
these doctors realized that that queen who has n't talked would appreciate these boys .	these doctors realized who that queen who has n't talked would appreciate these boys .
the king knew that that man who brought these bottles confused those doctors .	the king knew who that man who brought these bottles confused those doctors .
my friends remember that the person who must go to these rooms had bothered the queen .	my friends remember who the person who must go to these rooms had bothered the queen .
Denise did n't remember that that lady who could talk about this picture had liked this woman .	Denise did n't remember who that lady who could talk about this picture had liked this woman .
the doctors remember that the patient who passed that bank did n't bother these ladies .	the doctors remember who the patient who passed that bank did n't bother these ladies .
Dan learned that the dancer who knows those turtles likes the boy .	Dan learned who the dancer who knows those turtles likes the boy .
your wife has realized that the man who was n't talking about this crayon bothered that girl .	your wife has realized who the man who was n't talking about this crayon bothered that girl .
my doctors had seen that those girls who practice have confused this person .	my doctors had seen who those girls who practice have confused this person .
that man had n't seen that these people who might like this lady appreciate these men .	that man had n't seen who these people who might like this lady appreciate these men .
your wife has n't seen that this teacher who the people can n't sound like could hate that king .	your wife has n't seen who this teacher who the people can n't sound like could hate that king .
your brother wo n't see that that adult who could talk about the bed had n't bothered the teachers .	your brother wo n't see who that adult who could talk about the bed had n't bothered the teachers .
these people learn that these people who talk about the toys would n't hate that customer .	these people learn who these people who talk about the toys would n't hate that customer .
these children can n't see that that man who this customer could n't know bothered that dentist .	these children can n't see who that man who this customer could n't know bothered that dentist .
your grandmother saw that the girl who was going to this room had liked this child .	your grandmother saw who the girl who was going to this room had liked this child .
your teachers had n't noticed that the dentist who kept those crayons will hate the driver .	your teachers had n't noticed who the dentist who kept those crayons will hate the driver .
these teachers learned that this king who must read had liked the women .	these teachers learned who this king who must read had liked the women .
those teachers have noticed that the girl who takes that plate would bother that queen .	those teachers have noticed who the girl who takes that plate would bother that queen .
those doctors know that those doctors who this customer had n't talked about bothered this child .	those doctors know who those doctors who this customer had n't talked about bothered this child .
that man sees that that queen who can remember this candle was n't bothering these doctors .	that man sees who that queen who can remember this candle was n't bothering these doctors .
the children should n't see that this teacher who had n't left that school would like the man .	the children should n't see who this teacher who had n't left that school would like the man .
my friends had n't seen that this person who had lost may bother this king .	my friends had n't seen who this person who had lost may bother this king .
your son can realize that that man who was thinking about those cars did n't like the boys .	your son can realize who that man who was thinking about those cars did n't like the boys .
those children realize that that doctor who could n't remember those crayons had n't scared the adult .	those children realize who that doctor who could n't remember those crayons had n't scared the adult .
your sister realized that this teacher who wo n't bring this shirt does n't like that queen .	your sister realized who this teacher who wo n't bring this shirt does n't like that queen .
your cousins saw that the teachers who those girls can look like like the doctors .	your cousins saw who the teachers who those girls can look like like the doctors .
my teachers have n't known that those guys who should n't lie are n't bothering the child .	my teachers have n't known who those guys who should n't lie are n't bothering the child .
the children have n't known that the doctor who that teacher can talk about will appreciate that lady .	the children have n't known who the doctor who that teacher can talk about will appreciate that lady .
your daughter remembered that the adult who noticed that car bothered these boys .	your daughter remembered who the adult who noticed that car bothered these boys .
your doctors should n't see that these boys who those guys heard have confused that adult .	your doctors should n't see who these boys who those guys heard have confused that adult .
Steven forgot that the men who stretch confused the women .	Steven forgot who the men who stretch confused the women .
your cousins saw that those doctors who have n't talked about that dish scare the dentist .	your cousins saw who those doctors who have n't talked about that dish scare the dentist .
Denise remembered that the ladies who the customer was talking about have bothered that child .	Denise remembered who the ladies who the customer was talking about have bothered that child .
my friends realize that these doctors who painted were bothering this boy .	my friends realize who these doctors who painted were bothering this boy .
your friends had n't realized that the ladies who win bothered that adult .	your friends had n't realized who the ladies who win bothered that adult .
my cousins wo n't remember that these girls who hate the bicycle hate these doctors .	my cousins wo n't remember who these girls who hate the bicycle hate these doctors .
that king wo n't learn that the king who moved those candles could scare this boy .	that king wo n't learn who the king who moved those candles could scare this boy .
your son forgot that that boy who had n't moved that bicycle had liked that driver .	your son forgot who that boy who had n't moved that bicycle had liked that driver .
those doctors can n't learn that these doctors who are dropping the fork hate that child .	those doctors can n't learn who these doctors who are dropping the fork hate that child .
these doctors might see that the king who has n't noticed that glass liked that person .	these doctors might see who the king who has n't noticed that glass liked that person .
your friends would n't forget that the lady who could n't paint would hate the teacher .	your friends would n't forget who the lady who could n't paint would hate the teacher .
your cousins could n't realize that the patient who wo n't like these books wo n't hate these doctors .	your cousins could n't realize who the patient who wo n't like these books wo n't hate these doctors .
those people notice that the driver who had read had n't confused that child .	those people notice who the driver who had read had n't confused that child .
my teachers noticed that the person who was talking about this cup had liked the boys .	my teachers noticed who the person who was talking about this cup had liked the boys .
your cousins forgot that those ladies who would remember the spoon wo n't like this driver .	your cousins forgot who those ladies who would remember the spoon wo n't like this driver .
Jerry had realized that the girl who saw the ship liked the guys .	Jerry had realized who the girl who saw the ship liked the guys .
your father learned that the women who would n't stretch hate the children .	your father learned who the women who would n't stretch hate the children .
my cousins know that these guys who took this crayon were n't bothering that woman .	my cousins know who these guys who took this crayon were n't bothering that woman .
those people can realize that this woman who the women heard did n't praise this lady .	those people can realize who this woman who the women heard did n't praise this lady .
your mother must learn that that driver who had won scared this dancer .	your mother must learn who that driver who had won scared this dancer .
those people noticed that those doctors who are talking about the chairs should appreciate that woman .	those people noticed who those doctors who are talking about the chairs should appreciate that woman .
Laura realized that that child who is thinking about that ring bothered the guy .	Laura realized who that child who is thinking about that ring bothered the guy .
those doctors forgot that the boys who are thinking about this man bothered this king .	those doctors forgot who the boys who are thinking about this man bothered this king .
the woman sees that those guys who can n't notice these rabbits like the king .	the woman sees who those guys who can n't notice these rabbits like the king .
your friends might notice that the women who the queen did n't sound like had scared the king .	your friends might notice who the women who the queen did n't sound like had scared the king .
my friends realize that those boys who are n't waving wo n't praise the dancer .	my friends realize who those boys who are n't waving wo n't praise the dancer .
these doctors forget that this queen who may go to the hospital has liked those boys .	these doctors forget who this queen who may go to the hospital has liked those boys .
these teachers would n't realize that those teachers who paint were n't bothering the king .	these teachers would n't realize who those teachers who paint were n't bothering the king .
these teachers see that these people who looked like the men were bothering this girl .	these teachers see who these people who looked like the men were bothering this girl .
your wife had n't seen that these children who would n't scream confused that doctor .	your wife had n't seen who these children who would n't scream confused that doctor .
your brother might know that the women who do n't buy that truck hate those children .	your brother might know who the women who do n't buy that truck hate those children .
these children did n't see that this guy who sounded like these doctors bothered this guy .	these children did n't see who this guy who sounded like these doctors bothered this guy .
this lady does n't see that this girl who was n't talking about the bag can like this person .	this lady does n't see who this girl who was n't talking about the bag can like this person .
your friends remember that the dentist who took that candle likes these children .	your friends remember who the dentist who took that candle likes these children .
Carol will see that that guy who loves these boats scares that customer .	Carol will see who that guy who loves these boats scares that customer .
James has n't known that this dentist who has n't talked about this plane likes this lady .	James has n't known who this dentist who has n't talked about this plane likes this lady .
my dad can notice that that boy who hears the mouse liked the doctors .	my dad can notice who that boy who hears the mouse liked the doctors .
those doctors have realized that the king who took the chairs bothered this lady .	those doctors have realized who the king who took the chairs bothered this lady .
that boy knew that this girl who this customer talks about scared this king .	that boy knew who this girl who this customer talks about scared this king .
that queen learned that these women who the man wo n't look like scared this queen .	that queen learned who these women who the man wo n't look like scared this queen .
Vanessa has n't noticed that the ladies who talked scare the doctors .	Vanessa has n't noticed who the ladies who talked scare the doctors .
my son should know that the people who the girls are talking about could praise the boy .	my son should know who the people who the girls are talking about could praise the boy .
these children had remembered that that driver who liked the guy can bother that woman .	these children had remembered who that driver who liked the guy can bother that woman .
Noah will know that that boy who is holding those buttons can bother these people .	Noah will know who that boy who is holding those buttons can bother these people .
Rebecca realized that that guy who has n't read has n't scared this man .	Rebecca realized who that guy who has n't read has n't scared this man .
those teachers had noticed that the dancer who these men were talking about has n't liked these ladies .	those teachers had noticed who the dancer who these men were talking about has n't liked these ladies .
your father had remembered that the patient who talked about those buttons had n't liked this driver .	your father had remembered who the patient who talked about those buttons had n't liked this driver .
the girl has n't learned that the teachers who cough can appreciate this child .	the girl has n't learned who the teachers who cough can appreciate this child .
that woman has learned that this patient who those girls must sound like did n't scare that dentist .	that woman has learned who this patient who those girls must sound like did n't scare that dentist .
those children did n't notice that the queen who may walk through those schools likes the lady .	those children did n't notice who the queen who may walk through those schools likes the lady .
Karen knew that the guys who had n't found the glasses hate this doctor .	Karen knew who the guys who had n't found the glasses hate this doctor .
