Rachel learned that that dentist likes the boy .	Rachel learned who that dentist likes the boy .
these teachers do n't know that the man should n't bother that person .	these teachers do n't know who the man should n't bother that person .
this lady would remember that these men have n't liked the people .	this lady would remember who these men have n't liked the people .
your teachers saw that that woman might praise this dentist .	your teachers saw who that woman might praise this dentist .
the people notice that these doctors bother the guys .	the people notice who these doctors bother the guys .
my daughter sees that those people will appreciate those children .	my daughter sees who those people will appreciate those children .
that king realized that the woman was bothering these women .	that king realized who the woman was bothering these women .
your cousins saw that the adult had confused the dentist .	your cousins saw who the adult had confused the dentist .
your doctors can notice that this girl is n't bothering the woman .	your doctors can notice who this girl is n't bothering the woman .
the guy had n't remembered that those women bothered these men .	the guy had n't remembered who those women bothered these men .
these children forget that that girl would appreciate these teachers .	these children forget who that girl would appreciate these teachers .
my grandmother has n't realized that this woman has confused that child .	my grandmother has n't realized who this woman has confused that child .
your friends noticed that the people were n't bothering the adult .	your friends noticed who the people were n't bothering the adult .
Andrew will forget that that lady would praise this driver .	Andrew will forget who that lady would praise this driver .
Sarah does n't learn that this person has n't bothered that queen .	Sarah does n't learn who this person has n't bothered that queen .
your husband has n't known that this doctor liked that boy .	your husband has n't known who this doctor liked that boy .
your doctors had remembered that the people had n't liked this lady .	your doctors had remembered who the people had n't liked this lady .
the boy noticed that the men must scare the lady .	the boy noticed who the men must scare the lady .
Noah could forget that those people bothered the teacher .	Noah could forget who those people bothered the teacher .
those teachers could n't forget that the king wo n't scare the men .	those teachers could n't forget who the king wo n't scare the men .
Eric has n't learned that the adult can appreciate that dancer .	Eric has n't learned who the adult can appreciate that dancer .
your doctors forgot that that dentist would n't bother the queen .	your doctors forgot who that dentist would n't bother the queen .
your doctors see that that woman scared this customer .	your doctors see who that woman scared this customer .
your cousins realize that this queen can n't scare the girl .	your cousins realize who this queen can n't scare the girl .
Jason could n't know that that child scared the girls .	Jason could n't know who that child scared the girls .
the children have n't remembered that the woman may scare that dancer .	the children have n't remembered who the woman may scare that dancer .
your doctors do n't remember that the boy had n't bothered the woman .	your doctors do n't remember who the boy had n't bothered the woman .
your friends had known that that king was n't bothering the guys .	your friends had known who that king was n't bothering the guys .
Alexander sees that that woman should hate that girl .	Alexander sees who that woman should hate that girl .
those people must know that that patient will scare this man .	those people must know who that patient will scare this man .
these children had n't remembered that those guys should scare the lady .	these children had n't remembered who those guys should scare the lady .
these people knew that those girls appreciate this lady .	these people knew who those girls appreciate this lady .
my mother can realize that this driver had n't scared those men .	my mother can realize who this driver had n't scared those men .
my daughter saw that the man bothered that doctor .	my daughter saw who the man bothered that doctor .
the queen had seen that this dancer had n't bothered that child .	the queen had seen who this dancer had n't bothered that child .
your cousins remember that that king liked this customer .	your cousins remember who that king liked this customer .
that queen has n't realized that that dentist bothered the men .	that queen has n't realized who that dentist bothered the men .
those doctors saw that that queen does n't like that teacher .	those doctors saw who that queen does n't like that teacher .
your teachers will see that these teachers had liked the customer .	your teachers will see who these teachers had liked the customer .
that woman had n't realized that those guys would appreciate the teachers .	that woman had n't realized who those guys would appreciate the teachers .
the boy knows that these children have n't confused that girl .	the boy knows who these children have n't confused that girl .
your doctors saw that this doctor likes the king .	your doctors saw who this doctor likes the king .
your cousins realize that the boys bother the driver .	your cousins realize who the boys bother the driver .
these teachers realize that the person has bothered that woman .	these teachers realize who the person has bothered that woman .
Linda can n't see that those children would hate this doctor .	Linda can n't see who those children would hate this doctor .
the woman had noticed that this child likes this dentist .	the woman had noticed who this child likes this dentist .
your cousins knew that that person does n't bother this teacher .	your cousins knew who that person does n't bother this teacher .
Mark remembered that this guy scared the ladies .	Mark remembered who this guy scared the ladies .
this woman had n't learned that those teachers bothered the doctor .	this woman had n't learned who those teachers bothered the doctor .
my teachers have n't noticed that the child likes those people .	my teachers have n't noticed who the child likes those people .
your friends remembered that the patient scares the children .	your friends remembered who the patient scares the children .
that guy had realized that that dancer scares that lady .	that guy had realized who that dancer scares that lady .
Brett forgot that that man likes that driver .	Brett forgot who that man likes that driver .
this king has n't seen that that boy liked the patient .	this king has n't seen who that boy liked the patient .
your cousins had n't seen that these children liked that lady .	your cousins had n't seen who these children liked that lady .
my grandmother had n't remembered that the ladies like this dentist .	my grandmother had n't remembered who the ladies like this dentist .
that man wo n't know that the customer can n't praise the women .	that man wo n't know who the customer can n't praise the women .
this queen had n't seen that the guys are n't bothering the king .	this queen had n't seen who the guys are n't bothering the king .
your cousins knew that that dentist scared the boy .	your cousins knew who that dentist scared the boy .
these children saw that that man wo n't appreciate the child .	these children saw who that man wo n't appreciate the child .
the doctors knew that the dancer liked these men .	the doctors knew who the dancer liked these men .
your cousins realize that these teachers scare the guy .	your cousins realize who these teachers scare the guy .
Emily had seen that the women had n't liked this person .	Emily had seen who the women had n't liked this person .
my doctors notice that the people bother the children .	my doctors notice who the people bother the children .
these children saw that the child bothered the boy .	these children saw who the child bothered the boy .
my teachers learn that that lady does n't hate the doctor .	my teachers learn who that lady does n't hate the doctor .
my cousins see that this boy must praise that driver .	my cousins see who this boy must praise that driver .
my dad would n't forget that that girl can scare that person .	my dad would n't forget who that girl can scare that person .
those people had noticed that that man scares the man .	those people had noticed who that man scares the man .
these people have n't remembered that that guy is bothering that queen .	these people have n't remembered who that guy is bothering that queen .
my doctors knew that those guys praise those ladies .	my doctors knew who those guys praise those ladies .
this man had n't known that that woman liked that adult .	this man had n't known who that woman liked that adult .
those children know that the customer bothered that dentist .	those children know who the customer bothered that dentist .
Kayla realized that that patient had n't bothered that woman .	Kayla realized who that patient had n't bothered that woman .
your daughter realized that these girls scared this guy .	your daughter realized who these girls scared this guy .
these children could n't notice that this patient could appreciate the girl .	these children could n't notice who this patient could appreciate the girl .
Denise should n't forget that that adult is n't bothering these men .	Denise should n't forget who that adult is n't bothering these men .
these doctors can n't know that this woman scares the guy .	these doctors can n't know who this woman scares the guy .
your son wo n't notice that the adult had confused the customer .	your son wo n't notice who the adult had confused the customer .
this man sees that that doctor confused this dentist .	this man sees who that doctor confused this dentist .
these teachers remember that the boys appreciate the teachers .	these teachers remember who the boys appreciate the teachers .
the teachers would n't learn that the girl bothered that child .	the teachers would n't learn who the girl bothered that child .
those people forget that those ladies can like this queen .	those people forget who those ladies can like this queen .
Ronald had remembered that this adult wo n't bother that lady .	Ronald had remembered who this adult wo n't bother that lady .
this lady had n't remembered that the guys had n't bothered the people .	this lady had n't remembered who the guys had n't bothered the people .
my mother had n't noticed that those teachers bother the patient .	my mother had n't noticed who those teachers bother the patient .
Naomi wo n't notice that the patient was bothering the queen .	Naomi wo n't notice who the patient was bothering the queen .
your mom wo n't notice that the doctors have n't liked those boys .	your mom wo n't notice who the doctors have n't liked those boys .
your husband has n't known that the dentist scared the person .	your husband has n't known who the dentist scared the person .
those teachers had seen that this king has n't liked these girls .	those teachers had seen who this king has n't liked these girls .
your cousins realized that that person was bothering the queen .	your cousins realized who that person was bothering the queen .
those people may notice that that person could n't scare this child .	those people may notice who that person could n't scare this child .
these people realize that those girls bothered this driver .	these people realize who those girls bothered this driver .
my friends notice that this person can n't hate that adult .	my friends notice who this person can n't hate that adult .
those teachers realize that that dentist scares these boys .	those teachers realize who that dentist scares these boys .
the doctors should n't realize that those teachers scare the child .	the doctors should n't realize who those teachers scare the child .
those teachers have seen that these guys scare the girls .	those teachers have seen who these guys scare the girls .
my teachers learn that this teacher had n't confused this queen .	my teachers learn who this teacher had n't confused this queen .
the teachers do n't realize that this driver bothered those boys .	the teachers do n't realize who this driver bothered those boys .
my son must remember that those children bother those guys .	my son must remember who those children bother those guys .
Julia wo n't realize that the dancer bothered the driver .	Julia wo n't realize who the dancer bothered the driver .
Deborah should n't learn that those women scare the doctors .	Deborah should n't learn who those women scare the doctors .
your teachers can n't realize that the woman has bothered the guys .	your teachers can n't realize who the woman has bothered the guys .
the king has known that the ladies praise this queen .	the king has known who the ladies praise this queen .
William has n't remembered that this child bothered this driver .	William has n't remembered who this child bothered this driver .
the people realize that these girls may appreciate that doctor .	the people realize who these girls may appreciate that doctor .
James remembered that those boys can n't scare these children .	James remembered who those boys can n't scare these children .
my doctors realized that that woman bothered the teacher .	my doctors realized who that woman bothered the teacher .
your doctors remember that that lady scared the adult .	your doctors remember who that lady scared the adult .
your friends have known that this patient likes the teachers .	your friends have known who this patient likes the teachers .
my husband should n't know that that patient is bothering the woman .	my husband should n't know who that patient is bothering the woman .
Barbara forgot that these men wo n't like those women .	Barbara forgot who these men wo n't like those women .
your friends must remember that the customer had n't confused that dentist .	your friends must remember who the customer had n't confused that dentist .
Jerry should n't know that the patient did n't bother the customer .	Jerry should n't know who the patient did n't bother the customer .
my friends could n't see that those men have n't liked the child .	my friends could n't see who those men have n't liked the child .
my son could forget that those doctors liked that king .	my son could forget who those doctors liked that king .
those doctors did n't notice that that doctor is n't bothering these teachers .	those doctors did n't notice who that doctor is n't bothering these teachers .
my father forgot that that dancer scares the person .	my father forgot who that dancer scares the person .
those children have n't seen that this teacher has confused this king .	those children have n't seen who this teacher has confused this king .
these children had n't known that the adult did n't like those men .	these children had n't known who the adult did n't like those men .
my doctors realized that these ladies do n't bother these men .	my doctors realized who these ladies do n't bother these men .
your teachers saw that the doctor would n't praise the children .	your teachers saw who the doctor would n't praise the children .
the children will learn that the child can n't scare the girls .	the children will learn who the child can n't scare the girls .
your father has n't realized that the guys like this boy .	your father has n't realized who the guys like this boy .
my cousins knew that these teachers might appreciate these women .	my cousins knew who these teachers might appreciate these women .
the doctors can n't learn that this queen confused this girl .	the doctors can n't learn who this queen confused this girl .
my cousins saw that these guys have n't bothered that driver .	my cousins saw who these guys have n't bothered that driver .
those people had realized that the man liked this girl .	those people had realized who the man liked this girl .
my dad has n't noticed that the men liked the doctors .	my dad has n't noticed who the men liked the doctors .
my wife has n't realized that those children scared the children .	my wife has n't realized who those children scared the children .
my friends might know that the doctors bothered this king .	my friends might know who the doctors bothered this king .
William had n't known that those ladies scared that dentist .	William had n't known who those ladies scared that dentist .
those children knew that the dentist liked the girl .	those children knew who the dentist liked the girl .
your teachers forget that the guys had liked this queen .	your teachers forget who the guys had liked this queen .
these children knew that that man can n't scare those boys .	these children knew who that man can n't scare those boys .
this queen could n't notice that these guys like those women .	this queen could n't notice who these guys like those women .
your husband has learned that the dancer was n't bothering these doctors .	your husband has learned who the dancer was n't bothering these doctors .
my friends learn that the girls would n't appreciate the lady .	my friends learn who the girls would n't appreciate the lady .
Todd saw that this driver confused those children .	Todd saw who this driver confused those children .
your daughter should n't learn that this adult would n't praise the dentist .	your daughter should n't learn who this adult would n't praise the dentist .
your brother can notice that those boys appreciate the teachers .	your brother can notice who those boys appreciate the teachers .
Lisa would n't notice that this woman should n't scare the driver .	Lisa would n't notice who this woman should n't scare the driver .
these people forget that the boys hate those boys .	these people forget who the boys hate those boys .
my cousins forgot that these ladies confused the girls .	my cousins forgot who these ladies confused the girls .
William knows that the woman liked the customer .	William knows who the woman liked the customer .
your doctors remembered that the lady is n't bothering the person .	your doctors remembered who the lady is n't bothering the person .
that queen has seen that this patient may hate this child .	that queen has seen who this patient may hate this child .
my son had n't remembered that the adult was n't bothering the man .	my son had n't remembered who the adult was n't bothering the man .
my teachers forget that these women had n't liked this lady .	my teachers forget who these women had n't liked this lady .
this queen forgot that this queen has liked this teacher .	this queen forgot who this queen has liked this teacher .
my teachers forgot that those girls appreciate this doctor .	my teachers forgot who those girls appreciate this doctor .
my doctors may notice that the guy liked this patient .	my doctors may notice who the guy liked this patient .
those teachers would learn that the ladies wo n't appreciate this guy .	those teachers would learn who the ladies wo n't appreciate this guy .
that queen has n't seen that the doctor confused that dancer .	that queen has n't seen who the doctor confused that dancer .
my doctors have n't known that that woman bothered the queen .	my doctors have n't known who that woman bothered the queen .
my friends realized that this driver is bothering these children .	my friends realized who this driver is bothering these children .
my doctors notice that the doctor bothered the girls .	my doctors notice who the doctor bothered the girls .
your doctors have n't seen that this child has n't confused the people .	your doctors have n't seen who this child has n't confused the people .
this girl had n't realized that that patient confused the children .	this girl had n't realized who that patient confused the children .
those doctors can n't forget that the guy scares those doctors .	those doctors can n't forget who the guy scares those doctors .
my daughter had known that these children did n't like those women .	my daughter had known who these children did n't like those women .
the king knew that that girl had confused that lady .	the king knew who that girl had confused that lady .
your friends learn that the guys should like that woman .	your friends learn who the guys should like that woman .
my grandmother knows that that child had bothered these men .	my grandmother knows who that child had bothered these men .
your cousins should see that this man will praise this dentist .	your cousins should see who this man will praise this dentist .
the teachers have realized that those men could appreciate the dentist .	the teachers have realized who those men could appreciate the dentist .
Kristen could see that those teachers would like this customer .	Kristen could see who those teachers would like this customer .
your brother remembered that the driver should n't praise the driver .	your brother remembered who the driver should n't praise the driver .
these children remembered that these women appreciate these guys .	these children remembered who these women appreciate these guys .
your mom has n't remembered that the ladies like these children .	your mom has n't remembered who the ladies like these children .
your husband can n't forget that those women are bothering those people .	your husband can n't forget who those women are bothering those people .
these teachers know that the woman can bother the customer .	these teachers know who the woman can bother the customer .
the people should remember that the dancer liked those teachers .	the people should remember who the dancer liked those teachers .
my doctors forget that this driver would scare those doctors .	my doctors forget who this driver would scare those doctors .
Karen must forget that the king will appreciate this child .	Karen must forget who the king will appreciate this child .
your friends had n't remembered that the girls bother this dancer .	your friends had n't remembered who the girls bother this dancer .
my friends forget that these boys scare this patient .	my friends forget who these boys scare this patient .
the children see that that driver scares this boy .	the children see who that driver scares this boy .
your daughter can notice that those teachers scare those guys .	your daughter can notice who those teachers scare those guys .
the woman had n't known that the queen has n't scared the patient .	the woman had n't known who the queen has n't scared the patient .
your friends learn that the children could n't praise those men .	your friends learn who the children could n't praise those men .
the guy has noticed that this dentist could n't scare this queen .	the guy has noticed who this dentist could n't scare this queen .
Sara has n't seen that this queen wo n't appreciate the king .	Sara has n't seen who this queen wo n't appreciate the king .
my doctors realize that the girl has n't bothered that man .	my doctors realize who the girl has n't bothered that man .
your friends could n't learn that those teachers may like those guys .	your friends could n't learn who those teachers may like those guys .
my friends had learned that that lady has n't bothered this dentist .	my friends had learned who that lady has n't bothered this dentist .
these children noticed that the child liked the king .	these children noticed who the child liked the king .
your cousins will learn that the teachers scare that woman .	your cousins will learn who the teachers scare that woman .
Richard has realized that the patient confused this child .	Richard has realized who the patient confused this child .
my brother has known that the people scared this customer .	my brother has known who the people scared this customer .
that boy could learn that the doctors would n't praise that adult .	that boy could learn who the doctors would n't praise that adult .
the teachers knew that the girls liked this patient .	the teachers knew who the girls liked this patient .
your father would remember that those girls do n't appreciate this woman .	your father would remember who those girls do n't appreciate this woman .
my wife has n't noticed that these teachers have confused those people .	my wife has n't noticed who these teachers have confused those people .
these teachers see that that boy should bother that lady .	these teachers see who that boy should bother that lady .
these doctors have known that this boy had n't liked that person .	these doctors have known who this boy had n't liked that person .
that queen has known that the driver must praise that boy .	that queen has known who the driver must praise that boy .
these people will forget that the guy scared the men .	these people will forget who the guy scared the men .
these doctors notice that the teacher liked this person .	these doctors notice who the teacher liked this person .
your father has n't remembered that the driver likes that driver .	your father has n't remembered who the driver likes that driver .
these people notice that these girls had n't scared that man .	these people notice who these girls had n't scared that man .
this lady can remember that that adult must like this lady .	this lady can remember who that adult must like this lady .
your teachers noticed that these teachers have n't bothered the dancer .	your teachers noticed who these teachers have n't bothered the dancer .
David forgot that the ladies bothered the ladies .	David forgot who the ladies bothered the ladies .
Judy noticed that the patient does n't like the king .	Judy noticed who the patient does n't like the king .
my friends might know that those guys bother the woman .	my friends might know who those guys bother the woman .
your cousins remembered that the boys may bother the king .	your cousins remembered who the boys may bother the king .
your doctors must learn that the doctors can n't like the king .	your doctors must learn who the doctors can n't like the king .
your cousins notice that this woman confused these girls .	your cousins notice who this woman confused these girls .
my cousins have seen that these doctors do n't praise that doctor .	my cousins have seen who these doctors do n't praise that doctor .
your friends had known that this patient had n't liked the patient .	your friends had known who this patient had n't liked the patient .
your sister might see that the man had liked these children .	your sister might see who the man had liked these children .
your daughter had seen that that adult should n't praise that person .	your daughter had seen who that adult should n't praise that person .
your doctors see that that doctor liked the teacher .	your doctors see who that doctor liked the teacher .
the king must remember that the woman has scared the queen .	the king must remember who the woman has scared the queen .
your friends can notice that the women confused that queen .	your friends can notice who the women confused that queen .
your mother forgot that this customer is bothering those boys .	your mother forgot who this customer is bothering those boys .
my cousins remember that these ladies like these ladies .	my cousins remember who these ladies like these ladies .
Mary noticed that the driver had scared those doctors .	Mary noticed who the driver had scared those doctors .
the queen will see that the woman bothered the boy .	the queen will see who the woman bothered the boy .
this woman did n't know that that driver is n't bothering that girl .	this woman did n't know who that driver is n't bothering that girl .
this woman remembered that the woman bothered this dentist .	this woman remembered who the woman bothered this dentist .
your doctors know that these teachers scare these children .	your doctors know who these teachers scare these children .
your doctors have known that the doctors scare that customer .	your doctors have known who the doctors scare that customer .
my brother had n't learned that those children hate that lady .	my brother had n't learned who those children hate that lady .
those children saw that those girls have confused this teacher .	those children saw who those girls have confused this teacher .
these teachers can know that that dentist has confused the teacher .	these teachers can know who that dentist has confused the teacher .
Adam could n't remember that that woman liked the guys .	Adam could n't remember who that woman liked the guys .
my friends realize that these people bothered the guy .	my friends realize who these people bothered the guy .
your friends remember that these people scared this customer .	your friends remember who these people scared this customer .
my cousins realized that the man is n't bothering the men .	my cousins realized who the man is n't bothering the men .
my teachers knew that the children liked the guy .	my teachers knew who the children liked the guy .
Jessica would realize that this man could n't like these men .	Jessica would realize who this man could n't like these men .
your teachers should see that this queen confused these boys .	your teachers should see who this queen confused these boys .
Alexander could forget that the ladies could scare this queen .	Alexander could forget who the ladies could scare this queen .
my son has n't remembered that the girls like this girl .	my son has n't remembered who the girls like this girl .
those children forgot that the children did n't appreciate those boys .	those children forgot who the children did n't appreciate those boys .
your cousins had n't known that this patient could like those men .	your cousins had n't known who this patient could like those men .
that lady learned that the lady scared the patient .	that lady learned who the lady scared the patient .
the doctors have n't known that these ladies praise this queen .	the doctors have n't known who these ladies praise this queen .
your friends realized that that king has n't liked those girls .	your friends realized who that king has n't liked those girls .
the teachers noticed that this boy could appreciate the doctors .	the teachers noticed who this boy could appreciate the doctors .
Jennifer had learned that the women liked those women .	Jennifer had learned who the women liked those women .
those doctors had n't known that the children could hate this lady .	those doctors had n't known who the children could hate this lady .
your friends learned that those men scare these men .	your friends learned who those men scare these men .
these people know that this teacher should n't praise that queen .	these people know who this teacher should n't praise that queen .
my friends forgot that the people liked that adult .	my friends forgot who the people liked that adult .
the children remember that these ladies can n't hate the adult .	the children remember who these ladies can n't hate the adult .
your friends can see that this teacher scares the doctors .	your friends can see who this teacher scares the doctors .
those people realize that this teacher had n't scared that person .	those people realize who this teacher had n't scared that person .
the people knew that the guys liked that queen .	the people knew who the guys liked that queen .
those doctors forget that this customer could hate that king .	those doctors forget who this customer could hate that king .
those doctors learn that the people scare those women .	those doctors learn who the people scare those women .
your mother should remember that those children wo n't praise this guy .	your mother should remember who those children wo n't praise this guy .
these doctors should n't know that that dentist has n't liked that girl .	these doctors should n't know who that dentist has n't liked that girl .
my teachers did n't learn that the guy would appreciate those doctors .	my teachers did n't learn who the guy would appreciate those doctors .
the children may forget that these boys were n't bothering this patient .	the children may forget who these boys were n't bothering this patient .
Nancy had learned that this patient has n't confused that woman .	Nancy had learned who this patient has n't confused that woman .
that guy can n't learn that this driver had bothered those guys .	that guy can n't learn who this driver had bothered those guys .
my doctors forget that those girls were bothering this child .	my doctors forget who those girls were bothering this child .
this lady knew that this boy confused these women .	this lady knew who this boy confused these women .
my friends realized that the customer liked this woman .	my friends realized who the customer liked this woman .
my teachers know that these teachers were n't bothering this child .	my teachers know who these teachers were n't bothering this child .
my dad would forget that those ladies confused the children .	my dad would forget who those ladies confused the children .
these teachers have realized that this dentist was n't bothering that teacher .	these teachers have realized who this dentist was n't bothering that teacher .
Jerry has noticed that that customer scares those women .	Jerry has noticed who that customer scares those women .
my friends remember that the men like the women .	my friends remember who the men like the women .
these doctors knew that this dancer liked the queen .	these doctors knew who this dancer liked the queen .
that boy has n't learned that that boy should scare the adult .	that boy has n't learned who that boy should scare the adult .
Peter wo n't see that this man likes these women .	Peter wo n't see who this man likes these women .
these children did n't realize that this driver has scared that child .	these children did n't realize who this driver has scared that child .
these doctors realized that the doctors bothered the person .	these doctors realized who the doctors bothered the person .
my husband has n't known that those people hate the woman .	my husband has n't known who those people hate the woman .
my teachers might see that these ladies have n't liked those ladies .	my teachers might see who these ladies have n't liked those ladies .
the teachers remembered that those doctors liked those women .	the teachers remembered who those doctors liked those women .
my cousins had n't noticed that that patient scared this king .	my cousins had n't noticed who that patient scared this king .
Erin realized that that man should n't appreciate this person .	Erin realized who that man should n't appreciate this person .
my doctors could n't realize that the children should n't hate the woman .	my doctors could n't realize who the children should n't hate the woman .
my doctors would notice that that man can n't appreciate those people .	my doctors would notice who that man can n't appreciate those people .
the children wo n't realize that that woman may like this man .	the children wo n't realize who that woman may like this man .
that queen has remembered that that dancer did n't appreciate that dentist .	that queen has remembered who that dancer did n't appreciate that dentist .
Daniel could see that these children like the woman .	Daniel could see who these children like the woman .
your doctors notice that these people can bother those people .	your doctors notice who these people can bother those people .
my grandmother saw that the children scared that child .	my grandmother saw who the children scared that child .
the doctors see that the king was n't bothering that customer .	the doctors see who the king was n't bothering that customer .
your friends knew that the child bothered the queen .	your friends knew who the child bothered the queen .
that woman can learn that that patient confused the teachers .	that woman can learn who that patient confused the teachers .
your cousins had noticed that the girls bothered those women .	your cousins had noticed who the girls bothered those women .
your doctors know that the boy should like the driver .	your doctors know who the boy should like the driver .
Naomi noticed that that woman is bothering the king .	Naomi noticed who that woman is bothering the king .
your cousins have n't remembered that that queen scares those children .	your cousins have n't remembered who that queen scares those children .
Alexander had noticed that those girls liked the queen .	Alexander had noticed who those girls liked the queen .
my friends notice that this teacher has liked the dentist .	my friends notice who this teacher has liked the dentist .
my cousins do n't realize that that lady had liked the adult .	my cousins do n't realize who that lady had liked the adult .
the children know that that boy is n't bothering those boys .	the children know who that boy is n't bothering those boys .
Frank might know that the man had confused the guy .	Frank might know who the man had confused the guy .
those children learned that that patient has n't bothered these people .	those children learned who that patient has n't bothered these people .
the king should n't remember that the person had n't liked that teacher .	the king should n't remember who the person had n't liked that teacher .
your friends know that those ladies scared these women .	your friends know who those ladies scared these women .
Kristen sees that those guys should bother these teachers .	Kristen sees who those guys should bother these teachers .
the boy remembered that that boy will praise that adult .	the boy remembered who that boy will praise that adult .
these people have n't remembered that the patient may like that king .	these people have n't remembered who the patient may like that king .
your husband learned that that woman was bothering this customer .	your husband learned who that woman was bothering this customer .
the children realized that those guys must scare the queen .	the children realized who those guys must scare the queen .
my doctors remembered that this queen had n't bothered this boy .	my doctors remembered who this queen had n't bothered this boy .
those children notice that that person scared those women .	those children notice who that person scared those women .
William did n't realize that this customer had liked the men .	William did n't realize who this customer had liked the men .
Jill saw that this driver has scared that driver .	Jill saw who this driver has scared that driver .
your grandmother has n't remembered that this dancer likes this king .	your grandmother has n't remembered who this dancer likes this king .
this man had seen that those men would bother that woman .	this man had seen who those men would bother that woman .
those children realize that the teacher wo n't praise the ladies .	those children realize who the teacher wo n't praise the ladies .
my dad learned that this customer likes those boys .	my dad learned who this customer likes those boys .
those teachers remember that these children scared this lady .	those teachers remember who these children scared this lady .
these doctors have n't noticed that these women could n't hate the women .	these doctors have n't noticed who these women could n't hate the women .
these doctors had n't learned that these guys like the girl .	these doctors had n't learned who these guys like the girl .
those teachers could know that this driver was bothering that boy .	those teachers could know who this driver was bothering that boy .
the doctors forget that the adult scared the children .	the doctors forget who the adult scared the children .
Dan noticed that the ladies confused the girls .	Dan noticed who the ladies confused the girls .
my cousins learned that this customer would hate these people .	my cousins learned who this customer would hate these people .
Sarah knew that these guys should n't praise those boys .	Sarah knew who these guys should n't praise those boys .
the children could n't know that that doctor bothered the doctor .	the children could n't know who that doctor bothered the doctor .
Thomas has remembered that those boys had n't bothered these ladies .	Thomas has remembered who those boys had n't bothered these ladies .
those teachers learned that this boy scared this man .	those teachers learned who this boy scared this man .
Tracy sees that the adult did n't praise these teachers .	Tracy sees who the adult did n't praise these teachers .
your doctors do n't learn that the children should scare this boy .	your doctors do n't learn who the children should scare this boy .
the teachers knew that this person was bothering this queen .	the teachers knew who this person was bothering this queen .
that woman might learn that the doctor wo n't like that dentist .	that woman might learn who the doctor wo n't like that dentist .
that king does n't remember that the guys were n't bothering those ladies .	that king does n't remember who the guys were n't bothering those ladies .
this woman had learned that this guy bothered the boy .	this woman had learned who this guy bothered the boy .
those teachers forgot that the child is n't bothering the doctors .	those teachers forgot who the child is n't bothering the doctors .
your teachers saw that the guys would n't praise that customer .	your teachers saw who the guys would n't praise that customer .
your brother did n't learn that that dancer had bothered the girls .	your brother did n't learn who that dancer had bothered the girls .
the children remembered that the customer scared the dancer .	the children remembered who the customer scared the dancer .
my mother could realize that these girls bother the man .	my mother could realize who these girls bother the man .
Becca learned that the guy is bothering this man .	Becca learned who the guy is bothering this man .
Bill did n't realize that those doctors hate these ladies .	Bill did n't realize who those doctors hate these ladies .
these teachers wo n't realize that these teachers have scared the teachers .	these teachers wo n't realize who these teachers have scared the teachers .
those teachers learned that that girl had bothered the person .	those teachers learned who that girl had bothered the person .
your cousins see that that queen had confused the people .	your cousins see who that queen had confused the people .
those people would n't see that that doctor bothered the guy .	those people would n't see who that doctor bothered the guy .
Karen would remember that these women appreciate these women .	Karen would remember who these women appreciate these women .
those children realize that these people scare the teacher .	those children realize who these people scare the teacher .
Liam forgot that this child has n't scared that person .	Liam forgot who this child has n't scared that person .
your brother wo n't realize that that guy had n't confused this man .	your brother wo n't realize who that guy had n't confused this man .
Bill sees that these girls confused the woman .	Bill sees who these girls confused the woman .
my daughter does n't learn that that child confused this child .	my daughter does n't learn who that child confused this child .
your teachers had learned that the people scare the person .	your teachers had learned who the people scare the person .
these people remember that these boys liked the boy .	these people remember who these boys liked the boy .
my husband realized that the girls confused these children .	my husband realized who the girls confused these children .
my teachers may know that this queen was bothering the woman .	my teachers may know who this queen was bothering the woman .
my father should n't see that this boy had confused the teachers .	my father should n't see who this boy had confused the teachers .
these people forget that those teachers would hate this dancer .	these people forget who those teachers would hate this dancer .
those children know that the teacher might bother the person .	those children know who the teacher might bother the person .
that boy could n't see that that customer could hate the man .	that boy could n't see who that customer could hate the man .
your daughter had seen that the children hate this lady .	your daughter had seen who the children hate this lady .
those people see that the king should appreciate that dancer .	those people see who the king should appreciate that dancer .
your cousins remembered that the person has n't confused the dancer .	your cousins remembered who the person has n't confused the dancer .
the king may learn that those guys can n't appreciate the doctors .	the king may learn who those guys can n't appreciate the doctors .
my cousins can see that these girls bother this adult .	my cousins can see who these girls bother this adult .
my friends remember that this man has scared that doctor .	my friends remember who this man has scared that doctor .
the guy forgot that these doctors liked the men .	the guy forgot who these doctors liked the men .
your teachers forgot that that king bothered these children .	your teachers forgot who that king bothered these children .
my teachers notice that this dentist confused these women .	my teachers notice who this dentist confused these women .
the children knew that that guy scares this queen .	the children knew who that guy scares this queen .
your son must realize that those doctors will hate this adult .	your son must realize who those doctors will hate this adult .
the queen noticed that the boy scares these people .	the queen noticed who the boy scares these people .
these children had n't realized that the women confused these people .	these children had n't realized who the women confused these people .
these children would n't notice that this dentist could scare the girls .	these children would n't notice who this dentist could scare the girls .
this man can n't see that the men praise the teachers .	this man can n't see who the men praise the teachers .
the people saw that this teacher likes that man .	the people saw who this teacher likes that man .
this guy forgot that that guy liked these boys .	this guy forgot who that guy liked these boys .
the girl learned that these doctors liked that driver .	the girl learned who these doctors liked that driver .
my father saw that the person had n't confused the ladies .	my father saw who the person had n't confused the ladies .
these doctors learned that this queen likes this person .	these doctors learned who this queen likes this person .
the lady could notice that those teachers can scare the girls .	the lady could notice who those teachers can scare the girls .
your sister realized that the children do n't hate the boy .	your sister realized who the children do n't hate the boy .
this guy has n't noticed that those teachers do n't bother the woman .	this guy has n't noticed who those teachers do n't bother the woman .
these people forget that this boy has n't scared that person .	these people forget who this boy has n't scared that person .
my friends have realized that those guys would n't praise this child .	my friends have realized who those guys would n't praise this child .
that guy forgot that the king was bothering that customer .	that guy forgot who the king was bothering that customer .
my friends had n't noticed that the girls bother this girl .	my friends had n't noticed who the girls bother this girl .
these people noticed that that king had scared the ladies .	these people noticed who that king had scared the ladies .
that boy knows that that woman scared the men .	that boy knows who that woman scared the men .
the queen has noticed that that adult is bothering this dentist .	the queen has noticed who that adult is bothering this dentist .
Allison had n't learned that this queen bothered that dancer .	Allison had n't learned who this queen bothered that dancer .
my daughter could n't notice that these teachers should n't like that king .	my daughter could n't notice who these teachers should n't like that king .
my doctors had noticed that the king would appreciate the lady .	my doctors had noticed who the king would appreciate the lady .
these people had n't seen that these ladies scared that driver .	these people had n't seen who these ladies scared that driver .
my dad learned that that dancer liked the boys .	my dad learned who that dancer liked the boys .
your friends might remember that the boys have n't bothered the boy .	your friends might remember who the boys have n't bothered the boy .
these doctors do n't remember that that teacher should n't scare the adult .	these doctors do n't remember who that teacher should n't scare the adult .
Michael did n't notice that that dancer has scared this person .	Michael did n't notice who that dancer has scared this person .
my mother would realize that that man can hate these teachers .	my mother would realize who that man can hate these teachers .
my doctors notice that this man might praise this dentist .	my doctors notice who this man might praise this dentist .
these children learn that this lady had n't liked the children .	these children learn who this lady had n't liked the children .
your doctors remember that the guys had confused these teachers .	your doctors remember who the guys had confused these teachers .
your doctors remember that those women appreciate the man .	your doctors remember who those women appreciate the man .
my teachers had known that the dancer can n't scare the doctor .	my teachers had known who the dancer can n't scare the doctor .
your father has n't seen that these people should n't praise the girls .	your father has n't seen who these people should n't praise the girls .
my teachers remember that this girl bothered the dancer .	my teachers remember who this girl bothered the dancer .
your grandmother learned that the ladies like the girl .	your grandmother learned who the ladies like the girl .
your mom noticed that these children do n't scare that person .	your mom noticed who these children do n't scare that person .
my cousins have n't learned that this driver should appreciate the women .	my cousins have n't learned who this driver should appreciate the women .
this guy had n't seen that this customer confused that dancer .	this guy had n't seen who this customer confused that dancer .
Linda may notice that the children are bothering that patient .	Linda may notice who the children are bothering that patient .
the children have n't learned that this customer had liked that dentist .	the children have n't learned who this customer had liked that dentist .
Kristen learned that those boys have n't confused that dancer .	Kristen learned who those boys have n't confused that dancer .
these doctors forget that this doctor would appreciate that doctor .	these doctors forget who this doctor would appreciate that doctor .
your wife has n't seen that that king has bothered this person .	your wife has n't seen who that king has bothered this person .
your doctors noticed that this doctor bothered these men .	your doctors noticed who this doctor bothered these men .
the doctors know that the dancer will hate this doctor .	the doctors know who the dancer will hate this doctor .
this man can see that the customer liked those children .	this man can see who the customer liked those children .
these children have n't remembered that those teachers bothered that dancer .	these children have n't remembered who those teachers bothered that dancer .
Aaron can n't forget that the ladies should n't hate the queen .	Aaron can n't forget who the ladies should n't hate the queen .
the boy had n't learned that this person would scare that girl .	the boy had n't learned who this person would scare that girl .
those teachers remembered that the guy has n't scared the adult .	those teachers remembered who the guy has n't scared the adult .
your son knew that the doctor could n't praise that guy .	your son knew who the doctor could n't praise that guy .
your cousins do n't learn that this boy may like this queen .	your cousins do n't learn who this boy may like this queen .
those teachers forget that those men bothered these doctors .	those teachers forget who those men bothered these doctors .
my friends have n't remembered that the adult had n't liked this woman .	my friends have n't remembered who the adult had n't liked this woman .
the woman remembered that this teacher is bothering this teacher .	the woman remembered who this teacher is bothering this teacher .
these teachers had noticed that the person was n't bothering that doctor .	these teachers had noticed who the person was n't bothering that doctor .
Robert had realized that those boys could praise the person .	Robert had realized who those boys could praise the person .
the queen has n't remembered that these children like that child .	the queen has n't remembered who these children like that child .
this guy could n't notice that that boy would appreciate that adult .	this guy could n't notice who that boy would appreciate that adult .
these people noticed that this boy may praise the doctor .	these people noticed who this boy may praise the doctor .
these teachers may know that the ladies hate the guys .	these teachers may know who the ladies hate the guys .
your cousins noticed that the child can n't like that guy .	your cousins noticed who the child can n't like that guy .
your friends might learn that these boys may bother that boy .	your friends might learn who these boys may bother that boy .
the lady may notice that that king has scared the men .	the lady may notice who that king has scared the men .
Mary could learn that that dancer would n't bother that girl .	Mary could learn who that dancer would n't bother that girl .
these people have n't noticed that that boy bothered that dancer .	these people have n't noticed who that boy bothered that dancer .
Peter has n't learned that this adult scares that driver .	Peter has n't learned who this adult scares that driver .
these doctors notice that these girls had n't scared these guys .	these doctors notice who these girls had n't scared these guys .
your cousins have n't realized that this teacher did n't like these children .	your cousins have n't realized who this teacher did n't like these children .
Susan could notice that these men hate that child .	Susan could notice who these men hate that child .
this guy had known that this girl does n't like those guys .	this guy had known who this girl does n't like those guys .
the teachers see that those men confused the dentist .	the teachers see who those men confused the dentist .
the children learned that the boys appreciate that man .	the children learned who the boys appreciate that man .
those children realized that the children confused these women .	those children realized who the children confused these women .
my doctors realize that these doctors were bothering the dancer .	my doctors realize who these doctors were bothering the dancer .
this woman noticed that these doctors had confused that child .	this woman noticed who these doctors had confused that child .
your friends saw that these women had n't bothered this king .	your friends saw who these women had n't bothered this king .
my grandmother saw that this person likes that dentist .	my grandmother saw who this person likes that dentist .
Vanessa has learned that this dancer has n't bothered those people .	Vanessa has learned who this dancer has n't bothered those people .
my son had n't noticed that the teacher may like the girls .	my son had n't noticed who the teacher may like the girls .
my cousins did n't see that these girls did n't scare this king .	my cousins did n't see who these girls did n't scare this king .
your dad could n't forget that the adult has n't bothered that queen .	your dad could n't forget who the adult has n't bothered that queen .
the lady saw that this customer will appreciate the lady .	the lady saw who this customer will appreciate the lady .
the doctors do n't forget that the queen is n't bothering this driver .	the doctors do n't forget who the queen is n't bothering this driver .
the children may forget that those people do n't scare those ladies .	the children may forget who those people do n't scare those ladies .
this lady sees that that child does n't hate the man .	this lady sees who that child does n't hate the man .
Frank knows that those boys would n't hate that girl .	Frank knows who those boys would n't hate that girl .
your father had realized that the lady could scare these teachers .	your father had realized who the lady could scare these teachers .
the children had seen that this queen bothered these ladies .	the children had seen who this queen bothered these ladies .
those teachers should forget that these women have scared this queen .	those teachers should forget who these women have scared this queen .
the queen might see that that dentist can like these doctors .	the queen might see who that dentist can like these doctors .
these children see that that boy likes the teachers .	these children see who that boy likes the teachers .
your doctors realized that that boy would n't like this queen .	your doctors realized who that boy would n't like this queen .
your son does n't know that the dancer could scare this king .	your son does n't know who the dancer could scare this king .
those teachers have remembered that these boys had liked the teachers .	those teachers have remembered who these boys had liked the teachers .
these doctors realize that this driver has liked that person .	these doctors realize who this driver has liked that person .
your doctors can n't notice that those doctors do n't praise that person .	your doctors can n't notice who those doctors do n't praise that person .
this boy learned that the dancer scares the child .	this boy learned who the dancer scares the child .
your father remembered that that boy had bothered the guys .	your father remembered who that boy had bothered the guys .
these people have known that these doctors would n't bother those ladies .	these people have known who these doctors would n't bother those ladies .
those doctors have n't realized that the adult likes that king .	those doctors have n't realized who the adult likes that king .
the children realize that the queen confused these ladies .	the children realize who the queen confused these ladies .
this guy would realize that this lady confused the doctors .	this guy would realize who this lady confused the doctors .
these children had seen that the lady has confused the driver .	these children had seen who the lady has confused the driver .
the children could n't notice that the guys had scared those girls .	the children could n't notice who the guys had scared those girls .
that woman forgot that this girl confused that customer .	that woman forgot who this girl confused that customer .
that girl did n't forget that the customer has liked the children .	that girl did n't forget who the customer has liked the children .
these people remember that these men are n't bothering the doctor .	these people remember who these men are n't bothering the doctor .
Joseph has remembered that that driver is bothering the dancer .	Joseph has remembered who that driver is bothering the dancer .
my teachers have learned that the dentist bothered that dancer .	my teachers have learned who the dentist bothered that dancer .
Andrew forgot that that dentist should appreciate that patient .	Andrew forgot who that dentist should appreciate that patient .
the doctors saw that the girl bothered this girl .	the doctors saw who the girl bothered this girl .
my son can forget that the driver was n't bothering those men .	my son can forget who the driver was n't bothering those men .
the children may realize that the doctors liked the driver .	the children may realize who the doctors liked the driver .
those people remembered that the guy must hate that dentist .	those people remembered who the guy must hate that dentist .
my father has n't seen that the girls will hate the girls .	my father has n't seen who the girls will hate the girls .
that king did n't learn that that dentist can hate this customer .	that king did n't learn who that dentist can hate this customer .
Robert has n't seen that this man had n't bothered the customer .	Robert has n't seen who this man had n't bothered the customer .
the boy might realize that this guy had n't confused that lady .	the boy might realize who this guy had n't confused that lady .
your son could n't learn that these ladies confused these women .	your son could n't learn who these ladies confused these women .
John could n't see that those men were n't bothering those girls .	John could n't see who those men were n't bothering those girls .
those doctors could forget that that boy did n't scare this guy .	those doctors could forget who that boy did n't scare this guy .
my husband saw that that boy will like these girls .	my husband saw who that boy will like these girls .
my friends might know that the ladies can appreciate the men .	my friends might know who the ladies can appreciate the men .
your cousins realized that this girl would appreciate the ladies .	your cousins realized who this girl would appreciate the ladies .
my dad had remembered that the people must bother that teacher .	my dad had remembered who the people must bother that teacher .
your cousins learned that the customer confused this customer .	your cousins learned who the customer confused this customer .
those doctors do n't see that these doctors had n't bothered that girl .	those doctors do n't see who these doctors had n't bothered that girl .
these children know that these doctors could appreciate the queen .	these children know who these doctors could appreciate the queen .
these people will see that the king could appreciate that person .	these people will see who the king could appreciate that person .
the doctors can n't see that the children must hate the lady .	the doctors can n't see who the children must hate the lady .
the children noticed that these guys scared the driver .	the children noticed who these guys scared the driver .
Samantha learned that this lady should n't hate the driver .	Samantha learned who this lady should n't hate the driver .
that king would n't realize that the driver can scare the teachers .	that king would n't realize who the driver can scare the teachers .
my wife had remembered that those people had confused the person .	my wife had remembered who those people had confused the person .
Nancy had n't noticed that these ladies would bother those teachers .	Nancy had n't noticed who these ladies would bother those teachers .
that king does n't notice that the lady had scared the people .	that king does n't notice who the lady had scared the people .
Todd should know that that guy could praise the dentist .	Todd should know who that guy could praise the dentist .
your teachers could n't know that this man has n't bothered those ladies .	your teachers could n't know who this man has n't bothered those ladies .
your sister must know that those girls confused these women .	your sister must know who those girls confused these women .
that woman wo n't forget that those boys had confused that patient .	that woman wo n't forget who those boys had confused that patient .
your doctors remember that that guy is bothering the child .	your doctors remember who that guy is bothering the child .
John remembered that this king would n't appreciate this patient .	John remembered who this king would n't appreciate this patient .
your friends have learned that that customer likes that man .	your friends have learned who that customer likes that man .
my grandmother knows that this guy does n't hate those girls .	my grandmother knows who this guy does n't hate those girls .
my friends remembered that the ladies can bother those guys .	my friends remembered who the ladies can bother those guys .
your friends did n't know that this doctor can n't appreciate those women .	your friends did n't know who this doctor can n't appreciate those women .
the girl can know that this teacher may bother this girl .	the girl can know who this teacher may bother this girl .
my mother saw that this dancer was bothering the boy .	my mother saw who this dancer was bothering the boy .
your husband must realize that those ladies were n't bothering those guys .	your husband must realize who those ladies were n't bothering those guys .
my cousins had remembered that the patient had n't confused that king .	my cousins had remembered who the patient had n't confused that king .
the queen knew that the person would scare the dancer .	the queen knew who the person would scare the dancer .
your sister noticed that those guys scared those men .	your sister noticed who those guys scared those men .
the teachers noticed that these men appreciate the customer .	the teachers noticed who these men appreciate the customer .
these children knew that that person wo n't hate the guys .	these children knew who that person wo n't hate the guys .
those people remembered that the customer had n't bothered this dancer .	those people remembered who the customer had n't bothered this dancer .
your daughter learned that the girl was n't bothering that child .	your daughter learned who the girl was n't bothering that child .
the doctors could n't see that that king bothered this driver .	the doctors could n't see who that king bothered this driver .
Paul had n't noticed that the queen had n't scared the men .	Paul had n't noticed who the queen had n't scared the men .
these people would remember that those people scare these people .	these people would remember who those people scare these people .
Alexander wo n't remember that those ladies bother the driver .	Alexander wo n't remember who those ladies bother the driver .
your daughter learned that those boys have scared the man .	your daughter learned who those boys have scared the man .
this woman knew that this girl scares the guys .	this woman knew who this girl scares the guys .
my teachers forgot that that adult confused these doctors .	my teachers forgot who that adult confused these doctors .
those doctors had realized that the dentist had n't confused this king .	those doctors had realized who the dentist had n't confused this king .
your teachers notice that the women have bothered the teachers .	your teachers notice who the women have bothered the teachers .
those children have n't learned that that king likes the teachers .	those children have n't learned who that king likes the teachers .
that woman can see that the doctor was bothering this dentist .	that woman can see who the doctor was bothering this dentist .
your husband may forget that this dancer can n't like this doctor .	your husband may forget who this dancer can n't like this doctor .
my daughter noticed that this boy has n't scared this person .	my daughter noticed who this boy has n't scared this person .
your friends could n't know that these women praise that teacher .	your friends could n't know who these women praise that teacher .
the lady saw that these ladies could praise those people .	the lady saw who these ladies could praise those people .
my mother can n't know that that driver had confused that adult .	my mother can n't know who that driver had confused that adult .
your mom saw that this child has n't bothered the people .	your mom saw who this child has n't bothered the people .
this woman would n't notice that the people could n't like the patient .	this woman would n't notice who the people could n't like the patient .
this guy must notice that those guys can n't bother the ladies .	this guy must notice who those guys can n't bother the ladies .
these children had known that these girls do n't appreciate the girls .	these children had known who these girls do n't appreciate the girls .
your sister noticed that the people praise the king .	your sister noticed who the people praise the king .
the children realize that this patient had scared the teachers .	the children realize who this patient had scared the teachers .
the girl forgot that that king must like the women .	the girl forgot who that king must like the women .
your teachers should learn that the patient has confused this dancer .	your teachers should learn who the patient has confused this dancer .
this girl has realized that the girls liked the driver .	this girl has realized who the girls liked the driver .
your cousins remember that these girls have n't scared this king .	your cousins remember who these girls have n't scared this king .
my cousins realize that these boys had n't scared the guy .	my cousins realize who these boys had n't scared the guy .
my brother had realized that the girls would n't hate that girl .	my brother had realized who the girls would n't hate that girl .
the girl remembered that the customer has n't confused this patient .	the girl remembered who the customer has n't confused this patient .
Erin sees that that boy liked the men .	Erin sees who that boy liked the men .
Gregory wo n't remember that those ladies should n't scare these women .	Gregory wo n't remember who those ladies should n't scare these women .
these people will learn that these boys liked the guys .	these people will learn who these boys liked the guys .
those children notice that that doctor scared the ladies .	those children notice who that doctor scared the ladies .
Janet knows that that dentist scared those girls .	Janet knows who that dentist scared those girls .
my teachers forget that the people should n't bother those women .	my teachers forget who the people should n't bother those women .
the man may remember that those men would n't appreciate that teacher .	the man may remember who those men would n't appreciate that teacher .
the doctors would remember that that dentist had n't bothered this man .	the doctors would remember who that dentist had n't bothered this man .
your doctors must remember that this girl will praise that doctor .	your doctors must remember who this girl will praise that doctor .
the queen could notice that this customer bothered this girl .	the queen could notice who this customer bothered this girl .
Martin remembered that this guy liked this queen .	Martin remembered who this guy liked this queen .
those children know that those teachers have n't liked that queen .	those children know who those teachers have n't liked that queen .
that king knows that the person had n't bothered this doctor .	that king knows who the person had n't bothered this doctor .
Laura wo n't remember that those women appreciate these guys .	Laura wo n't remember who those women appreciate these guys .
my cousins could notice that the patient would n't like the lady .	my cousins could notice who the patient would n't like the lady .
Jill knew that the queen had n't bothered the customer .	Jill knew who the queen had n't bothered the customer .
this king remembered that the children hate those women .	this king remembered who the children hate those women .
the doctors should learn that the men scared that man .	the doctors should learn who the men scared that man .
Eric wo n't remember that this guy can n't praise these boys .	Eric wo n't remember who this guy can n't praise these boys .
my brother saw that the lady would n't scare those doctors .	my brother saw who the lady would n't scare those doctors .
the children see that this girl confused that girl .	the children see who this girl confused that girl .
that lady has n't seen that that adult likes this child .	that lady has n't seen who that adult likes this child .
the doctors could n't forget that the patient liked this adult .	the doctors could n't forget who the patient liked this adult .
the girl knows that this boy would bother the doctor .	the girl knows who this boy would bother the doctor .
my grandmother may remember that those ladies praise the ladies .	my grandmother may remember who those ladies praise the ladies .
Robert had known that this dancer is n't bothering this king .	Robert had known who this dancer is n't bothering this king .
Alexander remembered that that woman can hate the customer .	Alexander remembered who that woman can hate the customer .
my doctors realize that those guys had n't liked the queen .	my doctors realize who those guys had n't liked the queen .
the lady knew that this teacher liked the children .	the lady knew who this teacher liked the children .
Tracy had noticed that those girls have scared this queen .	Tracy had noticed who those girls have scared this queen .
those people forget that these boys should n't bother this adult .	those people forget who these boys should n't bother this adult .
those doctors can n't forget that that person had n't liked the girls .	those doctors can n't forget who that person had n't liked the girls .
those people forgot that the lady confused that customer .	those people forgot who the lady confused that customer .
these children have seen that the children appreciate the patient .	these children have seen who the children appreciate the patient .
the children can n't forget that this dancer had n't liked this woman .	the children can n't forget who this dancer had n't liked this woman .
the doctors should forget that those women might like these women .	the doctors should forget who those women might like these women .
the boy has remembered that the doctors had n't liked those men .	the boy has remembered who the doctors had n't liked those men .
your cousins realized that those ladies scare those men .	your cousins realized who those ladies scare those men .
the teachers could n't know that these guys scared that driver .	the teachers could n't know who these guys scared that driver .
my doctors learn that these guys confused the lady .	my doctors learn who these guys confused the lady .
my grandmother had n't noticed that the doctors have confused the women .	my grandmother had n't noticed who the doctors have confused the women .
Jerry saw that those men liked this king .	Jerry saw who those men liked this king .
Jennifer will notice that that patient bothered these teachers .	Jennifer will notice who that patient bothered these teachers .
my son knew that the ladies have liked these people .	my son knew who the ladies have liked these people .
these people have noticed that that dancer scared the doctor .	these people have noticed who that dancer scared the doctor .
your teachers can n't remember that that dancer is n't bothering the driver .	your teachers can n't remember who that dancer is n't bothering the driver .
my teachers forgot that these boys appreciate that man .	my teachers forgot who these boys appreciate that man .
Carl has noticed that the ladies had liked the driver .	Carl has noticed who the ladies had liked the driver .
my mom had remembered that that doctor bothered the guys .	my mom had remembered who that doctor bothered the guys .
Liam would n't know that this king would hate that lady .	Liam would n't know who this king would hate that lady .
my teachers realized that the teacher could hate that patient .	my teachers realized who the teacher could hate that patient .
my wife would learn that this doctor liked the teachers .	my wife would learn who this doctor liked the teachers .
your son had known that those men can n't praise this woman .	your son had known who those men can n't praise this woman .
this guy learned that these boys are bothering that doctor .	this guy learned who these boys are bothering that doctor .
your daughter had seen that that dancer will scare the boy .	your daughter had seen who that dancer will scare the boy .
my doctors know that this girl might appreciate the doctors .	my doctors know who this girl might appreciate the doctors .
my friends know that those doctors would hate that patient .	my friends know who those doctors would hate that patient .
that queen can know that this teacher had n't liked the girl .	that queen can know who this teacher had n't liked the girl .
these people have n't remembered that these men had bothered these ladies .	these people have n't remembered who these men had bothered these ladies .
Steven has seen that that guy scared that king .	Steven has seen who that guy scared that king .
my doctors would realize that that king is bothering the king .	my doctors would realize who that king is bothering the king .
your friends have seen that the dancer can bother the boys .	your friends have seen who the dancer can bother the boys .
John would see that the person has n't liked this lady .	John would see who the person has n't liked this lady .
the children had learned that that driver bothered those teachers .	the children had learned who that driver bothered those teachers .
this king did n't remember that this patient would hate the doctors .	this king did n't remember who this patient would hate the doctors .
my brother should n't realize that that adult likes that doctor .	my brother should n't realize who that adult likes that doctor .
these teachers forget that the girls have n't confused this patient .	these teachers forget who the girls have n't confused this patient .
those people remember that this child liked those ladies .	those people remember who this child liked those ladies .
Laura had learned that these girls praise the lady .	Laura had learned who these girls praise the lady .
your son should n't forget that those teachers have confused this girl .	your son should n't forget who those teachers have confused this girl .
those teachers remember that those people have confused the dentist .	those teachers remember who those people have confused the dentist .
this king will know that those doctors had n't bothered that dentist .	this king will know who those doctors had n't bothered that dentist .
the man would learn that that dentist can appreciate those men .	the man would learn who that dentist can appreciate those men .
Michelle can see that these teachers did n't like that king .	Michelle can see who these teachers did n't like that king .
your son knows that the person might like this guy .	your son knows who the person might like this guy .
this king did n't see that the child was n't bothering these doctors .	this king did n't see who the child was n't bothering these doctors .
Becca has known that these children praise that driver .	Becca has known who these children praise that driver .
those people must know that the doctor scares those men .	those people must know who the doctor scares those men .
my teachers notice that these girls would appreciate that man .	my teachers notice who these girls would appreciate that man .
Steve had n't remembered that that dentist bothered the girls .	Steve had n't remembered who that dentist bothered the girls .
my dad saw that this dancer scared the doctor .	my dad saw who this dancer scared the doctor .
those children have n't known that these boys appreciate the dancer .	those children have n't known who these boys appreciate the dancer .
that woman would realize that this customer should n't bother the boys .	that woman would realize who this customer should n't bother the boys .
your teachers realized that those children appreciate this man .	your teachers realized who those children appreciate this man .
my mother had n't noticed that those boys will praise this woman .	my mother had n't noticed who those boys will praise this woman .
my husband must forget that that adult likes the customer .	my husband must forget who that adult likes the customer .
your friends see that this girl would n't hate that guy .	your friends see who this girl would n't hate that guy .
your friends learned that that adult would hate this patient .	your friends learned who that adult would hate this patient .
your teachers do n't know that this dentist would like that dentist .	your teachers do n't know who this dentist would like that dentist .
my doctors had realized that the adult likes those children .	my doctors had realized who the adult likes those children .
Jennifer had n't seen that these girls scare the dentist .	Jennifer had n't seen who these girls scare the dentist .
your teachers had seen that the customer was bothering that queen .	your teachers had seen who the customer was bothering that queen .
that woman could notice that the dentist has bothered the women .	that woman could notice who the dentist has bothered the women .
this boy realized that these guys can n't hate this teacher .	this boy realized who these guys can n't hate this teacher .
that boy could n't remember that those boys bother that dentist .	that boy could n't remember who those boys bother that dentist .
those doctors had learned that the woman likes that doctor .	those doctors had learned who the woman likes that doctor .
Sara might notice that this guy would scare this child .	Sara might notice who this guy would scare this child .
your teachers could n't know that these girls could n't praise this girl .	your teachers could n't know who these girls could n't praise this girl .
the boy learned that these boys bother this man .	the boy learned who these boys bother this man .
that man knew that the teachers can praise this teacher .	that man knew who the teachers can praise this teacher .
that king might realize that the patient scared this man .	that king might realize who the patient scared this man .
my teachers had noticed that that woman has n't scared the teacher .	my teachers had noticed who that woman has n't scared the teacher .
your sister learned that the adult would like the lady .	your sister learned who the adult would like the lady .
these children could n't know that this woman was n't bothering the children .	these children could n't know who this woman was n't bothering the children .
that man had n't remembered that these doctors praise that girl .	that man had n't remembered who these doctors praise that girl .
Mary should n't remember that the people might appreciate that driver .	Mary should n't remember who the people might appreciate that driver .
your father learned that those men bothered this doctor .	your father learned who those men bothered this doctor .
that man remembered that this customer had confused that doctor .	that man remembered who this customer had confused that doctor .
these doctors forget that these girls have n't confused these doctors .	these doctors forget who these girls have n't confused these doctors .
those people did n't realize that the teachers can n't bother that patient .	those people did n't realize who the teachers can n't bother that patient .
my teachers have n't realized that this woman would n't praise the boys .	my teachers have n't realized who this woman would n't praise the boys .
my doctors did n't forget that those ladies had n't liked that person .	my doctors did n't forget who those ladies had n't liked that person .
my teachers saw that the boys confused the teachers .	my teachers saw who the boys confused the teachers .
my mom forgot that this boy will bother the girls .	my mom forgot who this boy will bother the girls .
Christopher forgot that the child has n't confused that patient .	Christopher forgot who the child has n't confused that patient .
your mother saw that these teachers are n't bothering these women .	your mother saw who these teachers are n't bothering these women .
the people have n't learned that this dancer has n't bothered the guys .	the people have n't learned who this dancer has n't bothered the guys .
the man sees that this child had scared the boy .	the man sees who this child had scared the boy .
the doctors notice that the customer liked that queen .	the doctors notice who the customer liked that queen .
your doctors learned that these doctors hate the customer .	your doctors learned who these doctors hate the customer .
these doctors may realize that the women have n't liked this woman .	these doctors may realize who the women have n't liked this woman .
my father had n't known that those women had liked that boy .	my father had n't known who those women had liked that boy .
these teachers did n't realize that that lady has liked these ladies .	these teachers did n't realize who that lady has liked these ladies .
your grandmother realized that those women bothered these doctors .	your grandmother realized who those women bothered these doctors .
my doctors should see that these men may scare these men .	my doctors should see who these men may scare these men .
James had seen that the patient could bother those children .	James had seen who the patient could bother those children .
your cousins know that these girls had n't bothered these people .	your cousins know who these girls had n't bothered these people .
your friends have n't seen that this girl had n't scared this queen .	your friends have n't seen who this girl had n't scared this queen .
your friends had remembered that these children can n't appreciate the men .	your friends had remembered who these children can n't appreciate the men .
Robert has n't realized that that lady bothered this dancer .	Robert has n't realized who that lady bothered this dancer .
your teachers know that that woman confused that doctor .	your teachers know who that woman confused that doctor .
your husband would remember that those girls can n't scare those people .	your husband would remember who those girls can n't scare those people .
this girl sees that the customer is n't bothering the patient .	this girl sees who the customer is n't bothering the patient .
your sister forgot that these guys bother this teacher .	your sister forgot who these guys bother this teacher .
my friends noticed that the patient had n't bothered that child .	my friends noticed who the patient had n't bothered that child .
the doctors notice that that driver has scared this dentist .	the doctors notice who that driver has scared this dentist .
your mother must forget that those doctors had liked that queen .	your mother must forget who those doctors had liked that queen .
your dad would n't see that this person confused that girl .	your dad would n't see who this person confused that girl .
the woman did n't notice that this queen was n't bothering this boy .	the woman did n't notice who this queen was n't bothering this boy .
these children can n't forget that the patient would scare this girl .	these children can n't forget who the patient would scare this girl .
those doctors had learned that that person has bothered those children .	those doctors had learned who that person has bothered those children .
your cousins notice that the guys appreciate this dancer .	your cousins notice who the guys appreciate this dancer .
the man has known that these ladies did n't like that king .	the man has known who these ladies did n't like that king .
the king remembered that the dentist should n't hate this driver .	the king remembered who the dentist should n't hate this driver .
these people have n't realized that the dancer has liked the doctor .	these people have n't realized who the dancer has liked the doctor .
my doctors have n't learned that the boys have confused this man .	my doctors have n't learned who the boys have confused this man .
that man had n't seen that those boys wo n't bother that woman .	that man had n't seen who those boys wo n't bother that woman .
your sister has n't seen that this driver must hate the woman .	your sister has n't seen who this driver must hate the woman .
your cousins noticed that that man should hate this girl .	your cousins noticed who that man should hate this girl .
these people will learn that this boy has liked that boy .	these people will learn who this boy has liked that boy .
the teachers learned that that man liked these boys .	the teachers learned who that man liked these boys .
my husband saw that this customer liked the children .	my husband saw who this customer liked the children .
your friends do n't remember that the boy may scare the boy .	your friends do n't remember who the boy may scare the boy .
my friends realize that that girl scared this driver .	my friends realize who that girl scared this driver .
these children should realize that this girl has n't bothered those doctors .	these children should realize who this girl has n't bothered those doctors .
this king had remembered that that adult had n't confused these guys .	this king had remembered who that adult had n't confused these guys .
your cousins must forget that these doctors liked the woman .	your cousins must forget who these doctors liked the woman .
the lady remembered that the king should appreciate this king .	the lady remembered who the king should appreciate this king .
this girl has known that those men scare these women .	this girl has known who those men scare these women .
my cousins would know that the girls bother the man .	my cousins would know who the girls bother the man .
those people learn that the guy would n't praise the driver .	those people learn who the guy would n't praise the driver .
your teachers had n't seen that that doctor was n't bothering that patient .	your teachers had n't seen who that doctor was n't bothering that patient .
Dan knows that the patient is n't bothering that dancer .	Dan knows who the patient is n't bothering that dancer .
that boy can n't realize that these women confused that teacher .	that boy can n't realize who these women confused that teacher .
Samantha did n't learn that that adult has liked those boys .	Samantha did n't learn who that adult has liked those boys .
Eric realized that this woman should n't bother that guy .	Eric realized who this woman should n't bother that guy .
my son remembered that these ladies scare that guy .	my son remembered who these ladies scare that guy .
these children can realize that these men might bother the patient .	these children can realize who these men might bother the patient .
your doctors would remember that this driver can n't bother the girls .	your doctors would remember who this driver can n't bother the girls .
these teachers learned that that woman likes these children .	these teachers learned who that woman likes these children .
my father wo n't know that the boys confused these teachers .	my father wo n't know who the boys confused these teachers .
the teachers had n't realized that the child has n't liked the women .	the teachers had n't realized who the child has n't liked the women .
my doctors had n't known that the women have n't liked the doctor .	my doctors had n't known who the women have n't liked the doctor .
Nancy sees that that girl should bother that customer .	Nancy sees who that girl should bother that customer .
your teachers have n't seen that that customer had confused this child .	your teachers have n't seen who that customer had confused this child .
that king forgot that this dentist has n't liked those girls .	that king forgot who this dentist has n't liked those girls .
your cousins forget that this doctor liked this lady .	your cousins forget who this doctor liked this lady .
those teachers realize that that king might like those girls .	those teachers realize who that king might like those girls .
my doctors realize that those teachers hate these women .	my doctors realize who those teachers hate these women .
your father has n't realized that that girl can appreciate these boys .	your father has n't realized who that girl can appreciate these boys .
those doctors learned that these men were bothering the driver .	those doctors learned who these men were bothering the driver .
your teachers know that these doctors scare that dancer .	your teachers know who these doctors scare that dancer .
my cousins remembered that the queen bothered this patient .	my cousins remembered who the queen bothered this patient .
this lady forgot that that driver did n't scare the children .	this lady forgot who that driver did n't scare the children .
the people know that the doctor scares this boy .	the people know who the doctor scares this boy .
the people knew that those girls could n't like those doctors .	the people knew who those girls could n't like those doctors .
Jennifer remembered that this lady may appreciate that woman .	Jennifer remembered who this lady may appreciate that woman .
your friends noticed that these guys would n't bother the women .	your friends noticed who these guys would n't bother the women .
that queen must learn that the people have scared that lady .	that queen must learn who the people have scared that lady .
these people had n't realized that this dentist likes these girls .	these people had n't realized who this dentist likes these girls .
the king knew that those teachers have n't scared these boys .	the king knew who those teachers have n't scared these boys .
your doctors could n't forget that the girls liked the children .	your doctors could n't forget who the girls liked the children .
your doctors realize that the adult could praise those men .	your doctors realize who the adult could praise those men .
those children remember that those men scare that adult .	those children remember who those men scare that adult .
my doctors can see that this person could n't praise that queen .	my doctors can see who this person could n't praise that queen .
those teachers might see that those men may appreciate that teacher .	those teachers might see who those men may appreciate that teacher .
the woman has learned that these women had bothered this child .	the woman has learned who these women had bothered this child .
your friends forget that this teacher confused those boys .	your friends forget who this teacher confused those boys .
Frank has n't realized that this queen had n't liked the guys .	Frank has n't realized who this queen had n't liked the guys .
Jane has learned that those ladies scared these ladies .	Jane has learned who those ladies scared these ladies .
your doctors noticed that this patient was n't bothering the teacher .	your doctors noticed who this patient was n't bothering the teacher .
these doctors do n't realize that the teacher liked the child .	these doctors do n't realize who the teacher liked the child .
your dad has n't remembered that this child had n't confused the doctors .	your dad has n't remembered who this child had n't confused the doctors .
Sally did n't know that these guys had n't liked the dancer .	Sally did n't know who these guys had n't liked the dancer .
your daughter can learn that that child scares the children .	your daughter can learn who that child scares the children .
the girl would n't see that the person had n't confused the teachers .	the girl would n't see who the person had n't confused the teachers .
your teachers had n't known that that driver can hate the king .	your teachers had n't known who that driver can hate the king .
Anne had n't remembered that this lady could scare the child .	Anne had n't remembered who this lady could scare the child .
those doctors realized that the child confused those teachers .	those doctors realized who the child confused those teachers .
your cousins learn that that person could n't bother that man .	your cousins learn who that person could n't bother that man .
the doctors do n't remember that this girl can n't appreciate this teacher .	the doctors do n't remember who this girl can n't appreciate this teacher .
your grandmother sees that the queen has scared those teachers .	your grandmother sees who the queen has scared those teachers .
Jerry has n't noticed that that man may praise that queen .	Jerry has n't noticed who that man may praise that queen .
this guy saw that that teacher liked this boy .	this guy saw who that teacher liked this boy .
your friends see that the children scare those girls .	your friends see who the children scare those girls .
Renee had realized that this driver scared these ladies .	Renee had realized who this driver scared these ladies .
your dad remembered that the ladies should praise the woman .	your dad remembered who the ladies should praise the woman .
Andrew knew that the teacher scared this woman .	Andrew knew who the teacher scared this woman .
your mother can remember that this man should n't like this dancer .	your mother can remember who this man should n't like this dancer .
your friends learned that the king should n't bother these girls .	your friends learned who the king should n't bother these girls .
Karen sees that the woman has confused this dancer .	Karen sees who the woman has confused this dancer .
Erin noticed that this customer will scare these guys .	Erin noticed who this customer will scare these guys .
my cousins see that that child bothered the people .	my cousins see who that child bothered the people .
my friends remembered that this doctor has bothered that guy .	my friends remembered who this doctor has bothered that guy .
the teachers learned that these people wo n't praise this king .	the teachers learned who these people wo n't praise this king .
your mother forgot that those ladies had n't bothered the doctor .	your mother forgot who those ladies had n't bothered the doctor .
your teachers might realize that this dentist confused that person .	your teachers might realize who this dentist confused that person .
those teachers can notice that the man is bothering those people .	those teachers can notice who the man is bothering those people .
the queen realized that this lady can n't hate that queen .	the queen realized who this lady can n't hate that queen .
Guy had n't remembered that the queen confused that child .	Guy had n't remembered who the queen confused that child .
Amelia learned that the doctors scare that queen .	Amelia learned who the doctors scare that queen .
your doctors forgot that this child had confused this teacher .	your doctors forgot who this child had confused this teacher .
your doctors have noticed that the queen must scare that dancer .	your doctors have noticed who the queen must scare that dancer .
the teachers remembered that that girl bothered the lady .	the teachers remembered who that girl bothered the lady .
this queen knows that these women praise that woman .	this queen knows who these women praise that woman .
these people had remembered that the customer bothered this guy .	these people had remembered who the customer bothered this guy .
the queen saw that that teacher has n't confused that person .	the queen saw who that teacher has n't confused that person .
your friends learn that the women liked the men .	your friends learn who the women liked the men .
these teachers know that that man did n't like this woman .	these teachers know who that man did n't like this woman .
my doctors had seen that that lady liked the girl .	my doctors had seen who that lady liked the girl .
the doctors should remember that those people had bothered that dentist .	the doctors should remember who those people had bothered that dentist .
Kristen has n't known that that doctor bothered these men .	Kristen has n't known who that doctor bothered these men .
your doctors had n't learned that the teachers praise those people .	your doctors had n't learned who the teachers praise those people .
my husband should forget that those teachers were bothering these women .	my husband should forget who those teachers were bothering these women .
the people forget that the dancer likes the men .	the people forget who the dancer likes the men .
your teachers forgot that these teachers have n't scared these women .	your teachers forgot who these teachers have n't scared these women .
your friends could n't forget that these teachers have n't bothered this dentist .	your friends could n't forget who these teachers have n't bothered this dentist .
Todd remembered that that customer scares that customer .	Todd remembered who that customer scares that customer .
those doctors notice that this teacher has confused this adult .	those doctors notice who this teacher has confused this adult .
Liam has known that this teacher wo n't hate the customer .	Liam has known who this teacher wo n't hate the customer .
your friends do n't remember that that doctor had bothered that patient .	your friends do n't remember who that doctor had bothered that patient .
those teachers should n't forget that the dentist had scared that girl .	those teachers should n't forget who the dentist had scared that girl .
Cindy has n't remembered that the doctor has n't confused that queen .	Cindy has n't remembered who the doctor has n't confused that queen .
your cousins would n't learn that these boys would praise the adult .	your cousins would n't learn who these boys would praise the adult .
Scott knows that that man will bother those women .	Scott knows who that man will bother those women .
those teachers learned that these teachers liked the teacher .	those teachers learned who these teachers liked the teacher .
Brian knows that those men should hate those doctors .	Brian knows who those men should hate those doctors .
my wife can learn that that patient will appreciate that customer .	my wife can learn who that patient will appreciate that customer .
Todd noticed that the dentist would n't praise this child .	Todd noticed who the dentist would n't praise this child .
your doctors had known that the boys had n't liked the adult .	your doctors had known who the boys had n't liked the adult .
your doctors knew that the person could praise this child .	your doctors knew who the person could praise this child .
your husband learned that this king is bothering that driver .	your husband learned who this king is bothering that driver .
your cousins forgot that this guy was n't bothering the driver .	your cousins forgot who this guy was n't bothering the driver .
your mom remembered that the teacher scared the queen .	your mom remembered who the teacher scared the queen .
my doctors had n't seen that the queen could n't hate the teachers .	my doctors had n't seen who the queen could n't hate the teachers .
your teachers had n't noticed that that doctor scares this man .	your teachers had n't noticed who that doctor scares this man .
your cousins had n't noticed that the doctors do n't hate this teacher .	your cousins had n't noticed who the doctors do n't hate this teacher .
your friends see that the patient bothered the driver .	your friends see who the patient bothered the driver .
my teachers know that the men scared those boys .	my teachers know who the men scared those boys .
David learned that this child scared those men .	David learned who this child scared those men .
your sister has n't realized that the women are bothering this queen .	your sister has n't realized who the women are bothering this queen .
the guy had n't seen that the king was bothering the boys .	the guy had n't seen who the king was bothering the boys .
your teachers see that these women appreciate those girls .	your teachers see who these women appreciate those girls .
that man has n't seen that that queen can bother the people .	that man has n't seen who that queen can bother the people .
this woman could n't learn that this dancer has n't confused the people .	this woman could n't learn who this dancer has n't confused the people .
Jane remembered that that customer bothered those girls .	Jane remembered who that customer bothered those girls .
my friends should know that that guy did n't praise that boy .	my friends should know who that guy did n't praise that boy .
my doctors might see that those ladies might like those men .	my doctors might see who those ladies might like those men .
those doctors forgot that this dentist does n't scare those ladies .	those doctors forgot who this dentist does n't scare those ladies .
these children will see that the person confused those men .	these children will see who the person confused those men .
your doctors have seen that that teacher will praise this person .	your doctors have seen who that teacher will praise this person .
that boy saw that that guy wo n't scare this adult .	that boy saw who that guy wo n't scare this adult .
the people had n't seen that this girl confused the men .	the people had n't seen who this girl confused the men .
those children noticed that that adult would n't like these men .	those children noticed who that adult would n't like these men .
this guy can n't remember that this teacher does n't bother that king .	this guy can n't remember who this teacher does n't bother that king .
my cousins had n't noticed that this guy likes the king .	my cousins had n't noticed who this guy likes the king .
my wife would n't learn that these girls praise the people .	my wife would n't learn who these girls praise the people .
Amy remembered that this boy likes the girls .	Amy remembered who this boy likes the girls .
the children could forget that this dentist likes the child .	the children could forget who this dentist likes the child .
your friends remembered that this dentist did n't bother this teacher .	your friends remembered who this dentist did n't bother this teacher .
your daughter had n't seen that this woman bothered the lady .	your daughter had n't seen who this woman bothered the lady .
those doctors have learned that the lady scares that driver .	those doctors have learned who the lady scares that driver .
the king had known that this dancer will hate the queen .	the king had known who this dancer will hate the queen .
Scott would notice that this lady had confused the boys .	Scott would notice who this lady had confused the boys .
my dad can learn that those people do n't appreciate this king .	my dad can learn who those people do n't appreciate this king .
the doctors remember that these ladies wo n't praise those men .	the doctors remember who these ladies wo n't praise those men .
your teachers noticed that these teachers are bothering that girl .	your teachers noticed who these teachers are bothering that girl .
those children will notice that the dancer scares this man .	those children will notice who the dancer scares this man .
my friends learn that the people praise that guy .	my friends learn who the people praise that guy .
your teachers do n't learn that this boy scared the adult .	your teachers do n't learn who this boy scared the adult .
my friends noticed that this child has n't bothered this guy .	my friends noticed who this child has n't bothered this guy .
my cousins know that that driver likes the king .	my cousins know who that driver likes the king .
my cousins realize that this child had scared the person .	my cousins realize who this child had scared the person .
those children have noticed that the lady should hate the adult .	those children have noticed who the lady should hate the adult .
the boy did n't realize that these teachers were n't bothering that customer .	the boy did n't realize who these teachers were n't bothering that customer .
your teachers notice that the adult was n't bothering the person .	your teachers notice who the adult was n't bothering the person .
your cousins wo n't see that the doctors can n't scare these people .	your cousins wo n't see who the doctors can n't scare these people .
Michelle remembered that that patient had bothered those doctors .	Michelle remembered who that patient had bothered those doctors .
your teachers saw that the girls appreciate the dentist .	your teachers saw who the girls appreciate the dentist .
this man should realize that that dentist must like this teacher .	this man should realize who that dentist must like this teacher .
your cousins forget that these ladies may like these girls .	your cousins forget who these ladies may like these girls .
your doctors know that the dancer scares those ladies .	your doctors know who the dancer scares those ladies .
my doctors had seen that this lady would n't praise that woman .	my doctors had seen who this lady would n't praise that woman .
Dan wo n't see that that doctor had n't liked those children .	Dan wo n't see who that doctor had n't liked those children .
your grandmother can n't know that those guys bother that person .	your grandmother can n't know who those guys bother that person .
the woman knows that the person had liked the man .	the woman knows who the person had liked the man .
my mother will see that that child has bothered that guy .	my mother will see who that child has bothered that guy .
these people have noticed that these people confused the ladies .	these people have noticed who these people confused the ladies .
your doctors noticed that these girls had scared these teachers .	your doctors noticed who these girls had scared these teachers .
Becky realized that this man has n't confused that person .	Becky realized who this man has n't confused that person .
this boy would n't know that the doctors had n't scared the doctors .	this boy would n't know who the doctors had n't scared the doctors .
this guy saw that those men do n't like that teacher .	this guy saw who those men do n't like that teacher .
your doctors have n't realized that that driver has n't confused that man .	your doctors have n't realized who that driver has n't confused that man .
these people know that that queen bothered this dentist .	these people know who that queen bothered this dentist .
your friends have known that the guy scared the patient .	your friends have known who the guy scared the patient .
those people have n't remembered that this man does n't appreciate this doctor .	those people have n't remembered who this man does n't appreciate this doctor .
the boy noticed that that lady would n't bother that queen .	the boy noticed who that lady would n't bother that queen .
those teachers knew that that girl likes this patient .	those teachers knew who that girl likes this patient .
my cousins learn that that adult likes the women .	my cousins learn who that adult likes the women .
these doctors know that these doctors may praise that woman .	these doctors know who these doctors may praise that woman .
my teachers noticed that these doctors had n't scared these doctors .	my teachers noticed who these doctors had n't scared these doctors .
that woman had n't seen that the teachers praise the doctor .	that woman had n't seen who the teachers praise the doctor .
my doctors know that those boys praise the men .	my doctors know who those boys praise the men .
David knows that those ladies were bothering the men .	David knows who those ladies were bothering the men .
Guy forgot that this queen bothered the guy .	Guy forgot who this queen bothered the guy .
Emily might know that this guy was bothering those people .	Emily might know who this guy was bothering those people .
my cousins forgot that these children bother those girls .	my cousins forgot who these children bother those girls .
Peter noticed that this guy scares this woman .	Peter noticed who this guy scares this woman .
those people have noticed that the guys bother these people .	those people have noticed who the guys bother these people .
William will know that that girl likes that driver .	William will know who that girl likes that driver .
these children wo n't see that those ladies scare this queen .	these children wo n't see who those ladies scare this queen .
my doctors noticed that that girl can n't bother these women .	my doctors noticed who that girl can n't bother these women .
that queen noticed that this teacher bothered the man .	that queen noticed who this teacher bothered the man .
my friends remember that that lady wo n't like this child .	my friends remember who that lady wo n't like this child .
that boy knew that that patient is bothering that man .	that boy knew who that patient is bothering that man .
my friends learned that the guy likes that woman .	my friends learned who the guy likes that woman .
your cousins see that the doctors had confused the man .	your cousins see who the doctors had confused the man .
your doctors remember that the men should n't appreciate that dentist .	your doctors remember who the men should n't appreciate that dentist .
my cousins know that this customer scares these women .	my cousins know who this customer scares these women .
my mother had n't noticed that these men scare the customer .	my mother had n't noticed who these men scare the customer .
Leslie realized that that boy has n't liked the queen .	Leslie realized who that boy has n't liked the queen .
your husband knows that that woman may like those boys .	your husband knows who that woman may like those boys .
my husband had noticed that these doctors hate those people .	my husband had noticed who these doctors hate those people .
the man forgot that these guys would like these boys .	the man forgot who these guys would like these boys .
Emily realized that these doctors have n't scared the boy .	Emily realized who these doctors have n't scared the boy .
your teachers have realized that the king confused the guys .	your teachers have realized who the king confused the guys .
Kayla had n't learned that the child does n't appreciate those women .	Kayla had n't learned who the child does n't appreciate those women .
those people had known that those boys confused the dentist .	those people had known who those boys confused the dentist .
Naomi should n't remember that this adult has confused this man .	Naomi should n't remember who this adult has confused this man .
these people noticed that these women bother that adult .	these people noticed who these women bother that adult .
that king should n't realize that these people confused that driver .	that king should n't realize who these people confused that driver .
the people must remember that these boys hate the dancer .	the people must remember who these boys hate the dancer .
this woman would learn that that lady scared this lady .	this woman would learn who that lady scared this lady .
the girl knows that this patient bothered this patient .	the girl knows who this patient bothered this patient .
that lady learned that those teachers should bother the doctors .	that lady learned who those teachers should bother the doctors .
your cousins realized that that driver might scare this customer .	your cousins realized who that driver might scare this customer .
this king has n't realized that the dentist scares this man .	this king has n't realized who the dentist scares this man .
the people could n't learn that this king liked this dancer .	the people could n't learn who this king liked this dancer .
your husband could n't forget that that person could n't hate the children .	your husband could n't forget who that person could n't hate the children .
Brett has n't realized that the doctor could praise that king .	Brett has n't realized who the doctor could praise that king .
my doctors remember that those boys appreciate that girl .	my doctors remember who those boys appreciate that girl .
my cousins remembered that these ladies should n't hate this guy .	my cousins remembered who these ladies should n't hate this guy .
this girl remembered that that dentist had bothered the teacher .	this girl remembered who that dentist had bothered the teacher .
the people remembered that the children have n't liked that boy .	the people remembered who the children have n't liked that boy .
those teachers notice that the doctors appreciate the patient .	those teachers notice who the doctors appreciate the patient .
the doctors notice that the children scare this man .	the doctors notice who the children scare this man .
your friends may forget that the man has liked this driver .	your friends may forget who the man has liked this driver .
my cousins did n't notice that the girl can n't praise those ladies .	my cousins did n't notice who the girl can n't praise those ladies .
Aaron had remembered that this driver may appreciate the girl .	Aaron had remembered who this driver may appreciate the girl .
Carl could n't notice that the woman has n't scared the boys .	Carl could n't notice who the woman has n't scared the boys .
your cousins have n't realized that that teacher should praise that doctor .	your cousins have n't realized who that teacher should praise that doctor .
Nicole has n't known that this adult can bother those men .	Nicole has n't known who this adult can bother those men .
the woman has n't known that the man has liked this child .	the woman has n't known who the man has liked this child .
these people remember that the woman likes the guys .	these people remember who the woman likes the guys .
Lisa knows that these children scared that dentist .	Lisa knows who these children scared that dentist .
the children have learned that that adult has n't confused the patient .	the children have learned who that adult has n't confused the patient .
my husband had remembered that the ladies have n't liked this boy .	my husband had remembered who the ladies have n't liked this boy .
your sister must forget that that teacher bothered this lady .	your sister must forget who that teacher bothered this lady .
my friends realize that the doctor is n't bothering this queen .	my friends realize who the doctor is n't bothering this queen .
those children would n't see that this child would n't appreciate the driver .	those children would n't see who this child would n't appreciate the driver .
my sister had n't realized that the teachers could n't hate these boys .	my sister had n't realized who the teachers could n't hate these boys .
your teachers learn that the dancer liked that person .	your teachers learn who the dancer liked that person .
Eric learned that these teachers could like that adult .	Eric learned who these teachers could like that adult .
the doctors can know that this teacher might praise these girls .	the doctors can know who this teacher might praise these girls .
my doctors had noticed that the driver has scared this dentist .	my doctors had noticed who the driver has scared this dentist .
my friends had remembered that this girl could n't scare this person .	my friends had remembered who this girl could n't scare this person .
your cousins forgot that this person confused the teacher .	your cousins forgot who this person confused the teacher .
your son wo n't learn that the girls scared that teacher .	your son wo n't learn who the girls scared that teacher .
my teachers wo n't notice that that guy should n't appreciate this adult .	my teachers wo n't notice who that guy should n't appreciate this adult .
Frank had realized that that guy confused the women .	Frank had realized who that guy confused the women .
this man will realize that these children would like the teacher .	this man will realize who these children would like the teacher .
my doctors realize that that person confused this dancer .	my doctors realize who that person confused this dancer .
this man knew that the doctors bother the doctor .	this man knew who the doctors bother the doctor .
my doctors can n't remember that the people have bothered that boy .	my doctors can n't remember who the people have bothered that boy .
your son has n't remembered that the doctor would n't hate that driver .	your son has n't remembered who the doctor would n't hate that driver .
your friends forget that the boys confused this driver .	your friends forget who the boys confused this driver .
my doctors can remember that this king bothered the girls .	my doctors can remember who this king bothered the girls .
Martin remembered that the guys like the children .	Martin remembered who the guys like the children .
these people must forget that the teachers hate the customer .	these people must forget who the teachers hate the customer .
my father noticed that these men had n't scared that adult .	my father noticed who these men had n't scared that adult .
your dad would learn that the boys must scare the queen .	your dad would learn who the boys must scare the queen .
this girl wo n't see that these teachers have scared these men .	this girl wo n't see who these teachers have scared these men .
those doctors see that these children confused this king .	those doctors see who these children confused this king .
your grandmother has seen that this king has n't confused this teacher .	your grandmother has seen who this king has n't confused this teacher .
my friends knew that this doctor has scared that man .	my friends knew who this doctor has scared that man .
your doctors forget that that girl was n't bothering these women .	your doctors forget who that girl was n't bothering these women .
Nicole should n't know that the driver had n't scared these women .	Nicole should n't know who the driver had n't scared these women .
Steven has n't seen that that adult has liked this dentist .	Steven has n't seen who that adult has liked this dentist .
my teachers remembered that that teacher bothered this patient .	my teachers remembered who that teacher bothered this patient .
these doctors would n't remember that the girl may appreciate the driver .	these doctors would n't remember who the girl may appreciate the driver .
these people had remembered that this king scares this dancer .	these people had remembered who this king scares this dancer .
my friends know that this boy liked those boys .	my friends know who this boy liked those boys .
your friends remember that the teacher did n't hate this customer .	your friends remember who the teacher did n't hate this customer .
the children have learned that these women will bother the dancer .	the children have learned who these women will bother the dancer .
those doctors must see that these men are bothering the driver .	those doctors must see who these men are bothering the driver .
that guy sees that the king has liked that doctor .	that guy sees who the king has liked that doctor .
those doctors know that these ladies scared the lady .	those doctors know who these ladies scared the lady .
Kevin can learn that those children wo n't appreciate that customer .	Kevin can learn who those children wo n't appreciate that customer .
my doctors knew that this woman scared this dentist .	my doctors knew who this woman scared this dentist .
those people knew that that guy had n't bothered those guys .	those people knew who that guy had n't bothered those guys .
my cousins notice that this boy confused those guys .	my cousins notice who this boy confused those guys .
that queen saw that the driver likes the lady .	that queen saw who the driver likes the lady .
these doctors forget that the guys appreciate the driver .	these doctors forget who the guys appreciate the driver .
your friends have seen that the queen can n't scare the doctors .	your friends have seen who the queen can n't scare the doctors .
my mom would remember that the queen is n't bothering the guys .	my mom would remember who the queen is n't bothering the guys .
my teachers learn that those men are n't bothering these girls .	my teachers learn who those men are n't bothering these girls .
the doctors realize that those boys bothered the dancer .	the doctors realize who those boys bothered the dancer .
my mom forgot that that teacher does n't appreciate the doctor .	my mom forgot who that teacher does n't appreciate the doctor .
my cousins should forget that the driver has scared this boy .	my cousins should forget who the driver has scared this boy .
my mom remembered that the teachers confused these women .	my mom remembered who the teachers confused these women .
the man has n't seen that that dentist wo n't hate this man .	the man has n't seen who that dentist wo n't hate this man .
your doctors noticed that the girl confused these children .	your doctors noticed who the girl confused these children .
this boy noticed that this teacher bothered this customer .	this boy noticed who this teacher bothered this customer .
Julia has noticed that the woman does n't scare that guy .	Julia has noticed who the woman does n't scare that guy .
those teachers saw that that dancer bothered the dentist .	those teachers saw who that dancer bothered the dentist .
your mother learned that those boys like the driver .	your mother learned who those boys like the driver .
those doctors see that that boy has liked the guys .	those doctors see who that boy has liked the guys .
the teachers know that that dentist does n't praise the person .	the teachers know who that dentist does n't praise the person .
