the guy cries very slowly .	the guy was very slowly .
the lady talks really quickly .	the lady is really quickly .
the girl exercises really quickly .	the girl is really quickly .
the man paints very carefully .	the man was very carefully .
the adult cries very perfectly .	the adult is very perfectly .
the adult sings very slowly .	the adult was very slowly .
the doctor waves really perfectly .	the doctor was really perfectly .
the boy talks really carefully .	the boy was really carefully .
the lady reads very carefully .	the lady is very carefully .
the dancer talks really quietly .	the dancer was really quietly .
the driver cries very perfectly .	the driver is very perfectly .
the boy reads very quietly .	the boy was very quietly .
the dancer talks very carefully .	the dancer is very carefully .
the doctor reads really perfectly .	the doctor is really perfectly .
the man reads really slowly .	the man was really slowly .
the dentist reads very perfectly .	the dentist was very perfectly .
the man talks really quickly .	the man is really quickly .
the child sings really slowly .	the child is really slowly .
the man paints really quickly .	the man is really quickly .
the person sings really carefully .	the person was really carefully .
the girl reads really quickly .	the girl was really quickly .
the doctor cries really perfectly .	the doctor is really perfectly .
the man sings really carefully .	the man was really carefully .
the teacher cries very perfectly .	the teacher is very perfectly .
the queen exercises really carefully .	the queen is really carefully .
the customer cries very quietly .	the customer is very quietly .
the child waves very quickly .	the child was very quickly .
the customer talks very carefully .	the customer was very carefully .
the adult waves very quietly .	the adult is very quietly .
the driver exercises really carefully .	the driver is really carefully .
the king reads very quickly .	the king is very quickly .
the driver reads very quietly .	the driver was very quietly .
the queen talks really carefully .	the queen was really carefully .
the person paints very perfectly .	the person was very perfectly .
the lady exercises very slowly .	the lady is very slowly .
the queen exercises very slowly .	the queen was very slowly .
the person exercises very slowly .	the person was very slowly .
the adult paints really slowly .	the adult is really slowly .
the patient waves very slowly .	the patient was very slowly .
the person waves very slowly .	the person is very slowly .
the woman reads really slowly .	the woman was really slowly .
the boy cries really slowly .	the boy is really slowly .
the person exercises really perfectly .	the person is really perfectly .
the person talks very slowly .	the person is very slowly .
the woman exercises really perfectly .	the woman was really perfectly .
the patient sings really quickly .	the patient was really quickly .
the adult exercises really quietly .	the adult was really quietly .
the guy cries very quietly .	the guy is very quietly .
the dancer sings very carefully .	the dancer was very carefully .
the driver paints really quickly .	the driver is really quickly .
the boy exercises very quickly .	the boy is very quickly .
the king cries very carefully .	the king was very carefully .
the queen talks really perfectly .	the queen was really perfectly .
the girl waves really slowly .	the girl is really slowly .
the customer exercises very perfectly .	the customer is very perfectly .
the girl talks very carefully .	the girl is very carefully .
the girl sings very perfectly .	the girl was very perfectly .
the dentist waves very carefully .	the dentist was very carefully .
the doctor reads very slowly .	the doctor was very slowly .
the girl talks very slowly .	the girl was very slowly .
the king paints very quietly .	the king was very quietly .
the king reads very quietly .	the king is very quietly .
the teacher paints very slowly .	the teacher is very slowly .
the teacher sings really quickly .	the teacher was really quickly .
the teacher exercises really perfectly .	the teacher was really perfectly .
the child waves very carefully .	the child was very carefully .
the person cries really quickly .	the person was really quickly .
the king reads very slowly .	the king was very slowly .
the doctor cries really quickly .	the doctor was really quickly .
the dentist paints very perfectly .	the dentist is very perfectly .
the man cries very perfectly .	the man is very perfectly .
the queen reads very carefully .	the queen is very carefully .
the woman reads very quickly .	the woman was very quickly .
the queen talks really carefully .	the queen is really carefully .
the dentist waves very perfectly .	the dentist was very perfectly .
the guy reads very slowly .	the guy was very slowly .
the queen exercises very perfectly .	the queen was very perfectly .
the boy cries very quickly .	the boy was very quickly .
the lady talks very quickly .	the lady is very quickly .
the driver paints really quickly .	the driver was really quickly .
the dentist waves really perfectly .	the dentist was really perfectly .
the customer waves very carefully .	the customer was very carefully .
the woman exercises very quickly .	the woman is very quickly .
the king sings very slowly .	the king was very slowly .
the customer waves really quickly .	the customer is really quickly .
the woman waves very carefully .	the woman was very carefully .
the customer sings very quietly .	the customer was very quietly .
the dancer sings really quietly .	the dancer is really quietly .
the girl talks really quietly .	the girl is really quietly .
the driver paints very quickly .	the driver is very quickly .
the lady cries really slowly .	the lady was really slowly .
the driver reads really perfectly .	the driver was really perfectly .
the dentist waves very perfectly .	the dentist is very perfectly .
the dentist sings very slowly .	the dentist is very slowly .
the teacher cries very quickly .	the teacher is very quickly .
the dentist paints really slowly .	the dentist was really slowly .
the man talks very quietly .	the man was very quietly .
the patient paints very slowly .	the patient was very slowly .
the dentist sings really quickly .	the dentist was really quickly .
the boy cries very carefully .	the boy was very carefully .
the man paints very perfectly .	the man was very perfectly .
the dancer talks really quickly .	the dancer was really quickly .
the guy talks really quietly .	the guy was really quietly .
the queen reads really quickly .	the queen is really quickly .
the guy paints really quickly .	the guy is really quickly .
the guy talks really carefully .	the guy is really carefully .
the woman cries really carefully .	the woman is really carefully .
the girl cries really perfectly .	the girl is really perfectly .
the person sings really quickly .	the person is really quickly .
the lady exercises very quietly .	the lady is very quietly .
the dentist sings really perfectly .	the dentist is really perfectly .
the man paints really carefully .	the man was really carefully .
the man cries really quickly .	the man was really quickly .
the lady waves very carefully .	the lady was very carefully .
the girl cries very quickly .	the girl was very quickly .
the queen paints really quickly .	the queen is really quickly .
the customer sings really slowly .	the customer was really slowly .
the lady talks very quietly .	the lady is very quietly .
the boy paints very perfectly .	the boy was very perfectly .
the guy exercises very carefully .	the guy was very carefully .
the boy talks really carefully .	the boy is really carefully .
the adult sings very quickly .	the adult is very quickly .
the adult talks really quickly .	the adult is really quickly .
the man cries really slowly .	the man is really slowly .
the queen waves very quickly .	the queen is very quickly .
the child reads really perfectly .	the child is really perfectly .
the girl exercises very perfectly .	the girl was very perfectly .
the teacher waves really slowly .	the teacher was really slowly .
the dentist reads really quickly .	the dentist is really quickly .
the customer paints really slowly .	the customer is really slowly .
the boy paints really carefully .	the boy is really carefully .
the king cries very perfectly .	the king is very perfectly .
the woman paints really slowly .	the woman was really slowly .
the lady talks very slowly .	the lady was very slowly .
the dentist reads really perfectly .	the dentist is really perfectly .
the man sings very perfectly .	the man is very perfectly .
the patient sings very slowly .	the patient is very slowly .
the woman exercises very quietly .	the woman was very quietly .
the person talks really quietly .	the person is really quietly .
the dentist paints really quickly .	the dentist is really quickly .
the adult talks very perfectly .	the adult was very perfectly .
the teacher waves really perfectly .	the teacher was really perfectly .
the queen sings really quietly .	the queen was really quietly .
the driver exercises very carefully .	the driver was very carefully .
the dancer sings very perfectly .	the dancer is very perfectly .
the lady paints very quietly .	the lady was very quietly .
the dentist talks really quietly .	the dentist was really quietly .
the girl reads very perfectly .	the girl was very perfectly .
the woman exercises very slowly .	the woman was very slowly .
the patient cries really carefully .	the patient was really carefully .
the doctor talks really quickly .	the doctor is really quickly .
the dancer paints very carefully .	the dancer was very carefully .
the driver cries very carefully .	the driver is very carefully .
the king paints really quietly .	the king is really quietly .
the driver reads really carefully .	the driver is really carefully .
the person reads really slowly .	the person is really slowly .
the dentist talks really slowly .	the dentist is really slowly .
the guy paints very quietly .	the guy was very quietly .
the driver cries really quietly .	the driver is really quietly .
the king paints really slowly .	the king was really slowly .
the doctor exercises very slowly .	the doctor is very slowly .
the child paints really carefully .	the child was really carefully .
the customer paints really quietly .	the customer was really quietly .
the adult paints really perfectly .	the adult was really perfectly .
the person reads very quickly .	the person was very quickly .
the doctor sings very slowly .	the doctor was very slowly .
the adult cries very quietly .	the adult is very quietly .
the king sings very perfectly .	the king is very perfectly .
the guy paints really quietly .	the guy is really quietly .
the boy reads very carefully .	the boy was very carefully .
the woman waves really quietly .	the woman was really quietly .
the driver sings really quickly .	the driver was really quickly .
the woman cries very perfectly .	the woman was very perfectly .
the girl exercises really perfectly .	the girl is really perfectly .
the adult cries really slowly .	the adult was really slowly .
the lady reads very quickly .	the lady is very quickly .
the doctor waves very carefully .	the doctor was very carefully .
the boy paints very slowly .	the boy is very slowly .
the teacher waves very quietly .	the teacher was very quietly .
the child exercises very perfectly .	the child was very perfectly .
the adult talks very quickly .	the adult was very quickly .
the adult exercises really quickly .	the adult is really quickly .
the patient waves very slowly .	the patient is very slowly .
the boy cries very carefully .	the boy is very carefully .
the doctor cries very slowly .	the doctor is very slowly .
the boy waves very quietly .	the boy is very quietly .
the adult cries very quietly .	the adult was very quietly .
the dentist talks really carefully .	the dentist is really carefully .
the doctor exercises very quickly .	the doctor was very quickly .
the boy paints really quietly .	the boy is really quietly .
the dancer sings very slowly .	the dancer is very slowly .
the lady paints really slowly .	the lady was really slowly .
the king sings really quietly .	the king was really quietly .
the adult paints really slowly .	the adult was really slowly .
the lady reads really slowly .	the lady is really slowly .
the person cries very perfectly .	the person is very perfectly .
the driver waves very quietly .	the driver is very quietly .
the boy talks very carefully .	the boy is very carefully .
the doctor cries very quietly .	the doctor was very quietly .
the guy waves really quickly .	the guy is really quickly .
the lady paints very carefully .	the lady is very carefully .
the doctor sings really carefully .	the doctor was really carefully .
the customer cries really quietly .	the customer was really quietly .
the dentist cries really quickly .	the dentist is really quickly .
the child sings really slowly .	the child was really slowly .
the person paints really perfectly .	the person was really perfectly .
the lady exercises very perfectly .	the lady was very perfectly .
the customer waves really carefully .	the customer was really carefully .
the child reads very slowly .	the child is very slowly .
the woman talks very perfectly .	the woman is very perfectly .
the lady cries really carefully .	the lady is really carefully .
the person paints very perfectly .	the person is very perfectly .
the man waves very quietly .	the man was very quietly .
the doctor waves very slowly .	the doctor was very slowly .
the guy exercises really quietly .	the guy was really quietly .
the driver cries very carefully .	the driver was very carefully .
the woman sings really carefully .	the woman was really carefully .
the king sings very quietly .	the king is very quietly .
the boy paints very carefully .	the boy was very carefully .
the customer cries really slowly .	the customer is really slowly .
the driver waves very quickly .	the driver is very quickly .
the adult reads very quietly .	the adult was very quietly .
the man waves very perfectly .	the man is very perfectly .
the lady paints really quickly .	the lady is really quickly .
the driver reads very quietly .	the driver is very quietly .
the dentist talks really slowly .	the dentist was really slowly .
the doctor reads really quietly .	the doctor was really quietly .
the patient cries very quickly .	the patient is very quickly .
the woman cries very quietly .	the woman was very quietly .
the teacher talks very carefully .	the teacher is very carefully .
the patient talks very perfectly .	the patient is very perfectly .
the child paints really slowly .	the child was really slowly .
the man reads really perfectly .	the man was really perfectly .
the customer sings very perfectly .	the customer is very perfectly .
the lady sings very slowly .	the lady is very slowly .
the dentist paints really slowly .	the dentist is really slowly .
the king waves very slowly .	the king is very slowly .
the dentist reads very slowly .	the dentist was very slowly .
the guy talks very quickly .	the guy is very quickly .
the doctor exercises very perfectly .	the doctor is very perfectly .
the person sings very slowly .	the person was very slowly .
the driver paints really carefully .	the driver is really carefully .
the adult paints really quietly .	the adult is really quietly .
the woman sings very slowly .	the woman was very slowly .
the doctor exercises really perfectly .	the doctor was really perfectly .
the adult talks very carefully .	the adult is very carefully .
the girl talks really carefully .	the girl was really carefully .
the dancer talks really perfectly .	the dancer is really perfectly .
the driver sings very quietly .	the driver is very quietly .
the driver waves really quickly .	the driver is really quickly .
the patient exercises really quickly .	the patient is really quickly .
the girl paints really slowly .	the girl is really slowly .
the driver exercises really quietly .	the driver is really quietly .
the man exercises very perfectly .	the man was very perfectly .
the lady waves really carefully .	the lady was really carefully .
the dentist cries really quietly .	the dentist was really quietly .
the king exercises really perfectly .	the king was really perfectly .
the man exercises really quickly .	the man is really quickly .
the woman exercises very perfectly .	the woman is very perfectly .
the girl cries really perfectly .	the girl was really perfectly .
the person paints really quietly .	the person is really quietly .
the man cries very slowly .	the man is very slowly .
the teacher sings very carefully .	the teacher is very carefully .
the queen waves really quietly .	the queen is really quietly .
the teacher sings really perfectly .	the teacher is really perfectly .
the guy exercises very slowly .	the guy is very slowly .
the woman waves very perfectly .	the woman is very perfectly .
the teacher cries really quietly .	the teacher was really quietly .
the adult sings very perfectly .	the adult was very perfectly .
the customer exercises really quickly .	the customer was really quickly .
the customer cries very perfectly .	the customer is very perfectly .
the doctor talks really quietly .	the doctor was really quietly .
the patient reads very quietly .	the patient is very quietly .
the doctor paints very perfectly .	the doctor is very perfectly .
the queen talks very carefully .	the queen was very carefully .
the guy cries very slowly .	the guy is very slowly .
the man sings very slowly .	the man was very slowly .
the teacher talks really carefully .	the teacher was really carefully .
the doctor exercises really slowly .	the doctor was really slowly .
the teacher talks very perfectly .	the teacher is very perfectly .
the man reads really perfectly .	the man is really perfectly .
the guy exercises really slowly .	the guy is really slowly .
the boy talks really quickly .	the boy was really quickly .
the patient sings very carefully .	the patient was very carefully .
the dancer sings very quickly .	the dancer was very quickly .
the teacher reads really slowly .	the teacher was really slowly .
the customer cries really perfectly .	the customer is really perfectly .
the dancer reads very quietly .	the dancer is very quietly .
the dentist reads very carefully .	the dentist is very carefully .
the girl reads very carefully .	the girl is very carefully .
the queen reads very quickly .	the queen is very quickly .
the girl cries very quietly .	the girl was very quietly .
the person waves very carefully .	the person was very carefully .
the man waves very carefully .	the man was very carefully .
the driver paints very quietly .	the driver is very quietly .
the dancer cries very quickly .	the dancer was very quickly .
the guy cries really slowly .	the guy was really slowly .
the patient talks very slowly .	the patient is very slowly .
the queen reads very quickly .	the queen was very quickly .
the man reads very perfectly .	the man is very perfectly .
the patient waves really perfectly .	the patient is really perfectly .
the adult sings really quietly .	the adult is really quietly .
the woman exercises very quietly .	the woman is very quietly .
the guy talks very slowly .	the guy was very slowly .
the customer paints very slowly .	the customer was very slowly .
the doctor paints really quietly .	the doctor was really quietly .
the doctor sings very quickly .	the doctor was very quickly .
the customer exercises very quietly .	the customer is very quietly .
the girl reads really quietly .	the girl was really quietly .
the guy waves very slowly .	the guy is very slowly .
the person talks really quickly .	the person is really quickly .
the queen waves very carefully .	the queen was very carefully .
the boy sings really slowly .	the boy was really slowly .
the woman cries very carefully .	the woman was very carefully .
the patient waves really quickly .	the patient was really quickly .
the doctor reads very slowly .	the doctor is very slowly .
the person sings really slowly .	the person was really slowly .
the dancer sings very slowly .	the dancer was very slowly .
the boy sings very quickly .	the boy was very quickly .
the man exercises very perfectly .	the man is very perfectly .
the dentist paints really quickly .	the dentist was really quickly .
the lady sings very quickly .	the lady is very quickly .
the woman exercises really perfectly .	the woman is really perfectly .
the customer paints very perfectly .	the customer was very perfectly .
the lady reads really slowly .	the lady was really slowly .
the girl reads really carefully .	the girl is really carefully .
the dentist reads very quietly .	the dentist is very quietly .
the driver exercises really perfectly .	the driver was really perfectly .
the driver sings really quietly .	the driver was really quietly .
the doctor sings very carefully .	the doctor was very carefully .
the woman cries very quickly .	the woman is very quickly .
the lady exercises very slowly .	the lady was very slowly .
the king talks really quickly .	the king is really quickly .
the dancer paints really perfectly .	the dancer is really perfectly .
the customer paints really quickly .	the customer is really quickly .
the teacher cries really quietly .	the teacher is really quietly .
the man paints really slowly .	the man is really slowly .
the child talks very carefully .	the child is very carefully .
the woman waves very quietly .	the woman is very quietly .
the guy cries really carefully .	the guy was really carefully .
the driver reads very perfectly .	the driver was very perfectly .
the child paints very carefully .	the child is very carefully .
the girl talks really slowly .	the girl was really slowly .
the patient paints very quietly .	the patient was very quietly .
the guy cries really quickly .	the guy is really quickly .
the person reads really carefully .	the person was really carefully .
the person paints really quickly .	the person is really quickly .
the king sings really carefully .	the king is really carefully .
the dancer paints very quietly .	the dancer is very quietly .
the dancer reads really carefully .	the dancer is really carefully .
the patient cries really slowly .	the patient is really slowly .
the teacher exercises really carefully .	the teacher was really carefully .
the teacher waves very perfectly .	the teacher is very perfectly .
the adult reads very quickly .	the adult is very quickly .
the girl talks really perfectly .	the girl was really perfectly .
the king exercises very carefully .	the king is very carefully .
the doctor exercises very carefully .	the doctor was very carefully .
the boy sings very perfectly .	the boy is very perfectly .
the dentist reads really slowly .	the dentist was really slowly .
the dancer exercises really carefully .	the dancer is really carefully .
the driver sings really slowly .	the driver was really slowly .
the customer cries very slowly .	the customer is very slowly .
the lady paints really slowly .	the lady is really slowly .
the doctor paints really quietly .	the doctor is really quietly .
the doctor exercises really carefully .	the doctor was really carefully .
the guy exercises really perfectly .	the guy was really perfectly .
the person exercises very carefully .	the person is very carefully .
the patient reads very quietly .	the patient was very quietly .
the person talks really slowly .	the person is really slowly .
the teacher waves really carefully .	the teacher was really carefully .
the girl paints really perfectly .	the girl was really perfectly .
the dancer sings really quickly .	the dancer is really quickly .
the doctor waves very quickly .	the doctor is very quickly .
the adult talks really perfectly .	the adult is really perfectly .
the woman exercises really carefully .	the woman was really carefully .
the dancer paints very quietly .	the dancer was very quietly .
the patient paints really quickly .	the patient is really quickly .
the child reads really perfectly .	the child was really perfectly .
the girl exercises really carefully .	the girl was really carefully .
the dancer sings really quickly .	the dancer was really quickly .
the patient exercises very slowly .	the patient is very slowly .
the teacher reads very quickly .	the teacher is very quickly .
the patient reads very quickly .	the patient was very quickly .
the guy waves very carefully .	the guy was very carefully .
the patient talks really quickly .	the patient is really quickly .
the patient reads really quickly .	the patient was really quickly .
the customer waves very carefully .	the customer is very carefully .
the boy reads really perfectly .	the boy was really perfectly .
the queen reads very perfectly .	the queen was very perfectly .
the woman exercises really slowly .	the woman is really slowly .
the dancer waves really perfectly .	the dancer was really perfectly .
the dancer cries very perfectly .	the dancer was very perfectly .
the teacher waves very carefully .	the teacher was very carefully .
the patient cries very perfectly .	the patient is very perfectly .
the driver sings very slowly .	the driver is very slowly .
the dentist cries very quickly .	the dentist was very quickly .
the king paints very slowly .	the king is very slowly .
the girl talks very quietly .	the girl is very quietly .
the child paints really slowly .	the child is really slowly .
the person exercises really quickly .	the person was really quickly .
the doctor paints really quickly .	the doctor is really quickly .
the adult exercises very quickly .	the adult was very quickly .
the boy reads very quickly .	the boy is very quickly .
the guy cries very quickly .	the guy is very quickly .
the adult exercises really quickly .	the adult was really quickly .
the man cries very quietly .	the man is very quietly .
the girl cries very slowly .	the girl is very slowly .
the boy waves very quickly .	the boy was very quickly .
the patient talks very perfectly .	the patient was very perfectly .
the dentist cries really slowly .	the dentist was really slowly .
the king paints really slowly .	the king is really slowly .
the man exercises really carefully .	the man was really carefully .
the guy paints really carefully .	the guy was really carefully .
the guy exercises very carefully .	the guy is very carefully .
the customer talks very perfectly .	the customer is very perfectly .
the doctor waves very quietly .	the doctor is very quietly .
the boy exercises very quietly .	the boy was very quietly .
the guy paints very perfectly .	the guy was very perfectly .
the girl sings very carefully .	the girl is very carefully .
the king talks very slowly .	the king is very slowly .
the king talks very slowly .	the king was very slowly .
the girl talks very perfectly .	the girl was very perfectly .
the adult reads very perfectly .	the adult was very perfectly .
the customer sings really quietly .	the customer is really quietly .
the child talks very quickly .	the child is very quickly .
the queen paints very slowly .	the queen was very slowly .
the dentist exercises very perfectly .	the dentist was very perfectly .
the man exercises very quietly .	the man was very quietly .
the woman sings really quietly .	the woman is really quietly .
the queen paints very perfectly .	the queen is very perfectly .
the guy waves very quickly .	the guy is very quickly .
the patient paints very slowly .	the patient is very slowly .
the dancer reads really perfectly .	the dancer is really perfectly .
the teacher paints very perfectly .	the teacher is very perfectly .
the adult cries really slowly .	the adult is really slowly .
the king cries really quietly .	the king was really quietly .
the man sings very quickly .	the man was very quickly .
the driver cries really perfectly .	the driver was really perfectly .
the king cries really slowly .	the king was really slowly .
the lady waves really quietly .	the lady is really quietly .
the queen sings really carefully .	the queen was really carefully .
the woman waves really quickly .	the woman was really quickly .
the boy talks really perfectly .	the boy is really perfectly .
the girl reads very perfectly .	the girl is very perfectly .
the queen cries really slowly .	the queen is really slowly .
the boy exercises very carefully .	the boy was very carefully .
the driver reads really slowly .	the driver is really slowly .
the lady reads very perfectly .	the lady was very perfectly .
the guy waves really quietly .	the guy was really quietly .
the patient cries very slowly .	the patient was very slowly .
the dentist exercises really perfectly .	the dentist is really perfectly .
the doctor reads very quickly .	the doctor is very quickly .
the child talks very slowly .	the child is very slowly .
the lady talks very carefully .	the lady was very carefully .
the dentist waves really slowly .	the dentist is really slowly .
the girl sings very carefully .	the girl was very carefully .
the dancer exercises really perfectly .	the dancer was really perfectly .
the girl paints very quietly .	the girl is very quietly .
the king reads very quickly .	the king was very quickly .
the queen sings really slowly .	the queen was really slowly .
the driver reads really quickly .	the driver was really quickly .
the person talks really perfectly .	the person was really perfectly .
the girl waves really slowly .	the girl was really slowly .
the lady cries really quietly .	the lady is really quietly .
the person reads really carefully .	the person is really carefully .
the doctor reads very quietly .	the doctor was very quietly .
the girl talks very perfectly .	the girl is very perfectly .
the man reads very quickly .	the man was very quickly .
the guy talks really perfectly .	the guy was really perfectly .
the king cries very slowly .	the king was very slowly .
the person talks really slowly .	the person was really slowly .
the driver reads really perfectly .	the driver is really perfectly .
the lady sings very perfectly .	the lady was very perfectly .
the patient talks really slowly .	the patient was really slowly .
the person waves really quietly .	the person is really quietly .
the woman talks really quietly .	the woman was really quietly .
the woman sings very perfectly .	the woman was very perfectly .
the girl paints very quickly .	the girl was very quickly .
the king sings very quietly .	the king was very quietly .
the dentist exercises really quietly .	the dentist is really quietly .
the customer cries really quietly .	the customer is really quietly .
the dentist cries very quietly .	the dentist is very quietly .
the customer talks really slowly .	the customer is really slowly .
the man talks very quickly .	the man was very quickly .
the queen reads really slowly .	the queen is really slowly .
the boy waves very perfectly .	the boy was very perfectly .
the queen paints really slowly .	the queen is really slowly .
the doctor exercises really quietly .	the doctor was really quietly .
the teacher exercises really slowly .	the teacher is really slowly .
the dancer exercises really quietly .	the dancer was really quietly .
the customer exercises very slowly .	the customer was very slowly .
the guy reads really quietly .	the guy is really quietly .
the adult sings really carefully .	the adult was really carefully .
the patient talks very quietly .	the patient is very quietly .
the guy paints very quietly .	the guy is very quietly .
the guy reads very quietly .	the guy was very quietly .
the woman talks very quickly .	the woman is very quickly .
the queen sings very quietly .	the queen was very quietly .
the dancer paints very quickly .	the dancer is very quickly .
the dentist exercises very slowly .	the dentist was very slowly .
the person paints very quickly .	the person was very quickly .
the doctor waves very quickly .	the doctor was very quickly .
the child cries very slowly .	the child is very slowly .
the customer waves really quietly .	the customer was really quietly .
the driver waves really perfectly .	the driver was really perfectly .
the driver exercises really carefully .	the driver was really carefully .
the dancer paints very perfectly .	the dancer was very perfectly .
the boy exercises very perfectly .	the boy was very perfectly .
the girl paints very slowly .	the girl was very slowly .
the patient paints very perfectly .	the patient is very perfectly .
the customer paints really quickly .	the customer was really quickly .
the person waves very quietly .	the person was very quietly .
the dancer reads really slowly .	the dancer was really slowly .
the woman sings very perfectly .	the woman is very perfectly .
the dancer paints very slowly .	the dancer is very slowly .
the king exercises very quietly .	the king is very quietly .
the patient waves really quietly .	the patient is really quietly .
the girl paints really quickly .	the girl is really quickly .
the customer waves really quickly .	the customer was really quickly .
the child exercises very quickly .	the child was very quickly .
the guy cries very quietly .	the guy was very quietly .
the girl sings really quietly .	the girl was really quietly .
the teacher sings very quietly .	the teacher is very quietly .
the adult cries very slowly .	the adult is very slowly .
the queen paints very quickly .	the queen was very quickly .
the man waves really quietly .	the man was really quietly .
the guy exercises very slowly .	the guy was very slowly .
the teacher sings very slowly .	the teacher is very slowly .
the king exercises very perfectly .	the king was very perfectly .
the dancer talks really slowly .	the dancer is really slowly .
the customer talks really carefully .	the customer is really carefully .
the dentist exercises very quickly .	the dentist was very quickly .
the dentist sings really perfectly .	the dentist was really perfectly .
the boy sings very quietly .	the boy is very quietly .
the doctor exercises really carefully .	the doctor is really carefully .
the woman reads really quietly .	the woman was really quietly .
the girl exercises really perfectly .	the girl was really perfectly .
the child exercises really quietly .	the child is really quietly .
the doctor cries really quickly .	the doctor is really quickly .
the dentist cries very carefully .	the dentist was very carefully .
the customer waves very perfectly .	the customer was very perfectly .
the guy paints really perfectly .	the guy is really perfectly .
the king paints very quietly .	the king is very quietly .
the driver sings very perfectly .	the driver was very perfectly .
the doctor sings really perfectly .	the doctor is really perfectly .
the child waves really slowly .	the child is really slowly .
the dentist waves very quickly .	the dentist was very quickly .
the driver cries very slowly .	the driver is very slowly .
the girl sings really carefully .	the girl is really carefully .
the king reads very carefully .	the king was very carefully .
the customer exercises very perfectly .	the customer was very perfectly .
the customer cries really carefully .	the customer is really carefully .
the driver paints very carefully .	the driver is very carefully .
the customer cries very perfectly .	the customer was very perfectly .
the patient exercises really slowly .	the patient was really slowly .
the boy paints really slowly .	the boy was really slowly .
the queen cries really perfectly .	the queen is really perfectly .
the customer sings very quickly .	the customer was very quickly .
the girl reads really quickly .	the girl is really quickly .
the king reads very perfectly .	the king is very perfectly .
the boy exercises really slowly .	the boy was really slowly .
the woman exercises really carefully .	the woman is really carefully .
the adult exercises really perfectly .	the adult was really perfectly .
the girl paints really quickly .	the girl was really quickly .
the child cries very quickly .	the child is very quickly .
the girl sings really quickly .	the girl is really quickly .
the child cries really slowly .	the child was really slowly .
the dentist paints really quietly .	the dentist is really quietly .
the adult sings very quietly .	the adult is very quietly .
the customer talks really slowly .	the customer was really slowly .
the man exercises very quietly .	the man is very quietly .
the girl paints very quietly .	the girl was very quietly .
the dancer waves really quickly .	the dancer is really quickly .
the customer sings really quickly .	the customer is really quickly .
the adult reads really quickly .	the adult is really quickly .
the doctor reads very carefully .	the doctor is very carefully .
the dentist talks really quickly .	the dentist is really quickly .
the doctor sings really quickly .	the doctor is really quickly .
the dentist waves very quickly .	the dentist is very quickly .
the man reads very quickly .	the man is very quickly .
the driver waves very slowly .	the driver is very slowly .
the dentist paints very carefully .	the dentist is very carefully .
the boy talks very quietly .	the boy is very quietly .
the lady reads really carefully .	the lady is really carefully .
the boy talks very carefully .	the boy was very carefully .
the teacher paints very quietly .	the teacher was very quietly .
the lady talks very perfectly .	the lady is very perfectly .
the dancer exercises really quickly .	the dancer is really quickly .
the boy waves very quietly .	the boy was very quietly .
the queen exercises very carefully .	the queen is very carefully .
the child sings very quietly .	the child was very quietly .
the guy exercises really quickly .	the guy was really quickly .
the queen cries very quietly .	the queen was very quietly .
the adult waves very carefully .	the adult was very carefully .
the girl cries very quickly .	the girl is very quickly .
the person reads very quietly .	the person was very quietly .
the patient paints really quickly .	the patient was really quickly .
the patient talks very carefully .	the patient is very carefully .
the queen talks really quietly .	the queen is really quietly .
the child talks really carefully .	the child is really carefully .
the person sings very quietly .	the person is very quietly .
the queen reads very quietly .	the queen is very quietly .
the man talks really carefully .	the man was really carefully .
the king waves really quietly .	the king is really quietly .
the girl talks really carefully .	the girl is really carefully .
the boy cries very perfectly .	the boy was very perfectly .
the teacher talks very slowly .	the teacher was very slowly .
the customer exercises very quietly .	the customer was very quietly .
the lady talks really quickly .	the lady was really quickly .
the dancer cries really carefully .	the dancer is really carefully .
the dancer cries really perfectly .	the dancer was really perfectly .
the child reads really carefully .	the child was really carefully .
the dancer waves really slowly .	the dancer was really slowly .
the teacher paints really carefully .	the teacher was really carefully .
the child exercises very quickly .	the child is very quickly .
the girl cries really quickly .	the girl was really quickly .
the guy talks very quietly .	the guy is very quietly .
the queen sings really quietly .	the queen is really quietly .
the child cries really quickly .	the child is really quickly .
the guy talks really slowly .	the guy is really slowly .
the doctor reads very quickly .	the doctor was very quickly .
the girl sings really carefully .	the girl was really carefully .
the customer cries really perfectly .	the customer was really perfectly .
the person exercises very carefully .	the person was very carefully .
the customer waves really quietly .	the customer is really quietly .
the person waves really perfectly .	the person was really perfectly .
the king waves really slowly .	the king is really slowly .
the woman reads really quickly .	the woman is really quickly .
the customer sings really slowly .	the customer is really slowly .
the teacher talks really slowly .	the teacher is really slowly .
the queen exercises very quickly .	the queen is very quickly .
the dentist exercises very perfectly .	the dentist is very perfectly .
the dentist talks very slowly .	the dentist was very slowly .
the patient exercises very quickly .	the patient is very quickly .
the teacher paints very slowly .	the teacher was very slowly .
the girl cries really carefully .	the girl is really carefully .
the lady talks really quietly .	the lady was really quietly .
the teacher sings really quietly .	the teacher was really quietly .
the guy exercises very quietly .	the guy was very quietly .
the dancer talks really carefully .	the dancer is really carefully .
the child paints very perfectly .	the child was very perfectly .
the dentist exercises really carefully .	the dentist was really carefully .
the child talks very perfectly .	the child is very perfectly .
the woman exercises really quietly .	the woman is really quietly .
the person reads very slowly .	the person was very slowly .
the woman reads very perfectly .	the woman was very perfectly .
the patient cries very carefully .	the patient is very carefully .
the boy talks really slowly .	the boy is really slowly .
the dentist reads very perfectly .	the dentist is very perfectly .
the adult paints very carefully .	the adult was very carefully .
the woman waves very quickly .	the woman is very quickly .
the adult sings very perfectly .	the adult is very perfectly .
the guy sings really perfectly .	the guy was really perfectly .
the boy reads very quietly .	the boy is very quietly .
the patient waves very quickly .	the patient is very quickly .
the queen reads very carefully .	the queen was very carefully .
the girl talks very slowly .	the girl is very slowly .
the dancer cries very quietly .	the dancer was very quietly .
the dancer waves very quickly .	the dancer is very quickly .
the adult exercises really slowly .	the adult was really slowly .
the man sings very perfectly .	the man was very perfectly .
the boy paints very quickly .	the boy was very quickly .
the person sings really perfectly .	the person is really perfectly .
the lady waves very slowly .	the lady was very slowly .
the guy cries really quickly .	the guy was really quickly .
the person sings really carefully .	the person is really carefully .
the man paints really perfectly .	the man is really perfectly .
the woman waves really perfectly .	the woman is really perfectly .
the person paints very carefully .	the person is very carefully .
the king cries really perfectly .	the king is really perfectly .
the girl cries really slowly .	the girl was really slowly .
the man waves really perfectly .	the man was really perfectly .
the man sings really slowly .	the man was really slowly .
the king exercises really quickly .	the king was really quickly .
the adult paints very slowly .	the adult is very slowly .
the driver sings very quietly .	the driver was very quietly .
the teacher cries very quietly .	the teacher was very quietly .
the boy cries very quickly .	the boy is very quickly .
the teacher paints really slowly .	the teacher was really slowly .
the boy talks very slowly .	the boy was very slowly .
the man cries very carefully .	the man is very carefully .
the girl waves very perfectly .	the girl was very perfectly .
the teacher reads really perfectly .	the teacher is really perfectly .
the dancer cries really slowly .	the dancer is really slowly .
the driver exercises very carefully .	the driver is very carefully .
the man reads very carefully .	the man is very carefully .
the child waves really quickly .	the child is really quickly .
the dancer exercises really quietly .	the dancer is really quietly .
the patient talks really slowly .	the patient is really slowly .
the girl cries very carefully .	the girl is very carefully .
the adult cries really carefully .	the adult was really carefully .
the lady cries really quickly .	the lady was really quickly .
the dancer waves really quietly .	the dancer was really quietly .
the lady reads really carefully .	the lady was really carefully .
the king sings very slowly .	the king is very slowly .
the doctor waves really perfectly .	the doctor is really perfectly .
the king waves really quickly .	the king was really quickly .
the queen waves really perfectly .	the queen was really perfectly .
the woman paints really perfectly .	the woman was really perfectly .
the boy talks really quickly .	the boy is really quickly .
the queen reads very quietly .	the queen was very quietly .
the person paints really slowly .	the person was really slowly .
the boy exercises really carefully .	the boy was really carefully .
the driver exercises really quickly .	the driver was really quickly .
the dentist talks really carefully .	the dentist was really carefully .
the driver paints very quickly .	the driver was very quickly .
the teacher exercises very carefully .	the teacher was very carefully .
the adult waves really quickly .	the adult was really quickly .
the woman exercises really quietly .	the woman was really quietly .
the driver reads really slowly .	the driver was really slowly .
the queen sings very quickly .	the queen is very quickly .
the man waves very carefully .	the man is very carefully .
the person paints very slowly .	the person was very slowly .
the dancer exercises very slowly .	the dancer is very slowly .
the lady paints very slowly .	the lady was very slowly .
the king reads really perfectly .	the king was really perfectly .
the dentist sings really carefully .	the dentist was really carefully .
the driver exercises really slowly .	the driver is really slowly .
the doctor sings really slowly .	the doctor is really slowly .
the woman talks very slowly .	the woman is very slowly .
the king waves very slowly .	the king was very slowly .
the dancer cries really quietly .	the dancer is really quietly .
the man sings really slowly .	the man is really slowly .
the driver waves really perfectly .	the driver is really perfectly .
the dancer reads very carefully .	the dancer is very carefully .
the lady exercises very quickly .	the lady was very quickly .
the teacher talks really quietly .	the teacher was really quietly .
the man exercises really quickly .	the man was really quickly .
the person waves very quickly .	the person was very quickly .
the adult paints really perfectly .	the adult is really perfectly .
the woman paints really perfectly .	the woman is really perfectly .
the dancer waves very perfectly .	the dancer was very perfectly .
the person cries really quietly .	the person is really quietly .
the king reads very quietly .	the king was very quietly .
the man cries really quickly .	the man is really quickly .
the adult talks really carefully .	the adult is really carefully .
the doctor talks very slowly .	the doctor was very slowly .
the king cries very slowly .	the king is very slowly .
the man talks very carefully .	the man is very carefully .
the queen waves really quickly .	the queen was really quickly .
the adult reads really quietly .	the adult is really quietly .
the dentist waves very slowly .	the dentist is very slowly .
the customer sings really perfectly .	the customer was really perfectly .
the guy sings very slowly .	the guy was very slowly .
the person reads really quickly .	the person is really quickly .
the dancer waves very slowly .	the dancer is very slowly .
the woman cries very slowly .	the woman is very slowly .
the doctor cries really carefully .	the doctor was really carefully .
the driver talks very quickly .	the driver is very quickly .
the dentist cries really carefully .	the dentist was really carefully .
the teacher talks really slowly .	the teacher was really slowly .
the dentist paints very quietly .	the dentist is very quietly .
the boy sings really quietly .	the boy is really quietly .
the teacher cries really slowly .	the teacher is really slowly .
the customer talks really perfectly .	the customer is really perfectly .
the man sings really perfectly .	the man is really perfectly .
the customer sings really quickly .	the customer was really quickly .
the doctor sings really quickly .	the doctor was really quickly .
the teacher reads really quietly .	the teacher is really quietly .
the man reads very perfectly .	the man was very perfectly .
the queen talks very quietly .	the queen is very quietly .
the driver talks very carefully .	the driver was very carefully .
the dentist talks very slowly .	the dentist is very slowly .
the teacher exercises really quietly .	the teacher is really quietly .
the girl cries very quietly .	the girl is very quietly .
the lady talks really slowly .	the lady was really slowly .
the lady sings really carefully .	the lady was really carefully .
the dancer sings very quietly .	the dancer is very quietly .
the guy cries really slowly .	the guy is really slowly .
the guy sings really quietly .	the guy was really quietly .
the person cries very quickly .	the person was very quickly .
the person waves very carefully .	the person is very carefully .
the driver reads very quickly .	the driver is very quickly .
the person sings really slowly .	the person is really slowly .
the guy sings really quietly .	the guy is really quietly .
the man cries very carefully .	the man was very carefully .
the boy talks very quickly .	the boy is very quickly .
the adult paints really quickly .	the adult was really quickly .
the patient exercises really quietly .	the patient is really quietly .
the teacher reads very quietly .	the teacher is very quietly .
the customer paints really slowly .	the customer was really slowly .
the queen talks very carefully .	the queen is very carefully .
the doctor talks very perfectly .	the doctor was very perfectly .
the dentist sings really quickly .	the dentist is really quickly .
the boy waves very carefully .	the boy was very carefully .
the teacher sings very quickly .	the teacher was very quickly .
the person waves really quickly .	the person was really quickly .
the man reads really carefully .	the man was really carefully .
the patient paints really perfectly .	the patient is really perfectly .
the person waves very quietly .	the person is very quietly .
the adult exercises very perfectly .	the adult was very perfectly .
the guy sings very quietly .	the guy is very quietly .
the patient cries very perfectly .	the patient was very perfectly .
the adult cries very quickly .	the adult is very quickly .
the doctor reads really carefully .	the doctor was really carefully .
the dancer reads really carefully .	the dancer was really carefully .
the driver paints really perfectly .	the driver is really perfectly .
the man paints really carefully .	the man is really carefully .
the adult sings very slowly .	the adult is very slowly .
the person paints very quietly .	the person was very quietly .
the king paints really perfectly .	the king is really perfectly .
the customer paints very quickly .	the customer is very quickly .
the guy sings very perfectly .	the guy was very perfectly .
the customer reads really quietly .	the customer was really quietly .
the adult sings really slowly .	the adult was really slowly .
the doctor waves very slowly .	the doctor is very slowly .
the teacher sings very quickly .	the teacher is very quickly .
the boy sings very slowly .	the boy is very slowly .
the child reads very quietly .	the child was very quietly .
the child reads very quickly .	the child was very quickly .
the girl talks really perfectly .	the girl is really perfectly .
the teacher reads really carefully .	the teacher was really carefully .
the patient exercises really quickly .	the patient was really quickly .
the girl exercises really carefully .	the girl is really carefully .
the child paints very quickly .	the child was very quickly .
the woman exercises very quickly .	the woman was very quickly .
the teacher talks really quietly .	the teacher is really quietly .
the person reads very quietly .	the person is very quietly .
the king waves really perfectly .	the king is really perfectly .
the lady waves really perfectly .	the lady is really perfectly .
the man talks very slowly .	the man is very slowly .
the person sings very carefully .	the person was very carefully .
the patient sings really slowly .	the patient was really slowly .
the boy reads very carefully .	the boy is very carefully .
the queen waves very slowly .	the queen is very slowly .
the woman talks very quietly .	the woman was very quietly .
the patient waves really slowly .	the patient is really slowly .
the woman exercises very carefully .	the woman is very carefully .
the adult reads really quietly .	the adult was really quietly .
the child exercises really slowly .	the child was really slowly .
the teacher waves very slowly .	the teacher was very slowly .
the king talks really perfectly .	the king was really perfectly .
the person paints really quietly .	the person was really quietly .
the guy cries really perfectly .	the guy is really perfectly .
the man cries really perfectly .	the man was really perfectly .
the doctor talks very slowly .	the doctor is very slowly .
the doctor paints very quietly .	the doctor is very quietly .
the patient waves very perfectly .	the patient was very perfectly .
the dentist cries really quietly .	the dentist is really quietly .
the man cries really quietly .	the man is really quietly .
the child reads very quickly .	the child is very quickly .
the guy sings very slowly .	the guy is very slowly .
the doctor exercises really quickly .	the doctor was really quickly .
the guy exercises really quietly .	the guy is really quietly .
the man sings really quietly .	the man was really quietly .
the lady exercises really perfectly .	the lady is really perfectly .
the customer cries very carefully .	the customer was very carefully .
the child exercises really perfectly .	the child is really perfectly .
the lady reads really quietly .	the lady was really quietly .
the girl paints very carefully .	the girl was very carefully .
the driver sings very perfectly .	the driver is very perfectly .
the patient waves really perfectly .	the patient was really perfectly .
the dancer paints very slowly .	the dancer was very slowly .
the driver waves really quietly .	the driver is really quietly .
the teacher talks really carefully .	the teacher is really carefully .
the dancer sings really slowly .	the dancer is really slowly .
the queen cries very quickly .	the queen was very quickly .
the girl cries very slowly .	the girl was very slowly .
the dancer waves very quietly .	the dancer is very quietly .
the lady reads really quickly .	the lady was really quickly .
the adult exercises very perfectly .	the adult is very perfectly .
the king sings really slowly .	the king is really slowly .
the woman waves really slowly .	the woman is really slowly .
the king talks really slowly .	the king is really slowly .
the dancer cries very quickly .	the dancer is very quickly .
the man paints very slowly .	the man was very slowly .
the man paints really slowly .	the man was really slowly .
the child exercises really perfectly .	the child was really perfectly .
the driver exercises really perfectly .	the driver is really perfectly .
the child waves really quietly .	the child is really quietly .
the child talks very quietly .	the child is very quietly .
the teacher waves very slowly .	the teacher is very slowly .
the customer exercises very carefully .	the customer is very carefully .
the driver sings really perfectly .	the driver was really perfectly .
the woman sings very carefully .	the woman is very carefully .
the driver reads really quickly .	the driver is really quickly .
the boy sings really perfectly .	the boy was really perfectly .
the person cries very slowly .	the person was very slowly .
the queen waves very perfectly .	the queen was very perfectly .
the king cries really quietly .	the king is really quietly .
the person cries very slowly .	the person is very slowly .
the lady sings really perfectly .	the lady is really perfectly .
the lady reads very perfectly .	the lady is very perfectly .
the king talks very carefully .	the king was very carefully .
the doctor sings really carefully .	the doctor is really carefully .
the person exercises really slowly .	the person is really slowly .
the adult cries very perfectly .	the adult was very perfectly .
the boy exercises really quietly .	the boy is really quietly .
the woman reads very quickly .	the woman is very quickly .
the customer sings very perfectly .	the customer was very perfectly .
the person cries very carefully .	the person is very carefully .
the king talks very quickly .	the king is very quickly .
the child exercises very perfectly .	the child is very perfectly .
the woman sings very quietly .	the woman is very quietly .
the dentist cries very quickly .	the dentist is very quickly .
the boy waves really slowly .	the boy was really slowly .
the woman talks really perfectly .	the woman was really perfectly .
the guy reads very perfectly .	the guy is very perfectly .
the guy reads very quickly .	the guy was very quickly .
the adult cries really quietly .	the adult is really quietly .
the customer cries very quickly .	the customer is very quickly .
the dentist paints very perfectly .	the dentist was very perfectly .
the patient cries very quickly .	the patient was very quickly .
the girl exercises really quietly .	the girl is really quietly .
the teacher sings really quickly .	the teacher is really quickly .
the child paints very carefully .	the child was very carefully .
the guy waves really perfectly .	the guy was really perfectly .
the king exercises really slowly .	the king was really slowly .
the dentist talks really quietly .	the dentist is really quietly .
the guy sings very quietly .	the guy was very quietly .
the person exercises really quickly .	the person is really quickly .
the guy exercises very perfectly .	the guy was very perfectly .
the guy sings very carefully .	the guy is very carefully .
the patient paints really quietly .	the patient was really quietly .
the customer reads really perfectly .	the customer is really perfectly .
the dentist sings really quietly .	the dentist was really quietly .
the patient paints really carefully .	the patient was really carefully .
the adult waves very slowly .	the adult is very slowly .
the girl cries really slowly .	the girl is really slowly .
the man cries really quietly .	the man was really quietly .
the man reads really quickly .	the man was really quickly .
the boy paints very perfectly .	the boy is very perfectly .
the girl exercises very perfectly .	the girl is very perfectly .
the dancer reads very quietly .	the dancer was very quietly .
the guy cries really quietly .	the guy is really quietly .
the man talks very slowly .	the man was very slowly .
the dancer cries really quietly .	the dancer was really quietly .
the adult talks very quietly .	the adult was very quietly .
the adult waves really perfectly .	the adult was really perfectly .
the woman talks very carefully .	the woman is very carefully .
the girl waves really quickly .	the girl was really quickly .
the child waves very quietly .	the child is very quietly .
the guy paints really slowly .	the guy is really slowly .
the woman reads really perfectly .	the woman is really perfectly .
the lady sings really slowly .	the lady was really slowly .
the adult waves very perfectly .	the adult was very perfectly .
the guy reads very carefully .	the guy is very carefully .
the teacher cries really perfectly .	the teacher was really perfectly .
the patient talks really quietly .	the patient is really quietly .
the king exercises really quietly .	the king was really quietly .
the teacher cries really quickly .	the teacher was really quickly .
the dentist waves really quickly .	the dentist is really quickly .
the king waves very quickly .	the king is very quickly .
the doctor cries really slowly .	the doctor was really slowly .
the customer sings really perfectly .	the customer is really perfectly .
the driver cries really carefully .	the driver is really carefully .
the driver reads very slowly .	the driver was very slowly .
the doctor talks really carefully .	the doctor is really carefully .
the patient reads very perfectly .	the patient is very perfectly .
the adult sings very quickly .	the adult was very quickly .
the customer sings very quietly .	the customer is very quietly .
the customer paints really perfectly .	the customer was really perfectly .
the woman reads really carefully .	the woman was really carefully .
the patient cries very quietly .	the patient is very quietly .
the adult reads very carefully .	the adult was very carefully .
the woman paints very perfectly .	the woman was very perfectly .
the doctor cries very quietly .	the doctor is very quietly .
the child paints really carefully .	the child is really carefully .
the lady cries really perfectly .	the lady is really perfectly .
the customer reads really carefully .	the customer is really carefully .
the patient exercises very slowly .	the patient was very slowly .
the child waves very quickly .	the child is very quickly .
the dentist waves very slowly .	the dentist was very slowly .
the dentist reads very slowly .	the dentist is very slowly .
the patient sings very slowly .	the patient was very slowly .
the doctor sings really perfectly .	the doctor was really perfectly .
the lady reads really perfectly .	the lady was really perfectly .
the boy cries really quietly .	the boy was really quietly .
the man sings very quietly .	the man was very quietly .
the teacher talks really quickly .	the teacher is really quickly .
the teacher paints really perfectly .	the teacher is really perfectly .
the customer reads very quietly .	the customer is very quietly .
the woman cries very quietly .	the woman is very quietly .
the queen cries really quickly .	the queen was really quickly .
the customer waves really carefully .	the customer is really carefully .
the person paints very quietly .	the person is very quietly .
the king waves very carefully .	the king was very carefully .
the girl sings really perfectly .	the girl was really perfectly .
the customer waves really perfectly .	the customer was really perfectly .
the customer paints really quietly .	the customer is really quietly .
the king exercises very quickly .	the king was very quickly .
the adult sings really quickly .	the adult is really quickly .
the woman waves very perfectly .	the woman was very perfectly .
the patient waves very quickly .	the patient was very quickly .
the lady exercises very carefully .	the lady is very carefully .
the patient waves very carefully .	the patient is very carefully .
the woman cries really quietly .	the woman was really quietly .
the dancer talks really slowly .	the dancer was really slowly .
the doctor paints really perfectly .	the doctor is really perfectly .
the child paints very quickly .	the child is very quickly .
the patient sings very quickly .	the patient is very quickly .
the adult paints very quickly .	the adult was very quickly .
the doctor cries very slowly .	the doctor was very slowly .
the teacher talks really quickly .	the teacher was really quickly .
the guy waves really quickly .	the guy was really quickly .
the man sings really perfectly .	the man was really perfectly .
the dancer sings very perfectly .	the dancer was very perfectly .
the customer waves very quickly .	the customer is very quickly .
the man exercises really quietly .	the man was really quietly .
the queen cries very slowly .	the queen is very slowly .
