the bottle bought your father 's boss 's grandmother 's teacher 's father 's cousin 's picture the truck .	the bottle cleaned your father 's boss 's grandmother 's teacher 's father 's cousin 's picture the truck .
the hat gave my daughter 's wife 's sister 's dentist 's sister 's friend 's book the crayon .	the hat held my daughter 's wife 's sister 's dentist 's sister 's friend 's book the crayon .
the spoon gave your wife 's dentist 's husband 's daughter 's mother 's cousin 's bag the crayon .	the spoon lost your wife 's dentist 's husband 's daughter 's mother 's cousin 's bag the crayon .
the dish bought my husband 's teacher 's dentist 's grandmother 's teacher 's mother 's plane the ship .	the dish shook my husband 's teacher 's dentist 's grandmother 's teacher 's mother 's plane the ship .
the window bought my teacher 's son 's wife 's sister 's wife 's brother 's candle the chair .	the window held my teacher 's son 's wife 's sister 's wife 's brother 's candle the chair .
the book bought my doctor 's father 's doctor 's doctor 's teacher 's dentist 's car the box .	the book lost my doctor 's father 's doctor 's doctor 's teacher 's dentist 's car the box .
the spoon sent my boss 's dad 's sister 's daughter 's sister 's grandmother 's bowl the hat .	the spoon held my boss 's dad 's sister 's daughter 's sister 's grandmother 's bowl the hat .
the mirror gave your daughter 's husband 's husband 's son 's husband 's father 's button the crayon .	the mirror lost your daughter 's husband 's husband 's son 's husband 's father 's button the crayon .
the plate showed my grandmother 's husband 's sister 's son 's dentist 's daughter 's truck the chair .	the plate dropped my grandmother 's husband 's sister 's son 's dentist 's daughter 's truck the chair .
the plane bought your grandmother 's father 's wife 's mother 's doctor 's wife 's truck the couch .	the plane kept your grandmother 's father 's wife 's mother 's doctor 's wife 's truck the couch .
the door bought your husband 's mom 's father 's doctor 's friend 's sister 's book the window .	the door dropped your husband 's mom 's father 's doctor 's friend 's sister 's book the window .
the mirror showed your friend 's son 's doctor 's cousin 's daughter 's boss 's car the chair .	the mirror dropped your friend 's son 's doctor 's cousin 's daughter 's boss 's car the chair .
the bag bought your son 's grandmother 's doctor 's dad 's teacher 's dad 's toy the mirror .	the bag kept your son 's grandmother 's doctor 's dad 's teacher 's dad 's toy the mirror .
the bottle showed my friend 's dad 's dentist 's grandmother 's wife 's wife 's chair the cup .	the bottle kept my friend 's dad 's dentist 's grandmother 's wife 's wife 's chair the cup .
the bed showed my wife 's cousin 's mother 's boss 's dentist 's husband 's couch the mirror .	the bed cleaned my wife 's cousin 's mother 's boss 's dentist 's husband 's couch the mirror .
the couch gave my brother 's sister 's dad 's sister 's mom 's husband 's plane the bag .	the couch kept my brother 's sister 's dad 's sister 's mom 's husband 's plane the bag .
the window showed my daughter 's doctor 's father 's mother 's doctor 's mother 's truck the shirt .	the window shook my daughter 's doctor 's father 's mother 's doctor 's mother 's truck the shirt .
the shoe gave my dentist 's brother 's son 's dentist 's dentist 's husband 's bottle the bowl .	the shoe dropped my dentist 's brother 's son 's dentist 's dentist 's husband 's bottle the bowl .
the glass sent your mother 's daughter 's mother 's doctor 's sister 's wife 's picture the rug .	the glass cleaned your mother 's daughter 's mother 's doctor 's sister 's wife 's picture the rug .
the shoe sent my brother 's grandmother 's daughter 's dentist 's daughter 's teacher 's picture the button .	the shoe shook my brother 's grandmother 's daughter 's dentist 's daughter 's teacher 's picture the button .
the glass showed my dentist 's mom 's mother 's husband 's mother 's mom 's crayon the truck .	the glass lost my dentist 's mom 's mother 's husband 's mother 's mom 's crayon the truck .
the rocket bought my mom 's father 's dentist 's brother 's mother 's grandmother 's bed the car .	the rocket lost my mom 's father 's dentist 's brother 's mother 's grandmother 's bed the car .
the plate sent your friend 's mom 's wife 's dad 's sister 's cousin 's doll the button .	the plate lost your friend 's mom 's wife 's dad 's sister 's cousin 's doll the button .
the bottle gave your father 's wife 's wife 's husband 's son 's husband 's truck the car .	the bottle cleaned your father 's wife 's wife 's husband 's son 's husband 's truck the car .
the fork bought your friend 's grandmother 's grandmother 's dad 's mom 's dentist 's bag the plane .	the fork kept your friend 's grandmother 's grandmother 's dad 's mom 's dentist 's bag the plane .
the box bought my mother 's sister 's dad 's mom 's son 's wife 's chair the cup .	the box shook my mother 's sister 's dad 's mom 's son 's wife 's chair the cup .
the hat sent your dentist 's cousin 's boss 's father 's sister 's mom 's doll the rocket .	the hat shook your dentist 's cousin 's boss 's father 's sister 's mom 's doll the rocket .
the plate showed my dentist 's grandmother 's grandmother 's teacher 's cousin 's mom 's toy the spoon .	the plate dropped my dentist 's grandmother 's grandmother 's teacher 's cousin 's mom 's toy the spoon .
the button gave my dentist 's daughter 's friend 's teacher 's grandmother 's teacher 's plate the window .	the button kept my dentist 's daughter 's friend 's teacher 's grandmother 's teacher 's plate the window .
the book showed your doctor 's father 's daughter 's boss 's friend 's friend 's bottle the bowl .	the book shook your doctor 's father 's daughter 's boss 's friend 's friend 's bottle the bowl .
the doll bought my grandmother 's son 's father 's dad 's friend 's doctor 's glass the box .	the doll dropped my grandmother 's son 's father 's dad 's friend 's doctor 's glass the box .
the shoe showed your sister 's mom 's grandmother 's mother 's dad 's friend 's shoe the spoon .	the shoe shook your sister 's mom 's grandmother 's mother 's dad 's friend 's shoe the spoon .
the bicycle showed my teacher 's doctor 's mother 's boss 's dentist 's mother 's rug the box .	the bicycle moved my teacher 's doctor 's mother 's boss 's dentist 's mother 's rug the box .
the book gave my cousin 's brother 's cousin 's doctor 's cousin 's wife 's picture the shoe .	the book lost my cousin 's brother 's cousin 's doctor 's cousin 's wife 's picture the shoe .
the bicycle sent your doctor 's mother 's grandmother 's boss 's boss 's mother 's bicycle the bicycle .	the bicycle kept your doctor 's mother 's grandmother 's boss 's boss 's mother 's bicycle the bicycle .
the cup sent your sister 's grandmother 's friend 's daughter 's dentist 's wife 's bicycle the spoon .	the cup shook your sister 's grandmother 's friend 's daughter 's dentist 's wife 's bicycle the spoon .
the hat showed your wife 's dad 's brother 's father 's brother 's friend 's car the doll .	the hat kept your wife 's dad 's brother 's father 's brother 's friend 's car the doll .
the bottle gave your mother 's mother 's father 's teacher 's friend 's grandmother 's bottle the button .	the bottle kept your mother 's mother 's father 's teacher 's friend 's grandmother 's bottle the button .
the boat showed my grandmother 's boss 's boss 's doctor 's doctor 's boss 's car the button .	the boat kept my grandmother 's boss 's boss 's doctor 's doctor 's boss 's car the button .
the ship showed my grandmother 's doctor 's mom 's son 's husband 's father 's fork the window .	the ship moved my grandmother 's doctor 's mom 's son 's husband 's father 's fork the window .
the bicycle bought your boss 's wife 's mother 's sister 's wife 's father 's glass the plane .	the bicycle dropped your boss 's wife 's mother 's sister 's wife 's father 's glass the plane .
the bottle gave my friend 's sister 's boss 's boss 's mom 's mom 's shirt the bed .	the bottle lost my friend 's sister 's boss 's boss 's mom 's mom 's shirt the bed .
the bowl gave your cousin 's sister 's father 's cousin 's brother 's father 's book the chair .	the bowl held your cousin 's sister 's father 's cousin 's brother 's father 's book the chair .
the bag sent my sister 's boss 's daughter 's friend 's doctor 's father 's shirt the plate .	the bag shook my sister 's boss 's daughter 's friend 's doctor 's father 's shirt the plate .
the plate gave my grandmother 's daughter 's son 's father 's dad 's friend 's cup the toy .	the plate shook my grandmother 's daughter 's son 's father 's dad 's friend 's cup the toy .
the truck sent my sister 's husband 's daughter 's husband 's brother 's father 's rocket the mirror .	the truck shook my sister 's husband 's daughter 's husband 's brother 's father 's rocket the mirror .
the book showed your daughter 's cousin 's son 's sister 's mom 's friend 's book the bicycle .	the book dropped your daughter 's cousin 's son 's sister 's mom 's friend 's book the bicycle .
the book gave your friend 's doctor 's husband 's husband 's dad 's dad 's window the book .	the book moved your friend 's doctor 's husband 's husband 's dad 's dad 's window the book .
the hat sent my friend 's daughter 's dad 's doctor 's doctor 's son 's bicycle the book .	the hat kept my friend 's daughter 's dad 's doctor 's doctor 's son 's bicycle the book .
the bowl gave my sister 's boss 's son 's boss 's boss 's son 's box the couch .	the bowl held my sister 's boss 's son 's boss 's boss 's son 's box the couch .
the book sent my mother 's son 's doctor 's brother 's brother 's sister 's chair the couch .	the book shook my mother 's son 's doctor 's brother 's brother 's sister 's chair the couch .
the bag showed your husband 's dad 's cousin 's boss 's husband 's son 's rug the shirt .	the bag held your husband 's dad 's cousin 's boss 's husband 's son 's rug the shirt .
the crayon sent your wife 's grandmother 's wife 's mom 's friend 's grandmother 's cup the hat .	the crayon moved your wife 's grandmother 's wife 's mom 's friend 's grandmother 's cup the hat .
the bowl sent your dad 's daughter 's dentist 's dentist 's wife 's sister 's bicycle the ship .	the bowl moved your dad 's daughter 's dentist 's dentist 's wife 's sister 's bicycle the ship .
the boat sent my teacher 's teacher 's doctor 's cousin 's dentist 's teacher 's bottle the plate .	the boat dropped my teacher 's teacher 's doctor 's cousin 's dentist 's teacher 's bottle the plate .
the bed gave my husband 's son 's dad 's husband 's daughter 's brother 's car the spoon .	the bed held my husband 's son 's dad 's husband 's daughter 's brother 's car the spoon .
the box sent my daughter 's teacher 's daughter 's sister 's son 's teacher 's button the ring .	the box dropped my daughter 's teacher 's daughter 's sister 's son 's teacher 's button the ring .
the glass showed your wife 's mother 's friend 's husband 's daughter 's teacher 's couch the rug .	the glass cleaned your wife 's mother 's friend 's husband 's daughter 's teacher 's couch the rug .
the bottle sent your mom 's mother 's brother 's friend 's sister 's mother 's boat the plate .	the bottle shook your mom 's mother 's brother 's friend 's sister 's mother 's boat the plate .
the hat showed your mother 's dentist 's father 's dentist 's doctor 's teacher 's bed the car .	the hat cleaned your mother 's dentist 's father 's dentist 's doctor 's teacher 's bed the car .
the crayon gave my daughter 's teacher 's sister 's mother 's dad 's dentist 's shoe the plane .	the crayon dropped my daughter 's teacher 's sister 's mother 's dad 's dentist 's shoe the plane .
the mirror gave my daughter 's dad 's boss 's dentist 's doctor 's wife 's glass the truck .	the mirror dropped my daughter 's dad 's boss 's dentist 's doctor 's wife 's glass the truck .
the spoon gave your dad 's friend 's boss 's boss 's doctor 's dentist 's toy the car .	the spoon shook your dad 's friend 's boss 's boss 's doctor 's dentist 's toy the car .
the crayon bought your husband 's teacher 's father 's daughter 's sister 's boss 's rug the truck .	the crayon kept your husband 's teacher 's father 's daughter 's sister 's boss 's rug the truck .
the car showed my mom 's dad 's grandmother 's mom 's boss 's dentist 's box the chair .	the car kept my mom 's dad 's grandmother 's mom 's boss 's dentist 's box the chair .
the rocket sent your husband 's daughter 's dad 's husband 's father 's husband 's hat the mirror .	the rocket dropped your husband 's daughter 's dad 's husband 's father 's husband 's hat the mirror .
the rocket sent your doctor 's dentist 's doctor 's mother 's husband 's cousin 's bowl the mirror .	the rocket lost your doctor 's dentist 's doctor 's mother 's husband 's cousin 's bowl the mirror .
the spoon gave my doctor 's wife 's father 's daughter 's wife 's dad 's book the bottle .	the spoon shook my doctor 's wife 's father 's daughter 's wife 's dad 's book the bottle .
the candle gave my brother 's mom 's wife 's cousin 's mom 's father 's hat the bed .	the candle moved my brother 's mom 's wife 's cousin 's mom 's father 's hat the bed .
the button gave my daughter 's dentist 's teacher 's son 's grandmother 's dentist 's book the ring .	the button dropped my daughter 's dentist 's teacher 's son 's grandmother 's dentist 's book the ring .
the spoon bought your brother 's mother 's friend 's friend 's grandmother 's wife 's cup the crayon .	the spoon kept your brother 's mother 's friend 's friend 's grandmother 's wife 's cup the crayon .
the fork bought your cousin 's dentist 's friend 's father 's father 's cousin 's glass the glass .	the fork moved your cousin 's dentist 's friend 's father 's father 's cousin 's glass the glass .
the car showed your dentist 's friend 's cousin 's mom 's son 's husband 's dish the doll .	the car dropped your dentist 's friend 's cousin 's mom 's son 's husband 's dish the doll .
the picture showed my dad 's cousin 's dentist 's husband 's friend 's grandmother 's doll the glass .	the picture dropped my dad 's cousin 's dentist 's husband 's friend 's grandmother 's doll the glass .
the candle sent my daughter 's dentist 's wife 's friend 's daughter 's son 's bicycle the ship .	the candle held my daughter 's dentist 's wife 's friend 's daughter 's son 's bicycle the ship .
the hat bought your brother 's dentist 's father 's cousin 's boss 's grandmother 's truck the glass .	the hat dropped your brother 's dentist 's father 's cousin 's boss 's grandmother 's truck the glass .
the plane sent my doctor 's mom 's cousin 's boss 's friend 's mother 's book the truck .	the plane moved my doctor 's mom 's cousin 's boss 's friend 's mother 's book the truck .
the candle showed your mom 's teacher 's wife 's daughter 's doctor 's grandmother 's plane the box .	the candle cleaned your mom 's teacher 's wife 's daughter 's doctor 's grandmother 's plane the box .
the button gave my teacher 's father 's son 's mom 's father 's boss 's fork the candle .	the button dropped my teacher 's father 's son 's mom 's father 's boss 's fork the candle .
the window bought my dad 's cousin 's grandmother 's doctor 's friend 's son 's spoon the glass .	the window held my dad 's cousin 's grandmother 's doctor 's friend 's son 's spoon the glass .
the plane sent my friend 's husband 's boss 's brother 's daughter 's mother 's toy the mirror .	the plane dropped my friend 's husband 's boss 's brother 's daughter 's mother 's toy the mirror .
the crayon gave my boss 's son 's father 's husband 's cousin 's mother 's cup the dish .	the crayon cleaned my boss 's son 's father 's husband 's cousin 's mother 's cup the dish .
the bag bought your cousin 's mom 's wife 's sister 's grandmother 's brother 's doll the plate .	the bag moved your cousin 's mom 's wife 's sister 's grandmother 's brother 's doll the plate .
the rug bought your mom 's friend 's doctor 's daughter 's cousin 's grandmother 's cup the ship .	the rug lost your mom 's friend 's doctor 's daughter 's cousin 's grandmother 's cup the ship .
the book bought my husband 's dentist 's father 's cousin 's dad 's mother 's rug the shoe .	the book moved my husband 's dentist 's father 's cousin 's dad 's mother 's rug the shoe .
the chair showed my dentist 's doctor 's dentist 's husband 's cousin 's son 's plane the couch .	the chair held my dentist 's doctor 's dentist 's husband 's cousin 's son 's plane the couch .
the cup showed your wife 's mother 's friend 's grandmother 's father 's son 's ring the book .	the cup moved your wife 's mother 's friend 's grandmother 's father 's son 's ring the book .
the bicycle sent your daughter 's mother 's teacher 's son 's husband 's mother 's dish the mirror .	the bicycle moved your daughter 's mother 's teacher 's son 's husband 's mother 's dish the mirror .
the picture showed my doctor 's sister 's mother 's dentist 's son 's wife 's bicycle the bottle .	the picture shook my doctor 's sister 's mother 's dentist 's son 's wife 's bicycle the bottle .
the door showed my dad 's dentist 's daughter 's doctor 's mom 's husband 's book the window .	the door cleaned my dad 's dentist 's daughter 's doctor 's mom 's husband 's book the window .
the box showed your boss 's son 's friend 's father 's husband 's boss 's book the picture .	the box lost your boss 's son 's friend 's father 's husband 's boss 's book the picture .
the spoon showed your father 's dentist 's daughter 's doctor 's cousin 's daughter 's book the dish .	the spoon kept your father 's dentist 's daughter 's doctor 's cousin 's daughter 's book the dish .
the couch gave my dad 's mother 's doctor 's dentist 's grandmother 's wife 's crayon the window .	the couch held my dad 's mother 's doctor 's dentist 's grandmother 's wife 's crayon the window .
the car gave my dad 's brother 's brother 's cousin 's son 's doctor 's book the glass .	the car held my dad 's brother 's brother 's cousin 's son 's doctor 's book the glass .
the bed showed your cousin 's cousin 's friend 's cousin 's cousin 's father 's mirror the bowl .	the bed lost your cousin 's cousin 's friend 's cousin 's cousin 's father 's mirror the bowl .
the plate gave my husband 's father 's husband 's son 's sister 's father 's shirt the fork .	the plate kept my husband 's father 's husband 's son 's sister 's father 's shirt the fork .
the bowl gave my son 's sister 's doctor 's husband 's wife 's mother 's plate the shirt .	the bowl dropped my son 's sister 's doctor 's husband 's wife 's mother 's plate the shirt .
the door bought your boss 's grandmother 's boss 's brother 's father 's father 's ship the chair .	the door lost your boss 's grandmother 's boss 's brother 's father 's father 's ship the chair .
the spoon bought your teacher 's mom 's daughter 's cousin 's brother 's son 's bag the button .	the spoon kept your teacher 's mom 's daughter 's cousin 's brother 's son 's bag the button .
the button bought my dentist 's wife 's grandmother 's mom 's son 's dad 's rug the shoe .	the button kept my dentist 's wife 's grandmother 's mom 's son 's dad 's rug the shoe .
the doll gave your mother 's dentist 's grandmother 's sister 's brother 's grandmother 's bicycle the couch .	the doll lost your mother 's dentist 's grandmother 's sister 's brother 's grandmother 's bicycle the couch .
the crayon bought your son 's dentist 's wife 's doctor 's daughter 's father 's plate the shirt .	the crayon dropped your son 's dentist 's wife 's doctor 's daughter 's father 's plate the shirt .
the shirt sent your dad 's mom 's sister 's mother 's dentist 's dad 's bed the truck .	the shirt dropped your dad 's mom 's sister 's mother 's dentist 's dad 's bed the truck .
the hat showed my dentist 's father 's dad 's wife 's dentist 's mom 's bed the button .	the hat kept my dentist 's father 's dad 's wife 's dentist 's mom 's bed the button .
the picture showed my friend 's brother 's mom 's boss 's father 's husband 's shirt the window .	the picture moved my friend 's brother 's mom 's boss 's father 's husband 's shirt the window .
the crayon showed my brother 's mother 's brother 's mother 's cousin 's daughter 's boat the window .	the crayon kept my brother 's mother 's brother 's mother 's cousin 's daughter 's boat the window .
the plane sent my wife 's brother 's mother 's father 's boss 's sister 's book the car .	the plane lost my wife 's brother 's mother 's father 's boss 's sister 's book the car .
the bed gave your wife 's son 's dad 's husband 's son 's wife 's bed the boat .	the bed dropped your wife 's son 's dad 's husband 's son 's wife 's bed the boat .
the glass gave my friend 's grandmother 's mother 's husband 's mother 's mom 's glass the couch .	the glass kept my friend 's grandmother 's mother 's husband 's mother 's mom 's glass the couch .
the couch showed your daughter 's cousin 's mom 's cousin 's doctor 's friend 's shoe the fork .	the couch cleaned your daughter 's cousin 's mom 's cousin 's doctor 's friend 's shoe the fork .
the box showed my brother 's daughter 's boss 's dentist 's mom 's boss 's chair the door .	the box dropped my brother 's daughter 's boss 's dentist 's mom 's boss 's chair the door .
the fork gave my son 's son 's dad 's boss 's brother 's mom 's mirror the door .	the fork moved my son 's son 's dad 's boss 's brother 's mom 's mirror the door .
the button sent your brother 's dad 's wife 's dentist 's grandmother 's sister 's ship the ring .	the button held your brother 's dad 's wife 's dentist 's grandmother 's sister 's ship the ring .
the window bought my father 's friend 's sister 's friend 's husband 's doctor 's book the window .	the window shook my father 's friend 's sister 's friend 's husband 's doctor 's book the window .
the shoe showed your boss 's daughter 's friend 's doctor 's sister 's teacher 's bed the boat .	the shoe dropped your boss 's daughter 's friend 's doctor 's sister 's teacher 's bed the boat .
the bicycle gave your mom 's daughter 's husband 's son 's son 's grandmother 's picture the box .	the bicycle dropped your mom 's daughter 's husband 's son 's son 's grandmother 's picture the box .
the shoe bought your cousin 's brother 's father 's boss 's dentist 's husband 's rocket the spoon .	the shoe moved your cousin 's brother 's father 's boss 's dentist 's husband 's rocket the spoon .
the plane sent my wife 's daughter 's cousin 's son 's wife 's father 's bottle the box .	the plane dropped my wife 's daughter 's cousin 's son 's wife 's father 's bottle the box .
the ring showed your boss 's dad 's wife 's friend 's boss 's father 's bed the hat .	the ring lost your boss 's dad 's wife 's friend 's boss 's father 's bed the hat .
the shirt gave your sister 's friend 's dentist 's mother 's dentist 's father 's bag the button .	the shirt shook your sister 's friend 's dentist 's mother 's dentist 's father 's bag the button .
the toy showed your brother 's dad 's teacher 's dentist 's wife 's son 's glass the hat .	the toy held your brother 's dad 's teacher 's dentist 's wife 's son 's glass the hat .
the bicycle gave my doctor 's daughter 's wife 's doctor 's grandmother 's mom 's book the chair .	the bicycle kept my doctor 's daughter 's wife 's doctor 's grandmother 's mom 's book the chair .
the bicycle gave my brother 's doctor 's dad 's mother 's mother 's teacher 's door the picture .	the bicycle held my brother 's doctor 's dad 's mother 's mother 's teacher 's door the picture .
the book bought your mom 's cousin 's grandmother 's grandmother 's husband 's daughter 's bicycle the book .	the book lost your mom 's cousin 's grandmother 's grandmother 's husband 's daughter 's bicycle the book .
the plate showed your mom 's teacher 's boss 's dad 's cousin 's brother 's book the button .	the plate lost your mom 's teacher 's boss 's dad 's cousin 's brother 's book the button .
the book bought your husband 's mom 's wife 's daughter 's husband 's teacher 's truck the bag .	the book shook your husband 's mom 's wife 's daughter 's husband 's teacher 's truck the bag .
the boat bought your mom 's dentist 's sister 's teacher 's doctor 's mother 's mirror the crayon .	the boat lost your mom 's dentist 's sister 's teacher 's doctor 's mother 's mirror the crayon .
the fork gave your son 's mom 's grandmother 's sister 's wife 's mother 's doll the spoon .	the fork lost your son 's mom 's grandmother 's sister 's wife 's mother 's doll the spoon .
the ring gave my cousin 's teacher 's friend 's friend 's cousin 's grandmother 's shirt the toy .	the ring held my cousin 's teacher 's friend 's friend 's cousin 's grandmother 's shirt the toy .
the picture bought my father 's mother 's husband 's brother 's wife 's mom 's ship the dish .	the picture shook my father 's mother 's husband 's brother 's wife 's mom 's ship the dish .
the crayon gave my grandmother 's friend 's wife 's boss 's dentist 's husband 's car the candle .	the crayon lost my grandmother 's friend 's wife 's boss 's dentist 's husband 's car the candle .
the mirror bought my husband 's wife 's dad 's teacher 's mother 's mom 's crayon the bicycle .	the mirror dropped my husband 's wife 's dad 's teacher 's mother 's mom 's crayon the bicycle .
the spoon bought my doctor 's daughter 's sister 's dad 's boss 's boss 's box the hat .	the spoon held my doctor 's daughter 's sister 's dad 's boss 's boss 's box the hat .
the bowl sent your sister 's grandmother 's son 's mom 's father 's doctor 's ring the candle .	the bowl held your sister 's grandmother 's son 's mom 's father 's doctor 's ring the candle .
the rug bought your brother 's teacher 's dad 's sister 's son 's mom 's bicycle the truck .	the rug moved your brother 's teacher 's dad 's sister 's son 's mom 's bicycle the truck .
the plate sent your sister 's daughter 's dentist 's grandmother 's doctor 's dentist 's bed the picture .	the plate moved your sister 's daughter 's dentist 's grandmother 's doctor 's dentist 's bed the picture .
the button bought your father 's grandmother 's father 's mom 's son 's teacher 's spoon the cup .	the button moved your father 's grandmother 's father 's mom 's son 's teacher 's spoon the cup .
the truck bought your father 's father 's cousin 's mom 's daughter 's doctor 's bowl the dish .	the truck moved your father 's father 's cousin 's mom 's daughter 's doctor 's bowl the dish .
the candle bought my sister 's father 's dentist 's doctor 's mother 's husband 's doll the shirt .	the candle lost my sister 's father 's dentist 's doctor 's mother 's husband 's doll the shirt .
the bottle gave your mother 's dentist 's doctor 's doctor 's dad 's dad 's bed the spoon .	the bottle shook your mother 's dentist 's doctor 's doctor 's dad 's dad 's bed the spoon .
the spoon sent my grandmother 's grandmother 's brother 's wife 's father 's wife 's ring the bag .	the spoon dropped my grandmother 's grandmother 's brother 's wife 's father 's wife 's ring the bag .
the ring bought my dentist 's husband 's friend 's sister 's dentist 's grandmother 's plane the ring .	the ring held my dentist 's husband 's friend 's sister 's dentist 's grandmother 's plane the ring .
the rocket showed your doctor 's dad 's boss 's daughter 's cousin 's boss 's rug the rug .	the rocket cleaned your doctor 's dad 's boss 's daughter 's cousin 's boss 's rug the rug .
the cup showed your doctor 's mom 's son 's mother 's father 's teacher 's toy the button .	the cup dropped your doctor 's mom 's son 's mother 's father 's teacher 's toy the button .
the shirt showed your dentist 's grandmother 's daughter 's teacher 's mother 's friend 's rug the bicycle .	the shirt shook your dentist 's grandmother 's daughter 's teacher 's mother 's friend 's rug the bicycle .
the button bought my husband 's friend 's dad 's wife 's mom 's grandmother 's crayon the rug .	the button dropped my husband 's friend 's dad 's wife 's mom 's grandmother 's crayon the rug .
the book showed my dentist 's teacher 's husband 's wife 's son 's daughter 's door the fork .	the book cleaned my dentist 's teacher 's husband 's wife 's son 's daughter 's door the fork .
the picture showed my mom 's sister 's mom 's boss 's grandmother 's teacher 's hat the shoe .	the picture shook my mom 's sister 's mom 's boss 's grandmother 's teacher 's hat the shoe .
the dish gave my father 's daughter 's brother 's wife 's daughter 's brother 's shirt the toy .	the dish kept my father 's daughter 's brother 's wife 's daughter 's brother 's shirt the toy .
the chair sent your teacher 's son 's dentist 's friend 's teacher 's mom 's couch the bowl .	the chair kept your teacher 's son 's dentist 's friend 's teacher 's mom 's couch the bowl .
the bicycle sent your grandmother 's doctor 's boss 's sister 's boss 's wife 's ring the rocket .	the bicycle shook your grandmother 's doctor 's boss 's sister 's boss 's wife 's ring the rocket .
the bed gave your dad 's sister 's brother 's grandmother 's husband 's father 's shoe the button .	the bed dropped your dad 's sister 's brother 's grandmother 's husband 's father 's shoe the button .
the bicycle sent my boss 's father 's mom 's wife 's teacher 's doctor 's toy the boat .	the bicycle dropped my boss 's father 's mom 's wife 's teacher 's doctor 's toy the boat .
the bowl showed your mom 's mom 's friend 's brother 's mother 's dad 's ring the car .	the bowl held your mom 's mom 's friend 's brother 's mother 's dad 's ring the car .
the mirror bought my son 's mom 's doctor 's doctor 's doctor 's teacher 's plane the car .	the mirror dropped my son 's mom 's doctor 's doctor 's doctor 's teacher 's plane the car .
the book bought my boss 's boss 's father 's husband 's brother 's father 's bed the chair .	the book cleaned my boss 's boss 's father 's husband 's brother 's father 's bed the chair .
the mirror sent my grandmother 's teacher 's cousin 's boss 's mom 's mother 's bicycle the rocket .	the mirror shook my grandmother 's teacher 's cousin 's boss 's mom 's mother 's bicycle the rocket .
the glass bought my daughter 's daughter 's dentist 's father 's teacher 's boss 's ring the picture .	the glass held my daughter 's daughter 's dentist 's father 's teacher 's boss 's ring the picture .
the rocket gave your dad 's boss 's boss 's mom 's husband 's brother 's fork the candle .	the rocket lost your dad 's boss 's boss 's mom 's husband 's brother 's fork the candle .
the hat sent your daughter 's dad 's teacher 's sister 's friend 's mom 's ship the book .	the hat moved your daughter 's dad 's teacher 's sister 's friend 's mom 's ship the book .
the couch bought my husband 's dad 's husband 's grandmother 's mother 's mom 's picture the book .	the couch lost my husband 's dad 's husband 's grandmother 's mother 's mom 's picture the book .
the door gave my boss 's mother 's dad 's daughter 's dad 's mother 's couch the book .	the door held my boss 's mother 's dad 's daughter 's dad 's mother 's couch the book .
the shoe showed my dentist 's father 's son 's brother 's mom 's boss 's book the window .	the shoe dropped my dentist 's father 's son 's brother 's mom 's boss 's book the window .
the rocket gave your teacher 's grandmother 's teacher 's dentist 's mom 's mom 's hat the crayon .	the rocket kept your teacher 's grandmother 's teacher 's dentist 's mom 's mom 's hat the crayon .
the box bought my mom 's doctor 's brother 's husband 's boss 's friend 's bowl the picture .	the box cleaned my mom 's doctor 's brother 's husband 's boss 's friend 's bowl the picture .
the car bought my wife 's friend 's dentist 's mother 's daughter 's son 's toy the car .	the car held my wife 's friend 's dentist 's mother 's daughter 's son 's toy the car .
the crayon sent your grandmother 's mother 's brother 's mother 's daughter 's husband 's book the button .	the crayon dropped your grandmother 's mother 's brother 's mother 's daughter 's husband 's book the button .
the rocket sent your boss 's father 's doctor 's friend 's mother 's dad 's box the ship .	the rocket moved your boss 's father 's doctor 's friend 's mother 's dad 's box the ship .
the dish gave my boss 's boss 's cousin 's daughter 's dentist 's husband 's ship the glass .	the dish cleaned my boss 's boss 's cousin 's daughter 's dentist 's husband 's ship the glass .
the glass showed my father 's sister 's sister 's boss 's sister 's husband 's bicycle the bicycle .	the glass cleaned my father 's sister 's sister 's boss 's sister 's husband 's bicycle the bicycle .
the spoon bought your cousin 's daughter 's daughter 's teacher 's doctor 's dad 's bag the button .	the spoon shook your cousin 's daughter 's daughter 's teacher 's doctor 's dad 's bag the button .
the candle showed my son 's friend 's boss 's doctor 's sister 's boss 's doll the fork .	the candle moved my son 's friend 's boss 's doctor 's sister 's boss 's doll the fork .
the doll gave my son 's doctor 's son 's daughter 's grandmother 's mother 's mirror the toy .	the doll moved my son 's doctor 's son 's daughter 's grandmother 's mother 's mirror the toy .
the couch bought my grandmother 's wife 's cousin 's wife 's mother 's grandmother 's mirror the toy .	the couch kept my grandmother 's wife 's cousin 's wife 's mother 's grandmother 's mirror the toy .
the mirror gave my mom 's brother 's father 's mother 's mom 's sister 's candle the rug .	the mirror lost my mom 's brother 's father 's mother 's mom 's sister 's candle the rug .
the shoe gave my mother 's cousin 's wife 's doctor 's husband 's mom 's book the hat .	the shoe cleaned my mother 's cousin 's wife 's doctor 's husband 's mom 's book the hat .
the glass bought my boss 's husband 's boss 's brother 's brother 's husband 's car the toy .	the glass moved my boss 's husband 's boss 's brother 's brother 's husband 's car the toy .
the car showed your mother 's mother 's cousin 's wife 's mom 's boss 's plane the bed .	the car dropped your mother 's mother 's cousin 's wife 's mom 's boss 's plane the bed .
the car showed my mom 's father 's mom 's brother 's grandmother 's son 's rocket the shirt .	the car shook my mom 's father 's mom 's brother 's grandmother 's son 's rocket the shirt .
the window bought your teacher 's cousin 's wife 's father 's teacher 's grandmother 's ship the shirt .	the window held your teacher 's cousin 's wife 's father 's teacher 's grandmother 's ship the shirt .
the box showed your grandmother 's mother 's sister 's dad 's cousin 's cousin 's ship the dish .	the box shook your grandmother 's mother 's sister 's dad 's cousin 's cousin 's ship the dish .
the cup bought your wife 's father 's teacher 's wife 's dentist 's doctor 's car the ship .	the cup moved your wife 's father 's teacher 's wife 's dentist 's doctor 's car the ship .
the couch gave your mother 's cousin 's teacher 's grandmother 's friend 's brother 's book the crayon .	the couch dropped your mother 's cousin 's teacher 's grandmother 's friend 's brother 's book the crayon .
the spoon showed your teacher 's doctor 's son 's wife 's doctor 's daughter 's picture the chair .	the spoon kept your teacher 's doctor 's son 's wife 's doctor 's daughter 's picture the chair .
the dish gave your brother 's husband 's wife 's friend 's brother 's sister 's spoon the spoon .	the dish cleaned your brother 's husband 's wife 's friend 's brother 's sister 's spoon the spoon .
the button bought my mom 's mom 's mom 's sister 's wife 's mother 's boat the bicycle .	the button kept my mom 's mom 's mom 's sister 's wife 's mother 's boat the bicycle .
the bowl gave your husband 's dentist 's teacher 's grandmother 's mom 's father 's box the bag .	the bowl shook your husband 's dentist 's teacher 's grandmother 's mom 's father 's box the bag .
the car showed my brother 's dad 's boss 's daughter 's daughter 's boss 's fork the picture .	the car dropped my brother 's dad 's boss 's daughter 's daughter 's boss 's fork the picture .
the box bought my dentist 's doctor 's husband 's mother 's dad 's mother 's plane the car .	the box held my dentist 's doctor 's husband 's mother 's dad 's mother 's plane the car .
the car sent my dad 's mom 's mom 's teacher 's boss 's father 's rocket the cup .	the car lost my dad 's mom 's mom 's teacher 's boss 's father 's rocket the cup .
the crayon showed your friend 's mother 's sister 's father 's father 's wife 's rug the candle .	the crayon shook your friend 's mother 's sister 's father 's father 's wife 's rug the candle .
the bowl showed my husband 's husband 's son 's mother 's husband 's wife 's ship the chair .	the bowl cleaned my husband 's husband 's son 's mother 's husband 's wife 's ship the chair .
the picture bought your mom 's boss 's wife 's doctor 's cousin 's dentist 's book the cup .	the picture cleaned your mom 's boss 's wife 's doctor 's cousin 's dentist 's book the cup .
the crayon showed your boss 's boss 's boss 's husband 's mother 's son 's box the plate .	the crayon kept your boss 's boss 's boss 's husband 's mother 's son 's box the plate .
the door showed your grandmother 's dentist 's teacher 's mother 's grandmother 's dentist 's bicycle the bowl .	the door lost your grandmother 's dentist 's teacher 's mother 's grandmother 's dentist 's bicycle the bowl .
the plate sent my friend 's sister 's teacher 's grandmother 's teacher 's brother 's ship the book .	the plate lost my friend 's sister 's teacher 's grandmother 's teacher 's brother 's ship the book .
the spoon showed your mother 's friend 's cousin 's daughter 's teacher 's mother 's plate the button .	the spoon held your mother 's friend 's cousin 's daughter 's teacher 's mother 's plate the button .
the hat bought my husband 's brother 's boss 's grandmother 's sister 's dad 's box the plane .	the hat cleaned my husband 's brother 's boss 's grandmother 's sister 's dad 's box the plane .
the ship gave my doctor 's dentist 's grandmother 's sister 's wife 's husband 's bed the plane .	the ship lost my doctor 's dentist 's grandmother 's sister 's wife 's husband 's bed the plane .
the ring gave your cousin 's father 's brother 's mom 's mom 's mother 's dish the button .	the ring shook your cousin 's father 's brother 's mom 's mom 's mother 's dish the button .
the truck bought my father 's grandmother 's mom 's cousin 's doctor 's grandmother 's dish the book .	the truck lost my father 's grandmother 's mom 's cousin 's doctor 's grandmother 's dish the book .
the car sent your cousin 's teacher 's friend 's cousin 's doctor 's boss 's glass the car .	the car kept your cousin 's teacher 's friend 's cousin 's doctor 's boss 's glass the car .
the toy gave my daughter 's son 's mother 's grandmother 's friend 's doctor 's bed the bag .	the toy held my daughter 's son 's mother 's grandmother 's friend 's doctor 's bed the bag .
the crayon gave your dad 's teacher 's daughter 's grandmother 's father 's dentist 's bicycle the button .	the crayon lost your dad 's teacher 's daughter 's grandmother 's father 's dentist 's bicycle the button .
the fork showed your dentist 's wife 's son 's mom 's father 's sister 's picture the shirt .	the fork dropped your dentist 's wife 's son 's mom 's father 's sister 's picture the shirt .
the bottle sent my dentist 's sister 's grandmother 's daughter 's mother 's mother 's plane the spoon .	the bottle lost my dentist 's sister 's grandmother 's daughter 's mother 's mother 's plane the spoon .
the dish gave my brother 's mom 's cousin 's sister 's mom 's mom 's rug the door .	the dish held my brother 's mom 's cousin 's sister 's mom 's mom 's rug the door .
the bottle gave my boss 's dad 's doctor 's cousin 's sister 's boss 's rug the cup .	the bottle kept my boss 's dad 's doctor 's cousin 's sister 's boss 's rug the cup .
the shoe showed your son 's cousin 's brother 's mom 's mother 's cousin 's shoe the mirror .	the shoe shook your son 's cousin 's brother 's mom 's mother 's cousin 's shoe the mirror .
the button bought my wife 's dad 's doctor 's cousin 's teacher 's teacher 's glass the car .	the button lost my wife 's dad 's doctor 's cousin 's teacher 's teacher 's glass the car .
the bicycle sent my friend 's brother 's teacher 's mother 's teacher 's mom 's boat the door .	the bicycle dropped my friend 's brother 's teacher 's mother 's teacher 's mom 's boat the door .
the bicycle sent your father 's grandmother 's wife 's daughter 's cousin 's friend 's plane the crayon .	the bicycle kept your father 's grandmother 's wife 's daughter 's cousin 's friend 's plane the crayon .
the spoon gave your son 's sister 's wife 's mom 's grandmother 's doctor 's boat the candle .	the spoon cleaned your son 's sister 's wife 's mom 's grandmother 's doctor 's boat the candle .
the car sent your husband 's sister 's father 's daughter 's son 's doctor 's cup the bottle .	the car cleaned your husband 's sister 's father 's daughter 's son 's doctor 's cup the bottle .
the rug bought your daughter 's friend 's teacher 's husband 's sister 's mom 's ring the dish .	the rug cleaned your daughter 's friend 's teacher 's husband 's sister 's mom 's ring the dish .
the door gave my son 's doctor 's doctor 's father 's son 's mom 's boat the window .	the door moved my son 's doctor 's doctor 's father 's son 's mom 's boat the window .
the picture gave your doctor 's father 's boss 's sister 's husband 's friend 's picture the book .	the picture dropped your doctor 's father 's boss 's sister 's husband 's friend 's picture the book .
the bottle bought your dad 's husband 's daughter 's teacher 's friend 's grandmother 's doll the rocket .	the bottle cleaned your dad 's husband 's daughter 's teacher 's friend 's grandmother 's doll the rocket .
the shirt gave my son 's cousin 's dentist 's wife 's father 's mother 's rug the plate .	the shirt dropped my son 's cousin 's dentist 's wife 's father 's mother 's rug the plate .
the picture sent your son 's daughter 's dad 's daughter 's boss 's doctor 's bowl the shoe .	the picture kept your son 's daughter 's dad 's daughter 's boss 's doctor 's bowl the shoe .
the couch sent your sister 's grandmother 's husband 's boss 's doctor 's grandmother 's car the glass .	the couch dropped your sister 's grandmother 's husband 's boss 's doctor 's grandmother 's car the glass .
the fork sent my father 's boss 's son 's dad 's cousin 's mom 's mirror the doll .	the fork held my father 's boss 's son 's dad 's cousin 's mom 's mirror the doll .
the car sent my grandmother 's brother 's mom 's sister 's friend 's wife 's bag the hat .	the car cleaned my grandmother 's brother 's mom 's sister 's friend 's wife 's bag the hat .
the hat gave your father 's cousin 's mom 's doctor 's son 's husband 's shoe the ring .	the hat dropped your father 's cousin 's mom 's doctor 's son 's husband 's shoe the ring .
the bowl bought my friend 's sister 's mom 's husband 's mother 's sister 's picture the bed .	the bowl lost my friend 's sister 's mom 's husband 's mother 's sister 's picture the bed .
the ring sent my mom 's wife 's teacher 's son 's dentist 's son 's ship the doll .	the ring cleaned my mom 's wife 's teacher 's son 's dentist 's son 's ship the doll .
the mirror showed your boss 's mother 's dad 's friend 's doctor 's friend 's rug the spoon .	the mirror lost your boss 's mother 's dad 's friend 's doctor 's friend 's rug the spoon .
the button gave your sister 's brother 's dad 's sister 's boss 's cousin 's ship the glass .	the button lost your sister 's brother 's dad 's sister 's boss 's cousin 's ship the glass .
the picture gave my son 's friend 's brother 's mom 's cousin 's grandmother 's rocket the car .	the picture cleaned my son 's friend 's brother 's mom 's cousin 's grandmother 's rocket the car .
the bottle sent my wife 's daughter 's wife 's son 's doctor 's dad 's plate the bottle .	the bottle held my wife 's daughter 's wife 's son 's doctor 's dad 's plate the bottle .
the book bought my son 's husband 's son 's friend 's mother 's teacher 's rocket the boat .	the book cleaned my son 's husband 's son 's friend 's mother 's teacher 's rocket the boat .
the doll gave your boss 's daughter 's dentist 's sister 's brother 's brother 's boat the couch .	the doll shook your boss 's daughter 's dentist 's sister 's brother 's brother 's boat the couch .
the glass showed my daughter 's sister 's dentist 's husband 's friend 's doctor 's ring the window .	the glass cleaned my daughter 's sister 's dentist 's husband 's friend 's doctor 's ring the window .
the mirror gave my doctor 's mom 's grandmother 's sister 's son 's wife 's mirror the door .	the mirror kept my doctor 's mom 's grandmother 's sister 's son 's wife 's mirror the door .
the cup bought my wife 's dad 's dad 's daughter 's cousin 's teacher 's ship the mirror .	the cup moved my wife 's dad 's dad 's daughter 's cousin 's teacher 's ship the mirror .
the book bought my cousin 's dentist 's teacher 's boss 's grandmother 's cousin 's window the toy .	the book dropped my cousin 's dentist 's teacher 's boss 's grandmother 's cousin 's window the toy .
the bowl bought my grandmother 's cousin 's sister 's cousin 's daughter 's dentist 's toy the crayon .	the bowl kept my grandmother 's cousin 's sister 's cousin 's daughter 's dentist 's toy the crayon .
the cup gave your friend 's dad 's boss 's boss 's teacher 's son 's cup the fork .	the cup moved your friend 's dad 's boss 's boss 's teacher 's son 's cup the fork .
the boat showed my friend 's dentist 's cousin 's dad 's son 's friend 's car the box .	the boat moved my friend 's dentist 's cousin 's dad 's son 's friend 's car the box .
the picture bought your daughter 's grandmother 's daughter 's mother 's mom 's grandmother 's bag the box .	the picture held your daughter 's grandmother 's daughter 's mother 's mom 's grandmother 's bag the box .
the plane showed your daughter 's father 's grandmother 's cousin 's mom 's wife 's glass the picture .	the plane kept your daughter 's father 's grandmother 's cousin 's mom 's wife 's glass the picture .
the picture sent your dad 's boss 's daughter 's mother 's grandmother 's grandmother 's chair the bag .	the picture held your dad 's boss 's daughter 's mother 's grandmother 's grandmother 's chair the bag .
the shoe sent my mom 's dad 's teacher 's boss 's teacher 's wife 's shirt the boat .	the shoe kept my mom 's dad 's teacher 's boss 's teacher 's wife 's shirt the boat .
the fork sent your daughter 's boss 's wife 's doctor 's husband 's dad 's fork the mirror .	the fork kept your daughter 's boss 's wife 's doctor 's husband 's dad 's fork the mirror .
the car bought your friend 's mother 's son 's doctor 's grandmother 's wife 's bicycle the truck .	the car cleaned your friend 's mother 's son 's doctor 's grandmother 's wife 's bicycle the truck .
the shirt sent my mother 's brother 's doctor 's cousin 's mother 's friend 's chair the box .	the shirt held my mother 's brother 's doctor 's cousin 's mother 's friend 's chair the box .
the glass bought your grandmother 's dad 's mother 's dentist 's friend 's brother 's shirt the book .	the glass dropped your grandmother 's dad 's mother 's dentist 's friend 's brother 's shirt the book .
the rug gave your sister 's brother 's grandmother 's father 's friend 's mother 's picture the picture .	the rug shook your sister 's brother 's grandmother 's father 's friend 's mother 's picture the picture .
the crayon bought your sister 's husband 's dad 's teacher 's dad 's sister 's car the bicycle .	the crayon moved your sister 's husband 's dad 's teacher 's dad 's sister 's car the bicycle .
the book showed my wife 's dad 's son 's cousin 's doctor 's boss 's shoe the hat .	the book cleaned my wife 's dad 's son 's cousin 's doctor 's boss 's shoe the hat .
the ring bought your cousin 's son 's grandmother 's friend 's teacher 's sister 's truck the toy .	the ring shook your cousin 's son 's grandmother 's friend 's teacher 's sister 's truck the toy .
the window gave your cousin 's doctor 's friend 's brother 's son 's mother 's glass the bag .	the window shook your cousin 's doctor 's friend 's brother 's son 's mother 's glass the bag .
the boat sent my friend 's teacher 's husband 's son 's mom 's cousin 's glass the bicycle .	the boat dropped my friend 's teacher 's husband 's son 's mom 's cousin 's glass the bicycle .
the rug bought my son 's boss 's doctor 's wife 's dentist 's mother 's shirt the crayon .	the rug held my son 's boss 's doctor 's wife 's dentist 's mother 's shirt the crayon .
the door sent my friend 's dad 's friend 's grandmother 's dad 's teacher 's box the rug .	the door kept my friend 's dad 's friend 's grandmother 's dad 's teacher 's box the rug .
the rug bought my teacher 's wife 's wife 's mother 's doctor 's brother 's ship the chair .	the rug dropped my teacher 's wife 's wife 's mother 's doctor 's brother 's ship the chair .
the hat bought your dentist 's mother 's wife 's friend 's dentist 's grandmother 's shoe the bed .	the hat shook your dentist 's mother 's wife 's friend 's dentist 's grandmother 's shoe the bed .
the car bought my father 's brother 's brother 's boss 's dentist 's cousin 's candle the button .	the car shook my father 's brother 's brother 's boss 's dentist 's cousin 's candle the button .
the chair sent your wife 's dad 's husband 's sister 's doctor 's daughter 's cup the hat .	the chair lost your wife 's dad 's husband 's sister 's doctor 's daughter 's cup the hat .
the book bought your dad 's friend 's friend 's mom 's teacher 's husband 's mirror the bicycle .	the book kept your dad 's friend 's friend 's mom 's teacher 's husband 's mirror the bicycle .
the shoe gave your daughter 's boss 's wife 's friend 's dentist 's friend 's truck the dish .	the shoe dropped your daughter 's boss 's wife 's friend 's dentist 's friend 's truck the dish .
the book sent your daughter 's husband 's mother 's doctor 's mother 's friend 's chair the glass .	the book lost your daughter 's husband 's mother 's doctor 's mother 's friend 's chair the glass .
the cup showed my dad 's father 's father 's boss 's daughter 's father 's dish the ship .	the cup moved my dad 's father 's father 's boss 's daughter 's father 's dish the ship .
the bicycle sent your doctor 's doctor 's father 's grandmother 's dad 's daughter 's rug the couch .	the bicycle held your doctor 's doctor 's father 's grandmother 's dad 's daughter 's rug the couch .
the bowl showed your boss 's father 's cousin 's sister 's brother 's dad 's bottle the spoon .	the bowl lost your boss 's father 's cousin 's sister 's brother 's dad 's bottle the spoon .
the bed gave my daughter 's doctor 's son 's mom 's boss 's teacher 's bicycle the doll .	the bed shook my daughter 's doctor 's son 's mom 's boss 's teacher 's bicycle the doll .
the button sent my grandmother 's daughter 's son 's sister 's doctor 's grandmother 's boat the glass .	the button dropped my grandmother 's daughter 's son 's sister 's doctor 's grandmother 's boat the glass .
the button gave my wife 's son 's boss 's mother 's sister 's wife 's bottle the door .	the button cleaned my wife 's son 's boss 's mother 's sister 's wife 's bottle the door .
the crayon bought my grandmother 's teacher 's daughter 's father 's boss 's wife 's hat the truck .	the crayon kept my grandmother 's teacher 's daughter 's father 's boss 's wife 's hat the truck .
the hat gave your cousin 's cousin 's cousin 's husband 's husband 's daughter 's door the spoon .	the hat lost your cousin 's cousin 's cousin 's husband 's husband 's daughter 's door the spoon .
the picture sent your son 's cousin 's cousin 's grandmother 's boss 's father 's rocket the book .	the picture kept your son 's cousin 's cousin 's grandmother 's boss 's father 's rocket the book .
the candle showed your son 's dad 's mother 's mom 's dad 's son 's shirt the picture .	the candle kept your son 's dad 's mother 's mom 's dad 's son 's shirt the picture .
the spoon showed your cousin 's sister 's doctor 's teacher 's boss 's wife 's bicycle the plate .	the spoon kept your cousin 's sister 's doctor 's teacher 's boss 's wife 's bicycle the plate .
the spoon gave your mother 's friend 's husband 's son 's doctor 's friend 's crayon the toy .	the spoon kept your mother 's friend 's husband 's son 's doctor 's friend 's crayon the toy .
the chair gave my doctor 's mother 's grandmother 's sister 's grandmother 's boss 's glass the hat .	the chair cleaned my doctor 's mother 's grandmother 's sister 's grandmother 's boss 's glass the hat .
the car sent my dentist 's brother 's friend 's husband 's daughter 's doctor 's dish the toy .	the car cleaned my dentist 's brother 's friend 's husband 's daughter 's doctor 's dish the toy .
the bicycle bought your father 's sister 's mother 's daughter 's daughter 's wife 's chair the toy .	the bicycle moved your father 's sister 's mother 's daughter 's daughter 's wife 's chair the toy .
the door sent my mom 's husband 's daughter 's wife 's boss 's mom 's plane the glass .	the door shook my mom 's husband 's daughter 's wife 's boss 's mom 's plane the glass .
the bicycle bought your grandmother 's doctor 's friend 's son 's teacher 's brother 's car the spoon .	the bicycle shook your grandmother 's doctor 's friend 's son 's teacher 's brother 's car the spoon .
the bed showed my doctor 's wife 's friend 's sister 's cousin 's boss 's dish the glass .	the bed moved my doctor 's wife 's friend 's sister 's cousin 's boss 's dish the glass .
the dish gave my sister 's boss 's sister 's mother 's boss 's husband 's car the mirror .	the dish lost my sister 's boss 's sister 's mother 's boss 's husband 's car the mirror .
the box showed my mom 's mom 's mom 's dad 's brother 's wife 's candle the bed .	the box moved my mom 's mom 's mom 's dad 's brother 's wife 's candle the bed .
the crayon gave my cousin 's son 's dad 's mother 's cousin 's wife 's plate the truck .	the crayon moved my cousin 's son 's dad 's mother 's cousin 's wife 's plate the truck .
the crayon sent your grandmother 's dad 's sister 's cousin 's brother 's brother 's bowl the car .	the crayon dropped your grandmother 's dad 's sister 's cousin 's brother 's brother 's bowl the car .
the shirt gave my daughter 's son 's friend 's dentist 's father 's father 's dish the bed .	the shirt lost my daughter 's son 's friend 's dentist 's father 's father 's dish the bed .
the rug sent my cousin 's mom 's doctor 's daughter 's grandmother 's mother 's book the book .	the rug held my cousin 's mom 's doctor 's daughter 's grandmother 's mother 's book the book .
the shoe showed my father 's cousin 's doctor 's friend 's daughter 's brother 's bicycle the button .	the shoe held my father 's cousin 's doctor 's friend 's daughter 's brother 's bicycle the button .
the crayon sent your grandmother 's mother 's mom 's father 's sister 's wife 's dish the rocket .	the crayon dropped your grandmother 's mother 's mom 's father 's sister 's wife 's dish the rocket .
the candle sent your friend 's friend 's mom 's brother 's wife 's teacher 's fork the cup .	the candle lost your friend 's friend 's mom 's brother 's wife 's teacher 's fork the cup .
the book bought my mother 's friend 's doctor 's mom 's doctor 's mom 's car the mirror .	the book moved my mother 's friend 's doctor 's mom 's doctor 's mom 's car the mirror .
the plane sent your boss 's mother 's doctor 's dentist 's dentist 's husband 's dish the cup .	the plane kept your boss 's mother 's doctor 's dentist 's dentist 's husband 's dish the cup .
the couch bought my daughter 's dentist 's friend 's sister 's wife 's friend 's picture the mirror .	the couch shook my daughter 's dentist 's friend 's sister 's wife 's friend 's picture the mirror .
the book sent your mom 's daughter 's mom 's mother 's mother 's friend 's ship the couch .	the book shook your mom 's daughter 's mom 's mother 's mother 's friend 's ship the couch .
the door sent my husband 's wife 's daughter 's mom 's doctor 's brother 's rug the plane .	the door moved my husband 's wife 's daughter 's mom 's doctor 's brother 's rug the plane .
the ring gave my boss 's grandmother 's cousin 's mother 's teacher 's wife 's crayon the couch .	the ring shook my boss 's grandmother 's cousin 's mother 's teacher 's wife 's crayon the couch .
the mirror bought your mother 's grandmother 's boss 's boss 's teacher 's dad 's doll the doll .	the mirror held your mother 's grandmother 's boss 's boss 's teacher 's dad 's doll the doll .
the bottle bought my mother 's father 's dad 's mother 's cousin 's sister 's candle the window .	the bottle cleaned my mother 's father 's dad 's mother 's cousin 's sister 's candle the window .
the book showed your teacher 's teacher 's wife 's dentist 's husband 's grandmother 's car the candle .	the book held your teacher 's teacher 's wife 's dentist 's husband 's grandmother 's car the candle .
the dish bought my husband 's cousin 's cousin 's son 's grandmother 's sister 's rocket the boat .	the dish lost my husband 's cousin 's cousin 's son 's grandmother 's sister 's rocket the boat .
the car gave your father 's brother 's mom 's brother 's mother 's mother 's rocket the box .	the car shook your father 's brother 's mom 's brother 's mother 's mother 's rocket the box .
the bag bought my doctor 's wife 's doctor 's father 's sister 's father 's button the bowl .	the bag moved my doctor 's wife 's doctor 's father 's sister 's father 's button the bowl .
the rug sent my doctor 's doctor 's daughter 's mother 's daughter 's mom 's button the shoe .	the rug kept my doctor 's doctor 's daughter 's mother 's daughter 's mom 's button the shoe .
the rug bought your mother 's doctor 's husband 's friend 's daughter 's husband 's toy the box .	the rug held your mother 's doctor 's husband 's friend 's daughter 's husband 's toy the box .
the mirror sent my teacher 's doctor 's dad 's mom 's brother 's father 's mirror the shirt .	the mirror shook my teacher 's doctor 's dad 's mom 's brother 's father 's mirror the shirt .
the cup sent my cousin 's dad 's brother 's father 's brother 's sister 's ship the window .	the cup held my cousin 's dad 's brother 's father 's brother 's sister 's ship the window .
the ring gave your mother 's dad 's grandmother 's daughter 's cousin 's teacher 's plate the box .	the ring dropped your mother 's dad 's grandmother 's daughter 's cousin 's teacher 's plate the box .
the fork showed your teacher 's dad 's wife 's brother 's mom 's sister 's door the crayon .	the fork dropped your teacher 's dad 's wife 's brother 's mom 's sister 's door the crayon .
the fork showed my wife 's father 's husband 's boss 's doctor 's daughter 's window the door .	the fork lost my wife 's father 's husband 's boss 's doctor 's daughter 's window the door .
the doll gave my daughter 's sister 's wife 's wife 's doctor 's dad 's rocket the crayon .	the doll held my daughter 's sister 's wife 's wife 's doctor 's dad 's rocket the crayon .
the fork gave your grandmother 's dad 's cousin 's grandmother 's sister 's mom 's toy the boat .	the fork cleaned your grandmother 's dad 's cousin 's grandmother 's sister 's mom 's toy the boat .
the fork showed your daughter 's mom 's mom 's daughter 's brother 's husband 's bottle the hat .	the fork held your daughter 's mom 's mom 's daughter 's brother 's husband 's bottle the hat .
the spoon showed your dad 's grandmother 's dentist 's sister 's mother 's mom 's couch the book .	the spoon kept your dad 's grandmother 's dentist 's sister 's mother 's mom 's couch the book .
the book gave your doctor 's wife 's friend 's mother 's sister 's daughter 's plane the couch .	the book dropped your doctor 's wife 's friend 's mother 's sister 's daughter 's plane the couch .
the cup sent my dentist 's boss 's teacher 's dad 's cousin 's father 's shirt the button .	the cup held my dentist 's boss 's teacher 's dad 's cousin 's father 's shirt the button .
the shoe gave your brother 's husband 's dentist 's mother 's brother 's brother 's bed the rug .	the shoe kept your brother 's husband 's dentist 's mother 's brother 's brother 's bed the rug .
the doll bought my cousin 's friend 's sister 's mom 's boss 's mom 's window the car .	the doll moved my cousin 's friend 's sister 's mom 's boss 's mom 's window the car .
the dish showed my dentist 's mother 's boss 's daughter 's dad 's daughter 's car the bicycle .	the dish dropped my dentist 's mother 's boss 's daughter 's dad 's daughter 's car the bicycle .
the bottle showed your father 's grandmother 's wife 's mom 's brother 's boss 's book the cup .	the bottle lost your father 's grandmother 's wife 's mom 's brother 's boss 's book the cup .
the dish showed my husband 's brother 's dad 's daughter 's mom 's brother 's shirt the plate .	the dish shook my husband 's brother 's dad 's daughter 's mom 's brother 's shirt the plate .
the glass bought your dad 's grandmother 's doctor 's wife 's teacher 's mother 's car the toy .	the glass cleaned your dad 's grandmother 's doctor 's wife 's teacher 's mother 's car the toy .
the bicycle gave my mom 's daughter 's daughter 's cousin 's cousin 's husband 's toy the doll .	the bicycle dropped my mom 's daughter 's daughter 's cousin 's cousin 's husband 's toy the doll .
the toy bought my mom 's teacher 's cousin 's brother 's husband 's mom 's door the bottle .	the toy moved my mom 's teacher 's cousin 's brother 's husband 's mom 's door the bottle .
the book bought your mother 's grandmother 's teacher 's brother 's dad 's doctor 's bicycle the fork .	the book dropped your mother 's grandmother 's teacher 's brother 's dad 's doctor 's bicycle the fork .
the cup bought my mother 's daughter 's daughter 's cousin 's father 's husband 's bottle the spoon .	the cup kept my mother 's daughter 's daughter 's cousin 's father 's husband 's bottle the spoon .
the book sent your mom 's husband 's brother 's friend 's son 's doctor 's dish the door .	the book shook your mom 's husband 's brother 's friend 's son 's doctor 's dish the door .
the bicycle bought my wife 's wife 's son 's mom 's mom 's brother 's fork the bed .	the bicycle lost my wife 's wife 's son 's mom 's mom 's brother 's fork the bed .
the plate gave your wife 's wife 's grandmother 's mother 's wife 's sister 's fork the bicycle .	the plate kept your wife 's wife 's grandmother 's mother 's wife 's sister 's fork the bicycle .
the ship bought my daughter 's grandmother 's daughter 's wife 's daughter 's mother 's book the crayon .	the ship kept my daughter 's grandmother 's daughter 's wife 's daughter 's mother 's book the crayon .
the ring sent my wife 's cousin 's friend 's mother 's teacher 's friend 's dish the door .	the ring moved my wife 's cousin 's friend 's mother 's teacher 's friend 's dish the door .
the book bought my mother 's dentist 's mom 's son 's sister 's boss 's shoe the car .	the book shook my mother 's dentist 's mom 's son 's sister 's boss 's shoe the car .
the glass sent your mother 's teacher 's mother 's boss 's dentist 's friend 's car the spoon .	the glass moved your mother 's teacher 's mother 's boss 's dentist 's friend 's car the spoon .
the box showed your sister 's mom 's father 's father 's grandmother 's doctor 's box the bottle .	the box kept your sister 's mom 's father 's father 's grandmother 's doctor 's box the bottle .
the glass gave your mother 's sister 's husband 's brother 's mother 's grandmother 's boat the candle .	the glass kept your mother 's sister 's husband 's brother 's mother 's grandmother 's boat the candle .
the window gave my mom 's mom 's brother 's dentist 's dentist 's husband 's bicycle the bottle .	the window dropped my mom 's mom 's brother 's dentist 's dentist 's husband 's bicycle the bottle .
the car bought my son 's dentist 's doctor 's brother 's dentist 's wife 's bed the window .	the car shook my son 's dentist 's doctor 's brother 's dentist 's wife 's bed the window .
the bottle sent your dad 's dentist 's sister 's father 's daughter 's father 's dish the bottle .	the bottle cleaned your dad 's dentist 's sister 's father 's daughter 's father 's dish the bottle .
the button sent your father 's husband 's dentist 's mom 's dad 's husband 's car the shirt .	the button shook your father 's husband 's dentist 's mom 's dad 's husband 's car the shirt .
the truck sent my brother 's grandmother 's wife 's son 's sister 's sister 's book the door .	the truck cleaned my brother 's grandmother 's wife 's son 's sister 's sister 's book the door .
the bicycle bought your sister 's daughter 's dad 's sister 's teacher 's daughter 's rocket the bottle .	the bicycle dropped your sister 's daughter 's dad 's sister 's teacher 's daughter 's rocket the bottle .
the rocket showed my wife 's mother 's mom 's husband 's brother 's wife 's bag the rug .	the rocket cleaned my wife 's mother 's mom 's husband 's brother 's wife 's bag the rug .
the ship showed your teacher 's dad 's grandmother 's doctor 's mother 's husband 's car the truck .	the ship kept your teacher 's dad 's grandmother 's doctor 's mother 's husband 's car the truck .
the window showed my brother 's dentist 's mom 's wife 's doctor 's friend 's ring the car .	the window cleaned my brother 's dentist 's mom 's wife 's doctor 's friend 's ring the car .
the ship showed your dentist 's cousin 's father 's mother 's mother 's son 's toy the plate .	the ship moved your dentist 's cousin 's father 's mother 's mother 's son 's toy the plate .
the bag bought my boss 's husband 's cousin 's grandmother 's son 's sister 's rocket the dish .	the bag moved my boss 's husband 's cousin 's grandmother 's son 's sister 's rocket the dish .
the plane gave my father 's mother 's dentist 's grandmother 's boss 's friend 's bowl the rug .	the plane held my father 's mother 's dentist 's grandmother 's boss 's friend 's bowl the rug .
the dish bought your dentist 's mother 's dad 's father 's mother 's doctor 's plane the car .	the dish cleaned your dentist 's mother 's dad 's father 's mother 's doctor 's plane the car .
the box sent my sister 's boss 's father 's sister 's father 's doctor 's dish the plate .	the box shook my sister 's boss 's father 's sister 's father 's doctor 's dish the plate .
the plate sent my mother 's dentist 's mother 's daughter 's boss 's son 's rocket the dish .	the plate lost my mother 's dentist 's mother 's daughter 's boss 's son 's rocket the dish .
the shirt gave my brother 's doctor 's brother 's wife 's sister 's teacher 's box the book .	the shirt held my brother 's doctor 's brother 's wife 's sister 's teacher 's box the book .
the glass gave my wife 's grandmother 's mom 's grandmother 's boss 's father 's shirt the truck .	the glass kept my wife 's grandmother 's mom 's grandmother 's boss 's father 's shirt the truck .
the plane sent your cousin 's father 's mother 's grandmother 's daughter 's grandmother 's candle the car .	the plane held your cousin 's father 's mother 's grandmother 's daughter 's grandmother 's candle the car .
the bowl sent your wife 's teacher 's daughter 's husband 's mother 's cousin 's car the shoe .	the bowl lost your wife 's teacher 's daughter 's husband 's mother 's cousin 's car the shoe .
the bicycle gave your grandmother 's doctor 's daughter 's sister 's brother 's boss 's bicycle the box .	the bicycle moved your grandmother 's doctor 's daughter 's sister 's brother 's boss 's bicycle the box .
the picture bought your wife 's friend 's boss 's son 's sister 's wife 's couch the mirror .	the picture cleaned your wife 's friend 's boss 's son 's sister 's wife 's couch the mirror .
the doll bought your daughter 's husband 's friend 's daughter 's son 's wife 's glass the couch .	the doll lost your daughter 's husband 's friend 's daughter 's son 's wife 's glass the couch .
the spoon showed my wife 's son 's boss 's husband 's boss 's boss 's spoon the book .	the spoon kept my wife 's son 's boss 's husband 's boss 's boss 's spoon the book .
the box showed my father 's dentist 's mom 's doctor 's sister 's boss 's hat the toy .	the box moved my father 's dentist 's mom 's doctor 's sister 's boss 's hat the toy .
the ring sent your grandmother 's son 's mom 's wife 's dentist 's dentist 's dish the bed .	the ring held your grandmother 's son 's mom 's wife 's dentist 's dentist 's dish the bed .
the fork bought your mom 's dad 's dad 's sister 's husband 's mom 's car the rug .	the fork shook your mom 's dad 's dad 's sister 's husband 's mom 's car the rug .
the ship bought my teacher 's brother 's husband 's teacher 's son 's boss 's bowl the car .	the ship shook my teacher 's brother 's husband 's teacher 's son 's boss 's bowl the car .
the book showed my dad 's sister 's grandmother 's father 's dentist 's doctor 's cup the book .	the book kept my dad 's sister 's grandmother 's father 's dentist 's doctor 's cup the book .
the box sent my daughter 's mom 's doctor 's wife 's husband 's dad 's plane the crayon .	the box lost my daughter 's mom 's doctor 's wife 's husband 's dad 's plane the crayon .
the couch bought my doctor 's doctor 's grandmother 's son 's grandmother 's grandmother 's plane the plane .	the couch lost my doctor 's doctor 's grandmother 's son 's grandmother 's grandmother 's plane the plane .
the bottle showed my husband 's wife 's daughter 's sister 's brother 's wife 's spoon the dish .	the bottle held my husband 's wife 's daughter 's sister 's brother 's wife 's spoon the dish .
the doll bought my mother 's teacher 's son 's son 's father 's dentist 's bag the rug .	the doll shook my mother 's teacher 's son 's son 's father 's dentist 's bag the rug .
the bowl gave my wife 's boss 's husband 's husband 's mother 's brother 's boat the plane .	the bowl shook my wife 's boss 's husband 's husband 's mother 's brother 's boat the plane .
the ring showed my mother 's son 's husband 's dentist 's teacher 's cousin 's dish the fork .	the ring cleaned my mother 's son 's husband 's dentist 's teacher 's cousin 's dish the fork .
the plane sent your mother 's son 's teacher 's sister 's son 's grandmother 's bed the chair .	the plane held your mother 's son 's teacher 's sister 's son 's grandmother 's bed the chair .
the rug gave my wife 's mother 's dentist 's teacher 's dentist 's grandmother 's button the window .	the rug dropped my wife 's mother 's dentist 's teacher 's dentist 's grandmother 's button the window .
the book gave my father 's dentist 's dad 's daughter 's husband 's cousin 's hat the mirror .	the book dropped my father 's dentist 's dad 's daughter 's husband 's cousin 's hat the mirror .
the door bought your daughter 's daughter 's friend 's friend 's daughter 's cousin 's dish the plane .	the door shook your daughter 's daughter 's friend 's friend 's daughter 's cousin 's dish the plane .
the doll gave my mom 's friend 's daughter 's sister 's father 's husband 's cup the shoe .	the doll held my mom 's friend 's daughter 's sister 's father 's husband 's cup the shoe .
the glass gave my dad 's friend 's mother 's son 's mom 's mom 's fork the book .	the glass shook my dad 's friend 's mother 's son 's mom 's mom 's fork the book .
the book sent your grandmother 's boss 's mom 's wife 's boss 's grandmother 's mirror the boat .	the book kept your grandmother 's boss 's mom 's wife 's boss 's grandmother 's mirror the boat .
the couch showed my boss 's sister 's brother 's daughter 's father 's teacher 's shoe the box .	the couch cleaned my boss 's sister 's brother 's daughter 's father 's teacher 's shoe the box .
the car showed my dentist 's friend 's husband 's dad 's grandmother 's friend 's cup the spoon .	the car shook my dentist 's friend 's husband 's dad 's grandmother 's friend 's cup the spoon .
the dish bought your father 's father 's daughter 's sister 's teacher 's sister 's shoe the car .	the dish lost your father 's father 's daughter 's sister 's teacher 's sister 's shoe the car .
the window sent my father 's teacher 's dad 's husband 's wife 's cousin 's rug the rug .	the window moved my father 's teacher 's dad 's husband 's wife 's cousin 's rug the rug .
the glass gave your son 's husband 's mom 's dentist 's son 's wife 's book the doll .	the glass dropped your son 's husband 's mom 's dentist 's son 's wife 's book the doll .
the rug bought my sister 's boss 's brother 's cousin 's doctor 's mom 's hat the door .	the rug lost my sister 's boss 's brother 's cousin 's doctor 's mom 's hat the door .
the mirror sent my boss 's cousin 's husband 's wife 's grandmother 's boss 's boat the bottle .	the mirror dropped my boss 's cousin 's husband 's wife 's grandmother 's boss 's boat the bottle .
the glass sent your boss 's grandmother 's dentist 's wife 's friend 's dentist 's door the hat .	the glass kept your boss 's grandmother 's dentist 's wife 's friend 's dentist 's door the hat .
the glass gave my son 's father 's husband 's cousin 's friend 's cousin 's bed the cup .	the glass dropped my son 's father 's husband 's cousin 's friend 's cousin 's bed the cup .
the door gave your boss 's son 's sister 's sister 's daughter 's daughter 's chair the mirror .	the door moved your boss 's son 's sister 's sister 's daughter 's daughter 's chair the mirror .
the ship sent your dad 's father 's mom 's cousin 's sister 's mother 's fork the car .	the ship lost your dad 's father 's mom 's cousin 's sister 's mother 's fork the car .
the car sent your friend 's cousin 's boss 's mother 's teacher 's son 's car the book .	the car lost your friend 's cousin 's boss 's mother 's teacher 's son 's car the book .
the shoe bought your brother 's son 's daughter 's grandmother 's teacher 's sister 's dish the hat .	the shoe kept your brother 's son 's daughter 's grandmother 's teacher 's sister 's dish the hat .
the couch gave my mom 's doctor 's mother 's brother 's dentist 's mom 's car the glass .	the couch moved my mom 's doctor 's mother 's brother 's dentist 's mom 's car the glass .
the window bought your son 's teacher 's cousin 's son 's husband 's grandmother 's plate the bed .	the window shook your son 's teacher 's cousin 's son 's husband 's grandmother 's plate the bed .
the car gave my dad 's husband 's dad 's husband 's mom 's husband 's spoon the dish .	the car kept my dad 's husband 's dad 's husband 's mom 's husband 's spoon the dish .
the cup gave my dentist 's brother 's boss 's mother 's friend 's grandmother 's plane the shirt .	the cup held my dentist 's brother 's boss 's mother 's friend 's grandmother 's plane the shirt .
the window sent my dad 's dentist 's husband 's daughter 's son 's daughter 's doll the chair .	the window cleaned my dad 's dentist 's husband 's daughter 's son 's daughter 's doll the chair .
the bed bought my boss 's doctor 's mom 's friend 's husband 's father 's plane the dish .	the bed moved my boss 's doctor 's mom 's friend 's husband 's father 's plane the dish .
the mirror gave my friend 's dad 's daughter 's mom 's cousin 's grandmother 's hat the spoon .	the mirror shook my friend 's dad 's daughter 's mom 's cousin 's grandmother 's hat the spoon .
the doll gave my son 's husband 's mother 's boss 's boss 's doctor 's bed the chair .	the doll cleaned my son 's husband 's mother 's boss 's boss 's doctor 's bed the chair .
the fork bought my mom 's husband 's mother 's cousin 's wife 's daughter 's boat the bag .	the fork shook my mom 's husband 's mother 's cousin 's wife 's daughter 's boat the bag .
the ship gave your teacher 's daughter 's daughter 's dad 's sister 's sister 's shirt the bicycle .	the ship shook your teacher 's daughter 's daughter 's dad 's sister 's sister 's shirt the bicycle .
the picture showed my dentist 's son 's teacher 's sister 's teacher 's mother 's mirror the cup .	the picture held my dentist 's son 's teacher 's sister 's teacher 's mother 's mirror the cup .
the rocket sent your doctor 's dad 's boss 's boss 's wife 's husband 's book the spoon .	the rocket cleaned your doctor 's dad 's boss 's boss 's wife 's husband 's book the spoon .
the plane showed my mom 's father 's husband 's wife 's dad 's grandmother 's plate the picture .	the plane moved my mom 's father 's husband 's wife 's dad 's grandmother 's plate the picture .
the doll gave my grandmother 's son 's father 's son 's daughter 's boss 's cup the shoe .	the doll cleaned my grandmother 's son 's father 's son 's daughter 's boss 's cup the shoe .
the truck bought my wife 's grandmother 's son 's daughter 's husband 's grandmother 's doll the ring .	the truck shook my wife 's grandmother 's son 's daughter 's husband 's grandmother 's doll the ring .
the mirror sent my husband 's friend 's son 's boss 's boss 's son 's crayon the spoon .	the mirror lost my husband 's friend 's son 's boss 's boss 's son 's crayon the spoon .
the cup sent your wife 's mother 's dad 's brother 's mom 's cousin 's car the button .	the cup kept your wife 's mother 's dad 's brother 's mom 's cousin 's car the button .
the fork showed my brother 's friend 's mom 's mother 's son 's father 's bicycle the car .	the fork shook my brother 's friend 's mom 's mother 's son 's father 's bicycle the car .
the rug sent your teacher 's teacher 's sister 's cousin 's husband 's friend 's cup the picture .	the rug moved your teacher 's teacher 's sister 's cousin 's husband 's friend 's cup the picture .
the mirror showed my boss 's friend 's dad 's doctor 's cousin 's mother 's boat the car .	the mirror held my boss 's friend 's dad 's doctor 's cousin 's mother 's boat the car .
the car gave your doctor 's husband 's teacher 's husband 's sister 's teacher 's box the fork .	the car lost your doctor 's husband 's teacher 's husband 's sister 's teacher 's box the fork .
the bed sent my husband 's friend 's doctor 's son 's boss 's mom 's toy the picture .	the bed dropped my husband 's friend 's doctor 's son 's boss 's mom 's toy the picture .
the box bought your teacher 's doctor 's son 's husband 's sister 's mother 's bottle the button .	the box lost your teacher 's doctor 's son 's husband 's sister 's mother 's bottle the button .
the rug bought my wife 's wife 's friend 's father 's wife 's husband 's rocket the rug .	the rug held my wife 's wife 's friend 's father 's wife 's husband 's rocket the rug .
the spoon showed my boss 's friend 's father 's wife 's brother 's sister 's button the bed .	the spoon lost my boss 's friend 's father 's wife 's brother 's sister 's button the bed .
the picture bought my mom 's doctor 's doctor 's cousin 's daughter 's dentist 's book the boat .	the picture held my mom 's doctor 's doctor 's cousin 's daughter 's dentist 's book the boat .
the bed bought your teacher 's husband 's dentist 's dentist 's mom 's boss 's crayon the window .	the bed lost your teacher 's husband 's dentist 's dentist 's mom 's boss 's crayon the window .
the hat sent my husband 's doctor 's doctor 's cousin 's son 's dad 's doll the door .	the hat cleaned my husband 's doctor 's doctor 's cousin 's son 's dad 's doll the door .
the crayon gave your brother 's teacher 's son 's husband 's dentist 's grandmother 's cup the candle .	the crayon kept your brother 's teacher 's son 's husband 's dentist 's grandmother 's cup the candle .
the mirror gave your son 's boss 's husband 's dentist 's friend 's sister 's plate the ring .	the mirror shook your son 's boss 's husband 's dentist 's friend 's sister 's plate the ring .
the crayon bought your mother 's mom 's wife 's husband 's friend 's dad 's fork the bowl .	the crayon dropped your mother 's mom 's wife 's husband 's friend 's dad 's fork the bowl .
the ring bought my father 's grandmother 's mom 's cousin 's dentist 's daughter 's fork the book .	the ring dropped my father 's grandmother 's mom 's cousin 's dentist 's daughter 's fork the book .
the shirt gave my dentist 's grandmother 's cousin 's cousin 's dentist 's daughter 's bottle the ring .	the shirt shook my dentist 's grandmother 's cousin 's cousin 's dentist 's daughter 's bottle the ring .
the door sent my father 's cousin 's grandmother 's father 's son 's sister 's boat the car .	the door kept my father 's cousin 's grandmother 's father 's son 's sister 's boat the car .
the cup sent your brother 's husband 's grandmother 's brother 's friend 's sister 's toy the ring .	the cup lost your brother 's husband 's grandmother 's brother 's friend 's sister 's toy the ring .
the glass gave your teacher 's husband 's dentist 's boss 's teacher 's sister 's bed the bottle .	the glass held your teacher 's husband 's dentist 's boss 's teacher 's sister 's bed the bottle .
the ring bought your dad 's wife 's father 's cousin 's father 's grandmother 's picture the plane .	the ring shook your dad 's wife 's father 's cousin 's father 's grandmother 's picture the plane .
the car gave your grandmother 's brother 's mother 's friend 's cousin 's sister 's rocket the crayon .	the car cleaned your grandmother 's brother 's mother 's friend 's cousin 's sister 's rocket the crayon .
the ring sent your doctor 's doctor 's mother 's cousin 's husband 's dad 's shirt the bottle .	the ring lost your doctor 's doctor 's mother 's cousin 's husband 's dad 's shirt the bottle .
the candle gave my mom 's friend 's doctor 's husband 's grandmother 's boss 's doll the truck .	the candle held my mom 's friend 's doctor 's husband 's grandmother 's boss 's doll the truck .
the toy bought my sister 's daughter 's cousin 's dad 's boss 's dad 's rocket the candle .	the toy dropped my sister 's daughter 's cousin 's dad 's boss 's dad 's rocket the candle .
the shoe bought my sister 's doctor 's mother 's father 's husband 's friend 's picture the glass .	the shoe held my sister 's doctor 's mother 's father 's husband 's friend 's picture the glass .
the shoe sent your dad 's boss 's father 's doctor 's daughter 's mom 's picture the spoon .	the shoe moved your dad 's boss 's father 's doctor 's daughter 's mom 's picture the spoon .
the bed showed my friend 's cousin 's teacher 's teacher 's boss 's daughter 's plate the dish .	the bed kept my friend 's cousin 's teacher 's teacher 's boss 's daughter 's plate the dish .
the bowl bought my brother 's friend 's friend 's father 's husband 's cousin 's bottle the dish .	the bowl moved my brother 's friend 's friend 's father 's husband 's cousin 's bottle the dish .
the chair bought your husband 's husband 's husband 's sister 's mother 's boss 's fork the button .	the chair kept your husband 's husband 's husband 's sister 's mother 's boss 's fork the button .
the dish gave my husband 's daughter 's son 's dentist 's cousin 's friend 's bag the ship .	the dish moved my husband 's daughter 's son 's dentist 's cousin 's friend 's bag the ship .
the hat gave my teacher 's daughter 's dentist 's brother 's dad 's sister 's shirt the bowl .	the hat held my teacher 's daughter 's dentist 's brother 's dad 's sister 's shirt the bowl .
the picture gave your dad 's mom 's mom 's dentist 's father 's dentist 's book the window .	the picture moved your dad 's mom 's mom 's dentist 's father 's dentist 's book the window .
the candle sent your daughter 's friend 's son 's husband 's cousin 's dad 's car the ring .	the candle moved your daughter 's friend 's son 's husband 's cousin 's dad 's car the ring .
the plane showed your teacher 's mom 's teacher 's dentist 's doctor 's friend 's bicycle the boat .	the plane moved your teacher 's mom 's teacher 's dentist 's doctor 's friend 's bicycle the boat .
the mirror bought my grandmother 's mother 's husband 's son 's teacher 's brother 's couch the toy .	the mirror shook my grandmother 's mother 's husband 's son 's teacher 's brother 's couch the toy .
the ship bought your sister 's son 's daughter 's boss 's father 's father 's button the candle .	the ship lost your sister 's son 's daughter 's boss 's father 's father 's button the candle .
the truck showed my brother 's doctor 's dad 's father 's wife 's sister 's spoon the toy .	the truck cleaned my brother 's doctor 's dad 's father 's wife 's sister 's spoon the toy .
the car showed your grandmother 's sister 's dad 's teacher 's friend 's cousin 's spoon the door .	the car held your grandmother 's sister 's dad 's teacher 's friend 's cousin 's spoon the door .
the bottle sent your boss 's dentist 's mother 's dad 's daughter 's mom 's car the truck .	the bottle dropped your boss 's dentist 's mother 's dad 's daughter 's mom 's car the truck .
the plate showed your father 's father 's sister 's dad 's teacher 's cousin 's chair the shoe .	the plate shook your father 's father 's sister 's dad 's teacher 's cousin 's chair the shoe .
the hat gave your son 's boss 's grandmother 's dentist 's mother 's son 's shoe the rocket .	the hat kept your son 's boss 's grandmother 's dentist 's mother 's son 's shoe the rocket .
the picture gave my sister 's doctor 's mother 's father 's boss 's wife 's door the chair .	the picture lost my sister 's doctor 's mother 's father 's boss 's wife 's door the chair .
the car sent your cousin 's teacher 's brother 's teacher 's dad 's husband 's hat the fork .	the car shook your cousin 's teacher 's brother 's teacher 's dad 's husband 's hat the fork .
the bowl sent your mother 's mom 's grandmother 's mother 's cousin 's grandmother 's car the plane .	the bowl shook your mother 's mom 's grandmother 's mother 's cousin 's grandmother 's car the plane .
the plane bought my dentist 's sister 's doctor 's dentist 's son 's mother 's book the bicycle .	the plane kept my dentist 's sister 's doctor 's dentist 's son 's mother 's book the bicycle .
the crayon sent your teacher 's grandmother 's mother 's brother 's dentist 's doctor 's book the hat .	the crayon lost your teacher 's grandmother 's mother 's brother 's dentist 's doctor 's book the hat .
the fork showed my mother 's cousin 's sister 's husband 's son 's brother 's plate the boat .	the fork held my mother 's cousin 's sister 's husband 's son 's brother 's plate the boat .
the mirror sent your dad 's son 's sister 's teacher 's dentist 's grandmother 's bicycle the dish .	the mirror dropped your dad 's son 's sister 's teacher 's dentist 's grandmother 's bicycle the dish .
the shoe sent my husband 's dentist 's doctor 's friend 's brother 's wife 's boat the plate .	the shoe shook my husband 's dentist 's doctor 's friend 's brother 's wife 's boat the plate .
the dish showed your grandmother 's sister 's daughter 's boss 's doctor 's wife 's cup the bottle .	the dish dropped your grandmother 's sister 's daughter 's boss 's doctor 's wife 's cup the bottle .
the car gave your father 's wife 's father 's mother 's brother 's mom 's ship the bicycle .	the car lost your father 's wife 's father 's mother 's brother 's mom 's ship the bicycle .
the candle gave my husband 's mother 's friend 's son 's mother 's teacher 's car the car .	the candle kept my husband 's mother 's friend 's son 's mother 's teacher 's car the car .
the plate bought my wife 's dad 's wife 's dentist 's father 's boss 's truck the car .	the plate kept my wife 's dad 's wife 's dentist 's father 's boss 's truck the car .
the rug sent your teacher 's mother 's daughter 's grandmother 's grandmother 's dentist 's dish the rug .	the rug cleaned your teacher 's mother 's daughter 's grandmother 's grandmother 's dentist 's dish the rug .
the doll gave my daughter 's mom 's daughter 's boss 's son 's dad 's fork the candle .	the doll lost my daughter 's mom 's daughter 's boss 's son 's dad 's fork the candle .
the book gave your dad 's father 's sister 's daughter 's mother 's mom 's doll the book .	the book cleaned your dad 's father 's sister 's daughter 's mother 's mom 's doll the book .
the truck showed my dentist 's dad 's grandmother 's wife 's grandmother 's mom 's spoon the shirt .	the truck lost my dentist 's dad 's grandmother 's wife 's grandmother 's mom 's spoon the shirt .
the book sent your son 's brother 's cousin 's mom 's cousin 's mom 's box the dish .	the book cleaned your son 's brother 's cousin 's mom 's cousin 's mom 's box the dish .
the bicycle showed your daughter 's mom 's boss 's sister 's husband 's mother 's cup the shoe .	the bicycle shook your daughter 's mom 's boss 's sister 's husband 's mother 's cup the shoe .
the book sent my dentist 's brother 's doctor 's teacher 's dad 's wife 's shoe the shirt .	the book dropped my dentist 's brother 's doctor 's teacher 's dad 's wife 's shoe the shirt .
the book sent my sister 's sister 's teacher 's mom 's doctor 's mom 's box the book .	the book moved my sister 's sister 's teacher 's mom 's doctor 's mom 's box the book .
the doll sent your boss 's cousin 's dad 's husband 's boss 's father 's book the cup .	the doll dropped your boss 's cousin 's dad 's husband 's boss 's father 's book the cup .
the toy bought my cousin 's daughter 's husband 's friend 's wife 's friend 's door the car .	the toy kept my cousin 's daughter 's husband 's friend 's wife 's friend 's door the car .
the book sent my sister 's dad 's sister 's mom 's father 's teacher 's chair the box .	the book moved my sister 's dad 's sister 's mom 's father 's teacher 's chair the box .
the dish sent my boss 's mom 's boss 's doctor 's doctor 's sister 's picture the mirror .	the dish held my boss 's mom 's boss 's doctor 's doctor 's sister 's picture the mirror .
the dish gave my dentist 's cousin 's grandmother 's cousin 's daughter 's mother 's hat the couch .	the dish dropped my dentist 's cousin 's grandmother 's cousin 's daughter 's mother 's hat the couch .
the hat gave your wife 's grandmother 's husband 's son 's friend 's doctor 's bed the picture .	the hat kept your wife 's grandmother 's husband 's son 's friend 's doctor 's bed the picture .
the hat showed my mother 's brother 's mom 's teacher 's teacher 's boss 's ship the crayon .	the hat lost my mother 's brother 's mom 's teacher 's teacher 's boss 's ship the crayon .
the shirt showed my wife 's teacher 's mom 's husband 's husband 's father 's doll the bottle .	the shirt dropped my wife 's teacher 's mom 's husband 's husband 's father 's doll the bottle .
the boat sent your cousin 's teacher 's dad 's mom 's dentist 's cousin 's window the glass .	the boat held your cousin 's teacher 's dad 's mom 's dentist 's cousin 's window the glass .
the hat sent my boss 's mom 's sister 's father 's boss 's husband 's bowl the bicycle .	the hat shook my boss 's mom 's sister 's father 's boss 's husband 's bowl the bicycle .
the box bought your daughter 's husband 's teacher 's father 's friend 's mom 's dish the button .	the box lost your daughter 's husband 's teacher 's father 's friend 's mom 's dish the button .
the shirt gave your son 's grandmother 's daughter 's mother 's boss 's dentist 's shoe the book .	the shirt moved your son 's grandmother 's daughter 's mother 's boss 's dentist 's shoe the book .
the rug sent my boss 's doctor 's son 's friend 's wife 's daughter 's button the couch .	the rug held my boss 's doctor 's son 's friend 's wife 's daughter 's button the couch .
the boat sent your teacher 's brother 's teacher 's dentist 's father 's brother 's picture the book .	the boat cleaned your teacher 's brother 's teacher 's dentist 's father 's brother 's picture the book .
the button bought your mom 's boss 's teacher 's brother 's husband 's mother 's shirt the shoe .	the button moved your mom 's boss 's teacher 's brother 's husband 's mother 's shirt the shoe .
the window sent your boss 's wife 's wife 's dad 's doctor 's brother 's shirt the car .	the window shook your boss 's wife 's wife 's dad 's doctor 's brother 's shirt the car .
the ring gave your father 's sister 's father 's daughter 's teacher 's son 's crayon the mirror .	the ring kept your father 's sister 's father 's daughter 's teacher 's son 's crayon the mirror .
the button bought my grandmother 's grandmother 's grandmother 's doctor 's wife 's sister 's doll the hat .	the button shook my grandmother 's grandmother 's grandmother 's doctor 's wife 's sister 's doll the hat .
the rug gave my friend 's dad 's brother 's boss 's father 's son 's boat the crayon .	the rug moved my friend 's dad 's brother 's boss 's father 's son 's boat the crayon .
the rug gave your daughter 's doctor 's boss 's brother 's daughter 's mother 's shirt the car .	the rug lost your daughter 's doctor 's boss 's brother 's daughter 's mother 's shirt the car .
the shirt gave my teacher 's mother 's daughter 's sister 's mom 's wife 's boat the plate .	the shirt lost my teacher 's mother 's daughter 's sister 's mom 's wife 's boat the plate .
the crayon sent your father 's grandmother 's mom 's dad 's sister 's grandmother 's crayon the shirt .	the crayon held your father 's grandmother 's mom 's dad 's sister 's grandmother 's crayon the shirt .
the mirror bought my sister 's brother 's daughter 's cousin 's father 's grandmother 's car the shirt .	the mirror lost my sister 's brother 's daughter 's cousin 's father 's grandmother 's car the shirt .
the button sent my son 's teacher 's teacher 's wife 's dad 's grandmother 's shirt the car .	the button shook my son 's teacher 's teacher 's wife 's dad 's grandmother 's shirt the car .
the boat bought my sister 's daughter 's brother 's son 's doctor 's dad 's book the button .	the boat dropped my sister 's daughter 's brother 's son 's doctor 's dad 's book the button .
the ship showed my dad 's dentist 's wife 's wife 's daughter 's boss 's ring the bicycle .	the ship held my dad 's dentist 's wife 's wife 's daughter 's boss 's ring the bicycle .
the bed gave my sister 's daughter 's teacher 's friend 's cousin 's husband 's fork the glass .	the bed lost my sister 's daughter 's teacher 's friend 's cousin 's husband 's fork the glass .
the shoe sent my dad 's grandmother 's grandmother 's friend 's cousin 's friend 's mirror the chair .	the shoe moved my dad 's grandmother 's grandmother 's friend 's cousin 's friend 's mirror the chair .
the plane gave my grandmother 's teacher 's mom 's cousin 's husband 's daughter 's car the box .	the plane dropped my grandmother 's teacher 's mom 's cousin 's husband 's daughter 's car the box .
the bottle gave my friend 's friend 's brother 's mom 's son 's wife 's window the window .	the bottle dropped my friend 's friend 's brother 's mom 's son 's wife 's window the window .
the car gave your doctor 's husband 's teacher 's teacher 's mother 's dentist 's book the book .	the car moved your doctor 's husband 's teacher 's teacher 's mother 's dentist 's book the book .
the toy sent my mom 's mother 's daughter 's mom 's dentist 's cousin 's ship the box .	the toy moved my mom 's mother 's daughter 's mom 's dentist 's cousin 's ship the box .
the doll gave my brother 's son 's husband 's teacher 's son 's cousin 's car the bottle .	the doll moved my brother 's son 's husband 's teacher 's son 's cousin 's car the bottle .
the dish bought your brother 's daughter 's grandmother 's husband 's brother 's friend 's bottle the candle .	the dish lost your brother 's daughter 's grandmother 's husband 's brother 's friend 's bottle the candle .
the rocket bought your dad 's grandmother 's friend 's dentist 's dad 's boss 's box the book .	the rocket shook your dad 's grandmother 's friend 's dentist 's dad 's boss 's box the book .
the car sent my sister 's brother 's friend 's son 's mother 's doctor 's plane the spoon .	the car dropped my sister 's brother 's friend 's son 's mother 's doctor 's plane the spoon .
the bicycle showed my daughter 's friend 's wife 's son 's dentist 's mom 's bottle the book .	the bicycle moved my daughter 's friend 's wife 's son 's dentist 's mom 's bottle the book .
the bed sent your husband 's wife 's mom 's sister 's son 's father 's glass the plate .	the bed dropped your husband 's wife 's mom 's sister 's son 's father 's glass the plate .
the chair bought your dentist 's doctor 's father 's dentist 's brother 's grandmother 's car the bed .	the chair held your dentist 's doctor 's father 's dentist 's brother 's grandmother 's car the bed .
the spoon gave your wife 's brother 's grandmother 's daughter 's mom 's teacher 's door the button .	the spoon kept your wife 's brother 's grandmother 's daughter 's mom 's teacher 's door the button .
the book gave your dentist 's teacher 's teacher 's mother 's son 's sister 's shoe the button .	the book held your dentist 's teacher 's teacher 's mother 's son 's sister 's shoe the button .
the shirt sent my doctor 's boss 's teacher 's sister 's mom 's brother 's plane the car .	the shirt held my doctor 's boss 's teacher 's sister 's mom 's brother 's plane the car .
the cup showed your boss 's grandmother 's doctor 's cousin 's grandmother 's husband 's shirt the spoon .	the cup cleaned your boss 's grandmother 's doctor 's cousin 's grandmother 's husband 's shirt the spoon .
the shirt sent my mom 's grandmother 's husband 's mother 's grandmother 's cousin 's bicycle the window .	the shirt lost my mom 's grandmother 's husband 's mother 's grandmother 's cousin 's bicycle the window .
the car sent your father 's mother 's sister 's wife 's mom 's wife 's shoe the boat .	the car shook your father 's mother 's sister 's wife 's mom 's wife 's shoe the boat .
the chair gave your dad 's daughter 's wife 's cousin 's grandmother 's friend 's bag the book .	the chair shook your dad 's daughter 's wife 's cousin 's grandmother 's friend 's bag the book .
the button gave my teacher 's dad 's brother 's dentist 's mother 's sister 's ring the box .	the button shook my teacher 's dad 's brother 's dentist 's mother 's sister 's ring the box .
the bicycle bought your dad 's grandmother 's mom 's son 's daughter 's son 's book the chair .	the bicycle shook your dad 's grandmother 's mom 's son 's daughter 's son 's book the chair .
the rocket showed my husband 's father 's cousin 's sister 's teacher 's son 's car the car .	the rocket kept my husband 's father 's cousin 's sister 's teacher 's son 's car the car .
the window showed your grandmother 's dentist 's husband 's cousin 's teacher 's brother 's picture the bag .	the window moved your grandmother 's dentist 's husband 's cousin 's teacher 's brother 's picture the bag .
the dish showed your doctor 's daughter 's daughter 's grandmother 's brother 's sister 's couch the glass .	the dish moved your doctor 's daughter 's daughter 's grandmother 's brother 's sister 's couch the glass .
the cup sent my mom 's sister 's sister 's grandmother 's boss 's mother 's ring the door .	the cup moved my mom 's sister 's sister 's grandmother 's boss 's mother 's ring the door .
the bicycle sent your cousin 's dentist 's daughter 's son 's dentist 's mother 's bowl the ring .	the bicycle held your cousin 's dentist 's daughter 's son 's dentist 's mother 's bowl the ring .
the boat showed my doctor 's mom 's father 's grandmother 's teacher 's dentist 's shoe the truck .	the boat held my doctor 's mom 's father 's grandmother 's teacher 's dentist 's shoe the truck .
the dish gave your dad 's friend 's husband 's dentist 's daughter 's boss 's fork the book .	the dish held your dad 's friend 's husband 's dentist 's daughter 's boss 's fork the book .
the shirt gave your friend 's son 's husband 's wife 's husband 's mother 's couch the button .	the shirt moved your friend 's son 's husband 's wife 's husband 's mother 's couch the button .
the doll showed your cousin 's sister 's brother 's father 's boss 's mother 's mirror the bowl .	the doll shook your cousin 's sister 's brother 's father 's boss 's mother 's mirror the bowl .
the bicycle bought your teacher 's mom 's brother 's dentist 's grandmother 's grandmother 's bottle the bowl .	the bicycle lost your teacher 's mom 's brother 's dentist 's grandmother 's grandmother 's bottle the bowl .
the chair gave your cousin 's mother 's father 's friend 's mother 's teacher 's car the shoe .	the chair cleaned your cousin 's mother 's father 's friend 's mother 's teacher 's car the shoe .
the shirt bought my boss 's husband 's teacher 's doctor 's teacher 's teacher 's book the bottle .	the shirt held my boss 's husband 's teacher 's doctor 's teacher 's teacher 's book the bottle .
the spoon bought my friend 's teacher 's grandmother 's daughter 's dad 's cousin 's door the plane .	the spoon cleaned my friend 's teacher 's grandmother 's daughter 's dad 's cousin 's door the plane .
the spoon bought your son 's friend 's wife 's dentist 's boss 's teacher 's shoe the hat .	the spoon dropped your son 's friend 's wife 's dentist 's boss 's teacher 's shoe the hat .
the chair showed my dentist 's boss 's grandmother 's brother 's doctor 's doctor 's book the boat .	the chair shook my dentist 's boss 's grandmother 's brother 's doctor 's doctor 's book the boat .
the cup showed your cousin 's cousin 's wife 's son 's grandmother 's father 's door the shirt .	the cup shook your cousin 's cousin 's wife 's son 's grandmother 's father 's door the shirt .
the glass gave my son 's wife 's mom 's husband 's dentist 's boss 's bowl the book .	the glass shook my son 's wife 's mom 's husband 's dentist 's boss 's bowl the book .
the shoe sent my boss 's cousin 's father 's dentist 's mother 's mother 's bag the window .	the shoe lost my boss 's cousin 's father 's dentist 's mother 's mother 's bag the window .
the doll gave my wife 's friend 's doctor 's dad 's teacher 's father 's boat the picture .	the doll shook my wife 's friend 's doctor 's dad 's teacher 's father 's boat the picture .
the glass bought your doctor 's mother 's cousin 's dentist 's father 's brother 's bed the bicycle .	the glass lost your doctor 's mother 's cousin 's dentist 's father 's brother 's bed the bicycle .
the truck gave my son 's grandmother 's father 's teacher 's friend 's husband 's plate the dish .	the truck kept my son 's grandmother 's father 's teacher 's friend 's husband 's plate the dish .
the dish sent my boss 's son 's wife 's cousin 's teacher 's husband 's crayon the dish .	the dish shook my boss 's son 's wife 's cousin 's teacher 's husband 's crayon the dish .
the car showed your brother 's wife 's daughter 's mom 's wife 's husband 's plane the bag .	the car dropped your brother 's wife 's daughter 's mom 's wife 's husband 's plane the bag .
the glass bought my daughter 's boss 's husband 's husband 's cousin 's son 's toy the rocket .	the glass kept my daughter 's boss 's husband 's husband 's cousin 's son 's toy the rocket .
the bicycle sent my son 's father 's daughter 's brother 's teacher 's brother 's button the chair .	the bicycle lost my son 's father 's daughter 's brother 's teacher 's brother 's button the chair .
the rocket gave my brother 's son 's son 's father 's mother 's grandmother 's picture the door .	the rocket lost my brother 's son 's son 's father 's mother 's grandmother 's picture the door .
the rocket bought your father 's brother 's boss 's sister 's cousin 's sister 's cup the bag .	the rocket cleaned your father 's brother 's boss 's sister 's cousin 's sister 's cup the bag .
the bottle bought your sister 's father 's son 's dad 's friend 's boss 's window the ship .	the bottle cleaned your sister 's father 's son 's dad 's friend 's boss 's window the ship .
the window bought my husband 's wife 's teacher 's teacher 's friend 's father 's book the cup .	the window held my husband 's wife 's teacher 's teacher 's friend 's father 's book the cup .
the plane gave your doctor 's teacher 's grandmother 's wife 's mother 's husband 's ring the window .	the plane kept your doctor 's teacher 's grandmother 's wife 's mother 's husband 's ring the window .
the shoe showed my son 's cousin 's mother 's cousin 's doctor 's mom 's picture the shoe .	the shoe kept my son 's cousin 's mother 's cousin 's doctor 's mom 's picture the shoe .
the car bought my dad 's sister 's dad 's mom 's dad 's son 's shoe the car .	the car kept my dad 's sister 's dad 's mom 's dad 's son 's shoe the car .
the bag showed your son 's doctor 's son 's teacher 's father 's grandmother 's candle the boat .	the bag dropped your son 's doctor 's son 's teacher 's father 's grandmother 's candle the boat .
the picture gave my dentist 's sister 's dad 's grandmother 's daughter 's brother 's bicycle the toy .	the picture lost my dentist 's sister 's dad 's grandmother 's daughter 's brother 's bicycle the toy .
the truck showed your brother 's dentist 's boss 's friend 's cousin 's husband 's ship the button .	the truck cleaned your brother 's dentist 's boss 's friend 's cousin 's husband 's ship the button .
the rug sent my son 's mom 's doctor 's doctor 's sister 's sister 's glass the picture .	the rug kept my son 's mom 's doctor 's doctor 's sister 's sister 's glass the picture .
the plate showed my dad 's husband 's mom 's cousin 's grandmother 's mom 's couch the chair .	the plate held my dad 's husband 's mom 's cousin 's grandmother 's mom 's couch the chair .
the glass bought your son 's husband 's dad 's daughter 's dad 's sister 's chair the hat .	the glass shook your son 's husband 's dad 's daughter 's dad 's sister 's chair the hat .
the book sent my doctor 's son 's cousin 's boss 's mother 's dentist 's ship the cup .	the book moved my doctor 's son 's cousin 's boss 's mother 's dentist 's ship the cup .
the bag showed my grandmother 's mom 's husband 's doctor 's husband 's mom 's couch the glass .	the bag dropped my grandmother 's mom 's husband 's doctor 's husband 's mom 's couch the glass .
the rocket showed your father 's dad 's daughter 's cousin 's cousin 's dentist 's bed the bowl .	the rocket lost your father 's dad 's daughter 's cousin 's cousin 's dentist 's bed the bowl .
the car sent your son 's brother 's dad 's daughter 's son 's father 's book the bottle .	the car moved your son 's brother 's dad 's daughter 's son 's father 's book the bottle .
the plate showed your doctor 's boss 's husband 's wife 's son 's mom 's bag the picture .	the plate lost your doctor 's boss 's husband 's wife 's son 's mom 's bag the picture .
the fork bought your teacher 's daughter 's daughter 's boss 's brother 's mom 's plane the candle .	the fork kept your teacher 's daughter 's daughter 's boss 's brother 's mom 's plane the candle .
the cup sent my teacher 's cousin 's father 's grandmother 's sister 's daughter 's spoon the bicycle .	the cup kept my teacher 's cousin 's father 's grandmother 's sister 's daughter 's spoon the bicycle .
the car sent my dentist 's wife 's dad 's wife 's sister 's grandmother 's shoe the picture .	the car cleaned my dentist 's wife 's dad 's wife 's sister 's grandmother 's shoe the picture .
the cup bought my teacher 's father 's dentist 's grandmother 's cousin 's dad 's bed the boat .	the cup shook my teacher 's father 's dentist 's grandmother 's cousin 's dad 's bed the boat .
the cup bought your teacher 's husband 's grandmother 's dad 's mother 's daughter 's dish the spoon .	the cup dropped your teacher 's husband 's grandmother 's dad 's mother 's daughter 's dish the spoon .
the crayon bought my sister 's wife 's dentist 's doctor 's mother 's father 's book the doll .	the crayon dropped my sister 's wife 's dentist 's doctor 's mother 's father 's book the doll .
the plane sent my husband 's mom 's teacher 's wife 's mom 's wife 's dish the bag .	the plane held my husband 's mom 's teacher 's wife 's mom 's wife 's dish the bag .
the candle sent my mother 's sister 's friend 's cousin 's father 's grandmother 's plane the rocket .	the candle lost my mother 's sister 's friend 's cousin 's father 's grandmother 's plane the rocket .
the spoon bought your mom 's dentist 's doctor 's friend 's mom 's mother 's rocket the doll .	the spoon kept your mom 's dentist 's doctor 's friend 's mom 's mother 's rocket the doll .
the truck gave your boss 's friend 's brother 's husband 's sister 's grandmother 's shoe the glass .	the truck shook your boss 's friend 's brother 's husband 's sister 's grandmother 's shoe the glass .
the bicycle showed my sister 's son 's brother 's teacher 's sister 's husband 's toy the fork .	the bicycle lost my sister 's son 's brother 's teacher 's sister 's husband 's toy the fork .
the bed gave my teacher 's dentist 's doctor 's wife 's sister 's dad 's chair the bottle .	the bed lost my teacher 's dentist 's doctor 's wife 's sister 's dad 's chair the bottle .
the door sent your sister 's father 's boss 's boss 's boss 's dad 's mirror the book .	the door held your sister 's father 's boss 's boss 's boss 's dad 's mirror the book .
the car bought your sister 's husband 's son 's daughter 's daughter 's sister 's ring the door .	the car lost your sister 's husband 's son 's daughter 's daughter 's sister 's ring the door .
the toy sent your father 's wife 's sister 's dentist 's boss 's dentist 's candle the ship .	the toy cleaned your father 's wife 's sister 's dentist 's boss 's dentist 's candle the ship .
the couch sent my sister 's mom 's dentist 's teacher 's dentist 's father 's boat the book .	the couch moved my sister 's mom 's dentist 's teacher 's dentist 's father 's boat the book .
the shoe showed my dentist 's boss 's daughter 's mother 's brother 's doctor 's hat the couch .	the shoe dropped my dentist 's boss 's daughter 's mother 's brother 's doctor 's hat the couch .
the crayon gave your teacher 's wife 's daughter 's teacher 's teacher 's husband 's rug the car .	the crayon shook your teacher 's wife 's daughter 's teacher 's teacher 's husband 's rug the car .
the rug sent my boss 's son 's mother 's mother 's doctor 's mother 's fork the plate .	the rug held my boss 's son 's mother 's mother 's doctor 's mother 's fork the plate .
the car gave my doctor 's sister 's father 's sister 's son 's sister 's shoe the bottle .	the car lost my doctor 's sister 's father 's sister 's son 's sister 's shoe the bottle .
the ring gave my cousin 's cousin 's brother 's wife 's doctor 's mom 's door the dish .	the ring cleaned my cousin 's cousin 's brother 's wife 's doctor 's mom 's door the dish .
the toy showed your brother 's grandmother 's friend 's teacher 's boss 's husband 's plane the bicycle .	the toy cleaned your brother 's grandmother 's friend 's teacher 's boss 's husband 's plane the bicycle .
the glass sent your doctor 's friend 's sister 's friend 's cousin 's husband 's fork the spoon .	the glass lost your doctor 's friend 's sister 's friend 's cousin 's husband 's fork the spoon .
the plane sent your cousin 's daughter 's father 's sister 's daughter 's dad 's rocket the book .	the plane held your cousin 's daughter 's father 's sister 's daughter 's dad 's rocket the book .
the ship bought my doctor 's mother 's cousin 's wife 's mom 's wife 's spoon the cup .	the ship moved my doctor 's mother 's cousin 's wife 's mom 's wife 's spoon the cup .
the cup bought your father 's sister 's daughter 's dentist 's daughter 's doctor 's shirt the bed .	the cup held your father 's sister 's daughter 's dentist 's daughter 's doctor 's shirt the bed .
the candle sent your daughter 's grandmother 's boss 's son 's mom 's daughter 's toy the bag .	the candle lost your daughter 's grandmother 's boss 's son 's mom 's daughter 's toy the bag .
the spoon sent your dad 's boss 's father 's mom 's brother 's cousin 's book the car .	the spoon moved your dad 's boss 's father 's mom 's brother 's cousin 's book the car .
the cup showed your boss 's dad 's dentist 's son 's sister 's sister 's bottle the crayon .	the cup cleaned your boss 's dad 's dentist 's son 's sister 's sister 's bottle the crayon .
the car bought your grandmother 's dad 's mother 's son 's cousin 's sister 's car the car .	the car dropped your grandmother 's dad 's mother 's son 's cousin 's sister 's car the car .
the box showed my teacher 's son 's sister 's teacher 's friend 's wife 's box the car .	the box cleaned my teacher 's son 's sister 's teacher 's friend 's wife 's box the car .
the bag gave your teacher 's wife 's son 's dentist 's son 's sister 's button the picture .	the bag held your teacher 's wife 's son 's dentist 's son 's sister 's button the picture .
the fork showed your father 's brother 's wife 's teacher 's doctor 's cousin 's bottle the bottle .	the fork dropped your father 's brother 's wife 's teacher 's doctor 's cousin 's bottle the bottle .
the chair bought your teacher 's son 's grandmother 's doctor 's sister 's boss 's box the doll .	the chair moved your teacher 's son 's grandmother 's doctor 's sister 's boss 's box the doll .
the hat sent my brother 's wife 's father 's dad 's brother 's husband 's crayon the crayon .	the hat lost my brother 's wife 's father 's dad 's brother 's husband 's crayon the crayon .
the bicycle gave your son 's cousin 's cousin 's boss 's brother 's daughter 's glass the doll .	the bicycle shook your son 's cousin 's cousin 's boss 's brother 's daughter 's glass the doll .
the plate showed your cousin 's husband 's doctor 's daughter 's father 's teacher 's bicycle the door .	the plate held your cousin 's husband 's doctor 's daughter 's father 's teacher 's bicycle the door .
the bicycle showed my teacher 's boss 's daughter 's husband 's boss 's teacher 's mirror the rug .	the bicycle held my teacher 's boss 's daughter 's husband 's boss 's teacher 's mirror the rug .
the box gave my sister 's cousin 's dad 's teacher 's son 's cousin 's candle the ship .	the box lost my sister 's cousin 's dad 's teacher 's son 's cousin 's candle the ship .
the picture bought your son 's brother 's brother 's cousin 's mother 's mom 's dish the crayon .	the picture moved your son 's brother 's brother 's cousin 's mother 's mom 's dish the crayon .
the bag sent your boss 's mother 's doctor 's friend 's brother 's boss 's car the glass .	the bag lost your boss 's mother 's doctor 's friend 's brother 's boss 's car the glass .
the truck sent my father 's mom 's grandmother 's sister 's cousin 's doctor 's plane the bowl .	the truck held my father 's mom 's grandmother 's sister 's cousin 's doctor 's plane the bowl .
the couch gave your dentist 's cousin 's sister 's son 's grandmother 's mother 's window the cup .	the couch dropped your dentist 's cousin 's sister 's son 's grandmother 's mother 's window the cup .
the bottle bought your husband 's friend 's mother 's husband 's father 's cousin 's car the car .	the bottle held your husband 's friend 's mother 's husband 's father 's cousin 's car the car .
the box sent my doctor 's dentist 's dentist 's daughter 's boss 's son 's crayon the cup .	the box moved my doctor 's dentist 's dentist 's daughter 's boss 's son 's crayon the cup .
the shoe bought my wife 's husband 's father 's dentist 's sister 's sister 's cup the candle .	the shoe moved my wife 's husband 's father 's dentist 's sister 's sister 's cup the candle .
the car sent my boss 's mom 's wife 's teacher 's wife 's doctor 's plate the chair .	the car cleaned my boss 's mom 's wife 's teacher 's wife 's doctor 's plate the chair .
the couch bought your friend 's husband 's wife 's boss 's sister 's daughter 's bed the fork .	the couch dropped your friend 's husband 's wife 's boss 's sister 's daughter 's bed the fork .
the rocket showed your son 's cousin 's daughter 's mother 's grandmother 's husband 's car the bowl .	the rocket lost your son 's cousin 's daughter 's mother 's grandmother 's husband 's car the bowl .
the doll gave my dentist 's grandmother 's teacher 's grandmother 's wife 's cousin 's rug the rug .	the doll moved my dentist 's grandmother 's teacher 's grandmother 's wife 's cousin 's rug the rug .
the rocket bought your grandmother 's doctor 's doctor 's grandmother 's brother 's sister 's spoon the cup .	the rocket moved your grandmother 's doctor 's doctor 's grandmother 's brother 's sister 's spoon the cup .
the spoon sent my grandmother 's teacher 's daughter 's husband 's daughter 's wife 's rocket the candle .	the spoon shook my grandmother 's teacher 's daughter 's husband 's daughter 's wife 's rocket the candle .
the plane gave my mom 's cousin 's grandmother 's brother 's doctor 's grandmother 's dish the candle .	the plane kept my mom 's cousin 's grandmother 's brother 's doctor 's grandmother 's dish the candle .
the car bought your mother 's father 's friend 's son 's daughter 's mom 's shirt the couch .	the car dropped your mother 's father 's friend 's son 's daughter 's mom 's shirt the couch .
the cup gave your doctor 's dad 's boss 's doctor 's cousin 's doctor 's box the box .	the cup kept your doctor 's dad 's boss 's doctor 's cousin 's doctor 's box the box .
the bowl bought my dentist 's sister 's son 's son 's father 's brother 's car the book .	the bowl lost my dentist 's sister 's son 's son 's father 's brother 's car the book .
the bottle gave your wife 's dad 's friend 's mother 's boss 's sister 's button the bag .	the bottle moved your wife 's dad 's friend 's mother 's boss 's sister 's button the bag .
the dish bought your wife 's mother 's dentist 's husband 's husband 's wife 's book the car .	the dish dropped your wife 's mother 's dentist 's husband 's husband 's wife 's book the car .
the dish showed my daughter 's husband 's sister 's dad 's cousin 's mother 's fork the bag .	the dish shook my daughter 's husband 's sister 's dad 's cousin 's mother 's fork the bag .
the car sent your boss 's boss 's sister 's daughter 's brother 's brother 's plate the bottle .	the car shook your boss 's boss 's sister 's daughter 's brother 's brother 's plate the bottle .
the bowl bought my teacher 's friend 's dad 's cousin 's dad 's friend 's hat the shirt .	the bowl dropped my teacher 's friend 's dad 's cousin 's dad 's friend 's hat the shirt .
the car sent your mother 's grandmother 's mother 's mom 's brother 's husband 's bag the ship .	the car dropped your mother 's grandmother 's mother 's mom 's brother 's husband 's bag the ship .
the rug bought your mother 's sister 's teacher 's husband 's teacher 's husband 's couch the fork .	the rug lost your mother 's sister 's teacher 's husband 's teacher 's husband 's couch the fork .
the shirt showed your father 's dentist 's daughter 's teacher 's son 's father 's ship the shoe .	the shirt kept your father 's dentist 's daughter 's teacher 's son 's father 's ship the shoe .
the shirt gave my wife 's husband 's husband 's friend 's husband 's dentist 's bag the car .	the shirt moved my wife 's husband 's husband 's friend 's husband 's dentist 's bag the car .
the spoon bought your mom 's wife 's mother 's grandmother 's cousin 's dad 's box the shirt .	the spoon moved your mom 's wife 's mother 's grandmother 's cousin 's dad 's box the shirt .
the bicycle showed your grandmother 's friend 's sister 's dad 's sister 's son 's ring the fork .	the bicycle kept your grandmother 's friend 's sister 's dad 's sister 's son 's ring the fork .
the candle gave your son 's dad 's mom 's grandmother 's dentist 's teacher 's rocket the shirt .	the candle lost your son 's dad 's mom 's grandmother 's dentist 's teacher 's rocket the shirt .
the rug showed my father 's son 's father 's husband 's mom 's grandmother 's doll the window .	the rug shook my father 's son 's father 's husband 's mom 's grandmother 's doll the window .
the fork gave my dad 's son 's brother 's husband 's sister 's sister 's spoon the cup .	the fork dropped my dad 's son 's brother 's husband 's sister 's sister 's spoon the cup .
the couch showed my boss 's friend 's brother 's grandmother 's brother 's father 's toy the spoon .	the couch held my boss 's friend 's brother 's grandmother 's brother 's father 's toy the spoon .
the glass showed my boss 's mom 's friend 's mom 's teacher 's doctor 's fork the dish .	the glass held my boss 's mom 's friend 's mom 's teacher 's doctor 's fork the dish .
the door bought your grandmother 's friend 's teacher 's grandmother 's cousin 's teacher 's bed the doll .	the door moved your grandmother 's friend 's teacher 's grandmother 's cousin 's teacher 's bed the doll .
the bowl gave my husband 's friend 's mom 's friend 's grandmother 's father 's bicycle the hat .	the bowl dropped my husband 's friend 's mom 's friend 's grandmother 's father 's bicycle the hat .
the hat sent your mother 's boss 's teacher 's son 's husband 's boss 's mirror the bag .	the hat cleaned your mother 's boss 's teacher 's son 's husband 's boss 's mirror the bag .
the ring gave your sister 's son 's grandmother 's friend 's doctor 's boss 's book the plate .	the ring moved your sister 's son 's grandmother 's friend 's doctor 's boss 's book the plate .
the box gave my brother 's sister 's daughter 's doctor 's wife 's friend 's plate the ship .	the box cleaned my brother 's sister 's daughter 's doctor 's wife 's friend 's plate the ship .
the chair sent my doctor 's father 's brother 's son 's father 's doctor 's boat the bed .	the chair cleaned my doctor 's father 's brother 's son 's father 's doctor 's boat the bed .
the button gave your daughter 's daughter 's mom 's doctor 's brother 's doctor 's bowl the shirt .	the button dropped your daughter 's daughter 's mom 's doctor 's brother 's doctor 's bowl the shirt .
the button sent your brother 's mom 's mom 's father 's daughter 's father 's rocket the bowl .	the button kept your brother 's mom 's mom 's father 's daughter 's father 's rocket the bowl .
the couch sent your dentist 's boss 's son 's father 's boss 's cousin 's boat the box .	the couch lost your dentist 's boss 's son 's father 's boss 's cousin 's boat the box .
the bottle sent your daughter 's teacher 's doctor 's doctor 's husband 's dentist 's door the shirt .	the bottle held your daughter 's teacher 's doctor 's doctor 's husband 's dentist 's door the shirt .
the crayon showed your husband 's brother 's wife 's doctor 's daughter 's husband 's door the couch .	the crayon shook your husband 's brother 's wife 's doctor 's daughter 's husband 's door the couch .
the rocket showed your dad 's daughter 's sister 's mom 's wife 's husband 's mirror the ring .	the rocket shook your dad 's daughter 's sister 's mom 's wife 's husband 's mirror the ring .
the bed gave your brother 's brother 's dentist 's father 's doctor 's teacher 's hat the fork .	the bed kept your brother 's brother 's dentist 's father 's doctor 's teacher 's hat the fork .
the car sent my mother 's mom 's boss 's doctor 's husband 's sister 's crayon the toy .	the car kept my mother 's mom 's boss 's doctor 's husband 's sister 's crayon the toy .
the truck bought my teacher 's doctor 's cousin 's mother 's father 's cousin 's book the boat .	the truck kept my teacher 's doctor 's cousin 's mother 's father 's cousin 's book the boat .
the bowl showed your mom 's husband 's daughter 's grandmother 's brother 's cousin 's box the bottle .	the bowl moved your mom 's husband 's daughter 's grandmother 's brother 's cousin 's box the bottle .
the picture bought your friend 's mother 's mother 's grandmother 's teacher 's friend 's button the couch .	the picture shook your friend 's mother 's mother 's grandmother 's teacher 's friend 's button the couch .
the bed bought your cousin 's cousin 's mother 's dentist 's dad 's sister 's bed the bottle .	the bed held your cousin 's cousin 's mother 's dentist 's dad 's sister 's bed the bottle .
the doll sent my cousin 's father 's daughter 's friend 's mom 's dentist 's crayon the truck .	the doll kept my cousin 's father 's daughter 's friend 's mom 's dentist 's crayon the truck .
the boat bought my mother 's mother 's boss 's teacher 's mother 's boss 's door the door .	the boat held my mother 's mother 's boss 's teacher 's mother 's boss 's door the door .
the cup bought my doctor 's grandmother 's husband 's father 's sister 's husband 's window the hat .	the cup cleaned my doctor 's grandmother 's husband 's father 's sister 's husband 's window the hat .
the book bought my boss 's boss 's brother 's daughter 's boss 's brother 's couch the bottle .	the book cleaned my boss 's boss 's brother 's daughter 's boss 's brother 's couch the bottle .
the truck bought my doctor 's dad 's doctor 's grandmother 's wife 's boss 's plane the shirt .	the truck cleaned my doctor 's dad 's doctor 's grandmother 's wife 's boss 's plane the shirt .
the truck bought your teacher 's wife 's wife 's friend 's grandmother 's teacher 's hat the car .	the truck kept your teacher 's wife 's wife 's friend 's grandmother 's teacher 's hat the car .
the rug gave my son 's daughter 's daughter 's daughter 's cousin 's doctor 's plate the couch .	the rug moved my son 's daughter 's daughter 's daughter 's cousin 's doctor 's plate the couch .
the glass showed my daughter 's friend 's dentist 's husband 's teacher 's dentist 's spoon the button .	the glass kept my daughter 's friend 's dentist 's husband 's teacher 's dentist 's spoon the button .
the glass bought my dad 's dentist 's mom 's daughter 's cousin 's father 's crayon the shirt .	the glass lost my dad 's dentist 's mom 's daughter 's cousin 's father 's crayon the shirt .
the dish sent your dad 's cousin 's boss 's teacher 's grandmother 's sister 's button the bed .	the dish lost your dad 's cousin 's boss 's teacher 's grandmother 's sister 's button the bed .
the toy sent your grandmother 's friend 's son 's husband 's brother 's daughter 's dish the doll .	the toy lost your grandmother 's friend 's son 's husband 's brother 's daughter 's dish the doll .
the ship sent your doctor 's teacher 's father 's father 's teacher 's grandmother 's couch the truck .	the ship moved your doctor 's teacher 's father 's father 's teacher 's grandmother 's couch the truck .
the car bought your sister 's cousin 's doctor 's wife 's father 's dad 's ring the shoe .	the car kept your sister 's cousin 's doctor 's wife 's father 's dad 's ring the shoe .
the book gave your brother 's teacher 's sister 's mother 's husband 's sister 's car the button .	the book moved your brother 's teacher 's sister 's mother 's husband 's sister 's car the button .
the couch bought my father 's son 's dad 's teacher 's friend 's boss 's window the book .	the couch dropped my father 's son 's dad 's teacher 's friend 's boss 's window the book .
the plane bought your grandmother 's boss 's brother 's dad 's teacher 's grandmother 's spoon the rug .	the plane kept your grandmother 's boss 's brother 's dad 's teacher 's grandmother 's spoon the rug .
the chair showed my grandmother 's cousin 's sister 's cousin 's boss 's dentist 's couch the book .	the chair lost my grandmother 's cousin 's sister 's cousin 's boss 's dentist 's couch the book .
the plate bought my dentist 's sister 's mom 's doctor 's sister 's friend 's boat the window .	the plate shook my dentist 's sister 's mom 's doctor 's sister 's friend 's boat the window .
the spoon sent my daughter 's doctor 's doctor 's daughter 's brother 's teacher 's book the rocket .	the spoon dropped my daughter 's doctor 's doctor 's daughter 's brother 's teacher 's book the rocket .
the cup gave your mother 's son 's cousin 's daughter 's mother 's mother 's box the shoe .	the cup moved your mother 's son 's cousin 's daughter 's mother 's mother 's box the shoe .
the ship bought your dentist 's friend 's teacher 's doctor 's mother 's doctor 's ship the toy .	the ship kept your dentist 's friend 's teacher 's doctor 's mother 's doctor 's ship the toy .
the rocket gave my mother 's boss 's boss 's brother 's friend 's husband 's cup the mirror .	the rocket cleaned my mother 's boss 's boss 's brother 's friend 's husband 's cup the mirror .
the couch sent my son 's boss 's friend 's dad 's brother 's son 's ship the bottle .	the couch lost my son 's boss 's friend 's dad 's brother 's son 's ship the bottle .
the toy bought my son 's grandmother 's father 's mom 's boss 's sister 's dish the truck .	the toy held my son 's grandmother 's father 's mom 's boss 's sister 's dish the truck .
the bag bought your dentist 's husband 's dad 's wife 's friend 's daughter 's glass the bowl .	the bag shook your dentist 's husband 's dad 's wife 's friend 's daughter 's glass the bowl .
the doll sent my friend 's wife 's boss 's wife 's husband 's boss 's toy the fork .	the doll moved my friend 's wife 's boss 's wife 's husband 's boss 's toy the fork .
the chair sent my wife 's brother 's son 's teacher 's daughter 's mother 's fork the dish .	the chair held my wife 's brother 's son 's teacher 's daughter 's mother 's fork the dish .
the hat showed your cousin 's mother 's dentist 's wife 's mom 's grandmother 's bicycle the mirror .	the hat moved your cousin 's mother 's dentist 's wife 's mom 's grandmother 's bicycle the mirror .
the bowl sent my mother 's son 's dad 's daughter 's dad 's friend 's bicycle the shirt .	the bowl moved my mother 's son 's dad 's daughter 's dad 's friend 's bicycle the shirt .
the bicycle bought your teacher 's boss 's husband 's wife 's mother 's friend 's door the candle .	the bicycle dropped your teacher 's boss 's husband 's wife 's mother 's friend 's door the candle .
the chair bought my cousin 's son 's husband 's father 's sister 's brother 's candle the car .	the chair kept my cousin 's son 's husband 's father 's sister 's brother 's candle the car .
the plane gave your father 's mother 's doctor 's husband 's wife 's doctor 's bowl the boat .	the plane shook your father 's mother 's doctor 's husband 's wife 's doctor 's bowl the boat .
the hat showed your wife 's grandmother 's cousin 's wife 's boss 's sister 's doll the hat .	the hat held your wife 's grandmother 's cousin 's wife 's boss 's sister 's doll the hat .
the rocket showed your sister 's cousin 's dentist 's daughter 's dad 's husband 's bed the spoon .	the rocket held your sister 's cousin 's dentist 's daughter 's dad 's husband 's bed the spoon .
the toy bought your son 's brother 's wife 's mother 's son 's brother 's bag the truck .	the toy kept your son 's brother 's wife 's mother 's son 's brother 's bag the truck .
the shirt showed your mom 's boss 's son 's wife 's brother 's wife 's car the bottle .	the shirt kept your mom 's boss 's son 's wife 's brother 's wife 's car the bottle .
the couch sent your daughter 's brother 's teacher 's boss 's husband 's dentist 's box the bowl .	the couch cleaned your daughter 's brother 's teacher 's boss 's husband 's dentist 's box the bowl .
the spoon gave my son 's son 's sister 's sister 's brother 's daughter 's book the bottle .	the spoon dropped my son 's son 's sister 's sister 's brother 's daughter 's book the bottle .
the ship bought my grandmother 's mother 's boss 's doctor 's doctor 's brother 's toy the hat .	the ship lost my grandmother 's mother 's boss 's doctor 's doctor 's brother 's toy the hat .
the car bought your daughter 's mother 's mom 's mom 's teacher 's cousin 's box the toy .	the car kept your daughter 's mother 's mom 's mom 's teacher 's cousin 's box the toy .
the book bought my mother 's boss 's sister 's father 's dad 's friend 's bottle the truck .	the book cleaned my mother 's boss 's sister 's father 's dad 's friend 's bottle the truck .
the glass sent your husband 's cousin 's mom 's brother 's cousin 's husband 's couch the shirt .	the glass held your husband 's cousin 's mom 's brother 's cousin 's husband 's couch the shirt .
the chair sent your grandmother 's son 's dentist 's brother 's dentist 's cousin 's candle the door .	the chair moved your grandmother 's son 's dentist 's brother 's dentist 's cousin 's candle the door .
the button sent your father 's mother 's mother 's wife 's husband 's teacher 's truck the shoe .	the button kept your father 's mother 's mother 's wife 's husband 's teacher 's truck the shoe .
the bag bought your cousin 's dad 's dad 's mom 's husband 's mom 's couch the truck .	the bag cleaned your cousin 's dad 's dad 's mom 's husband 's mom 's couch the truck .
the couch sent your mom 's dentist 's wife 's friend 's son 's brother 's book the mirror .	the couch held your mom 's dentist 's wife 's friend 's son 's brother 's book the mirror .
the rocket showed your dentist 's husband 's daughter 's father 's mother 's boss 's ship the spoon .	the rocket cleaned your dentist 's husband 's daughter 's father 's mother 's boss 's ship the spoon .
the book gave my cousin 's friend 's sister 's wife 's doctor 's cousin 's bag the ring .	the book kept my cousin 's friend 's sister 's wife 's doctor 's cousin 's bag the ring .
the hat gave my grandmother 's dad 's dad 's dentist 's mom 's friend 's shirt the ship .	the hat cleaned my grandmother 's dad 's dad 's dentist 's mom 's friend 's shirt the ship .
the rocket sent your cousin 's mother 's mom 's mother 's mom 's wife 's bottle the candle .	the rocket moved your cousin 's mother 's mom 's mother 's mom 's wife 's bottle the candle .
the cup sent your dentist 's dad 's dentist 's cousin 's father 's sister 's book the ring .	the cup cleaned your dentist 's dad 's dentist 's cousin 's father 's sister 's book the ring .
the window showed your doctor 's grandmother 's daughter 's husband 's husband 's mom 's bowl the car .	the window cleaned your doctor 's grandmother 's daughter 's husband 's husband 's mom 's bowl the car .
the bottle bought your son 's mom 's son 's husband 's friend 's son 's picture the window .	the bottle cleaned your son 's mom 's son 's husband 's friend 's son 's picture the window .
the book showed my son 's wife 's sister 's teacher 's sister 's teacher 's car the bottle .	the book dropped my son 's wife 's sister 's teacher 's sister 's teacher 's car the bottle .
the plate bought my friend 's sister 's sister 's sister 's son 's friend 's bicycle the picture .	the plate cleaned my friend 's sister 's sister 's sister 's son 's friend 's bicycle the picture .
the window bought my teacher 's boss 's husband 's doctor 's friend 's dad 's bottle the bowl .	the window dropped my teacher 's boss 's husband 's doctor 's friend 's dad 's bottle the bowl .
the bowl bought your dentist 's cousin 's friend 's daughter 's grandmother 's mother 's boat the book .	the bowl dropped your dentist 's cousin 's friend 's daughter 's grandmother 's mother 's boat the book .
the couch gave my brother 's mom 's daughter 's teacher 's friend 's mom 's chair the button .	the couch shook my brother 's mom 's daughter 's teacher 's friend 's mom 's chair the button .
the candle bought your husband 's father 's husband 's grandmother 's friend 's daughter 's mirror the truck .	the candle kept your husband 's father 's husband 's grandmother 's friend 's daughter 's mirror the truck .
the door showed my teacher 's dentist 's cousin 's daughter 's boss 's friend 's shoe the plane .	the door lost my teacher 's dentist 's cousin 's daughter 's boss 's friend 's shoe the plane .
the plate bought your friend 's mother 's cousin 's teacher 's boss 's wife 's couch the shoe .	the plate moved your friend 's mother 's cousin 's teacher 's boss 's wife 's couch the shoe .
the car showed your father 's brother 's grandmother 's friend 's dentist 's son 's boat the plate .	the car shook your father 's brother 's grandmother 's friend 's dentist 's son 's boat the plate .
the ship sent your mother 's friend 's dentist 's dentist 's boss 's mom 's cup the boat .	the ship kept your mother 's friend 's dentist 's dentist 's boss 's mom 's cup the boat .
the ship sent your daughter 's grandmother 's boss 's father 's friend 's dad 's window the doll .	the ship lost your daughter 's grandmother 's boss 's father 's friend 's dad 's window the doll .
the bicycle showed your doctor 's son 's teacher 's friend 's dentist 's son 's glass the boat .	the bicycle held your doctor 's son 's teacher 's friend 's dentist 's son 's glass the boat .
the book bought my dad 's mom 's grandmother 's father 's sister 's daughter 's cup the doll .	the book moved my dad 's mom 's grandmother 's father 's sister 's daughter 's cup the doll .
the picture sent my daughter 's wife 's dentist 's husband 's doctor 's father 's crayon the door .	the picture dropped my daughter 's wife 's dentist 's husband 's doctor 's father 's crayon the door .
the shoe sent your doctor 's mom 's brother 's dad 's doctor 's doctor 's doll the bowl .	the shoe lost your doctor 's mom 's brother 's dad 's doctor 's doctor 's doll the bowl .
the rug sent my boss 's dad 's dentist 's mother 's grandmother 's boss 's hat the button .	the rug moved my boss 's dad 's dentist 's mother 's grandmother 's boss 's hat the button .
the cup sent my daughter 's son 's dad 's daughter 's daughter 's mom 's glass the book .	the cup held my daughter 's son 's dad 's daughter 's daughter 's mom 's glass the book .
the bottle showed my cousin 's boss 's cousin 's grandmother 's dentist 's mother 's shoe the bed .	the bottle dropped my cousin 's boss 's cousin 's grandmother 's dentist 's mother 's shoe the bed .
the hat sent my mom 's son 's teacher 's doctor 's son 's brother 's candle the rug .	the hat dropped my mom 's son 's teacher 's doctor 's son 's brother 's candle the rug .
the bag sent my son 's sister 's father 's doctor 's husband 's boss 's book the bag .	the bag cleaned my son 's sister 's father 's doctor 's husband 's boss 's book the bag .
the truck gave my cousin 's husband 's mother 's dad 's grandmother 's father 's fork the car .	the truck shook my cousin 's husband 's mother 's dad 's grandmother 's father 's fork the car .
the shoe gave your grandmother 's sister 's friend 's dad 's grandmother 's son 's dish the shirt .	the shoe kept your grandmother 's sister 's friend 's dad 's grandmother 's son 's dish the shirt .
the bicycle sent my sister 's doctor 's dentist 's mother 's cousin 's mom 's bowl the door .	the bicycle moved my sister 's doctor 's dentist 's mother 's cousin 's mom 's bowl the door .
the bicycle bought your daughter 's sister 's wife 's teacher 's daughter 's dad 's box the bag .	the bicycle cleaned your daughter 's sister 's wife 's teacher 's daughter 's dad 's box the bag .
the plane gave your dad 's husband 's son 's dad 's brother 's cousin 's glass the bed .	the plane held your dad 's husband 's son 's dad 's brother 's cousin 's glass the bed .
the doll showed my husband 's teacher 's dentist 's mother 's grandmother 's dad 's book the bicycle .	the doll held my husband 's teacher 's dentist 's mother 's grandmother 's dad 's book the bicycle .
the spoon bought your wife 's son 's boss 's teacher 's father 's daughter 's shoe the plate .	the spoon held your wife 's son 's boss 's teacher 's father 's daughter 's shoe the plate .
the shoe showed your cousin 's doctor 's father 's daughter 's doctor 's dentist 's rug the window .	the shoe held your cousin 's doctor 's father 's daughter 's doctor 's dentist 's rug the window .
the couch gave my mother 's boss 's teacher 's grandmother 's husband 's grandmother 's button the couch .	the couch lost my mother 's boss 's teacher 's grandmother 's husband 's grandmother 's button the couch .
the truck bought your grandmother 's friend 's dentist 's daughter 's sister 's father 's door the boat .	the truck moved your grandmother 's friend 's dentist 's daughter 's sister 's father 's door the boat .
the door bought your daughter 's boss 's brother 's wife 's boss 's wife 's dish the fork .	the door lost your daughter 's boss 's brother 's wife 's boss 's wife 's dish the fork .
the picture sent your mother 's dad 's mother 's dad 's sister 's cousin 's glass the crayon .	the picture lost your mother 's dad 's mother 's dad 's sister 's cousin 's glass the crayon .
the shoe showed your father 's brother 's friend 's wife 's father 's sister 's car the button .	the shoe kept your father 's brother 's friend 's wife 's father 's sister 's car the button .
the car sent your dentist 's mother 's wife 's daughter 's husband 's wife 's candle the toy .	the car cleaned your dentist 's mother 's wife 's daughter 's husband 's wife 's candle the toy .
the door showed your father 's dad 's doctor 's mother 's father 's sister 's book the dish .	the door cleaned your father 's dad 's doctor 's mother 's father 's sister 's book the dish .
the window bought your cousin 's doctor 's cousin 's grandmother 's teacher 's mother 's plate the mirror .	the window kept your cousin 's doctor 's cousin 's grandmother 's teacher 's mother 's plate the mirror .
the rocket bought your father 's grandmother 's mother 's cousin 's wife 's dentist 's couch the rug .	the rocket lost your father 's grandmother 's mother 's cousin 's wife 's dentist 's couch the rug .
the shirt bought your mom 's husband 's teacher 's sister 's mom 's dentist 's fork the box .	the shirt shook your mom 's husband 's teacher 's sister 's mom 's dentist 's fork the box .
the bed bought your boss 's doctor 's cousin 's brother 's mom 's father 's truck the dish .	the bed lost your boss 's doctor 's cousin 's brother 's mom 's father 's truck the dish .
the car gave your mother 's brother 's daughter 's teacher 's wife 's mom 's doll the car .	the car moved your mother 's brother 's daughter 's teacher 's wife 's mom 's doll the car .
the ship showed my brother 's sister 's mother 's doctor 's cousin 's sister 's car the shoe .	the ship held my brother 's sister 's mother 's doctor 's cousin 's sister 's car the shoe .
the cup sent your mom 's mom 's son 's brother 's dentist 's dentist 's bowl the plate .	the cup held your mom 's mom 's son 's brother 's dentist 's dentist 's bowl the plate .
the car sent my brother 's wife 's dad 's wife 's friend 's mother 's hat the rocket .	the car moved my brother 's wife 's dad 's wife 's friend 's mother 's hat the rocket .
the box bought your brother 's husband 's mother 's husband 's teacher 's dentist 's plate the boat .	the box cleaned your brother 's husband 's mother 's husband 's teacher 's dentist 's plate the boat .
the toy showed your wife 's mom 's teacher 's boss 's mother 's father 's button the book .	the toy dropped your wife 's mom 's teacher 's boss 's mother 's father 's button the book .
the dish sent my father 's cousin 's dad 's daughter 's boss 's cousin 's hat the rocket .	the dish shook my father 's cousin 's dad 's daughter 's boss 's cousin 's hat the rocket .
the bowl bought my doctor 's friend 's doctor 's dad 's dentist 's sister 's truck the bottle .	the bowl lost my doctor 's friend 's doctor 's dad 's dentist 's sister 's truck the bottle .
the rocket bought my wife 's dad 's sister 's friend 's doctor 's dentist 's box the bottle .	the rocket shook my wife 's dad 's sister 's friend 's doctor 's dentist 's box the bottle .
the couch sent my father 's brother 's wife 's friend 's mother 's daughter 's rocket the plane .	the couch lost my father 's brother 's wife 's friend 's mother 's daughter 's rocket the plane .
the door bought my father 's boss 's son 's cousin 's mother 's wife 's cup the car .	the door shook my father 's boss 's son 's cousin 's mother 's wife 's cup the car .
the shoe sent your teacher 's mother 's wife 's son 's doctor 's son 's spoon the bag .	the shoe shook your teacher 's mother 's wife 's son 's doctor 's son 's spoon the bag .
the couch showed my boss 's dentist 's son 's mother 's husband 's boss 's window the dish .	the couch moved my boss 's dentist 's son 's mother 's husband 's boss 's window the dish .
the truck showed my mother 's dentist 's dad 's cousin 's cousin 's dentist 's bowl the candle .	the truck dropped my mother 's dentist 's dad 's cousin 's cousin 's dentist 's bowl the candle .
the box sent my dad 's daughter 's mother 's husband 's wife 's daughter 's bicycle the bed .	the box kept my dad 's daughter 's mother 's husband 's wife 's daughter 's bicycle the bed .
the plate bought your mother 's wife 's cousin 's dentist 's friend 's dad 's dish the door .	the plate held your mother 's wife 's cousin 's dentist 's friend 's dad 's dish the door .
the car showed my dad 's son 's boss 's doctor 's doctor 's mother 's bicycle the button .	the car cleaned my dad 's son 's boss 's doctor 's doctor 's mother 's bicycle the button .
the fork bought my friend 's dad 's grandmother 's grandmother 's doctor 's grandmother 's crayon the ring .	the fork lost my friend 's dad 's grandmother 's grandmother 's doctor 's grandmother 's crayon the ring .
the hat bought my teacher 's mother 's sister 's wife 's doctor 's boss 's mirror the book .	the hat moved my teacher 's mother 's sister 's wife 's doctor 's boss 's mirror the book .
the candle bought your daughter 's boss 's doctor 's husband 's wife 's sister 's rocket the shoe .	the candle held your daughter 's boss 's doctor 's husband 's wife 's sister 's rocket the shoe .
the doll showed your father 's boss 's dentist 's boss 's husband 's brother 's spoon the candle .	the doll lost your father 's boss 's dentist 's boss 's husband 's brother 's spoon the candle .
the boat gave your sister 's son 's wife 's boss 's dentist 's teacher 's spoon the dish .	the boat moved your sister 's son 's wife 's boss 's dentist 's teacher 's spoon the dish .
the bag showed your cousin 's daughter 's dentist 's wife 's cousin 's husband 's bag the couch .	the bag shook your cousin 's daughter 's dentist 's wife 's cousin 's husband 's bag the couch .
the couch sent my daughter 's sister 's mom 's husband 's friend 's friend 's truck the picture .	the couch shook my daughter 's sister 's mom 's husband 's friend 's friend 's truck the picture .
the shirt showed my friend 's doctor 's wife 's father 's son 's mom 's plane the toy .	the shirt moved my friend 's doctor 's wife 's father 's son 's mom 's plane the toy .
the shoe showed my daughter 's teacher 's husband 's mother 's mother 's son 's cup the box .	the shoe moved my daughter 's teacher 's husband 's mother 's mother 's son 's cup the box .
the button showed your sister 's mother 's daughter 's brother 's dentist 's wife 's spoon the bottle .	the button cleaned your sister 's mother 's daughter 's brother 's dentist 's wife 's spoon the bottle .
the glass gave my friend 's husband 's dad 's grandmother 's dentist 's cousin 's car the spoon .	the glass cleaned my friend 's husband 's dad 's grandmother 's dentist 's cousin 's car the spoon .
the bag sent my grandmother 's cousin 's cousin 's grandmother 's wife 's sister 's plane the shirt .	the bag held my grandmother 's cousin 's cousin 's grandmother 's wife 's sister 's plane the shirt .
the doll sent your dentist 's doctor 's wife 's son 's mother 's mother 's dish the ring .	the doll shook your dentist 's doctor 's wife 's son 's mother 's mother 's dish the ring .
the doll gave your sister 's boss 's sister 's wife 's brother 's daughter 's couch the bicycle .	the doll lost your sister 's boss 's sister 's wife 's brother 's daughter 's couch the bicycle .
the plate showed my wife 's dentist 's daughter 's dad 's grandmother 's cousin 's glass the box .	the plate shook my wife 's dentist 's daughter 's dad 's grandmother 's cousin 's glass the box .
the bowl showed my dentist 's dentist 's dad 's mother 's wife 's son 's ring the book .	the bowl lost my dentist 's dentist 's dad 's mother 's wife 's son 's ring the book .
the rug gave your father 's boss 's father 's cousin 's father 's friend 's window the book .	the rug lost your father 's boss 's father 's cousin 's father 's friend 's window the book .
the doll showed your cousin 's mother 's grandmother 's mother 's sister 's husband 's spoon the truck .	the doll dropped your cousin 's mother 's grandmother 's mother 's sister 's husband 's spoon the truck .
the fork sent your mom 's friend 's mom 's cousin 's cousin 's mother 's hat the book .	the fork moved your mom 's friend 's mom 's cousin 's cousin 's mother 's hat the book .
the fork sent your dad 's wife 's grandmother 's brother 's brother 's doctor 's window the dish .	the fork lost your dad 's wife 's grandmother 's brother 's brother 's doctor 's window the dish .
the bowl showed my wife 's wife 's friend 's wife 's husband 's friend 's book the shoe .	the bowl cleaned my wife 's wife 's friend 's wife 's husband 's friend 's book the shoe .
the shoe bought my boss 's doctor 's father 's wife 's father 's wife 's car the boat .	the shoe lost my boss 's doctor 's father 's wife 's father 's wife 's car the boat .
the bicycle showed your daughter 's mom 's teacher 's friend 's friend 's father 's car the dish .	the bicycle cleaned your daughter 's mom 's teacher 's friend 's friend 's father 's car the dish .
the plane bought my son 's mom 's father 's mother 's sister 's grandmother 's fork the plane .	the plane dropped my son 's mom 's father 's mother 's sister 's grandmother 's fork the plane .
the spoon gave your dad 's teacher 's doctor 's friend 's daughter 's dentist 's book the ship .	the spoon dropped your dad 's teacher 's doctor 's friend 's daughter 's dentist 's book the ship .
the ship sent your dad 's mom 's friend 's dentist 's grandmother 's sister 's rocket the window .	the ship dropped your dad 's mom 's friend 's dentist 's grandmother 's sister 's rocket the window .
the hat gave your mom 's mother 's mother 's brother 's friend 's dad 's mirror the rocket .	the hat held your mom 's mother 's mother 's brother 's friend 's dad 's mirror the rocket .
the book gave my son 's friend 's son 's grandmother 's dad 's father 's shirt the mirror .	the book cleaned my son 's friend 's son 's grandmother 's dad 's father 's shirt the mirror .
the hat showed your sister 's sister 's dentist 's sister 's cousin 's boss 's box the candle .	the hat dropped your sister 's sister 's dentist 's sister 's cousin 's boss 's box the candle .
the cup sent my doctor 's boss 's brother 's daughter 's grandmother 's dentist 's car the fork .	the cup kept my doctor 's boss 's brother 's daughter 's grandmother 's dentist 's car the fork .
the bowl bought my brother 's grandmother 's mother 's teacher 's son 's mom 's car the rocket .	the bowl dropped my brother 's grandmother 's mother 's teacher 's son 's mom 's car the rocket .
the shirt showed my father 's grandmother 's cousin 's son 's friend 's mom 's shirt the book .	the shirt lost my father 's grandmother 's cousin 's son 's friend 's mom 's shirt the book .
the couch showed your friend 's cousin 's father 's brother 's father 's friend 's car the ship .	the couch dropped your friend 's cousin 's father 's brother 's father 's friend 's car the ship .
the ship gave your wife 's dad 's wife 's boss 's grandmother 's mother 's hat the mirror .	the ship lost your wife 's dad 's wife 's boss 's grandmother 's mother 's hat the mirror .
the bowl sent my mom 's wife 's dentist 's father 's grandmother 's teacher 's door the button .	the bowl dropped my mom 's wife 's dentist 's father 's grandmother 's teacher 's door the button .
the toy bought your cousin 's grandmother 's mom 's brother 's friend 's son 's mirror the plane .	the toy held your cousin 's grandmother 's mom 's brother 's friend 's son 's mirror the plane .
the candle sent your teacher 's grandmother 's doctor 's friend 's brother 's brother 's button the hat .	the candle moved your teacher 's grandmother 's doctor 's friend 's brother 's brother 's button the hat .
the bowl showed my daughter 's husband 's sister 's cousin 's father 's brother 's button the bag .	the bowl kept my daughter 's husband 's sister 's cousin 's father 's brother 's button the bag .
the toy showed my cousin 's father 's grandmother 's wife 's brother 's mother 's window the door .	the toy dropped my cousin 's father 's grandmother 's wife 's brother 's mother 's window the door .
the rug sent my son 's daughter 's friend 's brother 's brother 's son 's plate the dish .	the rug kept my son 's daughter 's friend 's brother 's brother 's son 's plate the dish .
the rug bought my father 's daughter 's father 's doctor 's brother 's dentist 's fork the shoe .	the rug lost my father 's daughter 's father 's doctor 's brother 's dentist 's fork the shoe .
the couch gave your father 's teacher 's father 's husband 's grandmother 's sister 's window the plate .	the couch kept your father 's teacher 's father 's husband 's grandmother 's sister 's window the plate .
the couch gave my dentist 's friend 's father 's husband 's wife 's son 's door the mirror .	the couch kept my dentist 's friend 's father 's husband 's wife 's son 's door the mirror .
the book gave my friend 's son 's dentist 's mom 's father 's mother 's mirror the glass .	the book shook my friend 's son 's dentist 's mom 's father 's mother 's mirror the glass .
the crayon gave my dentist 's dentist 's teacher 's sister 's daughter 's mother 's box the cup .	the crayon shook my dentist 's dentist 's teacher 's sister 's daughter 's mother 's box the cup .
the plane showed my son 's grandmother 's mother 's friend 's father 's dentist 's window the bed .	the plane lost my son 's grandmother 's mother 's friend 's father 's dentist 's window the bed .
the door gave my grandmother 's husband 's teacher 's daughter 's husband 's husband 's bag the car .	the door kept my grandmother 's husband 's teacher 's daughter 's husband 's husband 's bag the car .
the rug gave my father 's brother 's daughter 's mom 's doctor 's dad 's button the chair .	the rug held my father 's brother 's daughter 's mom 's doctor 's dad 's button the chair .
the crayon sent your doctor 's father 's brother 's dad 's wife 's brother 's door the bed .	the crayon shook your doctor 's father 's brother 's dad 's wife 's brother 's door the bed .
the bowl sent your dentist 's mom 's daughter 's boss 's son 's teacher 's cup the box .	the bowl held your dentist 's mom 's daughter 's boss 's son 's teacher 's cup the box .
the ship bought your sister 's cousin 's cousin 's teacher 's daughter 's dentist 's bicycle the ring .	the ship shook your sister 's cousin 's cousin 's teacher 's daughter 's dentist 's bicycle the ring .
the bowl showed my dad 's mom 's brother 's father 's wife 's teacher 's button the dish .	the bowl moved my dad 's mom 's brother 's father 's wife 's teacher 's button the dish .
the door showed my doctor 's husband 's friend 's dentist 's wife 's son 's button the bag .	the door shook my doctor 's husband 's friend 's dentist 's wife 's son 's button the bag .
the plane showed your friend 's friend 's teacher 's teacher 's cousin 's cousin 's chair the fork .	the plane held your friend 's friend 's teacher 's teacher 's cousin 's cousin 's chair the fork .
the bag bought your doctor 's doctor 's sister 's grandmother 's father 's wife 's glass the couch .	the bag held your doctor 's doctor 's sister 's grandmother 's father 's wife 's glass the couch .
the crayon bought my mom 's sister 's teacher 's mother 's wife 's son 's bag the bicycle .	the crayon cleaned my mom 's sister 's teacher 's mother 's wife 's son 's bag the bicycle .
the shoe bought your brother 's dad 's teacher 's mother 's daughter 's dentist 's button the door .	the shoe moved your brother 's dad 's teacher 's mother 's daughter 's dentist 's button the door .
the window sent your mom 's boss 's grandmother 's dad 's dentist 's doctor 's car the car .	the window cleaned your mom 's boss 's grandmother 's dad 's dentist 's doctor 's car the car .
the picture sent my dad 's son 's wife 's son 's mother 's friend 's dish the bed .	the picture dropped my dad 's son 's wife 's son 's mother 's friend 's dish the bed .
the candle sent your friend 's father 's boss 's boss 's friend 's grandmother 's picture the ring .	the candle lost your friend 's father 's boss 's boss 's friend 's grandmother 's picture the ring .
the doll bought your teacher 's mother 's grandmother 's father 's grandmother 's daughter 's doll the crayon .	the doll cleaned your teacher 's mother 's grandmother 's father 's grandmother 's daughter 's doll the crayon .
the couch gave your father 's friend 's son 's son 's cousin 's boss 's rocket the shoe .	the couch held your father 's friend 's son 's son 's cousin 's boss 's rocket the shoe .
the candle showed my mother 's mom 's friend 's father 's teacher 's son 's car the door .	the candle shook my mother 's mom 's friend 's father 's teacher 's son 's car the door .
the plane sent your dad 's father 's mom 's boss 's wife 's brother 's book the ship .	the plane lost your dad 's father 's mom 's boss 's wife 's brother 's book the ship .
the dish bought your husband 's daughter 's mom 's boss 's brother 's wife 's hat the couch .	the dish dropped your husband 's daughter 's mom 's boss 's brother 's wife 's hat the couch .
the chair sent your son 's dad 's dentist 's dentist 's sister 's doctor 's door the spoon .	the chair dropped your son 's dad 's dentist 's dentist 's sister 's doctor 's door the spoon .
the box sent your sister 's cousin 's wife 's father 's boss 's mother 's ship the couch .	the box kept your sister 's cousin 's wife 's father 's boss 's mother 's ship the couch .
the ring sent your teacher 's son 's father 's boss 's friend 's teacher 's spoon the chair .	the ring kept your teacher 's son 's father 's boss 's friend 's teacher 's spoon the chair .
the door sent my son 's grandmother 's brother 's cousin 's grandmother 's wife 's plane the glass .	the door lost my son 's grandmother 's brother 's cousin 's grandmother 's wife 's plane the glass .
the door sent your friend 's dad 's teacher 's son 's mother 's mom 's shirt the candle .	the door lost your friend 's dad 's teacher 's son 's mother 's mom 's shirt the candle .
the ship gave your boss 's grandmother 's husband 's husband 's boss 's cousin 's plane the candle .	the ship cleaned your boss 's grandmother 's husband 's husband 's boss 's cousin 's plane the candle .
the bed bought my teacher 's daughter 's sister 's dentist 's father 's wife 's car the doll .	the bed lost my teacher 's daughter 's sister 's dentist 's father 's wife 's car the doll .
the rug bought your teacher 's dentist 's wife 's cousin 's teacher 's daughter 's truck the plane .	the rug held your teacher 's dentist 's wife 's cousin 's teacher 's daughter 's truck the plane .
the boat gave your son 's dad 's grandmother 's wife 's boss 's dentist 's bag the spoon .	the boat shook your son 's dad 's grandmother 's wife 's boss 's dentist 's bag the spoon .
the dish gave your mother 's daughter 's husband 's brother 's dad 's boss 's ship the mirror .	the dish kept your mother 's daughter 's husband 's brother 's dad 's boss 's ship the mirror .
the shoe sent my grandmother 's mom 's doctor 's sister 's cousin 's doctor 's shirt the picture .	the shoe shook my grandmother 's mom 's doctor 's sister 's cousin 's doctor 's shirt the picture .
the door gave my teacher 's daughter 's dentist 's teacher 's husband 's sister 's plane the hat .	the door shook my teacher 's daughter 's dentist 's teacher 's husband 's sister 's plane the hat .
the mirror sent your cousin 's brother 's grandmother 's boss 's teacher 's daughter 's box the bag .	the mirror held your cousin 's brother 's grandmother 's boss 's teacher 's daughter 's box the bag .
the car gave my dentist 's friend 's husband 's dad 's son 's boss 's hat the door .	the car kept my dentist 's friend 's husband 's dad 's son 's boss 's hat the door .
the candle bought your daughter 's brother 's friend 's son 's dentist 's friend 's cup the truck .	the candle lost your daughter 's brother 's friend 's son 's dentist 's friend 's cup the truck .
the car sent your husband 's father 's dentist 's cousin 's mom 's dentist 's rug the bag .	the car moved your husband 's father 's dentist 's cousin 's mom 's dentist 's rug the bag .
the bowl sent your sister 's father 's son 's dentist 's grandmother 's dentist 's door the fork .	the bowl moved your sister 's father 's son 's dentist 's grandmother 's dentist 's door the fork .
the bicycle showed your mother 's cousin 's dentist 's father 's mother 's boss 's car the candle .	the bicycle lost your mother 's cousin 's dentist 's father 's mother 's boss 's car the candle .
the rocket bought my dad 's father 's daughter 's doctor 's sister 's friend 's rocket the shoe .	the rocket dropped my dad 's father 's daughter 's doctor 's sister 's friend 's rocket the shoe .
the chair gave my teacher 's mother 's brother 's boss 's cousin 's mother 's ring the rocket .	the chair cleaned my teacher 's mother 's brother 's boss 's cousin 's mother 's ring the rocket .
the cup bought your father 's brother 's brother 's mother 's brother 's daughter 's door the crayon .	the cup moved your father 's brother 's brother 's mother 's brother 's daughter 's door the crayon .
the car bought my teacher 's grandmother 's friend 's brother 's doctor 's brother 's bicycle the boat .	the car moved my teacher 's grandmother 's friend 's brother 's doctor 's brother 's bicycle the boat .
the bottle gave my brother 's son 's father 's friend 's grandmother 's son 's book the book .	the bottle held my brother 's son 's father 's friend 's grandmother 's son 's book the book .
the shoe bought your doctor 's dad 's daughter 's father 's wife 's dentist 's plate the ship .	the shoe kept your doctor 's dad 's daughter 's father 's wife 's dentist 's plate the ship .
the door bought your grandmother 's grandmother 's wife 's wife 's husband 's boss 's book the plate .	the door cleaned your grandmother 's grandmother 's wife 's wife 's husband 's boss 's book the plate .
the ship bought my daughter 's doctor 's son 's husband 's brother 's mom 's fork the bag .	the ship cleaned my daughter 's doctor 's son 's husband 's brother 's mom 's fork the bag .
the toy bought your boss 's doctor 's son 's mom 's daughter 's brother 's bicycle the window .	the toy lost your boss 's doctor 's son 's mom 's daughter 's brother 's bicycle the window .
the ship showed your dad 's grandmother 's cousin 's brother 's cousin 's dentist 's window the bowl .	the ship dropped your dad 's grandmother 's cousin 's brother 's cousin 's dentist 's window the bowl .
the bag bought my sister 's son 's sister 's dentist 's dad 's dad 's plate the couch .	the bag cleaned my sister 's son 's sister 's dentist 's dad 's dad 's plate the couch .
the window gave your brother 's husband 's son 's friend 's mother 's doctor 's shirt the candle .	the window cleaned your brother 's husband 's son 's friend 's mother 's doctor 's shirt the candle .
the bicycle gave my boss 's boss 's boss 's boss 's son 's friend 's truck the ring .	the bicycle shook my boss 's boss 's boss 's boss 's son 's friend 's truck the ring .
the mirror gave my father 's father 's cousin 's mom 's boss 's sister 's mirror the shoe .	the mirror kept my father 's father 's cousin 's mom 's boss 's sister 's mirror the shoe .
the toy bought your mother 's doctor 's father 's mom 's husband 's teacher 's crayon the boat .	the toy moved your mother 's doctor 's father 's mom 's husband 's teacher 's crayon the boat .
the hat bought my mom 's husband 's friend 's daughter 's father 's doctor 's candle the ship .	the hat cleaned my mom 's husband 's friend 's daughter 's father 's doctor 's candle the ship .
the chair gave my wife 's doctor 's wife 's daughter 's friend 's daughter 's fork the ring .	the chair held my wife 's doctor 's wife 's daughter 's friend 's daughter 's fork the ring .
the bottle gave my cousin 's sister 's daughter 's dad 's cousin 's father 's shoe the door .	the bottle kept my cousin 's sister 's daughter 's dad 's cousin 's father 's shoe the door .
the rocket gave my son 's brother 's friend 's teacher 's father 's dentist 's bicycle the button .	the rocket lost my son 's brother 's friend 's teacher 's father 's dentist 's bicycle the button .
the bowl sent your mom 's cousin 's daughter 's friend 's mother 's mother 's couch the shoe .	the bowl held your mom 's cousin 's daughter 's friend 's mother 's mother 's couch the shoe .
the cup bought your dentist 's dentist 's dad 's husband 's son 's doctor 's truck the couch .	the cup dropped your dentist 's dentist 's dad 's husband 's son 's doctor 's truck the couch .
the bag bought your son 's brother 's friend 's wife 's boss 's mom 's rug the picture .	the bag dropped your son 's brother 's friend 's wife 's boss 's mom 's rug the picture .
the toy sent your dentist 's son 's dentist 's doctor 's doctor 's mother 's rug the couch .	the toy cleaned your dentist 's son 's dentist 's doctor 's doctor 's mother 's rug the couch .
the book showed your brother 's husband 's father 's daughter 's father 's friend 's shoe the doll .	the book shook your brother 's husband 's father 's daughter 's father 's friend 's shoe the doll .
the spoon gave my dad 's father 's sister 's dentist 's friend 's doctor 's boat the book .	the spoon moved my dad 's father 's sister 's dentist 's friend 's doctor 's boat the book .
the candle showed your boss 's daughter 's teacher 's dentist 's mom 's cousin 's book the car .	the candle moved your boss 's daughter 's teacher 's dentist 's mom 's cousin 's book the car .
the button bought my son 's father 's teacher 's wife 's son 's doctor 's crayon the window .	the button shook my son 's father 's teacher 's wife 's son 's doctor 's crayon the window .
the glass showed my doctor 's son 's son 's husband 's dentist 's dad 's cup the candle .	the glass shook my doctor 's son 's son 's husband 's dentist 's dad 's cup the candle .
the plate gave my cousin 's husband 's son 's doctor 's friend 's dentist 's button the chair .	the plate kept my cousin 's husband 's son 's doctor 's friend 's dentist 's button the chair .
the dish showed my dad 's dad 's cousin 's friend 's cousin 's teacher 's bed the plate .	the dish held my dad 's dad 's cousin 's friend 's cousin 's teacher 's bed the plate .
the picture sent my son 's mom 's cousin 's son 's doctor 's dentist 's car the crayon .	the picture shook my son 's mom 's cousin 's son 's doctor 's dentist 's car the crayon .
the book sent your mom 's grandmother 's mother 's boss 's brother 's cousin 's bag the bed .	the book lost your mom 's grandmother 's mother 's boss 's brother 's cousin 's bag the bed .
the plate showed my teacher 's dentist 's mom 's boss 's doctor 's sister 's car the bag .	the plate dropped my teacher 's dentist 's mom 's boss 's doctor 's sister 's car the bag .
the bicycle gave my wife 's sister 's teacher 's friend 's boss 's dad 's picture the hat .	the bicycle moved my wife 's sister 's teacher 's friend 's boss 's dad 's picture the hat .
the mirror sent your doctor 's cousin 's grandmother 's mother 's grandmother 's husband 's cup the hat .	the mirror moved your doctor 's cousin 's grandmother 's mother 's grandmother 's husband 's cup the hat .
the car bought my dad 's friend 's father 's daughter 's mother 's grandmother 's spoon the plate .	the car lost my dad 's friend 's father 's daughter 's mother 's grandmother 's spoon the plate .
the door showed your mom 's mother 's daughter 's wife 's friend 's boss 's shoe the bag .	the door shook your mom 's mother 's daughter 's wife 's friend 's boss 's shoe the bag .
the crayon showed my father 's doctor 's mother 's cousin 's husband 's husband 's hat the crayon .	the crayon held my father 's doctor 's mother 's cousin 's husband 's husband 's hat the crayon .
the glass showed my husband 's cousin 's father 's son 's boss 's brother 's plate the ring .	the glass kept my husband 's cousin 's father 's son 's boss 's brother 's plate the ring .
the button gave your doctor 's daughter 's mother 's mother 's wife 's teacher 's couch the candle .	the button kept your doctor 's daughter 's mother 's mother 's wife 's teacher 's couch the candle .
the truck sent my father 's teacher 's boss 's teacher 's mother 's grandmother 's shoe the car .	the truck cleaned my father 's teacher 's boss 's teacher 's mother 's grandmother 's shoe the car .
the plate sent my daughter 's doctor 's mom 's daughter 's dad 's friend 's rug the fork .	the plate cleaned my daughter 's doctor 's mom 's daughter 's dad 's friend 's rug the fork .
the ring showed my dentist 's friend 's sister 's friend 's husband 's cousin 's rocket the doll .	the ring cleaned my dentist 's friend 's sister 's friend 's husband 's cousin 's rocket the doll .
the doll sent your friend 's sister 's husband 's doctor 's boss 's sister 's crayon the chair .	the doll lost your friend 's sister 's husband 's doctor 's boss 's sister 's crayon the chair .
the bottle sent your husband 's daughter 's dad 's dentist 's doctor 's brother 's picture the truck .	the bottle kept your husband 's daughter 's dad 's dentist 's doctor 's brother 's picture the truck .
the shoe showed your grandmother 's sister 's wife 's grandmother 's husband 's teacher 's window the candle .	the shoe cleaned your grandmother 's sister 's wife 's grandmother 's husband 's teacher 's window the candle .
the book bought your husband 's dentist 's father 's doctor 's sister 's sister 's car the ring .	the book kept your husband 's dentist 's father 's doctor 's sister 's sister 's car the ring .
the shirt sent your son 's brother 's wife 's cousin 's husband 's husband 's crayon the ring .	the shirt cleaned your son 's brother 's wife 's cousin 's husband 's husband 's crayon the ring .
the hat bought my grandmother 's wife 's boss 's mother 's dad 's grandmother 's box the glass .	the hat dropped my grandmother 's wife 's boss 's mother 's dad 's grandmother 's box the glass .
the rug showed your mom 's sister 's son 's son 's boss 's son 's glass the toy .	the rug lost your mom 's sister 's son 's son 's boss 's son 's glass the toy .
the ship bought my brother 's father 's brother 's daughter 's teacher 's sister 's box the button .	the ship shook my brother 's father 's brother 's daughter 's teacher 's sister 's box the button .
the toy sent your husband 's son 's teacher 's wife 's friend 's brother 's shoe the door .	the toy held your husband 's son 's teacher 's wife 's friend 's brother 's shoe the door .
the shirt gave my son 's mom 's doctor 's teacher 's father 's wife 's fork the plate .	the shirt lost my son 's mom 's doctor 's teacher 's father 's wife 's fork the plate .
the bottle sent your friend 's doctor 's brother 's teacher 's grandmother 's daughter 's box the bed .	the bottle dropped your friend 's doctor 's brother 's teacher 's grandmother 's daughter 's box the bed .
the button bought your mother 's grandmother 's brother 's father 's wife 's grandmother 's box the hat .	the button moved your mother 's grandmother 's brother 's father 's wife 's grandmother 's box the hat .
the car bought my mom 's dentist 's cousin 's father 's wife 's son 's bowl the bicycle .	the car kept my mom 's dentist 's cousin 's father 's wife 's son 's bowl the bicycle .
the doll showed my mom 's mother 's grandmother 's wife 's father 's mom 's rug the ship .	the doll kept my mom 's mother 's grandmother 's wife 's father 's mom 's rug the ship .
the ring gave your dentist 's cousin 's doctor 's sister 's sister 's teacher 's crayon the plane .	the ring shook your dentist 's cousin 's doctor 's sister 's sister 's teacher 's crayon the plane .
the toy sent my dad 's doctor 's husband 's sister 's son 's teacher 's bed the chair .	the toy kept my dad 's doctor 's husband 's sister 's son 's teacher 's bed the chair .
the doll bought my son 's daughter 's mother 's sister 's dad 's mother 's hat the ship .	the doll lost my son 's daughter 's mother 's sister 's dad 's mother 's hat the ship .
the mirror bought your dad 's dentist 's dad 's son 's dentist 's sister 's truck the shirt .	the mirror held your dad 's dentist 's dad 's son 's dentist 's sister 's truck the shirt .
the plane sent my teacher 's daughter 's grandmother 's friend 's sister 's father 's bottle the fork .	the plane dropped my teacher 's daughter 's grandmother 's friend 's sister 's father 's bottle the fork .
the candle bought my mom 's wife 's doctor 's husband 's sister 's boss 's book the ship .	the candle moved my mom 's wife 's doctor 's husband 's sister 's boss 's book the ship .
the chair bought your mother 's boss 's dad 's friend 's dad 's daughter 's mirror the bicycle .	the chair lost your mother 's boss 's dad 's friend 's dad 's daughter 's mirror the bicycle .
the glass sent my dentist 's mother 's teacher 's grandmother 's teacher 's husband 's shoe the bowl .	the glass kept my dentist 's mother 's teacher 's grandmother 's teacher 's husband 's shoe the bowl .
the couch showed your mother 's boss 's husband 's brother 's son 's son 's boat the fork .	the couch dropped your mother 's boss 's husband 's brother 's son 's son 's boat the fork .
the shirt sent your wife 's boss 's brother 's cousin 's sister 's mom 's crayon the hat .	the shirt kept your wife 's boss 's brother 's cousin 's sister 's mom 's crayon the hat .
the car gave your friend 's wife 's father 's son 's dad 's cousin 's ring the book .	the car cleaned your friend 's wife 's father 's son 's dad 's cousin 's ring the book .
the button gave my boss 's friend 's son 's teacher 's doctor 's husband 's mirror the spoon .	the button lost my boss 's friend 's son 's teacher 's doctor 's husband 's mirror the spoon .
the ship bought my cousin 's father 's teacher 's sister 's dad 's husband 's hat the rug .	the ship lost my cousin 's father 's teacher 's sister 's dad 's husband 's hat the rug .
the ship gave your wife 's mom 's dad 's sister 's wife 's friend 's rocket the cup .	the ship cleaned your wife 's mom 's dad 's sister 's wife 's friend 's rocket the cup .
the mirror bought my teacher 's brother 's mother 's teacher 's brother 's friend 's couch the glass .	the mirror held my teacher 's brother 's mother 's teacher 's brother 's friend 's couch the glass .
the rug bought my mother 's son 's daughter 's daughter 's brother 's daughter 's picture the crayon .	the rug cleaned my mother 's son 's daughter 's daughter 's brother 's daughter 's picture the crayon .
the glass sent my father 's sister 's sister 's son 's wife 's teacher 's book the toy .	the glass moved my father 's sister 's sister 's son 's wife 's teacher 's book the toy .
the crayon bought your brother 's cousin 's mother 's grandmother 's husband 's wife 's chair the toy .	the crayon lost your brother 's cousin 's mother 's grandmother 's husband 's wife 's chair the toy .
the mirror showed my dentist 's mom 's brother 's son 's daughter 's father 's button the boat .	the mirror moved my dentist 's mom 's brother 's son 's daughter 's father 's button the boat .
the bowl sent your father 's doctor 's husband 's husband 's dad 's wife 's ship the car .	the bowl kept your father 's doctor 's husband 's husband 's dad 's wife 's ship the car .
the bottle gave my mom 's dad 's friend 's dentist 's wife 's dentist 's shoe the chair .	the bottle held my mom 's dad 's friend 's dentist 's wife 's dentist 's shoe the chair .
the couch bought your mother 's wife 's doctor 's teacher 's teacher 's cousin 's box the book .	the couch held your mother 's wife 's doctor 's teacher 's teacher 's cousin 's box the book .
the book gave my wife 's dentist 's father 's brother 's cousin 's boss 's car the ship .	the book dropped my wife 's dentist 's father 's brother 's cousin 's boss 's car the ship .
the cup showed my brother 's boss 's son 's son 's father 's doctor 's book the window .	the cup lost my brother 's boss 's son 's son 's father 's doctor 's book the window .
the shirt showed my brother 's wife 's wife 's cousin 's friend 's son 's book the candle .	the shirt kept my brother 's wife 's wife 's cousin 's friend 's son 's book the candle .
the picture showed your friend 's doctor 's father 's son 's boss 's sister 's box the bicycle .	the picture moved your friend 's doctor 's father 's son 's boss 's sister 's box the bicycle .
the crayon bought my daughter 's boss 's sister 's wife 's father 's daughter 's crayon the couch .	the crayon held my daughter 's boss 's sister 's wife 's father 's daughter 's crayon the couch .
the couch showed your friend 's grandmother 's mother 's father 's boss 's dad 's boat the book .	the couch held your friend 's grandmother 's mother 's father 's boss 's dad 's boat the book .
the chair showed my brother 's grandmother 's sister 's dentist 's brother 's cousin 's cup the window .	the chair moved my brother 's grandmother 's sister 's dentist 's brother 's cousin 's cup the window .
the box showed my daughter 's father 's brother 's husband 's sister 's boss 's book the button .	the box dropped my daughter 's father 's brother 's husband 's sister 's boss 's book the button .
the rug showed your cousin 's daughter 's teacher 's dad 's wife 's wife 's bottle the spoon .	the rug cleaned your cousin 's daughter 's teacher 's dad 's wife 's wife 's bottle the spoon .
the bag bought your doctor 's boss 's teacher 's mother 's mom 's friend 's shirt the dish .	the bag shook your doctor 's boss 's teacher 's mother 's mom 's friend 's shirt the dish .
the toy sent your cousin 's friend 's sister 's daughter 's teacher 's brother 's rug the toy .	the toy dropped your cousin 's friend 's sister 's daughter 's teacher 's brother 's rug the toy .
the ring bought my sister 's dad 's cousin 's daughter 's dentist 's brother 's ring the bottle .	the ring lost my sister 's dad 's cousin 's daughter 's dentist 's brother 's ring the bottle .
the fork sent your daughter 's son 's dad 's grandmother 's friend 's grandmother 's spoon the door .	the fork cleaned your daughter 's son 's dad 's grandmother 's friend 's grandmother 's spoon the door .
the bag showed my brother 's grandmother 's father 's boss 's dentist 's daughter 's bottle the car .	the bag lost my brother 's grandmother 's father 's boss 's dentist 's daughter 's bottle the car .
the cup sent your daughter 's cousin 's sister 's friend 's cousin 's son 's truck the dish .	the cup held your daughter 's cousin 's sister 's friend 's cousin 's son 's truck the dish .
the button sent my mother 's mother 's dad 's friend 's boss 's doctor 's box the plate .	the button held my mother 's mother 's dad 's friend 's boss 's doctor 's box the plate .
the boat bought my teacher 's brother 's sister 's doctor 's husband 's brother 's doll the box .	the boat lost my teacher 's brother 's sister 's doctor 's husband 's brother 's doll the box .
the fork bought your husband 's boss 's teacher 's son 's son 's mom 's car the picture .	the fork held your husband 's boss 's teacher 's son 's son 's mom 's car the picture .
the window showed my dad 's husband 's grandmother 's husband 's mother 's wife 's crayon the chair .	the window dropped my dad 's husband 's grandmother 's husband 's mother 's wife 's crayon the chair .
the cup bought your grandmother 's sister 's son 's husband 's son 's brother 's door the glass .	the cup lost your grandmother 's sister 's son 's husband 's son 's brother 's door the glass .
the bed showed your dentist 's cousin 's sister 's grandmother 's father 's dad 's crayon the book .	the bed moved your dentist 's cousin 's sister 's grandmother 's father 's dad 's crayon the book .
the car showed your dad 's daughter 's mother 's sister 's teacher 's dad 's bowl the car .	the car dropped your dad 's daughter 's mother 's sister 's teacher 's dad 's bowl the car .
the toy sent my sister 's doctor 's doctor 's husband 's wife 's friend 's shoe the plane .	the toy cleaned my sister 's doctor 's doctor 's husband 's wife 's friend 's shoe the plane .
the plate bought my dad 's brother 's dad 's boss 's father 's husband 's picture the car .	the plate dropped my dad 's brother 's dad 's boss 's father 's husband 's picture the car .
the bicycle bought my wife 's friend 's friend 's doctor 's wife 's mom 's book the mirror .	the bicycle held my wife 's friend 's friend 's doctor 's wife 's mom 's book the mirror .
the rocket bought your dad 's cousin 's daughter 's husband 's husband 's sister 's hat the doll .	the rocket kept your dad 's cousin 's daughter 's husband 's husband 's sister 's hat the doll .
the box gave your son 's son 's wife 's husband 's dentist 's wife 's door the car .	the box held your son 's son 's wife 's husband 's dentist 's wife 's door the car .
the plane bought your dentist 's grandmother 's mom 's daughter 's boss 's father 's rocket the window .	the plane lost your dentist 's grandmother 's mom 's daughter 's boss 's father 's rocket the window .
the crayon gave your dad 's dad 's dad 's cousin 's daughter 's dentist 's plate the fork .	the crayon kept your dad 's dad 's dad 's cousin 's daughter 's dentist 's plate the fork .
the door gave your dentist 's boss 's doctor 's mother 's boss 's cousin 's chair the ring .	the door dropped your dentist 's boss 's doctor 's mother 's boss 's cousin 's chair the ring .
the hat sent my cousin 's mom 's wife 's daughter 's mother 's brother 's car the dish .	the hat lost my cousin 's mom 's wife 's daughter 's mother 's brother 's car the dish .
the book gave my wife 's grandmother 's husband 's sister 's daughter 's son 's rug the mirror .	the book held my wife 's grandmother 's husband 's sister 's daughter 's son 's rug the mirror .
the book bought my mother 's friend 's wife 's mom 's dad 's sister 's hat the spoon .	the book moved my mother 's friend 's wife 's mom 's dad 's sister 's hat the spoon .
the ring showed your husband 's father 's dentist 's grandmother 's mother 's dad 's cup the picture .	the ring cleaned your husband 's father 's dentist 's grandmother 's mother 's dad 's cup the picture .
the book showed my doctor 's dad 's boss 's sister 's brother 's teacher 's doll the box .	the book dropped my doctor 's dad 's boss 's sister 's brother 's teacher 's doll the box .
the box sent my father 's grandmother 's sister 's friend 's brother 's father 's car the candle .	the box dropped my father 's grandmother 's sister 's friend 's brother 's father 's car the candle .
the plate showed your grandmother 's boss 's wife 's boss 's dentist 's friend 's door the crayon .	the plate dropped your grandmother 's boss 's wife 's boss 's dentist 's friend 's door the crayon .
the cup sent your son 's grandmother 's teacher 's cousin 's daughter 's brother 's button the button .	the cup lost your son 's grandmother 's teacher 's cousin 's daughter 's brother 's button the button .
the shoe sent my cousin 's doctor 's doctor 's brother 's doctor 's mother 's bowl the chair .	the shoe held my cousin 's doctor 's doctor 's brother 's doctor 's mother 's bowl the chair .
the ring showed my father 's brother 's son 's cousin 's friend 's mom 's crayon the car .	the ring dropped my father 's brother 's son 's cousin 's friend 's mom 's crayon the car .
the car sent your mother 's daughter 's wife 's friend 's husband 's father 's toy the spoon .	the car kept your mother 's daughter 's wife 's friend 's husband 's father 's toy the spoon .
the glass showed my wife 's dad 's son 's husband 's boss 's sister 's bag the plane .	the glass dropped my wife 's dad 's son 's husband 's boss 's sister 's bag the plane .
the button bought your son 's cousin 's boss 's brother 's father 's cousin 's cup the glass .	the button kept your son 's cousin 's boss 's brother 's father 's cousin 's cup the glass .
the toy bought my husband 's mother 's mom 's brother 's dentist 's boss 's button the car .	the toy cleaned my husband 's mother 's mom 's brother 's dentist 's boss 's button the car .
the mirror gave my daughter 's boss 's father 's dad 's grandmother 's brother 's cup the dish .	the mirror lost my daughter 's boss 's father 's dad 's grandmother 's brother 's cup the dish .
the shoe showed your doctor 's brother 's grandmother 's daughter 's daughter 's teacher 's rocket the shirt .	the shoe lost your doctor 's brother 's grandmother 's daughter 's daughter 's teacher 's rocket the shirt .
the plane bought your teacher 's sister 's dad 's mom 's dad 's dentist 's door the dish .	the plane dropped your teacher 's sister 's dad 's mom 's dad 's dentist 's door the dish .
the car bought my brother 's doctor 's grandmother 's cousin 's friend 's son 's button the bicycle .	the car kept my brother 's doctor 's grandmother 's cousin 's friend 's son 's button the bicycle .
the hat sent your mother 's sister 's teacher 's daughter 's friend 's teacher 's car the fork .	the hat dropped your mother 's sister 's teacher 's daughter 's friend 's teacher 's car the fork .
the candle gave my mom 's daughter 's cousin 's teacher 's grandmother 's mother 's dish the bag .	the candle moved my mom 's daughter 's cousin 's teacher 's grandmother 's mother 's dish the bag .
the ship sent your boss 's wife 's dentist 's cousin 's cousin 's grandmother 's window the box .	the ship kept your boss 's wife 's dentist 's cousin 's cousin 's grandmother 's window the box .
the mirror sent your grandmother 's grandmother 's brother 's son 's grandmother 's daughter 's cup the fork .	the mirror dropped your grandmother 's grandmother 's brother 's son 's grandmother 's daughter 's cup the fork .
the window bought my mother 's wife 's boss 's husband 's brother 's boss 's couch the car .	the window moved my mother 's wife 's boss 's husband 's brother 's boss 's couch the car .
the fork bought your cousin 's daughter 's mom 's sister 's daughter 's son 's bicycle the door .	the fork dropped your cousin 's daughter 's mom 's sister 's daughter 's son 's bicycle the door .
the bed showed your son 's dad 's dentist 's dentist 's mom 's wife 's bottle the glass .	the bed held your son 's dad 's dentist 's dentist 's mom 's wife 's bottle the glass .
the car sent your wife 's grandmother 's doctor 's sister 's brother 's sister 's spoon the bed .	the car shook your wife 's grandmother 's doctor 's sister 's brother 's sister 's spoon the bed .
the plate showed your mother 's cousin 's dentist 's sister 's wife 's mom 's door the doll .	the plate shook your mother 's cousin 's dentist 's sister 's wife 's mom 's door the doll .
the glass sent my boss 's dentist 's grandmother 's dentist 's boss 's father 's bag the toy .	the glass shook my boss 's dentist 's grandmother 's dentist 's boss 's father 's bag the toy .
the bed gave my daughter 's dad 's husband 's dad 's father 's wife 's door the truck .	the bed cleaned my daughter 's dad 's husband 's dad 's father 's wife 's door the truck .
the plane bought your cousin 's son 's friend 's son 's son 's grandmother 's chair the spoon .	the plane held your cousin 's son 's friend 's son 's son 's grandmother 's chair the spoon .
the shoe bought my doctor 's boss 's teacher 's wife 's dad 's son 's ring the box .	the shoe shook my doctor 's boss 's teacher 's wife 's dad 's son 's ring the box .
the car gave your teacher 's brother 's dad 's son 's friend 's grandmother 's ship the truck .	the car kept your teacher 's brother 's dad 's son 's friend 's grandmother 's ship the truck .
the rocket showed your brother 's teacher 's mom 's sister 's friend 's mother 's ship the bed .	the rocket lost your brother 's teacher 's mom 's sister 's friend 's mother 's ship the bed .
the bicycle gave your daughter 's grandmother 's friend 's mother 's teacher 's doctor 's book the bag .	the bicycle moved your daughter 's grandmother 's friend 's mother 's teacher 's doctor 's book the bag .
the door bought my brother 's friend 's mother 's brother 's friend 's son 's book the car .	the door kept my brother 's friend 's mother 's brother 's friend 's son 's book the car .
the boat sent my daughter 's wife 's doctor 's grandmother 's sister 's sister 's bed the car .	the boat held my daughter 's wife 's doctor 's grandmother 's sister 's sister 's bed the car .
the book bought my brother 's mother 's teacher 's friend 's grandmother 's grandmother 's fork the door .	the book held my brother 's mother 's teacher 's friend 's grandmother 's grandmother 's fork the door .
the toy gave my dentist 's dad 's daughter 's boss 's teacher 's dad 's car the shoe .	the toy lost my dentist 's dad 's daughter 's boss 's teacher 's dad 's car the shoe .
the box showed my cousin 's doctor 's dad 's cousin 's friend 's dad 's candle the truck .	the box kept my cousin 's doctor 's dad 's cousin 's friend 's dad 's candle the truck .
the toy gave my husband 's doctor 's husband 's father 's husband 's mother 's bowl the bottle .	the toy moved my husband 's doctor 's husband 's father 's husband 's mother 's bowl the bottle .
the box sent my brother 's friend 's husband 's wife 's friend 's cousin 's plane the book .	the box cleaned my brother 's friend 's husband 's wife 's friend 's cousin 's plane the book .
the couch showed your husband 's doctor 's wife 's father 's cousin 's daughter 's shoe the button .	the couch cleaned your husband 's doctor 's wife 's father 's cousin 's daughter 's shoe the button .
the rocket gave your dentist 's son 's mom 's doctor 's teacher 's mother 's book the bowl .	the rocket moved your dentist 's son 's mom 's doctor 's teacher 's mother 's book the bowl .
the window showed your mother 's dad 's daughter 's grandmother 's grandmother 's daughter 's book the shirt .	the window held your mother 's dad 's daughter 's grandmother 's grandmother 's daughter 's book the shirt .
the cup bought my wife 's mom 's cousin 's husband 's wife 's boss 's window the bed .	the cup held my wife 's mom 's cousin 's husband 's wife 's boss 's window the bed .
the picture bought my mother 's husband 's brother 's mom 's boss 's grandmother 's spoon the chair .	the picture cleaned my mother 's husband 's brother 's mom 's boss 's grandmother 's spoon the chair .
the chair bought my daughter 's brother 's cousin 's brother 's dentist 's friend 's car the plate .	the chair dropped my daughter 's brother 's cousin 's brother 's dentist 's friend 's car the plate .
the rug gave your husband 's mother 's mother 's daughter 's dentist 's mom 's plate the toy .	the rug lost your husband 's mother 's mother 's daughter 's dentist 's mom 's plate the toy .
the bicycle bought your son 's sister 's boss 's father 's doctor 's cousin 's shirt the bed .	the bicycle moved your son 's sister 's boss 's father 's doctor 's cousin 's shirt the bed .
the bicycle showed my teacher 's doctor 's boss 's dentist 's brother 's cousin 's ring the fork .	the bicycle dropped my teacher 's doctor 's boss 's dentist 's brother 's cousin 's ring the fork .
the hat showed your friend 's brother 's doctor 's daughter 's wife 's grandmother 's couch the plane .	the hat dropped your friend 's brother 's doctor 's daughter 's wife 's grandmother 's couch the plane .
the doll bought your daughter 's father 's mom 's daughter 's father 's sister 's car the rocket .	the doll shook your daughter 's father 's mom 's daughter 's father 's sister 's car the rocket .
the dish showed my friend 's husband 's doctor 's dentist 's grandmother 's father 's car the door .	the dish moved my friend 's husband 's doctor 's dentist 's grandmother 's father 's car the door .
