the spoon says that your friend 's dad 's daughter 's fork is sleepy .	the spoon works with your friend 's dad 's daughter 's fork is sleepy .
the hat knows that your teacher 's husband 's daughter 's chair is helpful .	the hat talks to your teacher 's husband 's daughter 's chair is helpful .
the picture knows that your husband 's brother 's doctor 's plate is happy .	the picture talks to your husband 's brother 's doctor 's plate is happy .
the cup says that your teacher 's father 's dad 's ship is excited .	the cup works with your teacher 's father 's dad 's ship is excited .
the ship thinks that your teacher 's dentist 's doctor 's cup is friendly .	the ship works with your teacher 's dentist 's doctor 's cup is friendly .
the plane thinks that my brother 's dad 's teacher 's window is helpful .	the plane scares my brother 's dad 's teacher 's window is helpful .
the crayon knows that your dad 's cousin 's mom 's hat is boring .	the crayon talks to your dad 's cousin 's mom 's hat is boring .
the fork says that your boss 's boss 's boss 's book is curious .	the fork works with your boss 's boss 's boss 's book is curious .
the button says that your dad 's brother 's sister 's dish is hungry .	the button works with your dad 's brother 's sister 's dish is hungry .
the boat says that my friend 's doctor 's mother 's book is helpful .	the boat helps my friend 's doctor 's mother 's book is helpful .
the bag says that my sister 's boss 's boss 's plate is bored .	the bag helps my sister 's boss 's boss 's plate is bored .
the car says that my husband 's sister 's mother 's car is sleepy .	the car works with my husband 's sister 's mother 's car is sleepy .
the bag thinks that my mom 's father 's boss 's window is careful .	the bag talks to my mom 's father 's boss 's window is careful .
the glass thinks that your boss 's dad 's son 's truck is clever .	the glass talks to your boss 's dad 's son 's truck is clever .
the car thinks that my teacher 's brother 's boss 's spoon is smart .	the car helps my teacher 's brother 's boss 's spoon is smart .
the cup knows that your mom 's daughter 's father 's bottle is surprised .	the cup helps your mom 's daughter 's father 's bottle is surprised .
the bed knows that your daughter 's son 's wife 's toy is clever .	the bed works with your daughter 's son 's wife 's toy is clever .
the glass thinks that my sister 's cousin 's grandmother 's picture is happy .	the glass talks to my sister 's cousin 's grandmother 's picture is happy .
the bottle says that your doctor 's daughter 's dentist 's shirt is important .	the bottle works with your doctor 's daughter 's dentist 's shirt is important .
the crayon thinks that my dad 's sister 's teacher 's spoon is busy .	the crayon helps my dad 's sister 's teacher 's spoon is busy .
the picture knows that your sister 's teacher 's boss 's bed is tired .	the picture scares your sister 's teacher 's boss 's bed is tired .
the window knows that my grandmother 's teacher 's sister 's truck is curious .	the window works with my grandmother 's teacher 's sister 's truck is curious .
the plane knows that your son 's doctor 's mom 's bicycle is smart .	the plane scares your son 's doctor 's mom 's bicycle is smart .
the glass says that your husband 's boss 's mom 's plane is important .	the glass scares your husband 's boss 's mom 's plane is important .
the plate knows that your husband 's wife 's son 's bed is tall .	the plate works with your husband 's wife 's son 's bed is tall .
the picture says that my wife 's sister 's friend 's doll is important .	the picture scares my wife 's sister 's friend 's doll is important .
the shirt thinks that my doctor 's sister 's teacher 's ring is bored .	the shirt scares my doctor 's sister 's teacher 's ring is bored .
the button says that my wife 's boss 's mother 's shirt is lucky .	the button helps my wife 's boss 's mother 's shirt is lucky .
the plate knows that your brother 's sister 's teacher 's toy is angry .	the plate helps your brother 's sister 's teacher 's toy is angry .
the book says that your wife 's mother 's daughter 's hat is helpful .	the book works with your wife 's mother 's daughter 's hat is helpful .
the button thinks that my husband 's wife 's mother 's couch is sleepy .	the button scares my husband 's wife 's mother 's couch is sleepy .
the hat thinks that my teacher 's doctor 's doctor 's car is lucky .	the hat works with my teacher 's doctor 's doctor 's car is lucky .
the couch says that my dentist 's boss 's dentist 's ring is curious .	the couch helps my dentist 's boss 's dentist 's ring is curious .
the bottle thinks that your grandmother 's wife 's father 's spoon is upset .	the bottle scares your grandmother 's wife 's father 's spoon is upset .
the picture thinks that your teacher 's sister 's son 's truck is tired .	the picture helps your teacher 's sister 's son 's truck is tired .
the cup says that my son 's daughter 's son 's bottle is gentle .	the cup talks to my son 's daughter 's son 's bottle is gentle .
the box says that your father 's boss 's mom 's shoe is tall .	the box scares your father 's boss 's mom 's shoe is tall .
the ship thinks that your husband 's brother 's grandmother 's rocket is busy .	the ship helps your husband 's brother 's grandmother 's rocket is busy .
the ring thinks that my sister 's teacher 's husband 's cup is curious .	the ring talks to my sister 's teacher 's husband 's cup is curious .
the ship thinks that my sister 's dentist 's grandmother 's book is strong .	the ship helps my sister 's dentist 's grandmother 's book is strong .
the fork knows that your son 's friend 's mom 's spoon is kind .	the fork helps your son 's friend 's mom 's spoon is kind .
the box thinks that your boss 's brother 's son 's shoe is healthy .	the box scares your boss 's brother 's son 's shoe is healthy .
the ship knows that your father 's doctor 's boss 's shoe is angry .	the ship talks to your father 's doctor 's boss 's shoe is angry .
the plane says that my boss 's mom 's grandmother 's chair is confused .	the plane talks to my boss 's mom 's grandmother 's chair is confused .
the couch knows that my father 's husband 's doctor 's chair is busy .	the couch scares my father 's husband 's doctor 's chair is busy .
the crayon knows that your grandmother 's boss 's son 's candle is gentle .	the crayon helps your grandmother 's boss 's son 's candle is gentle .
the cup says that your mom 's brother 's daughter 's ring is young .	the cup works with your mom 's brother 's daughter 's ring is young .
the bed says that my brother 's daughter 's husband 's glass is gentle .	the bed helps my brother 's daughter 's husband 's glass is gentle .
the car says that my doctor 's sister 's husband 's box is tall .	the car talks to my doctor 's sister 's husband 's box is tall .
the car knows that my friend 's son 's doctor 's rug is curious .	the car works with my friend 's son 's doctor 's rug is curious .
the truck knows that my teacher 's dentist 's friend 's crayon is important .	the truck talks to my teacher 's dentist 's friend 's crayon is important .
the plane says that my mom 's brother 's brother 's window is quiet .	the plane helps my mom 's brother 's brother 's window is quiet .
the doll thinks that your wife 's sister 's grandmother 's bowl is helpful .	the doll helps your wife 's sister 's grandmother 's bowl is helpful .
the doll says that your father 's son 's dad 's plate is hungry .	the doll works with your father 's son 's dad 's plate is hungry .
the door thinks that my dad 's daughter 's doctor 's window is smart .	the door scares my dad 's daughter 's doctor 's window is smart .
the toy knows that your dentist 's brother 's brother 's door is sleepy .	the toy works with your dentist 's brother 's brother 's door is sleepy .
the button knows that my doctor 's husband 's brother 's mirror is smart .	the button scares my doctor 's husband 's brother 's mirror is smart .
the box says that my mother 's mom 's cousin 's plate is kind .	the box helps my mother 's mom 's cousin 's plate is kind .
the button knows that my husband 's brother 's husband 's chair is tired .	the button scares my husband 's brother 's husband 's chair is tired .
the rocket thinks that your cousin 's sister 's sister 's dish is tired .	the rocket scares your cousin 's sister 's sister 's dish is tired .
the book thinks that your dentist 's grandmother 's mom 's bottle is surprised .	the book works with your dentist 's grandmother 's mom 's bottle is surprised .
the bowl knows that your mother 's teacher 's dad 's bag is nice .	the bowl helps your mother 's teacher 's dad 's bag is nice .
the glass thinks that your wife 's dentist 's friend 's bicycle is lucky .	the glass works with your wife 's dentist 's friend 's bicycle is lucky .
the chair thinks that my mother 's dad 's friend 's candle is excited .	the chair scares my mother 's dad 's friend 's candle is excited .
the ring thinks that my grandmother 's dentist 's grandmother 's bicycle is tall .	the ring scares my grandmother 's dentist 's grandmother 's bicycle is tall .
the cup says that my friend 's husband 's mother 's mirror is boring .	the cup helps my friend 's husband 's mother 's mirror is boring .
the shirt knows that my boss 's mother 's doctor 's mirror is important .	the shirt scares my boss 's mother 's doctor 's mirror is important .
the bicycle says that my friend 's doctor 's grandmother 's book is bored .	the bicycle helps my friend 's doctor 's grandmother 's book is bored .
the bicycle thinks that your doctor 's wife 's wife 's fork is helpful .	the bicycle works with your doctor 's wife 's wife 's fork is helpful .
the rug knows that your mom 's brother 's husband 's bag is gentle .	the rug talks to your mom 's brother 's husband 's bag is gentle .
the crayon knows that my doctor 's dentist 's brother 's hat is clever .	the crayon talks to my doctor 's dentist 's brother 's hat is clever .
the book says that your son 's friend 's grandmother 's fork is important .	the book scares your son 's friend 's grandmother 's fork is important .
the spoon says that your dentist 's father 's daughter 's window is healthy .	the spoon scares your dentist 's father 's daughter 's window is healthy .
the mirror knows that your boss 's daughter 's husband 's window is wrong .	the mirror helps your boss 's daughter 's husband 's window is wrong .
the bowl knows that your dad 's grandmother 's grandmother 's bag is gentle .	the bowl works with your dad 's grandmother 's grandmother 's bag is gentle .
the hat knows that your friend 's daughter 's son 's ring is lucky .	the hat talks to your friend 's daughter 's son 's ring is lucky .
the glass thinks that my brother 's mother 's daughter 's book is curious .	the glass talks to my brother 's mother 's daughter 's book is curious .
the ring thinks that my daughter 's mom 's doctor 's plane is sleepy .	the ring helps my daughter 's mom 's doctor 's plane is sleepy .
the truck thinks that your dad 's husband 's dad 's bag is busy .	the truck talks to your dad 's husband 's dad 's bag is busy .
the ship says that my wife 's mother 's cousin 's candle is happy .	the ship helps my wife 's mother 's cousin 's candle is happy .
the box says that your wife 's father 's mom 's button is quiet .	the box talks to your wife 's father 's mom 's button is quiet .
the door knows that your sister 's boss 's teacher 's box is careful .	the door works with your sister 's boss 's teacher 's box is careful .
the rocket thinks that your cousin 's boss 's son 's book is strong .	the rocket scares your cousin 's boss 's son 's book is strong .
the glass knows that your brother 's brother 's wife 's bowl is boring .	the glass helps your brother 's brother 's wife 's bowl is boring .
the rocket knows that my dad 's brother 's teacher 's couch is curious .	the rocket helps my dad 's brother 's teacher 's couch is curious .
the book thinks that your sister 's teacher 's husband 's fork is important .	the book scares your sister 's teacher 's husband 's fork is important .
the rug says that your wife 's brother 's wife 's book is quiet .	the rug works with your wife 's brother 's wife 's book is quiet .
the truck says that your husband 's dad 's mother 's hat is angry .	the truck talks to your husband 's dad 's mother 's hat is angry .
the window knows that your mom 's doctor 's mother 's door is sleepy .	the window talks to your mom 's doctor 's mother 's door is sleepy .
the plane knows that your friend 's grandmother 's son 's button is busy .	the plane scares your friend 's grandmother 's son 's button is busy .
the rocket thinks that my boss 's boss 's wife 's door is friendly .	the rocket scares my boss 's boss 's wife 's door is friendly .
the shirt knows that my teacher 's doctor 's boss 's book is wrong .	the shirt helps my teacher 's doctor 's boss 's book is wrong .
the button knows that your father 's dad 's husband 's ring is excited .	the button works with your father 's dad 's husband 's ring is excited .
the ring says that your mother 's husband 's friend 's crayon is careful .	the ring talks to your mother 's husband 's friend 's crayon is careful .
the dish says that my teacher 's brother 's friend 's chair is quiet .	the dish helps my teacher 's brother 's friend 's chair is quiet .
the spoon says that your friend 's cousin 's doctor 's couch is curious .	the spoon helps your friend 's cousin 's doctor 's couch is curious .
the dish thinks that your wife 's cousin 's mom 's window is wrong .	the dish helps your wife 's cousin 's mom 's window is wrong .
the plane says that your daughter 's daughter 's daughter 's rocket is angry .	the plane talks to your daughter 's daughter 's daughter 's rocket is angry .
the window says that my friend 's teacher 's mother 's spoon is friendly .	the window helps my friend 's teacher 's mother 's spoon is friendly .
the plate knows that my boss 's father 's teacher 's couch is kind .	the plate helps my boss 's father 's teacher 's couch is kind .
the rocket says that my cousin 's brother 's dad 's truck is happy .	the rocket works with my cousin 's brother 's dad 's truck is happy .
the spoon thinks that my teacher 's wife 's boss 's car is hungry .	the spoon scares my teacher 's wife 's boss 's car is hungry .
the door knows that your doctor 's dentist 's boss 's dish is tall .	the door works with your doctor 's dentist 's boss 's dish is tall .
the rug knows that my doctor 's boss 's dentist 's fork is important .	the rug talks to my doctor 's boss 's dentist 's fork is important .
the rocket knows that my daughter 's mom 's doctor 's glass is quiet .	the rocket works with my daughter 's mom 's doctor 's glass is quiet .
the door thinks that your brother 's doctor 's sister 's ring is important .	the door works with your brother 's doctor 's sister 's ring is important .
the doll knows that my sister 's wife 's mom 's car is curious .	the doll works with my sister 's wife 's mom 's car is curious .
the doll says that my dad 's boss 's mother 's dish is sleepy .	the doll helps my dad 's boss 's mother 's dish is sleepy .
the bowl says that my mother 's son 's father 's box is sleepy .	the bowl helps my mother 's son 's father 's box is sleepy .
the book says that your boss 's husband 's teacher 's truck is smart .	the book works with your boss 's husband 's teacher 's truck is smart .
the button knows that your boss 's wife 's mother 's bag is important .	the button works with your boss 's wife 's mother 's bag is important .
the bowl knows that your cousin 's grandmother 's grandmother 's window is nice .	the bowl works with your cousin 's grandmother 's grandmother 's window is nice .
the window knows that your husband 's daughter 's cousin 's fork is upset .	the window works with your husband 's daughter 's cousin 's fork is upset .
the car thinks that your son 's mom 's daughter 's candle is friendly .	the car scares your son 's mom 's daughter 's candle is friendly .
the bag thinks that your wife 's daughter 's father 's chair is happy .	the bag helps your wife 's daughter 's father 's chair is happy .
the door thinks that my doctor 's sister 's boss 's button is kind .	the door scares my doctor 's sister 's boss 's button is kind .
the mirror says that my sister 's cousin 's son 's bowl is kind .	the mirror works with my sister 's cousin 's son 's bowl is kind .
the car knows that your wife 's dad 's son 's fork is confused .	the car works with your wife 's dad 's son 's fork is confused .
the bag thinks that your son 's mother 's sister 's window is happy .	the bag scares your son 's mother 's sister 's window is happy .
the car knows that your son 's sister 's mother 's shoe is happy .	the car works with your son 's sister 's mother 's shoe is happy .
the mirror says that your doctor 's sister 's cousin 's door is surprised .	the mirror scares your doctor 's sister 's cousin 's door is surprised .
the car thinks that my brother 's friend 's teacher 's bottle is healthy .	the car works with my brother 's friend 's teacher 's bottle is healthy .
the cup says that your cousin 's husband 's mother 's book is healthy .	the cup helps your cousin 's husband 's mother 's book is healthy .
the bicycle knows that my cousin 's brother 's father 's hat is curious .	the bicycle works with my cousin 's brother 's father 's hat is curious .
the bicycle knows that your brother 's dad 's teacher 's bicycle is sleepy .	the bicycle helps your brother 's dad 's teacher 's bicycle is sleepy .
the ship says that your boss 's brother 's cousin 's rocket is sleepy .	the ship works with your boss 's brother 's cousin 's rocket is sleepy .
the bag says that your husband 's son 's grandmother 's window is clever .	the bag scares your husband 's son 's grandmother 's window is clever .
the ship knows that my dentist 's teacher 's daughter 's book is strong .	the ship helps my dentist 's teacher 's daughter 's book is strong .
the ring knows that your teacher 's dentist 's boss 's crayon is bored .	the ring helps your teacher 's dentist 's boss 's crayon is bored .
the book knows that your dad 's grandmother 's father 's shirt is angry .	the book works with your dad 's grandmother 's father 's shirt is angry .
the doll thinks that my mom 's mother 's daughter 's boat is quiet .	the doll scares my mom 's mother 's daughter 's boat is quiet .
the fork knows that my dentist 's cousin 's sister 's car is kind .	the fork scares my dentist 's cousin 's sister 's car is kind .
the door thinks that your friend 's mom 's husband 's bottle is sleepy .	the door talks to your friend 's mom 's husband 's bottle is sleepy .
the car thinks that your mother 's husband 's boss 's fork is gentle .	the car helps your mother 's husband 's boss 's fork is gentle .
the glass knows that your sister 's wife 's teacher 's button is nice .	the glass scares your sister 's wife 's teacher 's button is nice .
the bed thinks that my father 's daughter 's sister 's bag is smart .	the bed scares my father 's daughter 's sister 's bag is smart .
the couch knows that my father 's brother 's mom 's plate is helpful .	the couch talks to my father 's brother 's mom 's plate is helpful .
the ship thinks that your husband 's mother 's brother 's car is sleepy .	the ship scares your husband 's mother 's brother 's car is sleepy .
the door thinks that my father 's daughter 's friend 's fork is important .	the door talks to my father 's daughter 's friend 's fork is important .
the bowl thinks that your mom 's doctor 's wife 's ring is clever .	the bowl scares your mom 's doctor 's wife 's ring is clever .
the door says that your father 's husband 's friend 's doll is surprised .	the door scares your father 's husband 's friend 's doll is surprised .
the candle thinks that my daughter 's mom 's dad 's bag is healthy .	the candle works with my daughter 's mom 's dad 's bag is healthy .
the bottle says that your friend 's dad 's friend 's spoon is curious .	the bottle works with your friend 's dad 's friend 's spoon is curious .
the bowl knows that my dad 's mom 's grandmother 's toy is boring .	the bowl scares my dad 's mom 's grandmother 's toy is boring .
the doll knows that my dad 's mom 's boss 's fork is tired .	the doll scares my dad 's mom 's boss 's fork is tired .
the toy knows that my sister 's brother 's daughter 's ship is confused .	the toy helps my sister 's brother 's daughter 's ship is confused .
the hat thinks that your mom 's brother 's son 's truck is happy .	the hat works with your mom 's brother 's son 's truck is happy .
the picture knows that my father 's son 's husband 's window is surprised .	the picture works with my father 's son 's husband 's window is surprised .
the bag knows that my sister 's daughter 's dentist 's bed is hungry .	the bag scares my sister 's daughter 's dentist 's bed is hungry .
the car thinks that my teacher 's daughter 's doctor 's candle is curious .	the car helps my teacher 's daughter 's doctor 's candle is curious .
the hat knows that your daughter 's brother 's father 's book is happy .	the hat works with your daughter 's brother 's father 's book is happy .
the couch says that my doctor 's doctor 's dad 's rug is clever .	the couch works with my doctor 's doctor 's dad 's rug is clever .
the bag thinks that your dad 's mom 's mother 's door is quiet .	the bag helps your dad 's mom 's mother 's door is quiet .
the bottle thinks that your son 's doctor 's sister 's hat is healthy .	the bottle works with your son 's doctor 's sister 's hat is healthy .
the bowl knows that my husband 's husband 's sister 's hat is nice .	the bowl scares my husband 's husband 's sister 's hat is nice .
the candle thinks that your wife 's boss 's teacher 's bowl is friendly .	the candle scares your wife 's boss 's teacher 's bowl is friendly .
the window thinks that my husband 's friend 's cousin 's bottle is clever .	the window scares my husband 's friend 's cousin 's bottle is clever .
the window knows that your husband 's dad 's son 's plate is important .	the window talks to your husband 's dad 's son 's plate is important .
the cup thinks that your wife 's dentist 's doctor 's cup is tired .	the cup helps your wife 's dentist 's doctor 's cup is tired .
the window knows that your dentist 's father 's mom 's shoe is surprised .	the window works with your dentist 's father 's mom 's shoe is surprised .
the picture says that your husband 's cousin 's dentist 's toy is upset .	the picture works with your husband 's cousin 's dentist 's toy is upset .
the couch thinks that my mom 's son 's cousin 's car is nice .	the couch works with my mom 's son 's cousin 's car is nice .
the ship says that your brother 's cousin 's mother 's door is confused .	the ship helps your brother 's cousin 's mother 's door is confused .
the box knows that your teacher 's son 's mom 's couch is young .	the box helps your teacher 's son 's mom 's couch is young .
the spoon thinks that your son 's cousin 's mother 's book is quiet .	the spoon scares your son 's cousin 's mother 's book is quiet .
the picture thinks that your husband 's husband 's father 's rug is confused .	the picture talks to your husband 's husband 's father 's rug is confused .
the button says that my mother 's boss 's grandmother 's glass is angry .	the button talks to my mother 's boss 's grandmother 's glass is angry .
the crayon says that my husband 's friend 's dentist 's truck is kind .	the crayon helps my husband 's friend 's dentist 's truck is kind .
the spoon knows that your mom 's cousin 's dentist 's window is kind .	the spoon scares your mom 's cousin 's dentist 's window is kind .
the rug says that your friend 's doctor 's boss 's glass is helpful .	the rug talks to your friend 's doctor 's boss 's glass is helpful .
the bag says that your doctor 's mother 's son 's toy is young .	the bag scares your doctor 's mother 's son 's toy is young .
the bottle knows that your wife 's mother 's daughter 's boat is careful .	the bottle helps your wife 's mother 's daughter 's boat is careful .
the dish thinks that my mom 's brother 's doctor 's candle is careful .	the dish works with my mom 's brother 's doctor 's candle is careful .
the fork says that my doctor 's mom 's doctor 's door is tall .	the fork talks to my doctor 's mom 's doctor 's door is tall .
the dish knows that your mom 's sister 's teacher 's door is quiet .	the dish talks to your mom 's sister 's teacher 's door is quiet .
the bag knows that my son 's son 's father 's bag is sleepy .	the bag talks to my son 's son 's father 's bag is sleepy .
the car thinks that your son 's daughter 's cousin 's box is strong .	the car scares your son 's daughter 's cousin 's box is strong .
the plate says that your son 's grandmother 's dad 's car is boring .	the plate works with your son 's grandmother 's dad 's car is boring .
the bicycle thinks that my dad 's teacher 's sister 's car is strong .	the bicycle talks to my dad 's teacher 's sister 's car is strong .
the ship thinks that my dentist 's doctor 's sister 's cup is quiet .	the ship works with my dentist 's doctor 's sister 's cup is quiet .
the bed thinks that your husband 's mom 's mom 's book is surprised .	the bed works with your husband 's mom 's mom 's book is surprised .
the button says that your sister 's dad 's grandmother 's spoon is strong .	the button scares your sister 's dad 's grandmother 's spoon is strong .
the book knows that your husband 's dentist 's father 's window is busy .	the book helps your husband 's dentist 's father 's window is busy .
the shirt thinks that my dad 's mother 's boss 's candle is smart .	the shirt scares my dad 's mother 's boss 's candle is smart .
the bowl says that your father 's dentist 's father 's car is healthy .	the bowl talks to your father 's dentist 's father 's car is healthy .
the bag thinks that your grandmother 's wife 's teacher 's cup is confused .	the bag works with your grandmother 's wife 's teacher 's cup is confused .
the fork thinks that my daughter 's cousin 's mother 's box is curious .	the fork talks to my daughter 's cousin 's mother 's box is curious .
the boat knows that your son 's daughter 's mom 's button is angry .	the boat scares your son 's daughter 's mom 's button is angry .
the box knows that your boss 's brother 's teacher 's book is quiet .	the box helps your boss 's brother 's teacher 's book is quiet .
the bed says that your sister 's son 's teacher 's shirt is confused .	the bed scares your sister 's son 's teacher 's shirt is confused .
the ship knows that my brother 's dad 's friend 's crayon is busy .	the ship talks to my brother 's dad 's friend 's crayon is busy .
the crayon says that my friend 's cousin 's boss 's toy is confused .	the crayon helps my friend 's cousin 's boss 's toy is confused .
the bowl says that my daughter 's mother 's brother 's car is careful .	the bowl talks to my daughter 's mother 's brother 's car is careful .
the book thinks that my dad 's daughter 's teacher 's glass is lucky .	the book talks to my dad 's daughter 's teacher 's glass is lucky .
the bicycle thinks that my teacher 's wife 's friend 's hat is wrong .	the bicycle helps my teacher 's wife 's friend 's hat is wrong .
the mirror knows that my grandmother 's wife 's mother 's shoe is tired .	the mirror talks to my grandmother 's wife 's mother 's shoe is tired .
the toy thinks that your mom 's husband 's daughter 's rug is wrong .	the toy talks to your mom 's husband 's daughter 's rug is wrong .
the window thinks that my husband 's son 's mom 's boat is tall .	the window helps my husband 's son 's mom 's boat is tall .
the glass thinks that my cousin 's dad 's cousin 's candle is hungry .	the glass talks to my cousin 's dad 's cousin 's candle is hungry .
the truck says that your boss 's boss 's mother 's rocket is tall .	the truck scares your boss 's boss 's mother 's rocket is tall .
the boat thinks that my dad 's brother 's doctor 's truck is upset .	the boat scares my dad 's brother 's doctor 's truck is upset .
the fork thinks that my sister 's father 's teacher 's chair is important .	the fork helps my sister 's father 's teacher 's chair is important .
the shoe knows that my boss 's doctor 's teacher 's fork is tired .	the shoe works with my boss 's doctor 's teacher 's fork is tired .
the plane knows that my daughter 's son 's dentist 's door is smart .	the plane talks to my daughter 's son 's dentist 's door is smart .
the spoon says that my daughter 's grandmother 's brother 's spoon is young .	the spoon helps my daughter 's grandmother 's brother 's spoon is young .
the toy knows that your daughter 's dentist 's dentist 's shirt is lucky .	the toy talks to your daughter 's dentist 's dentist 's shirt is lucky .
the book says that my cousin 's father 's sister 's book is important .	the book scares my cousin 's father 's sister 's book is important .
the picture knows that my son 's wife 's cousin 's bottle is tired .	the picture works with my son 's wife 's cousin 's bottle is tired .
the car knows that your dentist 's wife 's mom 's hat is hungry .	the car works with your dentist 's wife 's mom 's hat is hungry .
the bowl says that your dentist 's brother 's husband 's hat is smart .	the bowl scares your dentist 's brother 's husband 's hat is smart .
the ring thinks that my husband 's mother 's son 's toy is careful .	the ring talks to my husband 's mother 's son 's toy is careful .
the button knows that your mother 's cousin 's friend 's box is tired .	the button helps your mother 's cousin 's friend 's box is tired .
the shirt knows that my dad 's mom 's grandmother 's boat is sleepy .	the shirt helps my dad 's mom 's grandmother 's boat is sleepy .
the glass thinks that my husband 's mom 's mom 's ship is upset .	the glass works with my husband 's mom 's mom 's ship is upset .
the shoe knows that my husband 's dentist 's mother 's bag is excited .	the shoe talks to my husband 's dentist 's mother 's bag is excited .
the bicycle says that my father 's friend 's boss 's toy is hungry .	the bicycle talks to my father 's friend 's boss 's toy is hungry .
the truck says that my dad 's mother 's sister 's plane is quiet .	the truck scares my dad 's mother 's sister 's plane is quiet .
the plane knows that my daughter 's husband 's sister 's candle is helpful .	the plane helps my daughter 's husband 's sister 's candle is helpful .
the book thinks that my son 's son 's husband 's doll is curious .	the book works with my son 's son 's husband 's doll is curious .
the cup thinks that my doctor 's brother 's friend 's dish is bored .	the cup talks to my doctor 's brother 's friend 's dish is bored .
the ring says that your daughter 's sister 's cousin 's toy is tired .	the ring helps your daughter 's sister 's cousin 's toy is tired .
the bicycle knows that your teacher 's father 's friend 's shoe is healthy .	the bicycle scares your teacher 's father 's friend 's shoe is healthy .
the spoon thinks that my sister 's doctor 's dad 's spoon is confused .	the spoon talks to my sister 's doctor 's dad 's spoon is confused .
the picture knows that my friend 's father 's husband 's car is busy .	the picture works with my friend 's father 's husband 's car is busy .
the fork says that my mom 's wife 's cousin 's mirror is nice .	the fork talks to my mom 's wife 's cousin 's mirror is nice .
the bicycle says that my sister 's grandmother 's mom 's couch is gentle .	the bicycle scares my sister 's grandmother 's mom 's couch is gentle .
the bed thinks that your dentist 's dad 's friend 's bag is angry .	the bed talks to your dentist 's dad 's friend 's bag is angry .
the couch says that my teacher 's daughter 's cousin 's door is wrong .	the couch talks to my teacher 's daughter 's cousin 's door is wrong .
the rug says that my cousin 's cousin 's mom 's bowl is clever .	the rug helps my cousin 's cousin 's mom 's bowl is clever .
the toy says that your wife 's dad 's dentist 's bed is gentle .	the toy talks to your wife 's dad 's dentist 's bed is gentle .
the book thinks that your dad 's cousin 's boss 's ship is kind .	the book scares your dad 's cousin 's boss 's ship is kind .
the glass says that your son 's brother 's dentist 's truck is healthy .	the glass talks to your son 's brother 's dentist 's truck is healthy .
the bicycle says that your wife 's teacher 's doctor 's mirror is lucky .	the bicycle helps your wife 's teacher 's doctor 's mirror is lucky .
the fork says that your mother 's son 's daughter 's button is boring .	the fork works with your mother 's son 's daughter 's button is boring .
the shirt knows that your dentist 's daughter 's grandmother 's mirror is quiet .	the shirt talks to your dentist 's daughter 's grandmother 's mirror is quiet .
the bag knows that your father 's son 's son 's crayon is lucky .	the bag talks to your father 's son 's son 's crayon is lucky .
the cup knows that your son 's wife 's cousin 's hat is confused .	the cup works with your son 's wife 's cousin 's hat is confused .
the bed says that your boss 's sister 's mom 's bicycle is strong .	the bed talks to your boss 's sister 's mom 's bicycle is strong .
the mirror thinks that my friend 's husband 's dad 's book is upset .	the mirror works with my friend 's husband 's dad 's book is upset .
the shirt knows that my boss 's friend 's boss 's bicycle is strong .	the shirt works with my boss 's friend 's boss 's bicycle is strong .
the button says that your boss 's father 's daughter 's boat is healthy .	the button talks to your boss 's father 's daughter 's boat is healthy .
the boat thinks that your dentist 's boss 's dad 's mirror is sleepy .	the boat scares your dentist 's boss 's dad 's mirror is sleepy .
the chair says that your mom 's husband 's mom 's spoon is excited .	the chair helps your mom 's husband 's mom 's spoon is excited .
the mirror says that your sister 's mom 's cousin 's book is tired .	the mirror works with your sister 's mom 's cousin 's book is tired .
the hat thinks that my mother 's doctor 's sister 's car is young .	the hat scares my mother 's doctor 's sister 's car is young .
the crayon says that your cousin 's wife 's grandmother 's bottle is boring .	the crayon helps your cousin 's wife 's grandmother 's bottle is boring .
the candle thinks that your mother 's daughter 's brother 's bottle is busy .	the candle works with your mother 's daughter 's brother 's bottle is busy .
the ship says that my mother 's brother 's brother 's crayon is lucky .	the ship talks to my mother 's brother 's brother 's crayon is lucky .
the picture thinks that my dentist 's dentist 's dad 's ship is kind .	the picture scares my dentist 's dentist 's dad 's ship is kind .
the car thinks that your sister 's sister 's mother 's candle is tired .	the car scares your sister 's sister 's mother 's candle is tired .
the bottle thinks that my boss 's doctor 's dad 's crayon is smart .	the bottle works with my boss 's doctor 's dad 's crayon is smart .
the plane knows that your doctor 's dentist 's sister 's ship is tall .	the plane works with your doctor 's dentist 's sister 's ship is tall .
the spoon thinks that my sister 's husband 's husband 's picture is bored .	the spoon works with my sister 's husband 's husband 's picture is bored .
the bicycle thinks that my wife 's daughter 's father 's shirt is strong .	the bicycle talks to my wife 's daughter 's father 's shirt is strong .
the truck thinks that your dentist 's boss 's cousin 's bicycle is kind .	the truck helps your dentist 's boss 's cousin 's bicycle is kind .
the boat thinks that your mom 's mom 's grandmother 's button is smart .	the boat talks to your mom 's mom 's grandmother 's button is smart .
the book thinks that your brother 's dentist 's friend 's chair is lucky .	the book scares your brother 's dentist 's friend 's chair is lucky .
the car knows that my son 's husband 's doctor 's book is wrong .	the car helps my son 's husband 's doctor 's book is wrong .
the bottle thinks that my mother 's mom 's grandmother 's doll is wrong .	the bottle scares my mother 's mom 's grandmother 's doll is wrong .
the truck knows that my dentist 's teacher 's friend 's candle is lucky .	the truck talks to my dentist 's teacher 's friend 's candle is lucky .
the book thinks that my mother 's daughter 's daughter 's window is happy .	the book talks to my mother 's daughter 's daughter 's window is happy .
the candle knows that your mother 's husband 's dentist 's button is kind .	the candle works with your mother 's husband 's dentist 's button is kind .
the car says that your boss 's boss 's mom 's cup is strong .	the car helps your boss 's boss 's mom 's cup is strong .
the toy knows that my grandmother 's mother 's teacher 's ring is busy .	the toy works with my grandmother 's mother 's teacher 's ring is busy .
the crayon knows that my dentist 's sister 's boss 's bottle is surprised .	the crayon talks to my dentist 's sister 's boss 's bottle is surprised .
the cup knows that your dad 's brother 's mom 's ship is happy .	the cup helps your dad 's brother 's mom 's ship is happy .
the window knows that your grandmother 's brother 's daughter 's mirror is tired .	the window works with your grandmother 's brother 's daughter 's mirror is tired .
the book knows that my sister 's mother 's dentist 's cup is healthy .	the book talks to my sister 's mother 's dentist 's cup is healthy .
the fork knows that my teacher 's friend 's grandmother 's truck is surprised .	the fork works with my teacher 's friend 's grandmother 's truck is surprised .
the chair knows that your cousin 's father 's dad 's ship is tired .	the chair scares your cousin 's father 's dad 's ship is tired .
the doll says that my husband 's grandmother 's dad 's button is clever .	the doll talks to my husband 's grandmother 's dad 's button is clever .
the spoon thinks that my doctor 's dentist 's friend 's mirror is happy .	the spoon helps my doctor 's dentist 's friend 's mirror is happy .
the bicycle says that your father 's teacher 's mother 's crayon is nice .	the bicycle talks to your father 's teacher 's mother 's crayon is nice .
the bag says that my doctor 's dad 's mom 's button is quiet .	the bag helps my doctor 's dad 's mom 's button is quiet .
the candle knows that my sister 's father 's brother 's boat is kind .	the candle works with my sister 's father 's brother 's boat is kind .
the shoe knows that my son 's father 's doctor 's shoe is busy .	the shoe talks to my son 's father 's doctor 's shoe is busy .
the chair knows that your sister 's dentist 's husband 's shirt is clever .	the chair helps your sister 's dentist 's husband 's shirt is clever .
the glass says that your husband 's dentist 's sister 's box is wrong .	the glass helps your husband 's dentist 's sister 's box is wrong .
the chair thinks that my sister 's dentist 's dad 's bowl is confused .	the chair talks to my sister 's dentist 's dad 's bowl is confused .
the spoon knows that your father 's mom 's dad 's shoe is gentle .	the spoon talks to your father 's mom 's dad 's shoe is gentle .
the bed says that your cousin 's brother 's daughter 's book is tall .	the bed helps your cousin 's brother 's daughter 's book is tall .
the hat says that your doctor 's son 's wife 's mirror is wrong .	the hat scares your doctor 's son 's wife 's mirror is wrong .
the shoe says that your friend 's wife 's doctor 's rug is healthy .	the shoe works with your friend 's wife 's doctor 's rug is healthy .
the car says that my boss 's dad 's boss 's toy is upset .	the car scares my boss 's dad 's boss 's toy is upset .
the car knows that your teacher 's boss 's sister 's picture is strong .	the car scares your teacher 's boss 's sister 's picture is strong .
the door knows that your mom 's father 's doctor 's picture is gentle .	the door helps your mom 's father 's doctor 's picture is gentle .
the glass says that your brother 's son 's daughter 's doll is healthy .	the glass scares your brother 's son 's daughter 's doll is healthy .
the ring knows that your sister 's mom 's teacher 's plate is careful .	the ring talks to your sister 's mom 's teacher 's plate is careful .
the rocket thinks that my boss 's husband 's boss 's spoon is gentle .	the rocket works with my boss 's husband 's boss 's spoon is gentle .
the spoon says that your father 's teacher 's brother 's glass is smart .	the spoon works with your father 's teacher 's brother 's glass is smart .
the picture thinks that your dentist 's father 's dad 's fork is nice .	the picture scares your dentist 's father 's dad 's fork is nice .
the ring thinks that my doctor 's sister 's sister 's box is angry .	the ring helps my doctor 's sister 's sister 's box is angry .
the mirror knows that my teacher 's teacher 's mother 's door is tall .	the mirror helps my teacher 's teacher 's mother 's door is tall .
the bowl says that my father 's dentist 's boss 's hat is confused .	the bowl works with my father 's dentist 's boss 's hat is confused .
the couch knows that your mother 's sister 's doctor 's mirror is helpful .	the couch works with your mother 's sister 's doctor 's mirror is helpful .
the window knows that my doctor 's dad 's mom 's ring is curious .	the window works with my doctor 's dad 's mom 's ring is curious .
the fork knows that your cousin 's sister 's husband 's car is clever .	the fork works with your cousin 's sister 's husband 's car is clever .
the boat knows that your mom 's grandmother 's daughter 's bag is wrong .	the boat helps your mom 's grandmother 's daughter 's bag is wrong .
the rug thinks that my friend 's son 's dad 's toy is confused .	the rug works with my friend 's son 's dad 's toy is confused .
the ship knows that my father 's teacher 's dad 's bag is kind .	the ship helps my father 's teacher 's dad 's bag is kind .
the window knows that my doctor 's friend 's boss 's bed is clever .	the window helps my doctor 's friend 's boss 's bed is clever .
the spoon knows that my mom 's daughter 's boss 's picture is happy .	the spoon works with my mom 's daughter 's boss 's picture is happy .
the bicycle knows that my boss 's mother 's wife 's bowl is nice .	the bicycle helps my boss 's mother 's wife 's bowl is nice .
the bag says that your brother 's father 's father 's rug is kind .	the bag helps your brother 's father 's father 's rug is kind .
the box says that your grandmother 's teacher 's grandmother 's bottle is nice .	the box talks to your grandmother 's teacher 's grandmother 's bottle is nice .
the plane knows that your dad 's husband 's mother 's toy is confused .	the plane scares your dad 's husband 's mother 's toy is confused .
the picture says that my boss 's wife 's teacher 's truck is happy .	the picture works with my boss 's wife 's teacher 's truck is happy .
the fork thinks that your dentist 's wife 's friend 's ring is clever .	the fork works with your dentist 's wife 's friend 's ring is clever .
the shirt knows that your brother 's son 's husband 's box is bored .	the shirt helps your brother 's son 's husband 's box is bored .
the fork thinks that your dentist 's mother 's dentist 's truck is tall .	the fork helps your dentist 's mother 's dentist 's truck is tall .
the couch knows that your mother 's friend 's sister 's truck is gentle .	the couch scares your mother 's friend 's sister 's truck is gentle .
the cup thinks that my cousin 's friend 's mother 's door is gentle .	the cup talks to my cousin 's friend 's mother 's door is gentle .
the picture says that your daughter 's brother 's father 's box is friendly .	the picture works with your daughter 's brother 's father 's box is friendly .
the couch thinks that your dad 's wife 's boss 's window is boring .	the couch talks to your dad 's wife 's boss 's window is boring .
the bag says that my friend 's daughter 's cousin 's glass is quiet .	the bag talks to my friend 's daughter 's cousin 's glass is quiet .
the hat says that your brother 's mom 's wife 's shirt is wrong .	the hat works with your brother 's mom 's wife 's shirt is wrong .
the bowl thinks that my friend 's son 's dad 's rug is busy .	the bowl talks to my friend 's son 's dad 's rug is busy .
the window knows that my sister 's grandmother 's son 's spoon is curious .	the window works with my sister 's grandmother 's son 's spoon is curious .
the candle knows that my husband 's daughter 's mother 's doll is angry .	the candle talks to my husband 's daughter 's mother 's doll is angry .
the rug knows that your husband 's cousin 's husband 's book is important .	the rug works with your husband 's cousin 's husband 's book is important .
the mirror says that your father 's brother 's mother 's truck is careful .	the mirror scares your father 's brother 's mother 's truck is careful .
the shirt knows that my cousin 's mom 's daughter 's glass is surprised .	the shirt works with my cousin 's mom 's daughter 's glass is surprised .
the box knows that my daughter 's sister 's boss 's shirt is nice .	the box talks to my daughter 's sister 's boss 's shirt is nice .
the bicycle thinks that my husband 's teacher 's doctor 's ship is kind .	the bicycle helps my husband 's teacher 's doctor 's ship is kind .
the boat thinks that your cousin 's father 's husband 's cup is clever .	the boat helps your cousin 's father 's husband 's cup is clever .
the shoe thinks that my mom 's husband 's husband 's rug is helpful .	the shoe talks to my mom 's husband 's husband 's rug is helpful .
the rug knows that my sister 's mom 's grandmother 's spoon is lucky .	the rug talks to my sister 's mom 's grandmother 's spoon is lucky .
the bed says that your father 's wife 's doctor 's rocket is young .	the bed helps your father 's wife 's doctor 's rocket is young .
the doll knows that my cousin 's grandmother 's wife 's cup is nice .	the doll scares my cousin 's grandmother 's wife 's cup is nice .
the door knows that my mother 's dentist 's mother 's fork is surprised .	the door talks to my mother 's dentist 's mother 's fork is surprised .
the fork thinks that your mother 's husband 's father 's fork is upset .	the fork helps your mother 's husband 's father 's fork is upset .
the boat says that your son 's mom 's son 's bowl is strong .	the boat scares your son 's mom 's son 's bowl is strong .
the bicycle thinks that my grandmother 's friend 's doctor 's couch is busy .	the bicycle talks to my grandmother 's friend 's doctor 's couch is busy .
the ring thinks that your husband 's boss 's teacher 's plane is careful .	the ring helps your husband 's boss 's teacher 's plane is careful .
the window says that my son 's friend 's father 's bicycle is boring .	the window works with my son 's friend 's father 's bicycle is boring .
the fork thinks that my son 's friend 's sister 's rocket is confused .	the fork works with my son 's friend 's sister 's rocket is confused .
the car says that my doctor 's dad 's teacher 's rocket is tired .	the car scares my doctor 's dad 's teacher 's rocket is tired .
the door knows that your boss 's teacher 's father 's rug is surprised .	the door scares your boss 's teacher 's father 's rug is surprised .
the fork knows that your friend 's brother 's son 's bottle is helpful .	the fork scares your friend 's brother 's son 's bottle is helpful .
the ring thinks that your dentist 's sister 's dentist 's car is helpful .	the ring helps your dentist 's sister 's dentist 's car is helpful .
the dish knows that your brother 's sister 's boss 's ring is friendly .	the dish talks to your brother 's sister 's boss 's ring is friendly .
the ring thinks that my friend 's husband 's mom 's toy is happy .	the ring helps my friend 's husband 's mom 's toy is happy .
the hat says that my father 's husband 's mom 's book is smart .	the hat talks to my father 's husband 's mom 's book is smart .
the bowl knows that my teacher 's husband 's dentist 's book is upset .	the bowl scares my teacher 's husband 's dentist 's book is upset .
the bed says that my father 's son 's dad 's rug is important .	the bed talks to my father 's son 's dad 's rug is important .
the ring says that my mother 's doctor 's cousin 's bottle is strong .	the ring talks to my mother 's doctor 's cousin 's bottle is strong .
the rug thinks that my son 's husband 's mother 's truck is wrong .	the rug works with my son 's husband 's mother 's truck is wrong .
the mirror thinks that your doctor 's dad 's brother 's plane is friendly .	the mirror works with your doctor 's dad 's brother 's plane is friendly .
the shoe says that my boss 's father 's husband 's glass is strong .	the shoe talks to my boss 's father 's husband 's glass is strong .
the candle thinks that my teacher 's doctor 's daughter 's plate is curious .	the candle scares my teacher 's doctor 's daughter 's plate is curious .
the ship says that my boss 's teacher 's wife 's bottle is upset .	the ship works with my boss 's teacher 's wife 's bottle is upset .
the crayon says that your brother 's daughter 's grandmother 's bicycle is clever .	the crayon works with your brother 's daughter 's grandmother 's bicycle is clever .
the car says that my mother 's mother 's cousin 's crayon is nice .	the car works with my mother 's mother 's cousin 's crayon is nice .
the hat knows that your grandmother 's dad 's son 's door is excited .	the hat helps your grandmother 's dad 's son 's door is excited .
the ring knows that your grandmother 's husband 's father 's chair is boring .	the ring helps your grandmother 's husband 's father 's chair is boring .
the ring thinks that your mom 's brother 's brother 's candle is friendly .	the ring scares your mom 's brother 's brother 's candle is friendly .
the fork thinks that my boss 's brother 's friend 's shoe is bored .	the fork talks to my boss 's brother 's friend 's shoe is bored .
the hat thinks that your dentist 's brother 's cousin 's car is friendly .	the hat works with your dentist 's brother 's cousin 's car is friendly .
the box knows that your dentist 's husband 's grandmother 's plane is strong .	the box talks to your dentist 's husband 's grandmother 's plane is strong .
the plane knows that my son 's brother 's friend 's book is strong .	the plane talks to my son 's brother 's friend 's book is strong .
the glass thinks that your brother 's teacher 's mom 's hat is kind .	the glass talks to your brother 's teacher 's mom 's hat is kind .
the crayon thinks that my dentist 's sister 's dad 's toy is careful .	the crayon works with my dentist 's sister 's dad 's toy is careful .
the book knows that your father 's brother 's brother 's cup is angry .	the book scares your father 's brother 's brother 's cup is angry .
the book thinks that your brother 's daughter 's teacher 's crayon is surprised .	the book talks to your brother 's daughter 's teacher 's crayon is surprised .
the picture knows that my dentist 's son 's boss 's doll is healthy .	the picture scares my dentist 's son 's boss 's doll is healthy .
the bed thinks that my friend 's dentist 's son 's dish is helpful .	the bed scares my friend 's dentist 's son 's dish is helpful .
the couch knows that my dad 's mom 's friend 's plate is excited .	the couch helps my dad 's mom 's friend 's plate is excited .
the crayon thinks that your mom 's boss 's wife 's truck is confused .	the crayon works with your mom 's boss 's wife 's truck is confused .
the hat knows that your brother 's dad 's mother 's bag is friendly .	the hat works with your brother 's dad 's mother 's bag is friendly .
the fork knows that my dentist 's cousin 's husband 's couch is friendly .	the fork works with my dentist 's cousin 's husband 's couch is friendly .
the bag knows that my boss 's boss 's daughter 's fork is careful .	the bag works with my boss 's boss 's daughter 's fork is careful .
the glass knows that my dad 's wife 's cousin 's rug is kind .	the glass talks to my dad 's wife 's cousin 's rug is kind .
the rug thinks that my grandmother 's mom 's sister 's dish is hungry .	the rug helps my grandmother 's mom 's sister 's dish is hungry .
the bottle says that your husband 's boss 's cousin 's glass is helpful .	the bottle helps your husband 's boss 's cousin 's glass is helpful .
the shirt knows that my son 's sister 's doctor 's bottle is tall .	the shirt scares my son 's sister 's doctor 's bottle is tall .
the shirt knows that my father 's grandmother 's friend 's book is confused .	the shirt works with my father 's grandmother 's friend 's book is confused .
the plate knows that your cousin 's husband 's mother 's mirror is important .	the plate talks to your cousin 's husband 's mother 's mirror is important .
the cup says that your doctor 's husband 's teacher 's box is confused .	the cup scares your doctor 's husband 's teacher 's box is confused .
the rocket thinks that my wife 's grandmother 's brother 's dish is confused .	the rocket scares my wife 's grandmother 's brother 's dish is confused .
the cup thinks that your husband 's sister 's wife 's door is tall .	the cup works with your husband 's sister 's wife 's door is tall .
the cup says that my wife 's sister 's teacher 's fork is hungry .	the cup talks to my wife 's sister 's teacher 's fork is hungry .
the car knows that my grandmother 's mother 's doctor 's book is gentle .	the car talks to my grandmother 's mother 's doctor 's book is gentle .
the fork thinks that your father 's sister 's cousin 's crayon is upset .	the fork talks to your father 's sister 's cousin 's crayon is upset .
the doll knows that your husband 's daughter 's doctor 's bottle is hungry .	the doll scares your husband 's daughter 's doctor 's bottle is hungry .
the book knows that your mom 's husband 's wife 's bowl is smart .	the book works with your mom 's husband 's wife 's bowl is smart .
the mirror knows that your sister 's cousin 's daughter 's box is hungry .	the mirror works with your sister 's cousin 's daughter 's box is hungry .
the bag says that my mother 's teacher 's husband 's boat is nice .	the bag scares my mother 's teacher 's husband 's boat is nice .
the crayon knows that my brother 's doctor 's doctor 's rug is gentle .	the crayon talks to my brother 's doctor 's doctor 's rug is gentle .
the doll says that your dad 's friend 's boss 's car is bored .	the doll works with your dad 's friend 's boss 's car is bored .
the door knows that my dentist 's father 's wife 's door is kind .	the door scares my dentist 's father 's wife 's door is kind .
the hat says that your brother 's father 's son 's candle is boring .	the hat helps your brother 's father 's son 's candle is boring .
the dish thinks that my grandmother 's father 's boss 's couch is kind .	the dish talks to my grandmother 's father 's boss 's couch is kind .
the spoon says that my boss 's father 's dad 's bowl is busy .	the spoon talks to my boss 's father 's dad 's bowl is busy .
the rug thinks that your doctor 's cousin 's grandmother 's bed is angry .	the rug works with your doctor 's cousin 's grandmother 's bed is angry .
the book knows that my brother 's husband 's dad 's book is bored .	the book talks to my brother 's husband 's dad 's book is bored .
the chair knows that my teacher 's dentist 's father 's picture is bored .	the chair helps my teacher 's dentist 's father 's picture is bored .
the couch says that your teacher 's wife 's cousin 's ship is bored .	the couch helps your teacher 's wife 's cousin 's ship is bored .
the fork thinks that your friend 's brother 's friend 's glass is young .	the fork helps your friend 's brother 's friend 's glass is young .
the shoe knows that your doctor 's mother 's brother 's button is bored .	the shoe works with your doctor 's mother 's brother 's button is bored .
the bicycle knows that your doctor 's teacher 's son 's rocket is hungry .	the bicycle helps your doctor 's teacher 's son 's rocket is hungry .
the bag knows that your sister 's husband 's friend 's car is hungry .	the bag works with your sister 's husband 's friend 's car is hungry .
the cup says that my grandmother 's father 's teacher 's bottle is healthy .	the cup scares my grandmother 's father 's teacher 's bottle is healthy .
the bowl thinks that my dentist 's grandmother 's doctor 's rocket is happy .	the bowl talks to my dentist 's grandmother 's doctor 's rocket is happy .
the boat says that my friend 's doctor 's son 's book is wrong .	the boat helps my friend 's doctor 's son 's book is wrong .
the car says that your wife 's boss 's teacher 's bag is excited .	the car talks to your wife 's boss 's teacher 's bag is excited .
the boat thinks that your son 's mother 's brother 's bicycle is angry .	the boat talks to your son 's mother 's brother 's bicycle is angry .
the bicycle knows that your dentist 's wife 's dad 's crayon is smart .	the bicycle talks to your dentist 's wife 's dad 's crayon is smart .
the plate knows that my teacher 's doctor 's teacher 's chair is happy .	the plate helps my teacher 's doctor 's teacher 's chair is happy .
the boat knows that my son 's mom 's dad 's bottle is gentle .	the boat talks to my son 's mom 's dad 's bottle is gentle .
the picture thinks that your sister 's friend 's boss 's fork is boring .	the picture talks to your sister 's friend 's boss 's fork is boring .
the hat thinks that your boss 's teacher 's sister 's chair is wrong .	the hat works with your boss 's teacher 's sister 's chair is wrong .
the bottle knows that my husband 's doctor 's husband 's crayon is sleepy .	the bottle helps my husband 's doctor 's husband 's crayon is sleepy .
the door knows that my boss 's grandmother 's grandmother 's book is tall .	the door helps my boss 's grandmother 's grandmother 's book is tall .
the bed says that my grandmother 's boss 's teacher 's mirror is kind .	the bed scares my grandmother 's boss 's teacher 's mirror is kind .
the ship thinks that my daughter 's father 's dentist 's shoe is helpful .	the ship works with my daughter 's father 's dentist 's shoe is helpful .
the bottle says that your grandmother 's father 's daughter 's bed is bored .	the bottle works with your grandmother 's father 's daughter 's bed is bored .
the button says that my friend 's daughter 's sister 's rocket is important .	the button talks to my friend 's daughter 's sister 's rocket is important .
the picture knows that your friend 's dentist 's wife 's ring is clever .	the picture scares your friend 's dentist 's wife 's ring is clever .
the book says that your grandmother 's grandmother 's husband 's shoe is careful .	the book works with your grandmother 's grandmother 's husband 's shoe is careful .
the window knows that your boss 's son 's wife 's shoe is smart .	the window works with your boss 's son 's wife 's shoe is smart .
the book says that your sister 's wife 's son 's button is important .	the book helps your sister 's wife 's son 's button is important .
the rug says that my grandmother 's son 's mom 's button is tired .	the rug works with my grandmother 's son 's mom 's button is tired .
the cup says that your brother 's sister 's dad 's ring is quiet .	the cup helps your brother 's sister 's dad 's ring is quiet .
the door thinks that your sister 's husband 's father 's hat is smart .	the door works with your sister 's husband 's father 's hat is smart .
the spoon knows that your mom 's dad 's sister 's bed is smart .	the spoon helps your mom 's dad 's sister 's bed is smart .
the toy knows that your doctor 's friend 's boss 's crayon is important .	the toy talks to your doctor 's friend 's boss 's crayon is important .
the fork thinks that my dad 's father 's grandmother 's toy is excited .	the fork scares my dad 's father 's grandmother 's toy is excited .
the truck says that my husband 's mom 's husband 's car is helpful .	the truck works with my husband 's mom 's husband 's car is helpful .
the rug knows that your friend 's cousin 's dad 's window is clever .	the rug works with your friend 's cousin 's dad 's window is clever .
the door says that your cousin 's daughter 's grandmother 's button is careful .	the door scares your cousin 's daughter 's grandmother 's button is careful .
the book knows that your teacher 's doctor 's daughter 's bottle is nice .	the book talks to your teacher 's doctor 's daughter 's bottle is nice .
the ring thinks that my cousin 's dentist 's teacher 's dish is busy .	the ring works with my cousin 's dentist 's teacher 's dish is busy .
the door says that your brother 's wife 's daughter 's hat is wrong .	the door talks to your brother 's wife 's daughter 's hat is wrong .
the boat says that my cousin 's father 's dentist 's chair is strong .	the boat helps my cousin 's father 's dentist 's chair is strong .
the candle says that my teacher 's doctor 's husband 's boat is tired .	the candle works with my teacher 's doctor 's husband 's boat is tired .
the ring knows that my teacher 's brother 's dad 's bed is confused .	the ring works with my teacher 's brother 's dad 's bed is confused .
the cup says that your boss 's dad 's son 's rug is happy .	the cup works with your boss 's dad 's son 's rug is happy .
the car says that your father 's wife 's doctor 's rug is boring .	the car helps your father 's wife 's doctor 's rug is boring .
the plane knows that my friend 's son 's boss 's bed is angry .	the plane helps my friend 's son 's boss 's bed is angry .
the rug thinks that my friend 's father 's mom 's shoe is busy .	the rug works with my friend 's father 's mom 's shoe is busy .
the crayon knows that my cousin 's grandmother 's cousin 's chair is careful .	the crayon talks to my cousin 's grandmother 's cousin 's chair is careful .
the bicycle says that my sister 's cousin 's brother 's doll is busy .	the bicycle helps my sister 's cousin 's brother 's doll is busy .
the book knows that your husband 's friend 's doctor 's picture is nice .	the book works with your husband 's friend 's doctor 's picture is nice .
the book thinks that your boss 's brother 's cousin 's door is quiet .	the book helps your boss 's brother 's cousin 's door is quiet .
the crayon thinks that your grandmother 's dentist 's dentist 's picture is lucky .	the crayon helps your grandmother 's dentist 's dentist 's picture is lucky .
the rug says that your brother 's grandmother 's mother 's toy is kind .	the rug talks to your brother 's grandmother 's mother 's toy is kind .
the glass knows that my grandmother 's son 's mother 's toy is friendly .	the glass works with my grandmother 's son 's mother 's toy is friendly .
the toy thinks that your son 's cousin 's son 's cup is smart .	the toy works with your son 's cousin 's son 's cup is smart .
the glass says that my friend 's dentist 's daughter 's chair is kind .	the glass talks to my friend 's dentist 's daughter 's chair is kind .
the plane knows that my mother 's mother 's teacher 's bottle is lucky .	the plane works with my mother 's mother 's teacher 's bottle is lucky .
the bed says that your boss 's grandmother 's mother 's plane is surprised .	the bed helps your boss 's grandmother 's mother 's plane is surprised .
the spoon says that my mom 's father 's grandmother 's car is friendly .	the spoon talks to my mom 's father 's grandmother 's car is friendly .
the truck thinks that my brother 's wife 's friend 's window is confused .	the truck talks to my brother 's wife 's friend 's window is confused .
the shirt thinks that your husband 's sister 's brother 's plane is gentle .	the shirt helps your husband 's sister 's brother 's plane is gentle .
the boat knows that my mother 's mom 's dad 's bicycle is confused .	the boat talks to my mother 's mom 's dad 's bicycle is confused .
the glass knows that my teacher 's friend 's wife 's bowl is helpful .	the glass helps my teacher 's friend 's wife 's bowl is helpful .
the door says that your brother 's wife 's dentist 's shoe is quiet .	the door scares your brother 's wife 's dentist 's shoe is quiet .
the mirror thinks that your daughter 's daughter 's boss 's spoon is kind .	the mirror talks to your daughter 's daughter 's boss 's spoon is kind .
the ship thinks that my sister 's father 's sister 's window is boring .	the ship talks to my sister 's father 's sister 's window is boring .
the book knows that your doctor 's dad 's sister 's bottle is healthy .	the book talks to your doctor 's dad 's sister 's bottle is healthy .
the ring thinks that my dentist 's father 's dentist 's picture is busy .	the ring scares my dentist 's father 's dentist 's picture is busy .
the shirt knows that your brother 's mother 's boss 's bed is lucky .	the shirt talks to your brother 's mother 's boss 's bed is lucky .
the dish knows that my sister 's mother 's grandmother 's plane is curious .	the dish helps my sister 's mother 's grandmother 's plane is curious .
the car knows that your grandmother 's son 's cousin 's chair is surprised .	the car talks to your grandmother 's son 's cousin 's chair is surprised .
the window knows that my father 's dentist 's mother 's rocket is upset .	the window talks to my father 's dentist 's mother 's rocket is upset .
the car says that my daughter 's doctor 's grandmother 's bag is kind .	the car helps my daughter 's doctor 's grandmother 's bag is kind .
the box knows that your sister 's father 's mother 's rug is young .	the box helps your sister 's father 's mother 's rug is young .
the spoon says that your mom 's cousin 's wife 's mirror is gentle .	the spoon works with your mom 's cousin 's wife 's mirror is gentle .
the couch thinks that my wife 's mother 's son 's picture is hungry .	the couch works with my wife 's mother 's son 's picture is hungry .
the window says that my brother 's dad 's dentist 's doll is nice .	the window works with my brother 's dad 's dentist 's doll is nice .
the book thinks that your mother 's brother 's doctor 's car is angry .	the book works with your mother 's brother 's doctor 's car is angry .
the dish knows that my sister 's sister 's cousin 's window is wrong .	the dish works with my sister 's sister 's cousin 's window is wrong .
the bag says that your grandmother 's doctor 's father 's chair is strong .	the bag scares your grandmother 's doctor 's father 's chair is strong .
the toy knows that my mom 's wife 's grandmother 's hat is hungry .	the toy scares my mom 's wife 's grandmother 's hat is hungry .
the car thinks that your sister 's cousin 's boss 's fork is young .	the car talks to your sister 's cousin 's boss 's fork is young .
the bag says that your father 's grandmother 's brother 's doll is tired .	the bag talks to your father 's grandmother 's brother 's doll is tired .
the bowl knows that your wife 's doctor 's cousin 's truck is happy .	the bowl works with your wife 's doctor 's cousin 's truck is happy .
the glass says that your wife 's sister 's daughter 's door is strong .	the glass helps your wife 's sister 's daughter 's door is strong .
the bed says that your father 's daughter 's teacher 's dish is gentle .	the bed helps your father 's daughter 's teacher 's dish is gentle .
the box says that your boss 's dentist 's mom 's window is curious .	the box helps your boss 's dentist 's mom 's window is curious .
the glass knows that my dad 's daughter 's boss 's bottle is quiet .	the glass helps my dad 's daughter 's boss 's bottle is quiet .
the mirror thinks that my dentist 's teacher 's doctor 's shirt is tired .	the mirror talks to my dentist 's teacher 's doctor 's shirt is tired .
the chair says that your wife 's mother 's husband 's bicycle is bored .	the chair scares your wife 's mother 's husband 's bicycle is bored .
the button says that my mother 's father 's cousin 's glass is nice .	the button helps my mother 's father 's cousin 's glass is nice .
the cup says that your dentist 's friend 's teacher 's door is angry .	the cup helps your dentist 's friend 's teacher 's door is angry .
the book says that your mother 's wife 's teacher 's glass is curious .	the book works with your mother 's wife 's teacher 's glass is curious .
the door says that your doctor 's grandmother 's father 's button is wrong .	the door works with your doctor 's grandmother 's father 's button is wrong .
the crayon says that your son 's mom 's mother 's rug is angry .	the crayon helps your son 's mom 's mother 's rug is angry .
the ring says that your wife 's doctor 's grandmother 's box is happy .	the ring helps your wife 's doctor 's grandmother 's box is happy .
the rug says that my dentist 's husband 's mother 's fork is quiet .	the rug scares my dentist 's husband 's mother 's fork is quiet .
the ring knows that my cousin 's father 's dad 's toy is upset .	the ring scares my cousin 's father 's dad 's toy is upset .
the ship thinks that your son 's son 's friend 's couch is angry .	the ship talks to your son 's son 's friend 's couch is angry .
the book knows that your daughter 's husband 's grandmother 's book is smart .	the book scares your daughter 's husband 's grandmother 's book is smart .
the window says that my wife 's father 's father 's dish is nice .	the window helps my wife 's father 's father 's dish is nice .
the bottle says that my teacher 's mother 's brother 's window is lucky .	the bottle talks to my teacher 's mother 's brother 's window is lucky .
the door thinks that my dad 's sister 's daughter 's doll is important .	the door helps my dad 's sister 's daughter 's doll is important .
the window says that your mom 's mom 's mother 's mirror is tired .	the window scares your mom 's mom 's mother 's mirror is tired .
the bowl says that your friend 's daughter 's cousin 's bed is young .	the bowl talks to your friend 's daughter 's cousin 's bed is young .
the bottle knows that your friend 's boss 's mother 's picture is bored .	the bottle helps your friend 's boss 's mother 's picture is bored .
the box knows that my doctor 's cousin 's dentist 's window is bored .	the box scares my doctor 's cousin 's dentist 's window is bored .
the picture says that your husband 's grandmother 's sister 's boat is smart .	the picture scares your husband 's grandmother 's sister 's boat is smart .
the truck thinks that your doctor 's dentist 's friend 's book is friendly .	the truck helps your doctor 's dentist 's friend 's book is friendly .
the rug thinks that your grandmother 's brother 's mom 's toy is upset .	the rug talks to your grandmother 's brother 's mom 's toy is upset .
the plate thinks that your cousin 's brother 's wife 's mirror is clever .	the plate scares your cousin 's brother 's wife 's mirror is clever .
the rocket thinks that my mother 's dentist 's doctor 's glass is surprised .	the rocket talks to my mother 's dentist 's doctor 's glass is surprised .
the dish thinks that your daughter 's dad 's husband 's plane is wrong .	the dish talks to your daughter 's dad 's husband 's plane is wrong .
the plate thinks that my sister 's brother 's doctor 's crayon is wrong .	the plate talks to my sister 's brother 's doctor 's crayon is wrong .
the plane thinks that my doctor 's sister 's doctor 's door is helpful .	the plane helps my doctor 's sister 's doctor 's door is helpful .
the couch says that my grandmother 's son 's wife 's plane is friendly .	the couch works with my grandmother 's son 's wife 's plane is friendly .
the bottle says that my teacher 's sister 's cousin 's book is curious .	the bottle talks to my teacher 's sister 's cousin 's book is curious .
the dish knows that your friend 's grandmother 's husband 's doll is happy .	the dish helps your friend 's grandmother 's husband 's doll is happy .
the car thinks that my husband 's dentist 's sister 's dish is healthy .	the car scares my husband 's dentist 's sister 's dish is healthy .
the crayon says that my husband 's boss 's mother 's fork is curious .	the crayon scares my husband 's boss 's mother 's fork is curious .
the rocket knows that your mother 's wife 's sister 's doll is tall .	the rocket talks to your mother 's wife 's sister 's doll is tall .
the picture knows that my dad 's teacher 's boss 's book is angry .	the picture scares my dad 's teacher 's boss 's book is angry .
the fork knows that your dad 's doctor 's dentist 's rocket is careful .	the fork helps your dad 's doctor 's dentist 's rocket is careful .
the boat knows that my wife 's grandmother 's dentist 's book is tall .	the boat helps my wife 's grandmother 's dentist 's book is tall .
the couch knows that my mother 's daughter 's daughter 's picture is surprised .	the couch talks to my mother 's daughter 's daughter 's picture is surprised .
the box knows that your wife 's brother 's wife 's candle is confused .	the box talks to your wife 's brother 's wife 's candle is confused .
the truck knows that my teacher 's sister 's friend 's bicycle is upset .	the truck talks to my teacher 's sister 's friend 's bicycle is upset .
the bicycle says that my husband 's son 's teacher 's plane is nice .	the bicycle talks to my husband 's son 's teacher 's plane is nice .
the hat says that your mom 's brother 's brother 's crayon is lucky .	the hat helps your mom 's brother 's brother 's crayon is lucky .
the spoon says that your boss 's friend 's dentist 's shirt is upset .	the spoon talks to your boss 's friend 's dentist 's shirt is upset .
the door says that my doctor 's husband 's daughter 's dish is curious .	the door helps my doctor 's husband 's daughter 's dish is curious .
the couch says that your husband 's dad 's teacher 's spoon is hungry .	the couch scares your husband 's dad 's teacher 's spoon is hungry .
the dish thinks that my daughter 's cousin 's brother 's bowl is angry .	the dish talks to my daughter 's cousin 's brother 's bowl is angry .
the spoon says that your friend 's mom 's mom 's bottle is bored .	the spoon scares your friend 's mom 's mom 's bottle is bored .
the rug knows that your daughter 's father 's son 's chair is sleepy .	the rug scares your daughter 's father 's son 's chair is sleepy .
the book says that your husband 's dad 's father 's picture is gentle .	the book helps your husband 's dad 's father 's picture is gentle .
the cup thinks that my daughter 's dad 's husband 's glass is wrong .	the cup works with my daughter 's dad 's husband 's glass is wrong .
the doll knows that your doctor 's son 's grandmother 's bed is tired .	the doll helps your doctor 's son 's grandmother 's bed is tired .
the chair says that my friend 's grandmother 's husband 's spoon is confused .	the chair helps my friend 's grandmother 's husband 's spoon is confused .
the truck knows that my sister 's cousin 's dad 's couch is kind .	the truck scares my sister 's cousin 's dad 's couch is kind .
the box thinks that my teacher 's grandmother 's son 's bicycle is lucky .	the box scares my teacher 's grandmother 's son 's bicycle is lucky .
the plane says that your dad 's teacher 's dad 's car is bored .	the plane talks to your dad 's teacher 's dad 's car is bored .
the glass says that my teacher 's dad 's sister 's bottle is healthy .	the glass talks to my teacher 's dad 's sister 's bottle is healthy .
the shirt says that my doctor 's mother 's dad 's chair is upset .	the shirt works with my doctor 's mother 's dad 's chair is upset .
the couch thinks that my doctor 's son 's dad 's shirt is wrong .	the couch works with my doctor 's son 's dad 's shirt is wrong .
the bicycle knows that your brother 's grandmother 's brother 's bag is sleepy .	the bicycle works with your brother 's grandmother 's brother 's bag is sleepy .
the candle thinks that my daughter 's dad 's grandmother 's toy is excited .	the candle scares my daughter 's dad 's grandmother 's toy is excited .
the toy thinks that my cousin 's father 's grandmother 's hat is surprised .	the toy helps my cousin 's father 's grandmother 's hat is surprised .
the button says that your dentist 's father 's grandmother 's bowl is gentle .	the button helps your dentist 's father 's grandmother 's bowl is gentle .
the bicycle knows that your dad 's grandmother 's brother 's plane is healthy .	the bicycle helps your dad 's grandmother 's brother 's plane is healthy .
the ship knows that your boss 's boss 's mom 's plane is wrong .	the ship works with your boss 's boss 's mom 's plane is wrong .
the plane knows that your son 's father 's doctor 's cup is angry .	the plane helps your son 's father 's doctor 's cup is angry .
the truck knows that my grandmother 's husband 's mother 's bicycle is upset .	the truck works with my grandmother 's husband 's mother 's bicycle is upset .
the book says that my friend 's cousin 's son 's shirt is healthy .	the book works with my friend 's cousin 's son 's shirt is healthy .
the crayon knows that my grandmother 's mom 's sister 's picture is sleepy .	the crayon helps my grandmother 's mom 's sister 's picture is sleepy .
the cup thinks that your dad 's brother 's father 's book is friendly .	the cup works with your dad 's brother 's father 's book is friendly .
the rocket thinks that my father 's boss 's dentist 's plane is boring .	the rocket helps my father 's boss 's dentist 's plane is boring .
the shirt says that my husband 's grandmother 's mother 's box is young .	the shirt works with my husband 's grandmother 's mother 's box is young .
the plane knows that your father 's wife 's dad 's rocket is helpful .	the plane works with your father 's wife 's dad 's rocket is helpful .
the picture says that your mom 's boss 's teacher 's button is sleepy .	the picture scares your mom 's boss 's teacher 's button is sleepy .
the hat thinks that your grandmother 's grandmother 's brother 's bowl is kind .	the hat scares your grandmother 's grandmother 's brother 's bowl is kind .
the car says that your father 's mom 's wife 's button is important .	the car works with your father 's mom 's wife 's button is important .
the book says that my mother 's grandmother 's dentist 's car is surprised .	the book works with my mother 's grandmother 's dentist 's car is surprised .
the bicycle knows that your wife 's teacher 's sister 's book is clever .	the bicycle talks to your wife 's teacher 's sister 's book is clever .
the bag knows that my husband 's son 's sister 's dish is lucky .	the bag scares my husband 's son 's sister 's dish is lucky .
the car knows that your dentist 's mom 's brother 's box is curious .	the car scares your dentist 's mom 's brother 's box is curious .
the dish thinks that my teacher 's grandmother 's friend 's car is young .	the dish scares my teacher 's grandmother 's friend 's car is young .
the picture says that my brother 's boss 's father 's rug is curious .	the picture scares my brother 's boss 's father 's rug is curious .
the book knows that your wife 's doctor 's daughter 's rocket is wrong .	the book talks to your wife 's doctor 's daughter 's rocket is wrong .
the mirror knows that my friend 's dentist 's dad 's crayon is healthy .	the mirror scares my friend 's dentist 's dad 's crayon is healthy .
the cup thinks that your doctor 's dad 's boss 's chair is strong .	the cup works with your doctor 's dad 's boss 's chair is strong .
the bowl says that my daughter 's daughter 's mom 's bicycle is confused .	the bowl talks to my daughter 's daughter 's mom 's bicycle is confused .
the ship knows that your dad 's mom 's brother 's picture is helpful .	the ship helps your dad 's mom 's brother 's picture is helpful .
the crayon thinks that my grandmother 's dentist 's grandmother 's bed is bored .	the crayon helps my grandmother 's dentist 's grandmother 's bed is bored .
the hat thinks that my doctor 's doctor 's doctor 's bottle is friendly .	the hat talks to my doctor 's doctor 's doctor 's bottle is friendly .
the truck thinks that your dad 's brother 's teacher 's hat is hungry .	the truck scares your dad 's brother 's teacher 's hat is hungry .
the book says that my dentist 's son 's boss 's bowl is important .	the book scares my dentist 's son 's boss 's bowl is important .
the glass knows that your husband 's son 's brother 's car is clever .	the glass talks to your husband 's son 's brother 's car is clever .
the truck says that my doctor 's brother 's grandmother 's book is surprised .	the truck talks to my doctor 's brother 's grandmother 's book is surprised .
the rocket says that your grandmother 's friend 's teacher 's plate is hungry .	the rocket scares your grandmother 's friend 's teacher 's plate is hungry .
the box knows that your mom 's dad 's son 's rug is angry .	the box scares your mom 's dad 's son 's rug is angry .
the window thinks that your grandmother 's brother 's sister 's bag is tall .	the window scares your grandmother 's brother 's sister 's bag is tall .
the spoon knows that my sister 's dad 's dentist 's picture is happy .	the spoon scares my sister 's dad 's dentist 's picture is happy .
the candle knows that your brother 's grandmother 's doctor 's bicycle is excited .	the candle scares your brother 's grandmother 's doctor 's bicycle is excited .
the door knows that your mother 's mom 's sister 's crayon is nice .	the door talks to your mother 's mom 's sister 's crayon is nice .
the hat knows that my son 's dentist 's daughter 's bed is friendly .	the hat scares my son 's dentist 's daughter 's bed is friendly .
the bicycle knows that my dad 's wife 's teacher 's fork is important .	the bicycle helps my dad 's wife 's teacher 's fork is important .
the rocket thinks that your wife 's friend 's grandmother 's boat is curious .	the rocket scares your wife 's friend 's grandmother 's boat is curious .
the truck says that my wife 's cousin 's son 's spoon is sleepy .	the truck helps my wife 's cousin 's son 's spoon is sleepy .
the bowl knows that your teacher 's teacher 's brother 's ship is healthy .	the bowl helps your teacher 's teacher 's brother 's ship is healthy .
the book says that your father 's doctor 's doctor 's chair is boring .	the book helps your father 's doctor 's doctor 's chair is boring .
the truck says that my boss 's doctor 's father 's box is nice .	the truck helps my boss 's doctor 's father 's box is nice .
the car thinks that my cousin 's doctor 's mother 's ring is strong .	the car talks to my cousin 's doctor 's mother 's ring is strong .
the ring says that my dentist 's mom 's mom 's car is angry .	the ring helps my dentist 's mom 's mom 's car is angry .
the cup knows that your cousin 's sister 's boss 's rug is strong .	the cup helps your cousin 's sister 's boss 's rug is strong .
the chair says that your mom 's sister 's wife 's mirror is smart .	the chair talks to your mom 's sister 's wife 's mirror is smart .
the toy says that your son 's doctor 's dad 's fork is important .	the toy works with your son 's doctor 's dad 's fork is important .
the bag says that my son 's husband 's grandmother 's door is busy .	the bag works with my son 's husband 's grandmother 's door is busy .
the hat says that your mother 's dentist 's boss 's ship is excited .	the hat scares your mother 's dentist 's boss 's ship is excited .
the book knows that my dad 's wife 's daughter 's shoe is strong .	the book talks to my dad 's wife 's daughter 's shoe is strong .
the cup says that your dad 's teacher 's daughter 's shirt is kind .	the cup scares your dad 's teacher 's daughter 's shirt is kind .
the hat thinks that your daughter 's mother 's dad 's cup is bored .	the hat talks to your daughter 's mother 's dad 's cup is bored .
the bottle thinks that my mother 's friend 's mother 's car is sleepy .	the bottle helps my mother 's friend 's mother 's car is sleepy .
the dish thinks that your wife 's wife 's mother 's plane is quiet .	the dish helps your wife 's wife 's mother 's plane is quiet .
the rocket thinks that your mom 's cousin 's father 's fork is careful .	the rocket helps your mom 's cousin 's father 's fork is careful .
the crayon knows that my doctor 's dentist 's friend 's plane is clever .	the crayon helps my doctor 's dentist 's friend 's plane is clever .
the ship says that your daughter 's mother 's grandmother 's picture is nice .	the ship talks to your daughter 's mother 's grandmother 's picture is nice .
the couch knows that my dentist 's son 's dentist 's truck is confused .	the couch talks to my dentist 's son 's dentist 's truck is confused .
the plane says that your boss 's wife 's wife 's dish is sleepy .	the plane works with your boss 's wife 's wife 's dish is sleepy .
the bowl thinks that your father 's brother 's mother 's ship is happy .	the bowl scares your father 's brother 's mother 's ship is happy .
the cup says that my doctor 's son 's brother 's shoe is clever .	the cup helps my doctor 's son 's brother 's shoe is clever .
the book knows that my friend 's friend 's friend 's ring is wrong .	the book scares my friend 's friend 's friend 's ring is wrong .
the plate knows that my dad 's dad 's grandmother 's bed is busy .	the plate works with my dad 's dad 's grandmother 's bed is busy .
the bottle says that my husband 's mom 's son 's hat is bored .	the bottle scares my husband 's mom 's son 's hat is bored .
the hat knows that my husband 's husband 's grandmother 's bowl is hungry .	the hat scares my husband 's husband 's grandmother 's bowl is hungry .
the truck thinks that your mother 's son 's boss 's window is boring .	the truck scares your mother 's son 's boss 's window is boring .
the chair says that your friend 's teacher 's grandmother 's crayon is kind .	the chair scares your friend 's teacher 's grandmother 's crayon is kind .
the glass says that my teacher 's husband 's son 's car is lucky .	the glass works with my teacher 's husband 's son 's car is lucky .
the shirt thinks that my wife 's daughter 's grandmother 's window is upset .	the shirt works with my wife 's daughter 's grandmother 's window is upset .
the rug says that my mom 's father 's grandmother 's book is surprised .	the rug scares my mom 's father 's grandmother 's book is surprised .
the bowl says that my son 's friend 's father 's door is young .	the bowl works with my son 's friend 's father 's door is young .
the bicycle says that your daughter 's mother 's mother 's bicycle is nice .	the bicycle helps your daughter 's mother 's mother 's bicycle is nice .
the fork thinks that your cousin 's wife 's teacher 's rocket is friendly .	the fork talks to your cousin 's wife 's teacher 's rocket is friendly .
the bicycle knows that your mom 's husband 's brother 's plate is curious .	the bicycle works with your mom 's husband 's brother 's plate is curious .
the cup thinks that my dad 's father 's friend 's window is upset .	the cup scares my dad 's father 's friend 's window is upset .
the car thinks that your father 's son 's brother 's fork is hungry .	the car helps your father 's son 's brother 's fork is hungry .
the crayon says that my dentist 's friend 's teacher 's boat is tall .	the crayon talks to my dentist 's friend 's teacher 's boat is tall .
the spoon thinks that my mom 's doctor 's boss 's spoon is careful .	the spoon works with my mom 's doctor 's boss 's spoon is careful .
the rug thinks that my father 's doctor 's friend 's door is excited .	the rug talks to my father 's doctor 's friend 's door is excited .
the chair knows that your grandmother 's boss 's son 's spoon is nice .	the chair talks to your grandmother 's boss 's son 's spoon is nice .
the rocket knows that your brother 's father 's mother 's bed is helpful .	the rocket scares your brother 's father 's mother 's bed is helpful .
the car knows that my mom 's cousin 's grandmother 's hat is friendly .	the car works with my mom 's cousin 's grandmother 's hat is friendly .
the mirror says that your wife 's father 's brother 's dish is careful .	the mirror scares your wife 's father 's brother 's dish is careful .
the plane says that my mother 's doctor 's mother 's window is tired .	the plane scares my mother 's doctor 's mother 's window is tired .
the shirt knows that your daughter 's father 's sister 's shoe is important .	the shirt works with your daughter 's father 's sister 's shoe is important .
the hat thinks that your friend 's cousin 's son 's chair is helpful .	the hat scares your friend 's cousin 's son 's chair is helpful .
the spoon thinks that my friend 's father 's wife 's box is helpful .	the spoon talks to my friend 's father 's wife 's box is helpful .
the mirror knows that your father 's friend 's son 's rocket is nice .	the mirror works with your father 's friend 's son 's rocket is nice .
the truck knows that my wife 's boss 's son 's plate is hungry .	the truck scares my wife 's boss 's son 's plate is hungry .
the book knows that your mother 's cousin 's boss 's bed is careful .	the book helps your mother 's cousin 's boss 's bed is careful .
the doll knows that your cousin 's father 's dentist 's ship is curious .	the doll scares your cousin 's father 's dentist 's ship is curious .
the bag knows that your sister 's boss 's husband 's candle is young .	the bag scares your sister 's boss 's husband 's candle is young .
the bed knows that my father 's mother 's dentist 's window is quiet .	the bed talks to my father 's mother 's dentist 's window is quiet .
the candle thinks that my cousin 's brother 's son 's book is upset .	the candle helps my cousin 's brother 's son 's book is upset .
the picture says that your son 's son 's dad 's button is upset .	the picture works with your son 's son 's dad 's button is upset .
the dish thinks that your mom 's father 's boss 's glass is quiet .	the dish helps your mom 's father 's boss 's glass is quiet .
the toy thinks that my wife 's mom 's dentist 's ship is healthy .	the toy talks to my wife 's mom 's dentist 's ship is healthy .
the rocket knows that my mom 's cousin 's grandmother 's ship is tired .	the rocket works with my mom 's cousin 's grandmother 's ship is tired .
the bicycle knows that my father 's mother 's father 's truck is excited .	the bicycle helps my father 's mother 's father 's truck is excited .
the button thinks that your wife 's boss 's daughter 's picture is wrong .	the button helps your wife 's boss 's daughter 's picture is wrong .
the book says that your son 's dentist 's friend 's chair is important .	the book helps your son 's dentist 's friend 's chair is important .
the boat thinks that my husband 's friend 's dad 's picture is quiet .	the boat talks to my husband 's friend 's dad 's picture is quiet .
the book thinks that my wife 's teacher 's wife 's plane is tired .	the book works with my wife 's teacher 's wife 's plane is tired .
the fork thinks that my brother 's friend 's wife 's car is healthy .	the fork scares my brother 's friend 's wife 's car is healthy .
the bowl thinks that my sister 's cousin 's sister 's dish is kind .	the bowl helps my sister 's cousin 's sister 's dish is kind .
the window knows that your brother 's teacher 's mom 's box is angry .	the window talks to your brother 's teacher 's mom 's box is angry .
the spoon says that my son 's brother 's mom 's ring is wrong .	the spoon helps my son 's brother 's mom 's ring is wrong .
the rocket thinks that my dad 's sister 's dad 's dish is hungry .	the rocket works with my dad 's sister 's dad 's dish is hungry .
the glass says that my teacher 's dad 's dentist 's doll is gentle .	the glass scares my teacher 's dad 's dentist 's doll is gentle .
the doll knows that my daughter 's teacher 's dad 's bag is kind .	the doll talks to my daughter 's teacher 's dad 's bag is kind .
the ship thinks that your son 's dentist 's teacher 's bag is boring .	the ship helps your son 's dentist 's teacher 's bag is boring .
the book says that your mother 's sister 's boss 's crayon is happy .	the book scares your mother 's sister 's boss 's crayon is happy .
the shoe knows that your brother 's son 's grandmother 's bicycle is excited .	the shoe scares your brother 's son 's grandmother 's bicycle is excited .
the ship knows that my mother 's friend 's father 's rocket is friendly .	the ship helps my mother 's friend 's father 's rocket is friendly .
the dish says that my son 's son 's mother 's ship is boring .	the dish talks to my son 's son 's mother 's ship is boring .
the truck says that your mother 's dentist 's dad 's bicycle is quiet .	the truck talks to your mother 's dentist 's dad 's bicycle is quiet .
the glass knows that your brother 's cousin 's cousin 's shoe is healthy .	the glass scares your brother 's cousin 's cousin 's shoe is healthy .
the shirt thinks that my father 's doctor 's wife 's spoon is upset .	the shirt helps my father 's doctor 's wife 's spoon is upset .
the mirror thinks that your dentist 's son 's mother 's button is surprised .	the mirror talks to your dentist 's son 's mother 's button is surprised .
the candle knows that your brother 's friend 's dad 's plate is wrong .	the candle talks to your brother 's friend 's dad 's plate is wrong .
the chair knows that my mom 's cousin 's dad 's window is boring .	the chair talks to my mom 's cousin 's dad 's window is boring .
the dish knows that your mom 's sister 's wife 's plane is tired .	the dish talks to your mom 's sister 's wife 's plane is tired .
the bicycle knows that my doctor 's son 's brother 's hat is careful .	the bicycle works with my doctor 's son 's brother 's hat is careful .
the bowl knows that your boss 's grandmother 's daughter 's doll is hungry .	the bowl scares your boss 's grandmother 's daughter 's doll is hungry .
the button knows that my dentist 's doctor 's brother 's truck is wrong .	the button helps my dentist 's doctor 's brother 's truck is wrong .
the window says that my sister 's doctor 's father 's door is kind .	the window scares my sister 's doctor 's father 's door is kind .
the bowl knows that your dentist 's mother 's friend 's bed is upset .	the bowl works with your dentist 's mother 's friend 's bed is upset .
the car knows that your dad 's daughter 's father 's shirt is busy .	the car helps your dad 's daughter 's father 's shirt is busy .
the plane thinks that your mother 's grandmother 's boss 's candle is kind .	the plane talks to your mother 's grandmother 's boss 's candle is kind .
the button says that my son 's friend 's grandmother 's chair is lucky .	the button scares my son 's friend 's grandmother 's chair is lucky .
the rocket thinks that my husband 's sister 's wife 's rocket is lucky .	the rocket works with my husband 's sister 's wife 's rocket is lucky .
the car knows that your father 's mom 's boss 's car is excited .	the car helps your father 's mom 's boss 's car is excited .
the chair knows that my father 's dentist 's cousin 's bicycle is excited .	the chair helps my father 's dentist 's cousin 's bicycle is excited .
the fork knows that your teacher 's mom 's mother 's picture is quiet .	the fork scares your teacher 's mom 's mother 's picture is quiet .
the box thinks that your cousin 's mother 's boss 's plate is sleepy .	the box talks to your cousin 's mother 's boss 's plate is sleepy .
the candle says that your mother 's mom 's boss 's plate is angry .	the candle helps your mother 's mom 's boss 's plate is angry .
the ring says that your grandmother 's brother 's husband 's bowl is happy .	the ring scares your grandmother 's brother 's husband 's bowl is happy .
the spoon says that your cousin 's son 's brother 's button is hungry .	the spoon works with your cousin 's son 's brother 's button is hungry .
the doll says that my doctor 's doctor 's mother 's chair is busy .	the doll works with my doctor 's doctor 's mother 's chair is busy .
the toy knows that my brother 's mother 's brother 's mirror is friendly .	the toy talks to my brother 's mother 's brother 's mirror is friendly .
the door says that your boss 's doctor 's mother 's window is excited .	the door scares your boss 's doctor 's mother 's window is excited .
the window knows that your father 's wife 's boss 's rug is healthy .	the window helps your father 's wife 's boss 's rug is healthy .
the boat thinks that my mom 's cousin 's grandmother 's doll is quiet .	the boat helps my mom 's cousin 's grandmother 's doll is quiet .
the plate thinks that my mom 's brother 's wife 's car is strong .	the plate talks to my mom 's brother 's wife 's car is strong .
the crayon thinks that your son 's mother 's doctor 's button is confused .	the crayon works with your son 's mother 's doctor 's button is confused .
the bowl says that your doctor 's son 's friend 's boat is wrong .	the bowl works with your doctor 's son 's friend 's boat is wrong .
the ring knows that my dad 's cousin 's brother 's bottle is lucky .	the ring talks to my dad 's cousin 's brother 's bottle is lucky .
the candle knows that your mom 's friend 's mom 's chair is tall .	the candle talks to your mom 's friend 's mom 's chair is tall .
the truck says that my father 's teacher 's cousin 's plane is lucky .	the truck talks to my father 's teacher 's cousin 's plane is lucky .
the car says that your son 's mom 's grandmother 's boat is confused .	the car helps your son 's mom 's grandmother 's boat is confused .
the shoe says that your teacher 's mother 's dentist 's shoe is sleepy .	the shoe helps your teacher 's mother 's dentist 's shoe is sleepy .
the crayon thinks that your wife 's mother 's father 's shirt is bored .	the crayon talks to your wife 's mother 's father 's shirt is bored .
the book knows that my cousin 's mother 's son 's plane is important .	the book scares my cousin 's mother 's son 's plane is important .
the book says that my friend 's boss 's teacher 's cup is helpful .	the book works with my friend 's boss 's teacher 's cup is helpful .
the crayon knows that my daughter 's mother 's daughter 's book is angry .	the crayon helps my daughter 's mother 's daughter 's book is angry .
the shoe knows that my son 's father 's grandmother 's car is surprised .	the shoe helps my son 's father 's grandmother 's car is surprised .
the ship says that my father 's dentist 's daughter 's book is bored .	the ship scares my father 's dentist 's daughter 's book is bored .
the bottle thinks that my cousin 's doctor 's father 's window is smart .	the bottle works with my cousin 's doctor 's father 's window is smart .
the hat knows that my boss 's son 's mother 's bed is upset .	the hat scares my boss 's son 's mother 's bed is upset .
the fork knows that my doctor 's mother 's sister 's chair is busy .	the fork scares my doctor 's mother 's sister 's chair is busy .
the ring thinks that my dad 's dad 's son 's boat is clever .	the ring helps my dad 's dad 's son 's boat is clever .
the chair knows that your dentist 's sister 's dad 's plane is kind .	the chair talks to your dentist 's sister 's dad 's plane is kind .
the car thinks that my daughter 's brother 's mom 's fork is tall .	the car works with my daughter 's brother 's mom 's fork is tall .
the ship knows that my cousin 's daughter 's friend 's plane is strong .	the ship helps my cousin 's daughter 's friend 's plane is strong .
the couch thinks that your teacher 's dentist 's boss 's bed is tall .	the couch scares your teacher 's dentist 's boss 's bed is tall .
the bed thinks that your brother 's boss 's mother 's book is gentle .	the bed helps your brother 's boss 's mother 's book is gentle .
the spoon knows that your grandmother 's cousin 's son 's button is young .	the spoon talks to your grandmother 's cousin 's son 's button is young .
the dish says that my grandmother 's sister 's friend 's shoe is angry .	the dish scares my grandmother 's sister 's friend 's shoe is angry .
the ship says that your daughter 's mom 's wife 's truck is tired .	the ship works with your daughter 's mom 's wife 's truck is tired .
the candle says that your boss 's brother 's husband 's rocket is bored .	the candle scares your boss 's brother 's husband 's rocket is bored .
the hat knows that my mom 's father 's daughter 's bowl is friendly .	the hat helps my mom 's father 's daughter 's bowl is friendly .
the bag thinks that your brother 's dad 's teacher 's toy is lucky .	the bag works with your brother 's dad 's teacher 's toy is lucky .
the couch says that your dad 's cousin 's doctor 's button is angry .	the couch works with your dad 's cousin 's doctor 's button is angry .
the ship thinks that my father 's son 's boss 's bottle is surprised .	the ship helps my father 's son 's boss 's bottle is surprised .
the ship thinks that my mom 's friend 's father 's window is smart .	the ship talks to my mom 's friend 's father 's window is smart .
the shoe knows that your daughter 's teacher 's boss 's chair is careful .	the shoe talks to your daughter 's teacher 's boss 's chair is careful .
the rug knows that my teacher 's cousin 's son 's window is upset .	the rug talks to my teacher 's cousin 's son 's window is upset .
the bicycle knows that my grandmother 's husband 's doctor 's glass is wrong .	the bicycle helps my grandmother 's husband 's doctor 's glass is wrong .
the truck knows that my friend 's mother 's mom 's toy is young .	the truck scares my friend 's mother 's mom 's toy is young .
the hat says that my boss 's husband 's mom 's car is angry .	the hat scares my boss 's husband 's mom 's car is angry .
the picture knows that your wife 's brother 's doctor 's hat is lucky .	the picture works with your wife 's brother 's doctor 's hat is lucky .
the plane knows that my son 's dad 's friend 's plane is young .	the plane scares my son 's dad 's friend 's plane is young .
the door thinks that my wife 's mother 's teacher 's plate is tall .	the door helps my wife 's mother 's teacher 's plate is tall .
the chair says that your sister 's son 's grandmother 's picture is busy .	the chair helps your sister 's son 's grandmother 's picture is busy .
the shirt knows that your dad 's mom 's dentist 's plate is boring .	the shirt helps your dad 's mom 's dentist 's plate is boring .
the button knows that my wife 's daughter 's wife 's boat is healthy .	the button works with my wife 's daughter 's wife 's boat is healthy .
the fork thinks that my dentist 's sister 's mom 's bottle is helpful .	the fork scares my dentist 's sister 's mom 's bottle is helpful .
the fork knows that your sister 's boss 's husband 's car is tall .	the fork works with your sister 's boss 's husband 's car is tall .
the book knows that my father 's sister 's cousin 's rocket is hungry .	the book helps my father 's sister 's cousin 's rocket is hungry .
the hat knows that your father 's daughter 's mother 's toy is tired .	the hat helps your father 's daughter 's mother 's toy is tired .
the plate thinks that my wife 's dad 's friend 's dish is angry .	the plate helps my wife 's dad 's friend 's dish is angry .
the toy knows that your brother 's wife 's grandmother 's spoon is hungry .	the toy works with your brother 's wife 's grandmother 's spoon is hungry .
the bag thinks that your dad 's cousin 's doctor 's door is tall .	the bag helps your dad 's cousin 's doctor 's door is tall .
the crayon says that my mother 's son 's teacher 's toy is kind .	the crayon scares my mother 's son 's teacher 's toy is kind .
the doll says that your teacher 's friend 's dentist 's dish is excited .	the doll scares your teacher 's friend 's dentist 's dish is excited .
the button knows that your mom 's boss 's cousin 's glass is lucky .	the button works with your mom 's boss 's cousin 's glass is lucky .
the candle says that your teacher 's mother 's mom 's car is bored .	the candle talks to your teacher 's mother 's mom 's car is bored .
the mirror says that my doctor 's husband 's dad 's spoon is gentle .	the mirror talks to my doctor 's husband 's dad 's spoon is gentle .
the rug says that your daughter 's mom 's husband 's candle is tired .	the rug scares your daughter 's mom 's husband 's candle is tired .
the truck knows that my friend 's father 's dad 's picture is hungry .	the truck talks to my friend 's father 's dad 's picture is hungry .
the truck thinks that your teacher 's boss 's sister 's truck is angry .	the truck scares your teacher 's boss 's sister 's truck is angry .
the glass says that your mother 's mom 's dad 's bicycle is happy .	the glass helps your mother 's mom 's dad 's bicycle is happy .
the bowl knows that your brother 's husband 's father 's plate is important .	the bowl talks to your brother 's husband 's father 's plate is important .
the plate thinks that my mother 's wife 's brother 's book is healthy .	the plate helps my mother 's wife 's brother 's book is healthy .
the bowl says that your dentist 's cousin 's husband 's box is tall .	the bowl scares your dentist 's cousin 's husband 's box is tall .
the boat says that your dad 's doctor 's wife 's doll is upset .	the boat scares your dad 's doctor 's wife 's doll is upset .
the bowl knows that your sister 's teacher 's friend 's bottle is helpful .	the bowl talks to your sister 's teacher 's friend 's bottle is helpful .
the door says that my dad 's teacher 's wife 's bowl is busy .	the door works with my dad 's teacher 's wife 's bowl is busy .
the plate says that your teacher 's husband 's wife 's ship is nice .	the plate helps your teacher 's husband 's wife 's ship is nice .
the book says that my husband 's dad 's son 's chair is nice .	the book scares my husband 's dad 's son 's chair is nice .
the boat thinks that your boss 's cousin 's boss 's picture is bored .	the boat talks to your boss 's cousin 's boss 's picture is bored .
the book says that your brother 's husband 's grandmother 's plate is boring .	the book works with your brother 's husband 's grandmother 's plate is boring .
the plate thinks that my son 's son 's doctor 's chair is healthy .	the plate talks to my son 's son 's doctor 's chair is healthy .
the boat thinks that my brother 's dad 's grandmother 's plane is confused .	the boat scares my brother 's dad 's grandmother 's plane is confused .
the couch knows that my wife 's dad 's sister 's window is healthy .	the couch scares my wife 's dad 's sister 's window is healthy .
the crayon says that your sister 's doctor 's cousin 's plane is quiet .	the crayon works with your sister 's doctor 's cousin 's plane is quiet .
the toy thinks that my father 's doctor 's mom 's spoon is wrong .	the toy scares my father 's doctor 's mom 's spoon is wrong .
the truck says that my daughter 's father 's doctor 's book is healthy .	the truck helps my daughter 's father 's doctor 's book is healthy .
the candle thinks that my son 's sister 's dentist 's boat is strong .	the candle talks to my son 's sister 's dentist 's boat is strong .
the candle says that my mom 's brother 's mom 's couch is excited .	the candle helps my mom 's brother 's mom 's couch is excited .
the shoe knows that my friend 's friend 's son 's box is hungry .	the shoe talks to my friend 's friend 's son 's box is hungry .
the truck says that your husband 's cousin 's dentist 's hat is busy .	the truck helps your husband 's cousin 's dentist 's hat is busy .
the hat thinks that your grandmother 's daughter 's dad 's hat is tired .	the hat scares your grandmother 's daughter 's dad 's hat is tired .
the toy thinks that your dentist 's mother 's mom 's spoon is wrong .	the toy talks to your dentist 's mother 's mom 's spoon is wrong .
the glass says that my wife 's brother 's sister 's window is excited .	the glass works with my wife 's brother 's sister 's window is excited .
the door says that your son 's brother 's cousin 's dish is sleepy .	the door works with your son 's brother 's cousin 's dish is sleepy .
the bottle says that my father 's wife 's daughter 's picture is quiet .	the bottle works with my father 's wife 's daughter 's picture is quiet .
the picture thinks that my brother 's wife 's dentist 's box is young .	the picture helps my brother 's wife 's dentist 's box is young .
the cup says that your friend 's mother 's brother 's door is clever .	the cup scares your friend 's mother 's brother 's door is clever .
the spoon knows that your sister 's father 's father 's door is bored .	the spoon works with your sister 's father 's father 's door is bored .
the book thinks that my mother 's teacher 's daughter 's candle is tired .	the book talks to my mother 's teacher 's daughter 's candle is tired .
the rug thinks that my cousin 's son 's cousin 's bowl is careful .	the rug talks to my cousin 's son 's cousin 's bowl is careful .
the fork knows that my daughter 's teacher 's mother 's window is healthy .	the fork talks to my daughter 's teacher 's mother 's window is healthy .
the picture says that your teacher 's friend 's son 's plate is nice .	the picture scares your teacher 's friend 's son 's plate is nice .
the couch knows that my wife 's brother 's dad 's spoon is boring .	the couch helps my wife 's brother 's dad 's spoon is boring .
the door knows that your dentist 's mother 's daughter 's shirt is curious .	the door scares your dentist 's mother 's daughter 's shirt is curious .
the door thinks that your cousin 's friend 's sister 's plate is confused .	the door helps your cousin 's friend 's sister 's plate is confused .
the crayon knows that my brother 's dentist 's wife 's toy is friendly .	the crayon helps my brother 's dentist 's wife 's toy is friendly .
the ship says that my wife 's father 's wife 's bicycle is hungry .	the ship talks to my wife 's father 's wife 's bicycle is hungry .
the shoe says that my sister 's brother 's dad 's spoon is nice .	the shoe scares my sister 's brother 's dad 's spoon is nice .
the boat says that my grandmother 's daughter 's teacher 's glass is quiet .	the boat helps my grandmother 's daughter 's teacher 's glass is quiet .
the plane knows that your teacher 's brother 's daughter 's fork is smart .	the plane works with your teacher 's brother 's daughter 's fork is smart .
the candle knows that my sister 's teacher 's mother 's window is confused .	the candle scares my sister 's teacher 's mother 's window is confused .
the picture thinks that my teacher 's mom 's dentist 's crayon is important .	the picture scares my teacher 's mom 's dentist 's crayon is important .
the truck knows that your cousin 's grandmother 's father 's boat is friendly .	the truck helps your cousin 's grandmother 's father 's boat is friendly .
the glass says that my sister 's grandmother 's son 's bicycle is curious .	the glass scares my sister 's grandmother 's son 's bicycle is curious .
the plane knows that my husband 's daughter 's mother 's fork is careful .	the plane helps my husband 's daughter 's mother 's fork is careful .
the candle thinks that your doctor 's father 's cousin 's doll is quiet .	the candle works with your doctor 's father 's cousin 's doll is quiet .
the hat thinks that my husband 's sister 's father 's hat is hungry .	the hat helps my husband 's sister 's father 's hat is hungry .
the ring says that my mother 's doctor 's dad 's mirror is friendly .	the ring helps my mother 's doctor 's dad 's mirror is friendly .
the door knows that my mother 's son 's doctor 's shirt is lucky .	the door talks to my mother 's son 's doctor 's shirt is lucky .
the car thinks that your teacher 's teacher 's husband 's fork is wrong .	the car scares your teacher 's teacher 's husband 's fork is wrong .
the shoe says that your teacher 's doctor 's husband 's bottle is kind .	the shoe talks to your teacher 's doctor 's husband 's bottle is kind .
the book thinks that my mom 's mother 's teacher 's spoon is healthy .	the book scares my mom 's mother 's teacher 's spoon is healthy .
the car knows that my friend 's husband 's cousin 's ring is tired .	the car helps my friend 's husband 's cousin 's ring is tired .
the book says that your husband 's brother 's friend 's rocket is surprised .	the book talks to your husband 's brother 's friend 's rocket is surprised .
the car says that my sister 's cousin 's grandmother 's book is gentle .	the car works with my sister 's cousin 's grandmother 's book is gentle .
the couch knows that my cousin 's grandmother 's doctor 's picture is excited .	the couch works with my cousin 's grandmother 's doctor 's picture is excited .
the window says that your friend 's wife 's husband 's spoon is friendly .	the window works with your friend 's wife 's husband 's spoon is friendly .
the car says that my brother 's father 's son 's window is helpful .	the car talks to my brother 's father 's son 's window is helpful .
the box says that my son 's brother 's son 's bowl is happy .	the box scares my son 's brother 's son 's bowl is happy .
the bicycle says that my doctor 's mom 's daughter 's door is friendly .	the bicycle works with my doctor 's mom 's daughter 's door is friendly .
the hat thinks that my friend 's husband 's daughter 's shoe is sleepy .	the hat helps my friend 's husband 's daughter 's shoe is sleepy .
the book says that your daughter 's dad 's friend 's plane is wrong .	the book works with your daughter 's dad 's friend 's plane is wrong .
the plate knows that your brother 's wife 's cousin 's shirt is surprised .	the plate works with your brother 's wife 's cousin 's shirt is surprised .
the spoon knows that my doctor 's dad 's mom 's book is clever .	the spoon works with my doctor 's dad 's mom 's book is clever .
the bottle thinks that my grandmother 's dentist 's father 's doll is quiet .	the bottle helps my grandmother 's dentist 's father 's doll is quiet .
the truck says that your dad 's teacher 's sister 's book is friendly .	the truck helps your dad 's teacher 's sister 's book is friendly .
the car thinks that your friend 's boss 's mom 's ship is clever .	the car talks to your friend 's boss 's mom 's ship is clever .
the chair knows that my daughter 's cousin 's teacher 's book is careful .	the chair helps my daughter 's cousin 's teacher 's book is careful .
the bed knows that your sister 's son 's dad 's fork is surprised .	the bed works with your sister 's son 's dad 's fork is surprised .
the crayon thinks that my friend 's son 's friend 's rug is gentle .	the crayon scares my friend 's son 's friend 's rug is gentle .
the bed says that my husband 's wife 's daughter 's door is confused .	the bed helps my husband 's wife 's daughter 's door is confused .
the picture knows that my grandmother 's dentist 's son 's door is helpful .	the picture helps my grandmother 's dentist 's son 's door is helpful .
the cup thinks that your daughter 's father 's husband 's rocket is surprised .	the cup talks to your daughter 's father 's husband 's rocket is surprised .
the cup says that my cousin 's husband 's father 's box is helpful .	the cup scares my cousin 's husband 's father 's box is helpful .
the bicycle knows that your husband 's teacher 's sister 's box is clever .	the bicycle scares your husband 's teacher 's sister 's box is clever .
the bed says that your mother 's friend 's husband 's book is sleepy .	the bed scares your mother 's friend 's husband 's book is sleepy .
the shoe says that my son 's grandmother 's wife 's rocket is busy .	the shoe talks to my son 's grandmother 's wife 's rocket is busy .
the spoon says that your doctor 's friend 's grandmother 's shirt is kind .	the spoon works with your doctor 's friend 's grandmother 's shirt is kind .
the spoon says that your father 's daughter 's doctor 's shoe is hungry .	the spoon helps your father 's daughter 's doctor 's shoe is hungry .
the plate thinks that your brother 's brother 's dentist 's door is excited .	the plate scares your brother 's brother 's dentist 's door is excited .
the rug says that my son 's grandmother 's brother 's toy is healthy .	the rug talks to my son 's grandmother 's brother 's toy is healthy .
the picture knows that my boss 's mother 's brother 's ring is quiet .	the picture talks to my boss 's mother 's brother 's ring is quiet .
the boat knows that your boss 's friend 's sister 's couch is busy .	the boat talks to your boss 's friend 's sister 's couch is busy .
the spoon thinks that your boss 's son 's mom 's candle is lucky .	the spoon helps your boss 's son 's mom 's candle is lucky .
the candle knows that my son 's mother 's wife 's picture is tired .	the candle talks to my son 's mother 's wife 's picture is tired .
the bed says that your dad 's grandmother 's cousin 's bag is strong .	the bed works with your dad 's grandmother 's cousin 's bag is strong .
the ring thinks that your friend 's brother 's dentist 's bicycle is angry .	the ring helps your friend 's brother 's dentist 's bicycle is angry .
the book says that your daughter 's father 's dad 's book is strong .	the book helps your daughter 's father 's dad 's book is strong .
the plate thinks that your dentist 's son 's mother 's dish is busy .	the plate scares your dentist 's son 's mother 's dish is busy .
the ring thinks that my teacher 's daughter 's cousin 's fork is tired .	the ring talks to my teacher 's daughter 's cousin 's fork is tired .
the plate says that my daughter 's daughter 's father 's shoe is young .	the plate works with my daughter 's daughter 's father 's shoe is young .
the plate knows that your son 's cousin 's daughter 's mirror is quiet .	the plate helps your son 's cousin 's daughter 's mirror is quiet .
the fork says that your cousin 's dentist 's mother 's chair is gentle .	the fork works with your cousin 's dentist 's mother 's chair is gentle .
the car says that my brother 's dentist 's dad 's bottle is lucky .	the car helps my brother 's dentist 's dad 's bottle is lucky .
the candle says that your brother 's dentist 's mom 's couch is wrong .	the candle talks to your brother 's dentist 's mom 's couch is wrong .
the crayon says that my boss 's husband 's sister 's rug is nice .	the crayon works with my boss 's husband 's sister 's rug is nice .
the plane says that your cousin 's husband 's dad 's bag is hungry .	the plane scares your cousin 's husband 's dad 's bag is hungry .
the chair thinks that my wife 's husband 's dentist 's rug is helpful .	the chair talks to my wife 's husband 's dentist 's rug is helpful .
the shirt says that your husband 's wife 's doctor 's boat is angry .	the shirt scares your husband 's wife 's doctor 's boat is angry .
the boat says that your cousin 's husband 's wife 's rocket is gentle .	the boat talks to your cousin 's husband 's wife 's rocket is gentle .
the spoon says that my daughter 's brother 's teacher 's shoe is strong .	the spoon scares my daughter 's brother 's teacher 's shoe is strong .
the bottle thinks that my boss 's boss 's son 's ship is careful .	the bottle talks to my boss 's boss 's son 's ship is careful .
the book says that your sister 's husband 's sister 's glass is clever .	the book helps your sister 's husband 's sister 's glass is clever .
the doll thinks that your grandmother 's mom 's husband 's fork is bored .	the doll talks to your grandmother 's mom 's husband 's fork is bored .
the mirror thinks that my doctor 's mother 's husband 's bowl is nice .	the mirror works with my doctor 's mother 's husband 's bowl is nice .
the ship thinks that my son 's dad 's doctor 's truck is angry .	the ship works with my son 's dad 's doctor 's truck is angry .
the ship says that your daughter 's father 's daughter 's fork is tired .	the ship scares your daughter 's father 's daughter 's fork is tired .
the fork thinks that your husband 's boss 's grandmother 's plane is friendly .	the fork scares your husband 's boss 's grandmother 's plane is friendly .
the plane says that my doctor 's father 's daughter 's book is sleepy .	the plane talks to my doctor 's father 's daughter 's book is sleepy .
the dish says that your daughter 's mom 's father 's ship is tall .	the dish helps your daughter 's mom 's father 's ship is tall .
the mirror says that your mother 's sister 's dad 's shirt is sleepy .	the mirror helps your mother 's sister 's dad 's shirt is sleepy .
the chair thinks that my husband 's doctor 's dad 's ship is confused .	the chair works with my husband 's doctor 's dad 's ship is confused .
the rocket knows that my daughter 's wife 's doctor 's picture is excited .	the rocket works with my daughter 's wife 's doctor 's picture is excited .
the ship thinks that your dad 's mom 's mother 's car is happy .	the ship scares your dad 's mom 's mother 's car is happy .
the bag knows that my dentist 's teacher 's sister 's mirror is kind .	the bag talks to my dentist 's teacher 's sister 's mirror is kind .
the chair thinks that your friend 's grandmother 's friend 's couch is kind .	the chair helps your friend 's grandmother 's friend 's couch is kind .
the plane thinks that your husband 's brother 's sister 's bag is angry .	the plane talks to your husband 's brother 's sister 's bag is angry .
the ship says that your grandmother 's daughter 's brother 's box is tall .	the ship works with your grandmother 's daughter 's brother 's box is tall .
the rocket says that your mother 's wife 's husband 's shirt is careful .	the rocket works with your mother 's wife 's husband 's shirt is careful .
the glass thinks that your son 's mother 's son 's ship is careful .	the glass helps your son 's mother 's son 's ship is careful .
the spoon knows that your mother 's daughter 's cousin 's bicycle is healthy .	the spoon scares your mother 's daughter 's cousin 's bicycle is healthy .
the dish says that my cousin 's wife 's mom 's couch is confused .	the dish helps my cousin 's wife 's mom 's couch is confused .
the mirror thinks that your wife 's dentist 's son 's doll is excited .	the mirror works with your wife 's dentist 's son 's doll is excited .
the picture knows that your wife 's wife 's grandmother 's truck is sleepy .	the picture helps your wife 's wife 's grandmother 's truck is sleepy .
the chair says that your boss 's dentist 's mom 's door is happy .	the chair scares your boss 's dentist 's mom 's door is happy .
the plane thinks that your cousin 's mother 's friend 's box is tired .	the plane talks to your cousin 's mother 's friend 's box is tired .
the fork says that your dad 's sister 's friend 's rocket is boring .	the fork scares your dad 's sister 's friend 's rocket is boring .
the ship says that your dad 's doctor 's mom 's bowl is happy .	the ship talks to your dad 's doctor 's mom 's bowl is happy .
the couch knows that your friend 's wife 's mother 's rug is confused .	the couch scares your friend 's wife 's mother 's rug is confused .
the doll says that your sister 's boss 's husband 's ring is young .	the doll talks to your sister 's boss 's husband 's ring is young .
the glass thinks that your dad 's dentist 's father 's spoon is wrong .	the glass talks to your dad 's dentist 's father 's spoon is wrong .
the glass knows that your son 's grandmother 's sister 's truck is gentle .	the glass helps your son 's grandmother 's sister 's truck is gentle .
the plane thinks that my teacher 's cousin 's doctor 's boat is friendly .	the plane helps my teacher 's cousin 's doctor 's boat is friendly .
the book thinks that my father 's brother 's son 's cup is helpful .	the book works with my father 's brother 's son 's cup is helpful .
the box thinks that your brother 's son 's boss 's plate is tall .	the box scares your brother 's son 's boss 's plate is tall .
the box knows that your wife 's dentist 's friend 's glass is clever .	the box helps your wife 's dentist 's friend 's glass is clever .
the bowl says that your boss 's sister 's doctor 's door is gentle .	the bowl scares your boss 's sister 's doctor 's door is gentle .
the shoe thinks that your mom 's dentist 's son 's cup is boring .	the shoe works with your mom 's dentist 's son 's cup is boring .
the book says that your son 's dentist 's mother 's truck is lucky .	the book helps your son 's dentist 's mother 's truck is lucky .
the chair says that your brother 's wife 's dentist 's doll is curious .	the chair works with your brother 's wife 's dentist 's doll is curious .
the bottle knows that my grandmother 's grandmother 's husband 's crayon is strong .	the bottle helps my grandmother 's grandmother 's husband 's crayon is strong .
the book thinks that your father 's boss 's teacher 's bag is young .	the book scares your father 's boss 's teacher 's bag is young .
the couch thinks that my father 's brother 's mom 's fork is wrong .	the couch works with my father 's brother 's mom 's fork is wrong .
the fork knows that your grandmother 's daughter 's doctor 's book is surprised .	the fork scares your grandmother 's daughter 's doctor 's book is surprised .
the fork thinks that your cousin 's brother 's teacher 's car is wrong .	the fork talks to your cousin 's brother 's teacher 's car is wrong .
the rug says that your wife 's grandmother 's mother 's couch is curious .	the rug scares your wife 's grandmother 's mother 's couch is curious .
the boat thinks that my grandmother 's husband 's boss 's spoon is strong .	the boat works with my grandmother 's husband 's boss 's spoon is strong .
the rocket says that my wife 's cousin 's sister 's button is kind .	the rocket works with my wife 's cousin 's sister 's button is kind .
the ship thinks that my wife 's boss 's dentist 's toy is curious .	the ship scares my wife 's boss 's dentist 's toy is curious .
the dish thinks that your wife 's brother 's cousin 's bicycle is happy .	the dish talks to your wife 's brother 's cousin 's bicycle is happy .
the bicycle knows that my mother 's dentist 's boss 's window is happy .	the bicycle talks to my mother 's dentist 's boss 's window is happy .
the box says that your teacher 's cousin 's grandmother 's plane is helpful .	the box scares your teacher 's cousin 's grandmother 's plane is helpful .
the spoon says that your dad 's daughter 's grandmother 's couch is gentle .	the spoon helps your dad 's daughter 's grandmother 's couch is gentle .
the bowl says that your sister 's wife 's sister 's fork is nice .	the bowl works with your sister 's wife 's sister 's fork is nice .
the book thinks that my father 's husband 's boss 's ship is kind .	the book works with my father 's husband 's boss 's ship is kind .
the bed thinks that my sister 's dad 's wife 's bed is friendly .	the bed helps my sister 's dad 's wife 's bed is friendly .
the hat says that your cousin 's doctor 's wife 's shirt is helpful .	the hat talks to your cousin 's doctor 's wife 's shirt is helpful .
the mirror thinks that your mother 's mom 's cousin 's dish is strong .	the mirror talks to your mother 's mom 's cousin 's dish is strong .
the rug knows that my doctor 's grandmother 's dentist 's cup is clever .	the rug works with my doctor 's grandmother 's dentist 's cup is clever .
the car says that your son 's grandmother 's grandmother 's shoe is kind .	the car scares your son 's grandmother 's grandmother 's shoe is kind .
the window thinks that my dentist 's teacher 's dad 's mirror is wrong .	the window works with my dentist 's teacher 's dad 's mirror is wrong .
the rocket knows that my mom 's boss 's father 's plate is careful .	the rocket helps my mom 's boss 's father 's plate is careful .
the book thinks that my brother 's wife 's daughter 's crayon is sleepy .	the book helps my brother 's wife 's daughter 's crayon is sleepy .
the hat says that my teacher 's mom 's father 's glass is upset .	the hat helps my teacher 's mom 's father 's glass is upset .
the glass knows that your father 's mother 's teacher 's box is helpful .	the glass scares your father 's mother 's teacher 's box is helpful .
the boat says that my son 's husband 's friend 's car is bored .	the boat helps my son 's husband 's friend 's car is bored .
the ring knows that my daughter 's father 's boss 's hat is young .	the ring helps my daughter 's father 's boss 's hat is young .
the shirt thinks that your daughter 's son 's grandmother 's box is healthy .	the shirt scares your daughter 's son 's grandmother 's box is healthy .
the truck knows that your friend 's wife 's mother 's doll is smart .	the truck works with your friend 's wife 's mother 's doll is smart .
the truck knows that your daughter 's wife 's friend 's truck is sleepy .	the truck works with your daughter 's wife 's friend 's truck is sleepy .
the cup says that my daughter 's wife 's dad 's cup is confused .	the cup scares my daughter 's wife 's dad 's cup is confused .
the spoon knows that your dad 's mother 's husband 's car is healthy .	the spoon works with your dad 's mother 's husband 's car is healthy .
the spoon thinks that my sister 's friend 's daughter 's shirt is smart .	the spoon works with my sister 's friend 's daughter 's shirt is smart .
the bicycle knows that your daughter 's boss 's husband 's shoe is surprised .	the bicycle talks to your daughter 's boss 's husband 's shoe is surprised .
the cup says that your son 's father 's wife 's shoe is excited .	the cup talks to your son 's father 's wife 's shoe is excited .
the button says that your husband 's teacher 's dentist 's toy is nice .	the button works with your husband 's teacher 's dentist 's toy is nice .
the bottle thinks that your husband 's dad 's sister 's button is strong .	the bottle works with your husband 's dad 's sister 's button is strong .
the bag knows that my son 's mom 's doctor 's spoon is sleepy .	the bag helps my son 's mom 's doctor 's spoon is sleepy .
the door thinks that my dad 's husband 's daughter 's toy is surprised .	the door helps my dad 's husband 's daughter 's toy is surprised .
the car knows that my father 's grandmother 's wife 's glass is boring .	the car helps my father 's grandmother 's wife 's glass is boring .
the button knows that my doctor 's dentist 's cousin 's window is careful .	the button talks to my doctor 's dentist 's cousin 's window is careful .
the spoon says that your wife 's son 's doctor 's bag is clever .	the spoon scares your wife 's son 's doctor 's bag is clever .
the button says that your dentist 's father 's dentist 's car is wrong .	the button scares your dentist 's father 's dentist 's car is wrong .
the truck knows that my friend 's dad 's mother 's bowl is kind .	the truck works with my friend 's dad 's mother 's bowl is kind .
the glass says that my dentist 's sister 's sister 's crayon is gentle .	the glass helps my dentist 's sister 's sister 's crayon is gentle .
the bag thinks that my dentist 's boss 's boss 's ship is bored .	the bag helps my dentist 's boss 's boss 's ship is bored .
the spoon thinks that your husband 's doctor 's sister 's window is hungry .	the spoon helps your husband 's doctor 's sister 's window is hungry .
the plane knows that your son 's brother 's father 's button is helpful .	the plane scares your son 's brother 's father 's button is helpful .
the fork says that your son 's cousin 's grandmother 's ship is excited .	the fork works with your son 's cousin 's grandmother 's ship is excited .
the car knows that my teacher 's husband 's son 's candle is clever .	the car works with my teacher 's husband 's son 's candle is clever .
the bicycle knows that your son 's boss 's sister 's door is quiet .	the bicycle scares your son 's boss 's sister 's door is quiet .
the box thinks that my father 's father 's teacher 's bag is quiet .	the box talks to my father 's father 's teacher 's bag is quiet .
the book says that my teacher 's brother 's wife 's book is sleepy .	the book scares my teacher 's brother 's wife 's book is sleepy .
the truck says that my daughter 's dad 's friend 's window is confused .	the truck talks to my daughter 's dad 's friend 's window is confused .
the truck says that your wife 's grandmother 's husband 's door is hungry .	the truck scares your wife 's grandmother 's husband 's door is hungry .
the candle says that my wife 's daughter 's son 's dish is angry .	the candle scares my wife 's daughter 's son 's dish is angry .
the box knows that my boss 's cousin 's brother 's shirt is smart .	the box works with my boss 's cousin 's brother 's shirt is smart .
the bicycle knows that your husband 's cousin 's brother 's fork is upset .	the bicycle scares your husband 's cousin 's brother 's fork is upset .
the box knows that your mother 's mother 's teacher 's shoe is angry .	the box talks to your mother 's mother 's teacher 's shoe is angry .
the truck knows that my sister 's dentist 's dad 's chair is kind .	the truck helps my sister 's dentist 's dad 's chair is kind .
the window says that your teacher 's sister 's mother 's hat is sleepy .	the window scares your teacher 's sister 's mother 's hat is sleepy .
the rug says that your daughter 's son 's doctor 's bag is healthy .	the rug scares your daughter 's son 's doctor 's bag is healthy .
the door says that your friend 's teacher 's boss 's shirt is kind .	the door works with your friend 's teacher 's boss 's shirt is kind .
the crayon knows that your doctor 's boss 's husband 's rocket is bored .	the crayon works with your doctor 's boss 's husband 's rocket is bored .
the plate thinks that your son 's son 's brother 's plate is tired .	the plate helps your son 's son 's brother 's plate is tired .
the truck knows that your husband 's doctor 's boss 's toy is friendly .	the truck helps your husband 's doctor 's boss 's toy is friendly .
the hat knows that my daughter 's brother 's sister 's car is nice .	the hat talks to my daughter 's brother 's sister 's car is nice .
the bed knows that your cousin 's son 's son 's car is lucky .	the bed helps your cousin 's son 's son 's car is lucky .
the doll knows that your doctor 's grandmother 's dad 's bed is tall .	the doll helps your doctor 's grandmother 's dad 's bed is tall .
the bag says that my dentist 's boss 's brother 's ring is angry .	the bag works with my dentist 's boss 's brother 's ring is angry .
the boat thinks that my friend 's mother 's friend 's ring is careful .	the boat talks to my friend 's mother 's friend 's ring is careful .
the couch says that my dentist 's son 's teacher 's glass is helpful .	the couch works with my dentist 's son 's teacher 's glass is helpful .
the rocket says that my mom 's brother 's boss 's book is quiet .	the rocket scares my mom 's brother 's boss 's book is quiet .
the fork thinks that your brother 's wife 's dentist 's button is surprised .	the fork scares your brother 's wife 's dentist 's button is surprised .
the chair thinks that your cousin 's father 's wife 's bicycle is nice .	the chair scares your cousin 's father 's wife 's bicycle is nice .
the door says that your son 's doctor 's sister 's shoe is wrong .	the door talks to your son 's doctor 's sister 's shoe is wrong .
the picture says that your teacher 's son 's father 's toy is wrong .	the picture talks to your teacher 's son 's father 's toy is wrong .
the glass says that my mother 's brother 's mother 's bed is healthy .	the glass talks to my mother 's brother 's mother 's bed is healthy .
the candle says that my cousin 's doctor 's dad 's bed is wrong .	the candle talks to my cousin 's doctor 's dad 's bed is wrong .
the hat says that my brother 's boss 's husband 's candle is tired .	the hat scares my brother 's boss 's husband 's candle is tired .
the door says that my mom 's husband 's teacher 's rug is wrong .	the door works with my mom 's husband 's teacher 's rug is wrong .
the shoe says that your mother 's grandmother 's son 's toy is lucky .	the shoe scares your mother 's grandmother 's son 's toy is lucky .
the dish says that my dad 's daughter 's doctor 's plate is angry .	the dish works with my dad 's daughter 's doctor 's plate is angry .
the ring thinks that your friend 's wife 's mom 's mirror is quiet .	the ring talks to your friend 's wife 's mom 's mirror is quiet .
the chair thinks that your brother 's cousin 's doctor 's bag is tall .	the chair works with your brother 's cousin 's doctor 's bag is tall .
the crayon thinks that my teacher 's dentist 's son 's toy is tall .	the crayon helps my teacher 's dentist 's son 's toy is tall .
the bottle knows that my cousin 's sister 's brother 's plate is boring .	the bottle helps my cousin 's sister 's brother 's plate is boring .
the fork knows that your son 's cousin 's sister 's bowl is careful .	the fork helps your son 's cousin 's sister 's bowl is careful .
the book knows that your boss 's doctor 's father 's button is quiet .	the book talks to your boss 's doctor 's father 's button is quiet .
the door thinks that my dad 's dad 's doctor 's car is busy .	the door talks to my dad 's dad 's doctor 's car is busy .
the hat thinks that my teacher 's son 's wife 's rug is kind .	the hat helps my teacher 's son 's wife 's rug is kind .
the book knows that my sister 's son 's son 's door is excited .	the book works with my sister 's son 's son 's door is excited .
the bicycle says that my mother 's wife 's teacher 's toy is careful .	the bicycle works with my mother 's wife 's teacher 's toy is careful .
the box knows that my father 's wife 's sister 's book is important .	the box helps my father 's wife 's sister 's book is important .
the bottle knows that your husband 's teacher 's sister 's crayon is confused .	the bottle talks to your husband 's teacher 's sister 's crayon is confused .
the fork says that my wife 's teacher 's doctor 's picture is careful .	the fork works with my wife 's teacher 's doctor 's picture is careful .
the ring knows that my wife 's cousin 's dad 's rocket is curious .	the ring talks to my wife 's cousin 's dad 's rocket is curious .
the fork thinks that my dentist 's mom 's dentist 's window is busy .	the fork works with my dentist 's mom 's dentist 's window is busy .
the shirt thinks that my doctor 's friend 's sister 's button is quiet .	the shirt works with my doctor 's friend 's sister 's button is quiet .
the bed thinks that my daughter 's grandmother 's doctor 's toy is upset .	the bed works with my daughter 's grandmother 's doctor 's toy is upset .
the cup knows that your mother 's dentist 's daughter 's plate is happy .	the cup talks to your mother 's dentist 's daughter 's plate is happy .
the bowl says that your brother 's sister 's teacher 's doll is hungry .	the bowl works with your brother 's sister 's teacher 's doll is hungry .
the picture says that your boss 's teacher 's sister 's mirror is tall .	the picture works with your boss 's teacher 's sister 's mirror is tall .
the crayon knows that my mom 's sister 's son 's car is confused .	the crayon talks to my mom 's sister 's son 's car is confused .
the spoon thinks that your doctor 's husband 's wife 's truck is curious .	the spoon helps your doctor 's husband 's wife 's truck is curious .
the bottle knows that your mother 's wife 's father 's door is boring .	the bottle scares your mother 's wife 's father 's door is boring .
the couch knows that my dad 's dentist 's father 's doll is sleepy .	the couch helps my dad 's dentist 's father 's doll is sleepy .
the dish thinks that my father 's grandmother 's husband 's crayon is tired .	the dish talks to my father 's grandmother 's husband 's crayon is tired .
the shoe knows that your brother 's teacher 's doctor 's bag is clever .	the shoe talks to your brother 's teacher 's doctor 's bag is clever .
the bicycle thinks that my mother 's wife 's doctor 's rocket is young .	the bicycle talks to my mother 's wife 's doctor 's rocket is young .
the plane says that my dad 's son 's husband 's bicycle is curious .	the plane talks to my dad 's son 's husband 's bicycle is curious .
the truck thinks that your father 's dad 's grandmother 's chair is young .	the truck talks to your father 's dad 's grandmother 's chair is young .
the couch knows that your friend 's doctor 's grandmother 's book is happy .	the couch scares your friend 's doctor 's grandmother 's book is happy .
the shirt says that my dentist 's friend 's dad 's fork is excited .	the shirt works with my dentist 's friend 's dad 's fork is excited .
the bicycle knows that my friend 's dad 's cousin 's hat is careful .	the bicycle works with my friend 's dad 's cousin 's hat is careful .
