the door by the dish is boring .	the door was by the dish is boring .
the rug in the bank is young .	the rug was in the bank is young .
the picture on the floor was hungry .	the picture is on the floor was hungry .
the ship by the shirt is bored .	the ship was by the shirt is bored .
the plane on the ground was busy .	the plane is on the ground was busy .
the boat in the kitchen is friendly .	the boat was in the kitchen is friendly .
the bicycle on the couch is boring .	the bicycle was on the couch is boring .
the mirror on the table was confused .	the mirror is on the table was confused .
the toy in the library is friendly .	the toy was in the library is friendly .
the shoe on the street is nice .	the shoe was on the street is nice .
the rocket on the chair was young .	the rocket is on the chair was young .
the crayon by the window was bored .	the crayon is by the window was bored .
the glass in the museum was friendly .	the glass is in the museum was friendly .
the book on the bed is busy .	the book was on the bed is busy .
the window on the table is confused .	the window was on the table is confused .
the plate in the restaurant is bored .	the plate was in the restaurant is bored .
the dish on the table was sleepy .	the dish is on the table was sleepy .
the bowl on the table is nice .	the bowl was on the table is nice .
the hat on the couch is boring .	the hat was on the couch is boring .
the book in the school was sleepy .	the book is in the school was sleepy .
the glass by the chair is healthy .	the glass was by the chair is healthy .
the crayon in the park is lucky .	the crayon was in the park is lucky .
the chair in the restaurant was strong .	the chair is in the restaurant was strong .
the book in the museum was surprised .	the book is in the museum was surprised .
the bicycle in the library was gentle .	the bicycle is in the library was gentle .
the bowl by the button is quiet .	the bowl was by the button is quiet .
the shoe in the restaurant is kind .	the shoe was in the restaurant is kind .
the rocket in the park is excited .	the rocket was in the park is excited .
the glass on the street is careful .	the glass was on the street is careful .
the plane in the library is smart .	the plane was in the library is smart .
the candle by the fork was young .	the candle is by the fork was young .
the hat by the mirror was nice .	the hat is by the mirror was nice .
the plate on the table is excited .	the plate was on the table is excited .
the rug on the stool was clever .	the rug is on the stool was clever .
the door in the kitchen was busy .	the door is in the kitchen was busy .
the shoe on the street was quiet .	the shoe is on the street was quiet .
the bowl by the rocket is angry .	the bowl was by the rocket is angry .
the toy in the museum is happy .	the toy was in the museum is happy .
the box in the school was friendly .	the box is in the school was friendly .
the shoe by the door was tired .	the shoe is by the door was tired .
the box on the couch is sleepy .	the box was on the couch is sleepy .
the car in the restaurant is kind .	the car was in the restaurant is kind .
the mirror on the stool was helpful .	the mirror is on the stool was helpful .
the window on the ground is busy .	the window was on the ground is busy .
the book by the spoon is helpful .	the book was by the spoon is helpful .
the bottle by the shirt is curious .	the bottle was by the shirt is curious .
the truck in the room was upset .	the truck is in the room was upset .
the book by the glass was curious .	the book is by the glass was curious .
the bottle by the bicycle is happy .	the bottle was by the bicycle is happy .
the crayon by the shirt is angry .	the crayon was by the shirt is angry .
the fork on the couch is wrong .	the fork was on the couch is wrong .
the glass by the boat is curious .	the glass was by the boat is curious .
the box by the truck is busy .	the box was by the truck is busy .
the doll by the book is tired .	the doll was by the book is tired .
the couch on the chair is smart .	the couch was on the chair is smart .
the book in the mall was tall .	the book is in the mall was tall .
the bottle in the school is happy .	the bottle was in the school is happy .
the rocket by the plane was wrong .	the rocket is by the plane was wrong .
the mirror on the bed was confused .	the mirror is on the bed was confused .
the glass on the stool was young .	the glass is on the stool was young .
the shoe by the glass is busy .	the shoe was by the glass is busy .
the glass on the table is surprised .	the glass was on the table is surprised .
the spoon in the hospital was gentle .	the spoon is in the hospital was gentle .
the bottle in the restaurant was healthy .	the bottle is in the restaurant was healthy .
the toy on the ground is hungry .	the toy was on the ground is hungry .
the ring on the ground was upset .	the ring is on the ground was upset .
the rug on the ground was important .	the rug is on the ground was important .
the chair on the floor was young .	the chair is on the floor was young .
the button in the bank is upset .	the button was in the bank is upset .
the box on the chair was tall .	the box is on the chair was tall .
the ship on the bed was strong .	the ship is on the bed was strong .
the fork by the ring is strong .	the fork was by the ring is strong .
the ship by the button is excited .	the ship was by the button is excited .
the rocket by the window was smart .	the rocket is by the window was smart .
the doll in the park is strong .	the doll was in the park is strong .
the boat in the school was careful .	the boat is in the school was careful .
the plane by the ring is nice .	the plane was by the ring is nice .
the chair on the table was healthy .	the chair is on the table was healthy .
the cup by the doll was clever .	the cup is by the doll was clever .
the candle in the bank is excited .	the candle was in the bank is excited .
the doll on the table is strong .	the doll was on the table is strong .
the candle on the bed was surprised .	the candle is on the bed was surprised .
the plane on the table was important .	the plane is on the table was important .
the door on the table is angry .	the door was on the table is angry .
the door by the rocket is wrong .	the door was by the rocket is wrong .
the box by the book was wrong .	the box is by the book was wrong .
the bed on the bed is young .	the bed was on the bed is young .
the couch by the ship was confused .	the couch is by the ship was confused .
the bicycle in the restaurant was angry .	the bicycle is in the restaurant was angry .
the plane by the car is tall .	the plane was by the car is tall .
the plate in the school is excited .	the plate was in the school is excited .
the ring on the bed was sleepy .	the ring is on the bed was sleepy .
the bicycle on the bed was upset .	the bicycle is on the bed was upset .
the fork on the stool was gentle .	the fork is on the stool was gentle .
the shirt on the floor was angry .	the shirt is on the floor was angry .
the plate on the floor is nice .	the plate was on the floor is nice .
the car in the museum is smart .	the car was in the museum is smart .
the picture on the couch was important .	the picture is on the couch was important .
the ship in the mall is clever .	the ship was in the mall is clever .
the door on the floor is upset .	the door was on the floor is upset .
the bowl in the restaurant was tired .	the bowl is in the restaurant was tired .
the box on the floor is angry .	the box was on the floor is angry .
the car in the mall is wrong .	the car was in the mall is wrong .
the button in the school is bored .	the button was in the school is bored .
the window in the hospital is wrong .	the window was in the hospital is wrong .
the spoon by the spoon is quiet .	the spoon was by the spoon is quiet .
the rocket in the room was angry .	the rocket is in the room was angry .
the crayon by the hat was tired .	the crayon is by the hat was tired .
the book in the kitchen is helpful .	the book was in the kitchen is helpful .
the shirt in the kitchen was surprised .	the shirt is in the kitchen was surprised .
the shoe on the ground is confused .	the shoe was on the ground is confused .
the door by the shoe was lucky .	the door is by the shoe was lucky .
the button on the ground is curious .	the button was on the ground is curious .
the button on the couch was important .	the button is on the couch was important .
the bicycle on the ground is wrong .	the bicycle was on the ground is wrong .
the box on the floor was lucky .	the box is on the floor was lucky .
the doll on the table was hungry .	the doll is on the table was hungry .
the box by the doll was excited .	the box is by the doll was excited .
the toy in the park is careful .	the toy was in the park is careful .
the bicycle on the chair is angry .	the bicycle was on the chair is angry .
the window on the table is excited .	the window was on the table is excited .
the window by the picture is young .	the window was by the picture is young .
the couch by the plate is quiet .	the couch was by the plate is quiet .
the picture on the street was clever .	the picture is on the street was clever .
the bicycle on the floor is curious .	the bicycle was on the floor is curious .
the bowl by the glass is clever .	the bowl was by the glass is clever .
the button in the park was surprised .	the button is in the park was surprised .
the car on the couch is upset .	the car was on the couch is upset .
the bag on the table is angry .	the bag was on the table is angry .
the box by the mirror was smart .	the box is by the mirror was smart .
the bottle in the school is busy .	the bottle was in the school is busy .
the picture by the toy is tall .	the picture was by the toy is tall .
the book in the school is smart .	the book was in the school is smart .
the rug in the room was quiet .	the rug is in the room was quiet .
the bicycle on the stool was tall .	the bicycle is on the stool was tall .
the rocket on the bed was angry .	the rocket is on the bed was angry .
the rocket on the couch is helpful .	the rocket was on the couch is helpful .
the truck by the crayon was angry .	the truck is by the crayon was angry .
the couch in the bank was busy .	the couch is in the bank was busy .
the bag in the museum is confused .	the bag was in the museum is confused .
the ship on the ground was boring .	the ship is on the ground was boring .
the hat on the stool is lucky .	the hat was on the stool is lucky .
the boat on the stool is sleepy .	the boat was on the stool is sleepy .
the chair on the stool is excited .	the chair was on the stool is excited .
the box by the toy is important .	the box was by the toy is important .
the plate by the dish is strong .	the plate was by the dish is strong .
the shirt by the toy was tired .	the shirt is by the toy was tired .
the shirt in the restaurant was important .	the shirt is in the restaurant was important .
the dish in the hospital is bored .	the dish was in the hospital is bored .
the book on the table is lucky .	the book was on the table is lucky .
the spoon on the floor is upset .	the spoon was on the floor is upset .
the shoe in the school was hungry .	the shoe is in the school was hungry .
the boat in the restaurant is excited .	the boat was in the restaurant is excited .
the hat on the bed was tall .	the hat is on the bed was tall .
the rug by the boat is friendly .	the rug was by the boat is friendly .
the mirror on the street is kind .	the mirror was on the street is kind .
the bed in the kitchen is hungry .	the bed was in the kitchen is hungry .
the bottle on the chair was helpful .	the bottle is on the chair was helpful .
the ring by the boat was strong .	the ring is by the boat was strong .
the glass in the restaurant is sleepy .	the glass was in the restaurant is sleepy .
the ship by the doll is busy .	the ship was by the doll is busy .
the ring in the school is friendly .	the ring was in the school is friendly .
the hat by the bottle is healthy .	the hat was by the bottle is healthy .
the window by the boat is helpful .	the window was by the boat is helpful .
the ship on the table was wrong .	the ship is on the table was wrong .
the dish in the school was strong .	the dish is in the school was strong .
the rocket on the couch is happy .	the rocket was on the couch is happy .
the shirt in the museum was hungry .	the shirt is in the museum was hungry .
the rug on the stool was important .	the rug is on the stool was important .
the plane on the chair is surprised .	the plane was on the chair is surprised .
the car in the museum is happy .	the car was in the museum is happy .
the chair by the plane is wrong .	the chair was by the plane is wrong .
the hat by the box was quiet .	the hat is by the box was quiet .
the ship by the dish was excited .	the ship is by the dish was excited .
the hat on the table is tall .	the hat was on the table is tall .
the doll in the kitchen was smart .	the doll is in the kitchen was smart .
the cup in the mall was nice .	the cup is in the mall was nice .
the glass by the chair was strong .	the glass is by the chair was strong .
the door on the floor was young .	the door is on the floor was young .
the dish by the ship is strong .	the dish was by the ship is strong .
the book on the bed is excited .	the book was on the bed is excited .
the bed in the kitchen was surprised .	the bed is in the kitchen was surprised .
the button in the mall is busy .	the button was in the mall is busy .
the truck on the couch was tall .	the truck is on the couch was tall .
the chair on the street is quiet .	the chair was on the street is quiet .
the door on the chair is hungry .	the door was on the chair is hungry .
the spoon by the rug is clever .	the spoon was by the rug is clever .
the spoon in the museum was upset .	the spoon is in the museum was upset .
the plate on the chair was lucky .	the plate is on the chair was lucky .
the plate in the room was surprised .	the plate is in the room was surprised .
the car in the museum was smart .	the car is in the museum was smart .
the toy in the school was careful .	the toy is in the school was careful .
the mirror by the shirt was wrong .	the mirror is by the shirt was wrong .
the hat in the museum was sleepy .	the hat is in the museum was sleepy .
the box by the hat is kind .	the box was by the hat is kind .
the window by the mirror is strong .	the window was by the mirror is strong .
the bowl by the door was upset .	the bowl is by the door was upset .
the bed on the couch was hungry .	the bed is on the couch was hungry .
the car on the floor is careful .	the car was on the floor is careful .
the car by the boat was busy .	the car is by the boat was busy .
the door on the bed is gentle .	the door was on the bed is gentle .
the door by the hat was smart .	the door is by the hat was smart .
the hat by the bottle was hungry .	the hat is by the bottle was hungry .
the dish by the bottle was kind .	the dish is by the bottle was kind .
the mirror on the ground was tall .	the mirror is on the ground was tall .
the bottle on the table is surprised .	the bottle was on the table is surprised .
the candle on the floor is curious .	the candle was on the floor is curious .
the bag on the floor is tall .	the bag was on the floor is tall .
the shoe in the hospital is surprised .	the shoe was in the hospital is surprised .
the book in the bank was angry .	the book is in the bank was angry .
the bicycle by the plane is angry .	the bicycle was by the plane is angry .
the picture on the chair was bored .	the picture is on the chair was bored .
the shoe in the bank is surprised .	the shoe was in the bank is surprised .
the hat by the couch was curious .	the hat is by the couch was curious .
the candle in the room is busy .	the candle was in the room is busy .
the book in the room is confused .	the book was in the room is confused .
the shoe in the restaurant was angry .	the shoe is in the restaurant was angry .
the bag in the school is sleepy .	the bag was in the school is sleepy .
the ring in the bank is wrong .	the ring was in the bank is wrong .
the fork by the plate is careful .	the fork was by the plate is careful .
the glass on the stool was careful .	the glass is on the stool was careful .
the hat in the restaurant is excited .	the hat was in the restaurant is excited .
the couch in the mall was excited .	the couch is in the mall was excited .
the ship in the restaurant is wrong .	the ship was in the restaurant is wrong .
the bottle by the bowl was quiet .	the bottle is by the bowl was quiet .
the bed by the plate was tall .	the bed is by the plate was tall .
the bed by the hat is surprised .	the bed was by the hat is surprised .
the spoon by the ship was strong .	the spoon is by the ship was strong .
the ship in the school was young .	the ship is in the school was young .
the cup by the hat is quiet .	the cup was by the hat is quiet .
the fork on the ground is wrong .	the fork was on the ground is wrong .
the plane by the rocket was tired .	the plane is by the rocket was tired .
the button by the truck is quiet .	the button was by the truck is quiet .
the ring by the dish was confused .	the ring is by the dish was confused .
the button on the floor was quiet .	the button is on the floor was quiet .
the chair in the library is gentle .	the chair was in the library is gentle .
the spoon on the floor was sleepy .	the spoon is on the floor was sleepy .
the toy by the truck was lucky .	the toy is by the truck was lucky .
the mirror on the floor is bored .	the mirror was on the floor is bored .
the bed on the chair was sleepy .	the bed is on the chair was sleepy .
the candle by the couch is helpful .	the candle was by the couch is helpful .
the spoon by the ship was careful .	the spoon is by the ship was careful .
the cup in the hospital was hungry .	the cup is in the hospital was hungry .
the car in the park is healthy .	the car was in the park is healthy .
the book on the table is strong .	the book was on the table is strong .
the picture by the glass is curious .	the picture was by the glass is curious .
the box by the fork was important .	the box is by the fork was important .
the bowl by the rocket is sleepy .	the bowl was by the rocket is sleepy .
the car in the school is smart .	the car was in the school is smart .
the cup on the street is important .	the cup was on the street is important .
the car in the mall is excited .	the car was in the mall is excited .
the plane by the ring was clever .	the plane is by the ring was clever .
the fork on the stool was important .	the fork is on the stool was important .
the spoon in the school was angry .	the spoon is in the school was angry .
the ring by the plate is nice .	the ring was by the plate is nice .
the door on the floor is nice .	the door was on the floor is nice .
the mirror in the park is kind .	the mirror was in the park is kind .
the car in the mall was clever .	the car is in the mall was clever .
the bowl on the stool is careful .	the bowl was on the stool is careful .
the crayon on the stool is clever .	the crayon was on the stool is clever .
the doll on the table is careful .	the doll was on the table is careful .
the doll on the ground is important .	the doll was on the ground is important .
the hat on the couch was clever .	the hat is on the couch was clever .
the bowl by the boat was lucky .	the bowl is by the boat was lucky .
the truck by the bicycle was boring .	the truck is by the bicycle was boring .
the bowl in the park is curious .	the bowl was in the park is curious .
the book on the ground was clever .	the book is on the ground was clever .
the bowl by the plate is smart .	the bowl was by the plate is smart .
the toy on the table was strong .	the toy is on the table was strong .
the doll in the restaurant is important .	the doll was in the restaurant is important .
the button in the restaurant is quiet .	the button was in the restaurant is quiet .
the hat by the ring is upset .	the hat was by the ring is upset .
the hat by the box is clever .	the hat was by the box is clever .
the crayon in the hospital was tall .	the crayon is in the hospital was tall .
the door in the park was upset .	the door is in the park was upset .
the boat by the book was busy .	the boat is by the book was busy .
the hat by the shoe was important .	the hat is by the shoe was important .
the bed by the glass was lucky .	the bed is by the glass was lucky .
the doll in the school is healthy .	the doll was in the school is healthy .
the candle in the mall was young .	the candle is in the mall was young .
the window on the street was smart .	the window is on the street was smart .
the shirt by the crayon is lucky .	the shirt was by the crayon is lucky .
the car by the ship was upset .	the car is by the ship was upset .
the door by the rug was boring .	the door is by the rug was boring .
the plane by the ship was bored .	the plane is by the ship was bored .
the picture on the stool was clever .	the picture is on the stool was clever .
the plane by the ship is tall .	the plane was by the ship is tall .
the plane in the mall is clever .	the plane was in the mall is clever .
the bed on the table is helpful .	the bed was on the table is helpful .
the bed on the table is kind .	the bed was on the table is kind .
the shoe in the library was kind .	the shoe is in the library was kind .
the bottle in the bank is upset .	the bottle was in the bank is upset .
the cup on the bed was tall .	the cup is on the bed was tall .
the bed in the library is lucky .	the bed was in the library is lucky .
the fork on the couch was bored .	the fork is on the couch was bored .
the book by the ship was smart .	the book is by the ship was smart .
the picture by the toy is sleepy .	the picture was by the toy is sleepy .
the bottle by the bicycle is healthy .	the bottle was by the bicycle is healthy .
the glass on the ground is nice .	the glass was on the ground is nice .
the couch on the couch was hungry .	the couch is on the couch was hungry .
the bicycle by the button was bored .	the bicycle is by the button was bored .
the rocket on the floor was nice .	the rocket is on the floor was nice .
the bag by the doll was kind .	the bag is by the doll was kind .
the car in the bank is bored .	the car was in the bank is bored .
the car on the table is important .	the car was on the table is important .
the candle on the street was bored .	the candle is on the street was bored .
the cup on the floor was upset .	the cup is on the floor was upset .
the car in the hospital was bored .	the car is in the hospital was bored .
the rug on the ground is gentle .	the rug was on the ground is gentle .
the truck by the bag was young .	the truck is by the bag was young .
the door on the floor was important .	the door is on the floor was important .
the box on the couch is nice .	the box was on the couch is nice .
the cup in the park was confused .	the cup is in the park was confused .
the rocket by the box was bored .	the rocket is by the box was bored .
the cup on the bed was clever .	the cup is on the bed was clever .
the glass in the bank is young .	the glass was in the bank is young .
the bed on the ground was kind .	the bed is on the ground was kind .
the candle by the shirt is tired .	the candle was by the shirt is tired .
the window by the shirt was excited .	the window is by the shirt was excited .
the couch on the floor is careful .	the couch was on the floor is careful .
the dish on the floor was helpful .	the dish is on the floor was helpful .
the ring in the restaurant is boring .	the ring was in the restaurant is boring .
the bicycle by the fork was curious .	the bicycle is by the fork was curious .
the hat on the street is tired .	the hat was on the street is tired .
the dish on the ground was wrong .	the dish is on the ground was wrong .
the chair by the picture is confused .	the chair was by the picture is confused .
the car on the street was tired .	the car is on the street was tired .
the plate by the book was friendly .	the plate is by the book was friendly .
the bottle on the ground is angry .	the bottle was on the ground is angry .
the box in the kitchen was angry .	the box is in the kitchen was angry .
the mirror on the floor is helpful .	the mirror was on the floor is helpful .
the bag on the stool is lucky .	the bag was on the stool is lucky .
the chair by the rug was gentle .	the chair is by the rug was gentle .
the bowl on the chair was tired .	the bowl is on the chair was tired .
the ship on the couch is curious .	the ship was on the couch is curious .
the doll by the rocket was friendly .	the doll is by the rocket was friendly .
the bicycle on the table was healthy .	the bicycle is on the table was healthy .
the picture on the chair was wrong .	the picture is on the chair was wrong .
the door by the dish is careful .	the door was by the dish is careful .
the fork by the rocket was bored .	the fork is by the rocket was bored .
the window by the bottle is excited .	the window was by the bottle is excited .
the mirror in the restaurant was busy .	the mirror is in the restaurant was busy .
the rug by the spoon was young .	the rug is by the spoon was young .
the boat on the table is friendly .	the boat was on the table is friendly .
the doll by the ring is nice .	the doll was by the ring is nice .
the rug in the school was wrong .	the rug is in the school was wrong .
the plane by the rug was angry .	the plane is by the rug was angry .
the book on the bed was quiet .	the book is on the bed was quiet .
the car on the floor was busy .	the car is on the floor was busy .
the book on the ground was kind .	the book is on the ground was kind .
the window in the school is sleepy .	the window was in the school is sleepy .
the hat by the rug is careful .	the hat was by the rug is careful .
the plate on the couch is helpful .	the plate was on the couch is helpful .
the mirror on the chair was excited .	the mirror is on the chair was excited .
the crayon by the glass is happy .	the crayon was by the glass is happy .
the bottle on the stool was clever .	the bottle is on the stool was clever .
the plane by the boat was confused .	the plane is by the boat was confused .
the shoe by the cup was gentle .	the shoe is by the cup was gentle .
the rocket in the room is curious .	the rocket was in the room is curious .
the bowl in the mall was curious .	the bowl is in the mall was curious .
the mirror by the plate was boring .	the mirror is by the plate was boring .
the bottle on the chair is confused .	the bottle was on the chair is confused .
the plane in the park is excited .	the plane was in the park is excited .
the cup on the stool was upset .	the cup is on the stool was upset .
the book on the stool is excited .	the book was on the stool is excited .
the book in the school is tired .	the book was in the school is tired .
the ring on the floor is tired .	the ring was on the floor is tired .
the truck on the chair is quiet .	the truck was on the chair is quiet .
the cup in the bank is hungry .	the cup was in the bank is hungry .
the glass by the door is gentle .	the glass was by the door is gentle .
the ring in the museum is nice .	the ring was in the museum is nice .
the ship by the rocket was sleepy .	the ship is by the rocket was sleepy .
the book by the bowl is confused .	the book was by the bowl is confused .
the dish on the street was gentle .	the dish is on the street was gentle .
the plate by the glass was important .	the plate is by the glass was important .
the fork on the chair was friendly .	the fork is on the chair was friendly .
the ring on the stool is healthy .	the ring was on the stool is healthy .
the book on the stool is kind .	the book was on the stool is kind .
the book by the picture is helpful .	the book was by the picture is helpful .
the hat by the button was bored .	the hat is by the button was bored .
the ship in the restaurant was gentle .	the ship is in the restaurant was gentle .
the dish on the couch is tall .	the dish was on the couch is tall .
the book on the table is bored .	the book was on the table is bored .
the bag on the stool was kind .	the bag is on the stool was kind .
the spoon on the street is important .	the spoon was on the street is important .
the mirror by the car was tired .	the mirror is by the car was tired .
the bed by the bicycle was nice .	the bed is by the bicycle was nice .
the car by the ring was friendly .	the car is by the ring was friendly .
the spoon by the picture was important .	the spoon is by the picture was important .
the crayon on the ground was excited .	the crayon is on the ground was excited .
the bed in the museum is confused .	the bed was in the museum is confused .
the bowl on the floor was sleepy .	the bowl is on the floor was sleepy .
the bottle by the bag is boring .	the bottle was by the bag is boring .
the dish on the chair was boring .	the dish is on the chair was boring .
the window by the ship is important .	the window was by the ship is important .
the window in the school is boring .	the window was in the school is boring .
the boat by the candle was clever .	the boat is by the candle was clever .
the ring by the mirror was curious .	the ring is by the mirror was curious .
the fork in the school is upset .	the fork was in the school is upset .
the boat on the ground was busy .	the boat is on the ground was busy .
the plate by the boat was bored .	the plate is by the boat was bored .
the shoe in the library was lucky .	the shoe is in the library was lucky .
the box in the restaurant is clever .	the box was in the restaurant is clever .
the crayon on the chair was tired .	the crayon is on the chair was tired .
the door on the table is sleepy .	the door was on the table is sleepy .
the ring by the dish was upset .	the ring is by the dish was upset .
the truck by the toy is gentle .	the truck was by the toy is gentle .
the cup in the school was strong .	the cup is in the school was strong .
the glass in the mall is wrong .	the glass was in the mall is wrong .
the bowl by the candle is strong .	the bowl was by the candle is strong .
the book by the boat is upset .	the book was by the boat is upset .
the car by the box was wrong .	the car is by the box was wrong .
the plane in the library was smart .	the plane is in the library was smart .
the doll on the bed was lucky .	the doll is on the bed was lucky .
the plate on the couch is busy .	the plate was on the couch is busy .
the glass on the ground was happy .	the glass is on the ground was happy .
the hat in the library is important .	the hat was in the library is important .
the plate on the floor was quiet .	the plate is on the floor was quiet .
the bowl by the mirror is friendly .	the bowl was by the mirror is friendly .
the book by the couch is curious .	the book was by the couch is curious .
the car on the floor was quiet .	the car is on the floor was quiet .
the shirt in the school was hungry .	the shirt is in the school was hungry .
the ring in the hospital was happy .	the ring is in the hospital was happy .
the bottle by the spoon is bored .	the bottle was by the spoon is bored .
the shoe by the cup is kind .	the shoe was by the cup is kind .
the spoon on the bed is smart .	the spoon was on the bed is smart .
the car by the box is happy .	the car was by the box is happy .
the shirt by the picture was helpful .	the shirt is by the picture was helpful .
the bag in the room was nice .	the bag is in the room was nice .
the boat on the table is boring .	the boat was on the table is boring .
the car on the street is happy .	the car was on the street is happy .
the rug by the car was helpful .	the rug is by the car was helpful .
the dish in the museum was healthy .	the dish is in the museum was healthy .
the chair by the door was healthy .	the chair is by the door was healthy .
the truck by the dish is busy .	the truck was by the dish is busy .
the rug in the restaurant was wrong .	the rug is in the restaurant was wrong .
the hat on the ground was sleepy .	the hat is on the ground was sleepy .
the ship by the button is healthy .	the ship was by the button is healthy .
the book by the cup is careful .	the book was by the cup is careful .
the shoe on the couch was tall .	the shoe is on the couch was tall .
the bag by the car is friendly .	the bag was by the car is friendly .
the ring on the ground was busy .	the ring is on the ground was busy .
the shoe on the table is nice .	the shoe was on the table is nice .
the chair in the museum is nice .	the chair was in the museum is nice .
the picture in the mall was careful .	the picture is in the mall was careful .
the book by the bowl is curious .	the book was by the bowl is curious .
the bottle in the room is surprised .	the bottle was in the room is surprised .
the plane by the cup is confused .	the plane was by the cup is confused .
the candle in the museum is quiet .	the candle was in the museum is quiet .
the dish by the ring is important .	the dish was by the ring is important .
the candle by the bowl was tired .	the candle is by the bowl was tired .
the plate on the street was strong .	the plate is on the street was strong .
the glass in the restaurant was gentle .	the glass is in the restaurant was gentle .
the couch on the ground is careful .	the couch was on the ground is careful .
the bottle by the plate is surprised .	the bottle was by the plate is surprised .
the book by the plane is busy .	the book was by the plane is busy .
the mirror in the museum was kind .	the mirror is in the museum was kind .
the spoon in the library is quiet .	the spoon was in the library is quiet .
the truck on the bed was healthy .	the truck is on the bed was healthy .
the candle on the chair is excited .	the candle was on the chair is excited .
the bed on the table is healthy .	the bed was on the table is healthy .
the dish on the street was important .	the dish is on the street was important .
the boat on the street is angry .	the boat was on the street is angry .
the cup in the room is curious .	the cup was in the room is curious .
the cup in the park is boring .	the cup was in the park is boring .
the shirt by the bicycle is young .	the shirt was by the bicycle is young .
the candle on the table was healthy .	the candle is on the table was healthy .
the dish by the truck is helpful .	the dish was by the truck is helpful .
the shirt on the ground is helpful .	the shirt was on the ground is helpful .
the door in the museum was careful .	the door is in the museum was careful .
the doll on the floor is friendly .	the doll was on the floor is friendly .
the bottle on the street is tall .	the bottle was on the street is tall .
the plane on the ground is happy .	the plane was on the ground is happy .
the dish in the restaurant was boring .	the dish is in the restaurant was boring .
the plane by the doll was busy .	the plane is by the doll was busy .
the doll in the room is hungry .	the doll was in the room is hungry .
the car by the doll is confused .	the car was by the doll is confused .
the fork by the boat is healthy .	the fork was by the boat is healthy .
the plate in the school is angry .	the plate was in the school is angry .
the glass on the ground is lucky .	the glass was on the ground is lucky .
the book on the street was smart .	the book is on the street was smart .
the truck by the hat was lucky .	the truck is by the hat was lucky .
the ring on the floor is busy .	the ring was on the floor is busy .
the ship in the school is sleepy .	the ship was in the school is sleepy .
the book by the window is gentle .	the book was by the window is gentle .
the doll by the toy was smart .	the doll is by the toy was smart .
the window in the school was important .	the window is in the school was important .
the shirt on the street is young .	the shirt was on the street is young .
the mirror by the car was strong .	the mirror is by the car was strong .
the car on the couch was tall .	the car is on the couch was tall .
the hat in the library is strong .	the hat was in the library is strong .
the candle in the library was quiet .	the candle is in the library was quiet .
the spoon by the mirror is confused .	the spoon was by the mirror is confused .
the bottle on the chair is careful .	the bottle was on the chair is careful .
the shoe by the truck is curious .	the shoe was by the truck is curious .
the rocket in the school is strong .	the rocket was in the school is strong .
the bag by the spoon was upset .	the bag is by the spoon was upset .
the toy by the couch is healthy .	the toy was by the couch is healthy .
the rug on the couch was sleepy .	the rug is on the couch was sleepy .
the bottle by the truck was tall .	the bottle is by the truck was tall .
the bed in the park was strong .	the bed is in the park was strong .
the cup on the floor was excited .	the cup is on the floor was excited .
the bag on the bed was hungry .	the bag is on the bed was hungry .
the hat in the park was helpful .	the hat is in the park was helpful .
the chair on the chair was helpful .	the chair is on the chair was helpful .
the couch on the floor was careful .	the couch is on the floor was careful .
the ship on the couch was lucky .	the ship is on the couch was lucky .
the dish in the library was sleepy .	the dish is in the library was sleepy .
the bowl on the stool is happy .	the bowl was on the stool is happy .
the window in the restaurant was helpful .	the window is in the restaurant was helpful .
the ship on the floor was excited .	the ship is on the floor was excited .
the book in the bank is careful .	the book was in the bank is careful .
the spoon in the kitchen was wrong .	the spoon is in the kitchen was wrong .
the spoon in the park is sleepy .	the spoon was in the park is sleepy .
the book on the chair was curious .	the book is on the chair was curious .
the box in the restaurant was upset .	the box is in the restaurant was upset .
the box on the ground is helpful .	the box was on the ground is helpful .
the plane on the bed is healthy .	the plane was on the bed is healthy .
the crayon in the mall is healthy .	the crayon was in the mall is healthy .
the button on the ground is strong .	the button was on the ground is strong .
the cup by the plane was curious .	the cup is by the plane was curious .
the plate by the crayon is upset .	the plate was by the crayon is upset .
the dish by the hat is tired .	the dish was by the hat is tired .
the cup by the rug was young .	the cup is by the rug was young .
the hat in the mall is clever .	the hat was in the mall is clever .
the spoon by the fork is wrong .	the spoon was by the fork is wrong .
the picture on the couch was young .	the picture is on the couch was young .
the rug in the bank was surprised .	the rug is in the bank was surprised .
the shirt on the bed was important .	the shirt is on the bed was important .
the picture on the street was upset .	the picture is on the street was upset .
the bottle on the table is tall .	the bottle was on the table is tall .
the plate on the table is tall .	the plate was on the table is tall .
the rug in the bank was strong .	the rug is in the bank was strong .
the ring by the bottle was healthy .	the ring is by the bottle was healthy .
the book in the bank was sleepy .	the book is in the bank was sleepy .
the toy in the room was confused .	the toy is in the room was confused .
the cup in the kitchen is confused .	the cup was in the kitchen is confused .
the couch by the box is excited .	the couch was by the box is excited .
the couch by the bag is surprised .	the couch was by the bag is surprised .
the spoon on the street is surprised .	the spoon was on the street is surprised .
the fork in the mall was sleepy .	the fork is in the mall was sleepy .
the ship by the plate is clever .	the ship was by the plate is clever .
the truck on the stool is smart .	the truck was on the stool is smart .
the window on the table is young .	the window was on the table is young .
the couch on the table is young .	the couch was on the table is young .
the hat in the room is kind .	the hat was in the room is kind .
the rug on the table is tired .	the rug was on the table is tired .
the mirror in the library is confused .	the mirror was in the library is confused .
the box by the glass is confused .	the box was by the glass is confused .
the glass on the floor was kind .	the glass is on the floor was kind .
the candle on the ground is friendly .	the candle was on the ground is friendly .
the bed on the couch was happy .	the bed is on the couch was happy .
the truck on the bed is excited .	the truck was on the bed is excited .
the picture on the table was gentle .	the picture is on the table was gentle .
the hat by the book is nice .	the hat was by the book is nice .
the fork by the crayon was gentle .	the fork is by the crayon was gentle .
the rug by the plate is angry .	the rug was by the plate is angry .
the mirror in the hospital was quiet .	the mirror is in the hospital was quiet .
the book in the kitchen was tall .	the book is in the kitchen was tall .
the bowl on the floor was confused .	the bowl is on the floor was confused .
the boat on the ground was curious .	the boat is on the ground was curious .
the plane by the crayon is careful .	the plane was by the crayon is careful .
the toy in the park is tall .	the toy was in the park is tall .
the rug in the hospital was tall .	the rug is in the hospital was tall .
the book on the floor is careful .	the book was on the floor is careful .
the plate on the street was gentle .	the plate is on the street was gentle .
the mirror by the window is strong .	the mirror was by the window is strong .
the mirror on the stool was tired .	the mirror is on the stool was tired .
the truck in the museum is important .	the truck was in the museum is important .
the chair on the couch was tired .	the chair is on the couch was tired .
the cup on the table was helpful .	the cup is on the table was helpful .
the fork on the ground is confused .	the fork was on the ground is confused .
the picture by the car is young .	the picture was by the car is young .
the candle by the bottle is wrong .	the candle was by the bottle is wrong .
the box in the kitchen was friendly .	the box is in the kitchen was friendly .
the bed on the ground is nice .	the bed was on the ground is nice .
the rug in the school was lucky .	the rug is in the school was lucky .
the dish by the bag was curious .	the dish is by the bag was curious .
the hat in the kitchen is happy .	the hat was in the kitchen is happy .
the cup on the table is upset .	the cup was on the table is upset .
the glass on the ground was helpful .	the glass is on the ground was helpful .
the spoon by the bicycle was nice .	the spoon is by the bicycle was nice .
the picture on the stool is upset .	the picture was on the stool is upset .
the chair by the shoe was quiet .	the chair is by the shoe was quiet .
the plane on the floor was busy .	the plane is on the floor was busy .
the boat by the ring is busy .	the boat was by the ring is busy .
the window on the street was important .	the window is on the street was important .
the boat by the toy was careful .	the boat is by the toy was careful .
the ship in the museum is wrong .	the ship was in the museum is wrong .
the dish in the hospital was upset .	the dish is in the hospital was upset .
the mirror on the couch was wrong .	the mirror is on the couch was wrong .
the hat by the door is gentle .	the hat was by the door is gentle .
the box by the book is sleepy .	the box was by the book is sleepy .
the candle in the park was helpful .	the candle is in the park was helpful .
the picture on the floor was careful .	the picture is on the floor was careful .
the rocket on the couch is confused .	the rocket was on the couch is confused .
the car on the street is healthy .	the car was on the street is healthy .
the hat by the ship is excited .	the hat was by the ship is excited .
the rug by the box was friendly .	the rug is by the box was friendly .
the toy by the plane was kind .	the toy is by the plane was kind .
the bed on the chair is wrong .	the bed was on the chair is wrong .
the box on the stool was bored .	the box is on the stool was bored .
the doll by the couch is angry .	the doll was by the couch is angry .
the cup by the rocket is helpful .	the cup was by the rocket is helpful .
the book by the shoe was surprised .	the book is by the shoe was surprised .
the toy in the library was bored .	the toy is in the library was bored .
the glass on the stool was strong .	the glass is on the stool was strong .
the dish on the chair was excited .	the dish is on the chair was excited .
the rocket in the hospital is clever .	the rocket was in the hospital is clever .
the fork in the museum was excited .	the fork is in the museum was excited .
the chair on the ground was clever .	the chair is on the ground was clever .
the doll on the ground was friendly .	the doll is on the ground was friendly .
the picture on the floor was angry .	the picture is on the floor was angry .
the bottle on the couch was angry .	the bottle is on the couch was angry .
the car in the hospital is clever .	the car was in the hospital is clever .
the car by the cup was busy .	the car is by the cup was busy .
the box in the room was kind .	the box is in the room was kind .
the shoe in the school is helpful .	the shoe was in the school is helpful .
the button by the dish is boring .	the button was by the dish is boring .
the plane in the park is wrong .	the plane was in the park is wrong .
the book in the room is young .	the book was in the room is young .
the spoon on the bed was wrong .	the spoon is on the bed was wrong .
the car in the room is quiet .	the car was in the room is quiet .
the rocket by the book is quiet .	the rocket was by the book is quiet .
the picture in the school was excited .	the picture is in the school was excited .
the cup on the floor was important .	the cup is on the floor was important .
the bottle on the chair was careful .	the bottle is on the chair was careful .
the car by the bowl is helpful .	the car was by the bowl is helpful .
the truck on the bed was upset .	the truck is on the bed was upset .
the candle by the rug was lucky .	the candle is by the rug was lucky .
the chair by the rug is happy .	the chair was by the rug is happy .
the bag by the box is surprised .	the bag was by the box is surprised .
the cup by the truck was busy .	the cup is by the truck was busy .
the truck on the bed was clever .	the truck is on the bed was clever .
the hat by the rug is kind .	the hat was by the rug is kind .
the book on the chair is kind .	the book was on the chair is kind .
the boat in the bank is angry .	the boat was in the bank is angry .
the chair in the hospital is tired .	the chair was in the hospital is tired .
the window in the restaurant is angry .	the window was in the restaurant is angry .
the bottle in the museum was bored .	the bottle is in the museum was bored .
the rug on the stool was bored .	the rug is on the stool was bored .
the box on the chair was smart .	the box is on the chair was smart .
the couch in the mall is boring .	the couch was in the mall is boring .
the bicycle by the bicycle was busy .	the bicycle is by the bicycle was busy .
the hat on the ground was angry .	the hat is on the ground was angry .
the window on the floor is upset .	the window was on the floor is upset .
the ring in the park is bored .	the ring was in the park is bored .
the button in the school is quiet .	the button was in the school is quiet .
the car in the room was happy .	the car is in the room was happy .
the bottle by the bed is surprised .	the bottle was by the bed is surprised .
the cup on the ground is young .	the cup was on the ground is young .
the box on the table is curious .	the box was on the table is curious .
the plate on the floor was curious .	the plate is on the floor was curious .
the car in the kitchen was young .	the car is in the kitchen was young .
the picture in the kitchen was tall .	the picture is in the kitchen was tall .
the bicycle by the car is curious .	the bicycle was by the car is curious .
the car by the cup is confused .	the car was by the cup is confused .
the fork on the couch is angry .	the fork was on the couch is angry .
the doll on the couch is important .	the doll was on the couch is important .
the bed in the hospital was hungry .	the bed is in the hospital was hungry .
the car by the shoe is wrong .	the car was by the shoe is wrong .
the hat in the school was lucky .	the hat is in the school was lucky .
the bag in the mall is careful .	the bag was in the mall is careful .
the mirror by the mirror is curious .	the mirror was by the mirror is curious .
the dish in the library was lucky .	the dish is in the library was lucky .
the fork by the truck was smart .	the fork is by the truck was smart .
the book by the rocket was wrong .	the book is by the rocket was wrong .
the button by the hat is angry .	the button was by the hat is angry .
the book on the chair is busy .	the book was on the chair is busy .
the shoe in the park is quiet .	the shoe was in the park is quiet .
the shoe by the bowl was nice .	the shoe is by the bowl was nice .
the couch in the museum was careful .	the couch is in the museum was careful .
the hat in the museum was boring .	the hat is in the museum was boring .
the couch by the car was happy .	the couch is by the car was happy .
the ring in the library is surprised .	the ring was in the library is surprised .
the plane on the floor was tired .	the plane is on the floor was tired .
the spoon on the couch was quiet .	the spoon is on the couch was quiet .
the ship by the car is angry .	the ship was by the car is angry .
the book in the school was wrong .	the book is in the school was wrong .
the hat by the bicycle is confused .	the hat was by the bicycle is confused .
the boat in the bank is clever .	the boat was in the bank is clever .
the glass on the floor was young .	the glass is on the floor was young .
the crayon on the floor was surprised .	the crayon is on the floor was surprised .
the ship by the toy is angry .	the ship was by the toy is angry .
the bottle on the stool was nice .	the bottle is on the stool was nice .
the couch on the ground was surprised .	the couch is on the ground was surprised .
the car in the hospital was strong .	the car is in the hospital was strong .
the button by the toy was angry .	the button is by the toy was angry .
the car on the stool was surprised .	the car is on the stool was surprised .
the car on the ground is happy .	the car was on the ground is happy .
the bicycle on the bed was happy .	the bicycle is on the bed was happy .
the plane in the room was tired .	the plane is in the room was tired .
the dish in the museum was confused .	the dish is in the museum was confused .
the toy by the rug was upset .	the toy is by the rug was upset .
the chair by the toy is angry .	the chair was by the toy is angry .
the rocket on the bed was tired .	the rocket is on the bed was tired .
the shirt on the street is important .	the shirt was on the street is important .
the dish on the floor is helpful .	the dish was on the floor is helpful .
the rug by the glass is quiet .	the rug was by the glass is quiet .
the rocket in the bank is nice .	the rocket was in the bank is nice .
the button by the dish was happy .	the button is by the dish was happy .
the bed on the table is wrong .	the bed was on the table is wrong .
the crayon by the bag was excited .	the crayon is by the bag was excited .
the rocket by the crayon is healthy .	the rocket was by the crayon is healthy .
the chair by the box is happy .	the chair was by the box is happy .
the spoon by the dish was young .	the spoon is by the dish was young .
the ship on the bed was angry .	the ship is on the bed was angry .
the picture on the table was confused .	the picture is on the table was confused .
the bottle by the toy is curious .	the bottle was by the toy is curious .
the ring in the kitchen is wrong .	the ring was in the kitchen is wrong .
the crayon on the floor was helpful .	the crayon is on the floor was helpful .
the plate in the museum was wrong .	the plate is in the museum was wrong .
the hat by the candle is smart .	the hat was by the candle is smart .
the toy by the mirror was friendly .	the toy is by the mirror was friendly .
the couch on the table was smart .	the couch is on the table was smart .
the car by the glass was smart .	the car is by the glass was smart .
the shirt on the table was nice .	the shirt is on the table was nice .
the dish by the picture was helpful .	the dish is by the picture was helpful .
the candle by the shoe is helpful .	the candle was by the shoe is helpful .
the dish in the kitchen is boring .	the dish was in the kitchen is boring .
the car by the shoe is strong .	the car was by the shoe is strong .
the rug in the school is lucky .	the rug was in the school is lucky .
the bag on the street is healthy .	the bag was on the street is healthy .
the car by the shoe was clever .	the car is by the shoe was clever .
the shoe on the bed is careful .	the shoe was on the bed is careful .
the window on the table is friendly .	the window was on the table is friendly .
the picture by the spoon was angry .	the picture is by the spoon was angry .
the dish in the room is happy .	the dish was in the room is happy .
the car by the picture is excited .	the car was by the picture is excited .
the chair on the stool was tired .	the chair is on the stool was tired .
the bag in the school was boring .	the bag is in the school was boring .
the candle in the mall is friendly .	the candle was in the mall is friendly .
the crayon on the ground is happy .	the crayon was on the ground is happy .
the book by the bottle was busy .	the book is by the bottle was busy .
the window on the table was friendly .	the window is on the table was friendly .
the glass by the plane was healthy .	the glass is by the plane was healthy .
the glass on the floor is angry .	the glass was on the floor is angry .
the book by the bed was helpful .	the book is by the bed was helpful .
the mirror in the hospital was gentle .	the mirror is in the hospital was gentle .
the hat on the stool is wrong .	the hat was on the stool is wrong .
the bowl by the bed is nice .	the bowl was by the bed is nice .
the bottle on the bed is curious .	the bottle was on the bed is curious .
the spoon in the hospital was tall .	the spoon is in the hospital was tall .
the glass by the box is quiet .	the glass was by the box is quiet .
the toy on the ground is upset .	the toy was on the ground is upset .
the fork by the crayon is helpful .	the fork was by the crayon is helpful .
the spoon on the chair was strong .	the spoon is on the chair was strong .
the book in the school is friendly .	the book was in the school is friendly .
the glass on the chair is gentle .	the glass was on the chair is gentle .
the couch on the couch is gentle .	the couch was on the couch is gentle .
the plate by the car is healthy .	the plate was by the car is healthy .
the dish on the floor is surprised .	the dish was on the floor is surprised .
the rug in the kitchen is confused .	the rug was in the kitchen is confused .
the book on the floor is quiet .	the book was on the floor is quiet .
the bag by the book is important .	the bag was by the book is important .
the shoe on the ground was gentle .	the shoe is on the ground was gentle .
the book on the street was curious .	the book is on the street was curious .
the dish on the stool is busy .	the dish was on the stool is busy .
the bottle on the street is tired .	the bottle was on the street is tired .
the fork in the museum was clever .	the fork is in the museum was clever .
the candle by the ship was bored .	the candle is by the ship was bored .
the toy by the car is busy .	the toy was by the car is busy .
the car in the park was nice .	the car is in the park was nice .
the chair by the rug was tall .	the chair is by the rug was tall .
the doll in the hospital was angry .	the doll is in the hospital was angry .
the ring by the boat was boring .	the ring is by the boat was boring .
the rocket in the library is upset .	the rocket was in the library is upset .
the book on the table is healthy .	the book was on the table is healthy .
the candle in the kitchen was tall .	the candle is in the kitchen was tall .
the window by the bicycle was excited .	the window is by the bicycle was excited .
the picture on the chair is tall .	the picture was on the chair is tall .
the bottle by the car was smart .	the bottle is by the car was smart .
the glass in the school was quiet .	the glass is in the school was quiet .
the toy in the restaurant was confused .	the toy is in the restaurant was confused .
the rocket in the park was curious .	the rocket is in the park was curious .
the box by the doll is tired .	the box was by the doll is tired .
the plane by the boat is sleepy .	the plane was by the boat is sleepy .
the picture by the cup was smart .	the picture is by the cup was smart .
the shirt by the glass was busy .	the shirt is by the glass was busy .
the book by the bowl was boring .	the book is by the bowl was boring .
the doll by the window was boring .	the doll is by the window was boring .
the doll by the fork is strong .	the doll was by the fork is strong .
the boat on the chair was lucky .	the boat is on the chair was lucky .
the picture on the bed is excited .	the picture was on the bed is excited .
the candle by the book is happy .	the candle was by the book is happy .
the boat in the park was clever .	the boat is in the park was clever .
the rocket in the library is clever .	the rocket was in the library is clever .
the window on the stool is wrong .	the window was on the stool is wrong .
the shirt on the stool was excited .	the shirt is on the stool was excited .
the spoon in the room is gentle .	the spoon was in the room is gentle .
the toy by the rocket was kind .	the toy is by the rocket was kind .
the car on the couch was tired .	the car is on the couch was tired .
the button by the toy is helpful .	the button was by the toy is helpful .
the shoe on the chair was angry .	the shoe is on the chair was angry .
the ship in the kitchen was quiet .	the ship is in the kitchen was quiet .
the book by the plate was bored .	the book is by the plate was bored .
the plate by the rocket is curious .	the plate was by the rocket is curious .
the glass on the table is tall .	the glass was on the table is tall .
the shoe by the fork was smart .	the shoe is by the fork was smart .
the mirror in the hospital was clever .	the mirror is in the hospital was clever .
the bottle on the bed is excited .	the bottle was on the bed is excited .
the hat by the plane is important .	the hat was by the plane is important .
the shoe by the rug was smart .	the shoe is by the rug was smart .
the boat on the chair is wrong .	the boat was on the chair is wrong .
the fork in the school was healthy .	the fork is in the school was healthy .
the candle in the room was curious .	the candle is in the room was curious .
the crayon in the school was strong .	the crayon is in the school was strong .
the crayon in the hospital was busy .	the crayon is in the hospital was busy .
the bowl on the ground was friendly .	the bowl is on the ground was friendly .
the truck in the restaurant is excited .	the truck was in the restaurant is excited .
the candle in the school was wrong .	the candle is in the school was wrong .
the hat by the shirt is lucky .	the hat was by the shirt is lucky .
the car by the ship is confused .	the car was by the ship is confused .
the ship by the rug is strong .	the ship was by the rug is strong .
the doll in the library was quiet .	the doll is in the library was quiet .
the spoon in the restaurant was smart .	the spoon is in the restaurant was smart .
the window by the ship is excited .	the window was by the ship is excited .
the book in the kitchen is friendly .	the book was in the kitchen is friendly .
the door by the spoon is young .	the door was by the spoon is young .
the cup on the bed is bored .	the cup was on the bed is bored .
the rocket by the car was healthy .	the rocket is by the car was healthy .
the boat on the table was surprised .	the boat is on the table was surprised .
the doll on the ground was surprised .	the doll is on the ground was surprised .
the rocket on the table is sleepy .	the rocket was on the table is sleepy .
the bed by the couch was wrong .	the bed is by the couch was wrong .
the bed on the floor was strong .	the bed is on the floor was strong .
the book by the doll is helpful .	the book was by the doll is helpful .
the bottle on the table is healthy .	the bottle was on the table is healthy .
the doll in the school is tired .	the doll was in the school is tired .
the picture on the chair was helpful .	the picture is on the chair was helpful .
the dish in the room is bored .	the dish was in the room is bored .
the ring in the room is helpful .	the ring was in the room is helpful .
the spoon in the museum was angry .	the spoon is in the museum was angry .
the fork in the room was healthy .	the fork is in the room was healthy .
the dish in the kitchen was helpful .	the dish is in the kitchen was helpful .
the truck in the library was gentle .	the truck is in the library was gentle .
the ring by the candle is important .	the ring was by the candle is important .
the couch by the book was tall .	the couch is by the book was tall .
the rug by the bowl is wrong .	the rug was by the bowl is wrong .
the bed by the book is tall .	the bed was by the book is tall .
the plane in the restaurant is gentle .	the plane was in the restaurant is gentle .
the ship in the hospital was confused .	the ship is in the hospital was confused .
the hat in the hospital was healthy .	the hat is in the hospital was healthy .
the boat by the toy was tired .	the boat is by the toy was tired .
the hat by the shoe was curious .	the hat is by the shoe was curious .
the hat in the mall is strong .	the hat was in the mall is strong .
the fork on the table was sleepy .	the fork is on the table was sleepy .
the rug in the library was busy .	the rug is in the library was busy .
the glass in the park is angry .	the glass was in the park is angry .
the bag by the chair is bored .	the bag was by the chair is bored .
the box on the ground was nice .	the box is on the ground was nice .
the window in the room is surprised .	the window was in the room is surprised .
the chair by the toy is wrong .	the chair was by the toy is wrong .
the crayon by the candle is clever .	the crayon was by the candle is clever .
the window in the museum is hungry .	the window was in the museum is hungry .
the rocket in the hospital is confused .	the rocket was in the hospital is confused .
the candle by the window is tired .	the candle was by the window is tired .
the toy on the table is clever .	the toy was on the table is clever .
the fork by the button is wrong .	the fork was by the button is wrong .
the cup in the room was tall .	the cup is in the room was tall .
the shoe on the ground was quiet .	the shoe is on the ground was quiet .
the truck on the chair is strong .	the truck was on the chair is strong .
the couch in the museum was lucky .	the couch is in the museum was lucky .
the bag on the couch was excited .	the bag is on the couch was excited .
the truck on the couch is kind .	the truck was on the couch is kind .
the candle by the hat was surprised .	the candle is by the hat was surprised .
the shirt in the room was excited .	the shirt is in the room was excited .
the spoon in the school was lucky .	the spoon is in the school was lucky .
the rug in the park was kind .	the rug is in the park was kind .
the box on the table was careful .	the box is on the table was careful .
the bed on the chair is boring .	the bed was on the chair is boring .
the cup on the chair is nice .	the cup was on the chair is nice .
the toy on the table is helpful .	the toy was on the table is helpful .
the bed on the stool is sleepy .	the bed was on the stool is sleepy .
the plane on the couch is healthy .	the plane was on the couch is healthy .
the plane on the bed is tall .	the plane was on the bed is tall .
the shoe by the toy was bored .	the shoe is by the toy was bored .
the toy by the shoe was quiet .	the toy is by the shoe was quiet .
the couch in the school was gentle .	the couch is in the school was gentle .
the bag by the ship is careful .	the bag was by the ship is careful .
the shoe in the room is angry .	the shoe was in the room is angry .
the picture by the truck is tired .	the picture was by the truck is tired .
the rocket in the hospital is upset .	the rocket was in the hospital is upset .
the bicycle in the mall was kind .	the bicycle is in the mall was kind .
the fork in the bank was boring .	the fork is in the bank was boring .
the book on the street is upset .	the book was on the street is upset .
the plane in the restaurant is friendly .	the plane was in the restaurant is friendly .
the plane on the ground is busy .	the plane was on the ground is busy .
the glass on the couch is smart .	the glass was on the couch is smart .
the shirt by the cup is upset .	the shirt was by the cup is upset .
the candle in the hospital was hungry .	the candle is in the hospital was hungry .
the picture in the bank is lucky .	the picture was in the bank is lucky .
the doll by the hat was surprised .	the doll is by the hat was surprised .
the spoon on the street is clever .	the spoon was on the street is clever .
the chair on the floor is busy .	the chair was on the floor is busy .
the toy on the bed was strong .	the toy is on the bed was strong .
the box in the mall was smart .	the box is in the mall was smart .
the book on the stool is healthy .	the book was on the stool is healthy .
the spoon in the bank is angry .	the spoon was in the bank is angry .
the boat in the mall is helpful .	the boat was in the mall is helpful .
the bag by the button was gentle .	the bag is by the button was gentle .
the toy by the car was nice .	the toy is by the car was nice .
the hat in the school is lucky .	the hat was in the school is lucky .
the car by the doll was smart .	the car is by the doll was smart .
the picture on the table is tall .	the picture was on the table is tall .
the candle on the chair was lucky .	the candle is on the chair was lucky .
the glass on the chair is nice .	the glass was on the chair is nice .
the shoe by the spoon is tall .	the shoe was by the spoon is tall .
the hat by the car was clever .	the hat is by the car was clever .
the box in the mall is young .	the box was in the mall is young .
the shirt by the doll was smart .	the shirt is by the doll was smart .
the ship on the street is clever .	the ship was on the street is clever .
the shoe on the bed is excited .	the shoe was on the bed is excited .
the button by the box is happy .	the button was by the box is happy .
the shoe on the table is busy .	the shoe was on the table is busy .
the bowl by the mirror is excited .	the bowl was by the mirror is excited .
the bed on the street was happy .	the bed is on the street was happy .
the book by the bottle is hungry .	the book was by the bottle is hungry .
the ship in the room is quiet .	the ship was in the room is quiet .
the toy in the room is confused .	the toy was in the room is confused .
the cup in the restaurant was busy .	the cup is in the restaurant was busy .
the box on the chair is bored .	the box was on the chair is bored .
the picture in the hospital is surprised .	the picture was in the hospital is surprised .
the bottle on the floor is tall .	the bottle was on the floor is tall .
the glass by the book was hungry .	the glass is by the book was hungry .
the shirt by the cup was happy .	the shirt is by the cup was happy .
the truck in the museum is curious .	the truck was in the museum is curious .
the chair in the restaurant was sleepy .	the chair is in the restaurant was sleepy .
the shoe by the crayon is bored .	the shoe was by the crayon is bored .
the plane by the plane is clever .	the plane was by the plane is clever .
the couch on the street is quiet .	the couch was on the street is quiet .
the rocket in the school was hungry .	the rocket is in the school was hungry .
the doll by the doll is healthy .	the doll was by the doll is healthy .
the rocket in the mall is strong .	the rocket was in the mall is strong .
the picture on the couch is lucky .	the picture was on the couch is lucky .
the rocket by the shoe is happy .	the rocket was by the shoe is happy .
the bag on the bed is important .	the bag was on the bed is important .
the couch on the couch was busy .	the couch is on the couch was busy .
the window by the boat was helpful .	the window is by the boat was helpful .
the window on the ground is upset .	the window was on the ground is upset .
the shirt on the stool is careful .	the shirt was on the stool is careful .
the bicycle by the plane was bored .	the bicycle is by the plane was bored .
the book on the stool was bored .	the book is on the stool was bored .
the car by the crayon was upset .	the car is by the crayon was upset .
the book by the bed was wrong .	the book is by the bed was wrong .
the book on the ground is careful .	the book was on the ground is careful .
the boat on the chair was busy .	the boat is on the chair was busy .
the dish on the floor was excited .	the dish is on the floor was excited .
the dish by the fork is young .	the dish was by the fork is young .
the rocket on the stool was careful .	the rocket is on the stool was careful .
the mirror by the shirt is kind .	the mirror was by the shirt is kind .
the bag in the school was gentle .	the bag is in the school was gentle .
the shirt by the fork was gentle .	the shirt is by the fork was gentle .
the bowl on the couch is hungry .	the bowl was on the couch is hungry .
the truck in the museum is friendly .	the truck was in the museum is friendly .
the door on the stool is excited .	the door was on the stool is excited .
the bicycle in the mall is quiet .	the bicycle was in the mall is quiet .
the button by the truck is tall .	the button was by the truck is tall .
the rocket on the bed was upset .	the rocket is on the bed was upset .
the button on the floor was sleepy .	the button is on the floor was sleepy .
the fork on the bed is tall .	the fork was on the bed is tall .
the bed in the hospital is smart .	the bed was in the hospital is smart .
the spoon by the shoe was tired .	the spoon is by the shoe was tired .
the couch on the street is clever .	the couch was on the street is clever .
the rug in the museum is important .	the rug was in the museum is important .
the plane on the bed was young .	the plane is on the bed was young .
the window in the park is upset .	the window was in the park is upset .
the ship on the chair was excited .	the ship is on the chair was excited .
the button in the school is tired .	the button was in the school is tired .
the doll by the cup was careful .	the doll is by the cup was careful .
the window by the cup was smart .	the window is by the cup was smart .
the shoe on the ground is excited .	the shoe was on the ground is excited .
the mirror on the ground was clever .	the mirror is on the ground was clever .
the window on the bed is smart .	the window was on the bed is smart .
the shirt on the couch is sleepy .	the shirt was on the couch is sleepy .
the plate in the museum was friendly .	the plate is in the museum was friendly .
the glass in the museum was upset .	the glass is in the museum was upset .
the cup by the book was careful .	the cup is by the book was careful .
the boat on the bed was upset .	the boat is on the bed was upset .
the spoon in the park was curious .	the spoon is in the park was curious .
the ship on the floor was careful .	the ship is on the floor was careful .
the rocket on the table was sleepy .	the rocket is on the table was sleepy .
the bicycle by the bowl was upset .	the bicycle is by the bowl was upset .
the window in the mall is quiet .	the window was in the mall is quiet .
the candle in the hospital was tired .	the candle is in the hospital was tired .
the bed in the park is busy .	the bed was in the park is busy .
the spoon on the floor is boring .	the spoon was on the floor is boring .
the button in the school is friendly .	the button was in the school is friendly .
the glass on the floor is tired .	the glass was on the floor is tired .
the boat by the rug is smart .	the boat was by the rug is smart .
the crayon by the shoe was happy .	the crayon is by the shoe was happy .
the truck by the hat is sleepy .	the truck was by the hat is sleepy .
the candle by the bowl was angry .	the candle is by the bowl was angry .
the bed by the spoon was confused .	the bed is by the spoon was confused .
the window in the school is nice .	the window was in the school is nice .
the doll by the book was careful .	the doll is by the book was careful .
the doll in the bank was curious .	the doll is in the bank was curious .
the plate in the school is hungry .	the plate was in the school is hungry .
the fork in the bank was nice .	the fork is in the bank was nice .
the chair on the bed is nice .	the chair was on the bed is nice .
