Jessica says that your doctor is gentle .	Jessica works with your doctor is gentle .
Rachel thinks that your teacher is happy .	Rachel works with your teacher is happy .
the dentist knows that my dentist is clever .	the dentist talks to my dentist is clever .
Laura thinks that my brother is friendly .	Laura works with my brother is friendly .
the adult says that my mother is wrong .	the adult works with my mother is wrong .
my dentist knows that your cousin is busy .	my dentist works with your cousin is busy .
the driver says that my mother is gentle .	the driver scares my mother is gentle .
the person knows that your cousin is wrong .	the person scares your cousin is wrong .
my friend knows that my sister is helpful .	my friend works with my sister is helpful .
the dancer thinks that your wife is kind .	the dancer works with your wife is kind .
Laura knows that my wife is young .	Laura works with my wife is young .
your cousin says that my boss is gentle .	your cousin helps my boss is gentle .
the child thinks that my cousin is busy .	the child talks to my cousin is busy .
the customer knows that your dentist is hungry .	the customer talks to your dentist is hungry .
my dentist thinks that your wife is gentle .	my dentist talks to your wife is gentle .
the person says that my father is young .	the person helps my father is young .
the doctor knows that your daughter is sleepy .	the doctor scares your daughter is sleepy .
the teacher says that your teacher is excited .	the teacher scares your teacher is excited .
Nina thinks that my grandmother is healthy .	Nina talks to my grandmother is healthy .
Nicole knows that my teacher is tired .	Nicole talks to my teacher is tired .
my friend says that your husband is careful .	my friend scares your husband is careful .
the patient knows that my mother is careful .	the patient talks to my mother is careful .
your cousin knows that my sister is friendly .	your cousin works with my sister is friendly .
the dentist knows that your wife is wrong .	the dentist scares your wife is wrong .
your boss knows that your dentist is busy .	your boss scares your dentist is busy .
my dentist says that your cousin is upset .	my dentist helps your cousin is upset .
the teacher thinks that your boss is lucky .	the teacher works with your boss is lucky .
Renee says that my sister is surprised .	Renee talks to my sister is surprised .
Julia thinks that my mom is happy .	Julia talks to my mom is happy .
my cousin thinks that your dad is sleepy .	my cousin helps your dad is sleepy .
Donald says that your mother is bored .	Donald scares your mother is bored .
your cousin knows that your father is strong .	your cousin helps your father is strong .
Joseph knows that my doctor is bored .	Joseph scares my doctor is bored .
Rebecca knows that your doctor is happy .	Rebecca scares your doctor is happy .
my teacher knows that my dad is busy .	my teacher talks to my dad is busy .
Bill knows that my daughter is helpful .	Bill talks to my daughter is helpful .
your boss says that my teacher is excited .	your boss scares my teacher is excited .
the customer says that my wife is clever .	the customer talks to my wife is clever .
my doctor says that your son is quiet .	my doctor works with your son is quiet .
the patient says that your daughter is strong .	the patient talks to your daughter is strong .
my doctor says that your teacher is confused .	my doctor scares your teacher is confused .
Tracy says that my grandmother is careful .	Tracy helps my grandmother is careful .
the patient knows that my wife is lucky .	the patient works with my wife is lucky .
Brett says that my teacher is important .	Brett works with my teacher is important .
Bill thinks that your dentist is tired .	Bill works with your dentist is tired .
Adam says that your sister is bored .	Adam scares your sister is bored .
Sally thinks that my grandmother is clever .	Sally works with my grandmother is clever .
Carl thinks that your wife is nice .	Carl scares your wife is nice .
the dentist says that my boss is gentle .	the dentist scares my boss is gentle .
my dentist knows that my boss is careful .	my dentist helps my boss is careful .
the teacher says that your grandmother is important .	the teacher scares your grandmother is important .
Jill says that your wife is curious .	Jill helps your wife is curious .
Kevin says that your husband is upset .	Kevin works with your husband is upset .
Andrew knows that my boss is curious .	Andrew helps my boss is curious .
your teacher knows that my wife is angry .	your teacher helps my wife is angry .
your friend thinks that your brother is smart .	your friend helps your brother is smart .
Alice thinks that my husband is sleepy .	Alice helps my husband is sleepy .
the person thinks that your mom is friendly .	the person scares your mom is friendly .
Michael says that my dentist is bored .	Michael works with my dentist is bored .
the dancer says that my husband is quiet .	the dancer talks to my husband is quiet .
your cousin says that my teacher is confused .	your cousin helps my teacher is confused .
Jennifer says that my dentist is excited .	Jennifer works with my dentist is excited .
Julie thinks that my father is healthy .	Julie talks to my father is healthy .
your cousin knows that your father is excited .	your cousin scares your father is excited .
the patient knows that my dad is curious .	the patient works with my dad is curious .
my boss thinks that my mom is tall .	my boss helps my mom is tall .
Becca says that my boss is surprised .	Becca works with my boss is surprised .
the person thinks that your dentist is bored .	the person talks to your dentist is bored .
Renee thinks that my mom is important .	Renee helps my mom is important .
Brett knows that your wife is kind .	Brett helps your wife is kind .
Linda says that your teacher is kind .	Linda works with your teacher is kind .
the child knows that your wife is healthy .	the child helps your wife is healthy .
Nicole says that my daughter is curious .	Nicole scares my daughter is curious .
your boss thinks that my brother is young .	your boss helps my brother is young .
Nancy says that my sister is lucky .	Nancy works with my sister is lucky .
your cousin knows that my daughter is boring .	your cousin talks to my daughter is boring .
Richard knows that my boss is clever .	Richard works with my boss is clever .
my teacher thinks that my son is quiet .	my teacher scares my son is quiet .
my cousin says that your dentist is hungry .	my cousin helps your dentist is hungry .
your doctor says that your dentist is excited .	your doctor scares your dentist is excited .
Ronald knows that my boss is hungry .	Ronald works with my boss is hungry .
the doctor says that my daughter is excited .	the doctor scares my daughter is excited .
the driver thinks that my dad is angry .	the driver talks to my dad is angry .
Rebecca says that my brother is friendly .	Rebecca talks to my brother is friendly .
the person says that my son is hungry .	the person talks to my son is hungry .
your friend knows that my cousin is nice .	your friend works with my cousin is nice .
the adult knows that my wife is clever .	the adult works with my wife is clever .
the dancer says that your brother is clever .	the dancer scares your brother is clever .
my teacher thinks that your sister is sleepy .	my teacher helps your sister is sleepy .
Rachel knows that my doctor is gentle .	Rachel scares my doctor is gentle .
Mark says that my sister is excited .	Mark scares my sister is excited .
Anne thinks that my cousin is clever .	Anne works with my cousin is clever .
Dan says that my friend is clever .	Dan scares my friend is clever .
your dentist says that my daughter is surprised .	your dentist scares my daughter is surprised .
the customer says that my brother is lucky .	the customer scares my brother is lucky .
the patient knows that your teacher is confused .	the patient helps your teacher is confused .
your boss knows that my son is boring .	your boss scares my son is boring .
my dentist knows that my doctor is angry .	my dentist talks to my doctor is angry .
Nancy says that your husband is curious .	Nancy helps your husband is curious .
the dancer knows that my wife is careful .	the dancer scares my wife is careful .
the driver thinks that my boss is happy .	the driver talks to my boss is happy .
Julia knows that your grandmother is helpful .	Julia talks to your grandmother is helpful .
the teacher says that your husband is excited .	the teacher talks to your husband is excited .
your teacher knows that my friend is hungry .	your teacher talks to my friend is hungry .
my friend says that your teacher is curious .	my friend scares your teacher is curious .
the person knows that your cousin is healthy .	the person talks to your cousin is healthy .
my dentist knows that your dad is young .	my dentist works with your dad is young .
the patient says that my grandmother is kind .	the patient talks to my grandmother is kind .
your boss knows that my son is nice .	your boss helps my son is nice .
the customer thinks that my son is kind .	the customer talks to my son is kind .
the adult thinks that your dad is tall .	the adult talks to your dad is tall .
Anna says that your dad is happy .	Anna talks to your dad is happy .
the patient knows that your brother is wrong .	the patient works with your brother is wrong .
the dentist says that your mother is clever .	the dentist works with your mother is clever .
the person says that your mother is angry .	the person works with your mother is angry .
the dancer says that my father is surprised .	the dancer helps my father is surprised .
Jason thinks that your mother is friendly .	Jason scares your mother is friendly .
the patient knows that your sister is boring .	the patient works with your sister is boring .
my dentist says that my boss is careful .	my dentist helps my boss is careful .
Kevin says that my friend is quiet .	Kevin works with my friend is quiet .
Scott thinks that your sister is healthy .	Scott talks to your sister is healthy .
the dancer thinks that my father is boring .	the dancer works with my father is boring .
the adult thinks that my daughter is smart .	the adult scares my daughter is smart .
the person says that my doctor is careful .	the person scares my doctor is careful .
Wendy knows that my son is healthy .	Wendy talks to my son is healthy .
your doctor thinks that my father is smart .	your doctor helps my father is smart .
the driver thinks that my boss is quiet .	the driver works with my boss is quiet .
your boss says that my doctor is smart .	your boss helps my doctor is smart .
your cousin says that your dad is angry .	your cousin talks to your dad is angry .
the dentist knows that your cousin is careful .	the dentist helps your cousin is careful .
the dentist says that your cousin is lucky .	the dentist works with your cousin is lucky .
the dancer says that your brother is helpful .	the dancer talks to your brother is helpful .
Travis thinks that my mother is kind .	Travis scares my mother is kind .
the driver says that your mother is careful .	the driver helps your mother is careful .
the customer thinks that your grandmother is sleepy .	the customer works with your grandmother is sleepy .
my doctor knows that my brother is busy .	my doctor talks to my brother is busy .
Peter says that your grandmother is strong .	Peter talks to your grandmother is strong .
your friend says that your mother is angry .	your friend talks to your mother is angry .
my teacher knows that my dad is quiet .	my teacher helps my dad is quiet .
the dentist says that your mother is careful .	the dentist works with your mother is careful .
my teacher thinks that your daughter is important .	my teacher helps your daughter is important .
Linda knows that my brother is healthy .	Linda works with my brother is healthy .
the dentist thinks that my son is young .	the dentist scares my son is young .
Joseph knows that my mother is hungry .	Joseph talks to my mother is hungry .
the doctor says that my sister is nice .	the doctor helps my sister is nice .
my cousin says that your brother is wrong .	my cousin helps your brother is wrong .
the patient knows that your son is hungry .	the patient works with your son is hungry .
your doctor thinks that your friend is upset .	your doctor talks to your friend is upset .
the patient says that my friend is clever .	the patient works with my friend is clever .
your doctor thinks that my mother is tall .	your doctor helps my mother is tall .
your doctor knows that my teacher is healthy .	your doctor works with my teacher is healthy .
my dentist knows that your friend is surprised .	my dentist scares your friend is surprised .
the adult says that your brother is important .	the adult scares your brother is important .
Tracy knows that your daughter is hungry .	Tracy works with your daughter is hungry .
the teacher says that my teacher is strong .	the teacher scares my teacher is strong .
my cousin knows that your friend is important .	my cousin scares your friend is important .
the patient thinks that your cousin is confused .	the patient scares your cousin is confused .
my friend knows that your sister is wrong .	my friend scares your sister is wrong .
your teacher says that your son is upset .	your teacher helps your son is upset .
your teacher says that my dentist is tired .	your teacher works with my dentist is tired .
Richard says that my mother is helpful .	Richard talks to my mother is helpful .
your teacher thinks that my wife is helpful .	your teacher talks to my wife is helpful .
the customer thinks that your boss is healthy .	the customer scares your boss is healthy .
the adult knows that your husband is tired .	the adult scares your husband is tired .
my friend thinks that my teacher is hungry .	my friend works with my teacher is hungry .
the customer says that your husband is excited .	the customer works with your husband is excited .
my boss thinks that your grandmother is quiet .	my boss helps your grandmother is quiet .
your boss knows that my husband is curious .	your boss scares my husband is curious .
Bill thinks that your brother is nice .	Bill talks to your brother is nice .
the dancer thinks that your brother is busy .	the dancer scares your brother is busy .
the teacher knows that your cousin is tired .	the teacher scares your cousin is tired .
your doctor says that your friend is wrong .	your doctor helps your friend is wrong .
Alice thinks that my husband is young .	Alice scares my husband is young .
the driver says that my daughter is lucky .	the driver works with my daughter is lucky .
your friend says that your mom is surprised .	your friend works with your mom is surprised .
my cousin thinks that my son is clever .	my cousin talks to my son is clever .
my friend says that your brother is nice .	my friend talks to your brother is nice .
the person knows that your son is bored .	the person talks to your son is bored .
the driver knows that your father is healthy .	the driver scares your father is healthy .
your boss says that my sister is nice .	your boss scares my sister is nice .
the customer knows that your father is quiet .	the customer talks to your father is quiet .
the doctor says that my father is hungry .	the doctor talks to my father is hungry .
Michael says that your wife is confused .	Michael helps your wife is confused .
the doctor says that your brother is clever .	the doctor talks to your brother is clever .
Christopher thinks that your teacher is excited .	Christopher works with your teacher is excited .
your dentist says that your son is tired .	your dentist helps your son is tired .
the child says that my sister is busy .	the child helps my sister is busy .
Kristen thinks that your teacher is surprised .	Kristen talks to your teacher is surprised .
the dentist says that my teacher is smart .	the dentist talks to my teacher is smart .
the patient knows that your brother is happy .	the patient scares your brother is happy .
the child knows that your cousin is sleepy .	the child helps your cousin is sleepy .
the dentist knows that my father is important .	the dentist works with my father is important .
Richard thinks that my grandmother is angry .	Richard helps my grandmother is angry .
the dentist knows that my husband is sleepy .	the dentist talks to my husband is sleepy .
your cousin knows that my boss is helpful .	your cousin talks to my boss is helpful .
Brian knows that my dentist is nice .	Brian scares my dentist is nice .
the dancer knows that your doctor is sleepy .	the dancer scares your doctor is sleepy .
your doctor thinks that my son is young .	your doctor helps my son is young .
your boss thinks that your dentist is quiet .	your boss talks to your dentist is quiet .
the patient says that your daughter is happy .	the patient helps your daughter is happy .
my boss thinks that your doctor is nice .	my boss talks to your doctor is nice .
my doctor says that your brother is lucky .	my doctor works with your brother is lucky .
Sara says that your grandmother is healthy .	Sara talks to your grandmother is healthy .
your boss thinks that my friend is friendly .	your boss works with my friend is friendly .
the person says that your brother is busy .	the person works with your brother is busy .
the customer thinks that my wife is confused .	the customer talks to my wife is confused .
the adult knows that your cousin is young .	the adult talks to your cousin is young .
the doctor knows that your teacher is young .	the doctor scares your teacher is young .
the driver knows that my boss is young .	the driver talks to my boss is young .
your friend says that your mother is tall .	your friend works with your mother is tall .
Guy thinks that your husband is nice .	Guy helps your husband is nice .
your cousin thinks that my mom is surprised .	your cousin works with my mom is surprised .
the child says that my mother is hungry .	the child talks to my mother is hungry .
Susan knows that my father is busy .	Susan talks to my father is busy .
the doctor thinks that your wife is lucky .	the doctor works with your wife is lucky .
the teacher says that your mother is helpful .	the teacher helps your mother is helpful .
Laurie says that your husband is smart .	Laurie scares your husband is smart .
my friend knows that your mom is wrong .	my friend works with your mom is wrong .
my teacher thinks that your cousin is sleepy .	my teacher scares your cousin is sleepy .
my friend knows that your wife is bored .	my friend works with your wife is bored .
Jerry knows that my doctor is bored .	Jerry helps my doctor is bored .
my boss says that my teacher is surprised .	my boss scares my teacher is surprised .
Laurie thinks that your dad is happy .	Laurie helps your dad is happy .
the child knows that my cousin is healthy .	the child scares my cousin is healthy .
the patient says that my doctor is curious .	the patient helps my doctor is curious .
my teacher says that my dentist is quiet .	my teacher works with my dentist is quiet .
your teacher thinks that my wife is clever .	your teacher scares my wife is clever .
Karen knows that my father is excited .	Karen helps my father is excited .
the customer thinks that your dentist is nice .	the customer helps your dentist is nice .
Donna knows that your mother is friendly .	Donna talks to your mother is friendly .
Rebecca knows that your sister is important .	Rebecca scares your sister is important .
the teacher says that my boss is busy .	the teacher scares my boss is busy .
Mary says that my friend is curious .	Mary works with my friend is curious .
Steven thinks that my mom is boring .	Steven scares my mom is boring .
the driver says that my sister is strong .	the driver works with my sister is strong .
the child says that your grandmother is happy .	the child helps your grandmother is happy .
Paul knows that my husband is healthy .	Paul talks to my husband is healthy .
your boss knows that your daughter is upset .	your boss talks to your daughter is upset .
your friend says that my cousin is important .	your friend scares my cousin is important .
Lisa says that my son is upset .	Lisa talks to my son is upset .
your cousin thinks that your daughter is smart .	your cousin talks to your daughter is smart .
my friend says that my grandmother is angry .	my friend scares my grandmother is angry .
the person knows that my father is careful .	the person helps my father is careful .
your cousin knows that your boss is excited .	your cousin scares your boss is excited .
your friend thinks that my brother is clever .	your friend scares my brother is clever .
Robert knows that your father is confused .	Robert scares your father is confused .
the customer says that your dentist is happy .	the customer talks to your dentist is happy .
the dentist says that your teacher is nice .	the dentist talks to your teacher is nice .
Kevin knows that your husband is wrong .	Kevin helps your husband is wrong .
Naomi knows that your cousin is kind .	Naomi talks to your cousin is kind .
Brett knows that your son is wrong .	Brett scares your son is wrong .
the dancer knows that my mom is important .	the dancer works with my mom is important .
your dentist says that your boss is strong .	your dentist helps your boss is strong .
my doctor thinks that your friend is helpful .	my doctor works with your friend is helpful .
William knows that my friend is sleepy .	William works with my friend is sleepy .
my boss thinks that my son is tired .	my boss talks to my son is tired .
Robert knows that your son is lucky .	Robert helps your son is lucky .
my boss says that your cousin is strong .	my boss scares your cousin is strong .
Timothy knows that my mother is lucky .	Timothy talks to my mother is lucky .
Scott says that my cousin is friendly .	Scott talks to my cousin is friendly .
the doctor says that my doctor is tall .	the doctor scares my doctor is tall .
Brett knows that your cousin is careful .	Brett helps your cousin is careful .
Sarah thinks that your cousin is friendly .	Sarah talks to your cousin is friendly .
Gregory thinks that your brother is upset .	Gregory helps your brother is upset .
my dentist thinks that my son is strong .	my dentist scares my son is strong .
my doctor thinks that my wife is quiet .	my doctor talks to my wife is quiet .
my teacher says that your wife is excited .	my teacher helps your wife is excited .
my friend says that your mom is helpful .	my friend talks to your mom is helpful .
Gregory says that my wife is surprised .	Gregory scares my wife is surprised .
Sandra thinks that my friend is boring .	Sandra helps my friend is boring .
Ronald says that my father is hungry .	Ronald scares my father is hungry .
Scott knows that my mother is strong .	Scott scares my mother is strong .
my doctor knows that my mom is upset .	my doctor helps my mom is upset .
the driver thinks that my dentist is upset .	the driver scares my dentist is upset .
your cousin knows that my sister is surprised .	your cousin scares my sister is surprised .
Brian knows that my friend is curious .	Brian scares my friend is curious .
Donna says that your friend is young .	Donna scares your friend is young .
the adult thinks that my dad is important .	the adult works with my dad is important .
your teacher thinks that your brother is young .	your teacher talks to your brother is young .
the teacher thinks that your daughter is clever .	the teacher helps your daughter is clever .
Sara says that my cousin is tall .	Sara helps my cousin is tall .
your doctor thinks that my husband is angry .	your doctor talks to my husband is angry .
the patient says that my sister is happy .	the patient helps my sister is happy .
Anna says that my grandmother is healthy .	Anna scares my grandmother is healthy .
your cousin thinks that your daughter is curious .	your cousin scares your daughter is curious .
the teacher knows that my father is important .	the teacher scares my father is important .
Melissa says that your sister is tired .	Melissa works with your sister is tired .
my doctor thinks that my husband is careful .	my doctor talks to my husband is careful .
the child knows that my wife is lucky .	the child works with my wife is lucky .
Aaron thinks that my sister is young .	Aaron works with my sister is young .
Kristen knows that your doctor is hungry .	Kristen helps your doctor is hungry .
Jason thinks that your brother is excited .	Jason scares your brother is excited .
the person knows that my wife is sleepy .	the person scares my wife is sleepy .
the doctor thinks that your teacher is tired .	the doctor helps your teacher is tired .
the customer thinks that my father is lucky .	the customer talks to my father is lucky .
my doctor says that your dad is hungry .	my doctor helps your dad is hungry .
Kristen knows that my dentist is sleepy .	Kristen works with my dentist is sleepy .
your boss knows that my teacher is wrong .	your boss scares my teacher is wrong .
your teacher thinks that my mother is sleepy .	your teacher talks to my mother is sleepy .
my teacher says that my boss is helpful .	my teacher works with my boss is helpful .
Ronald knows that your brother is careful .	Ronald talks to your brother is careful .
my doctor says that your husband is lucky .	my doctor scares your husband is lucky .
Samantha knows that your son is bored .	Samantha scares your son is bored .
my dentist thinks that my brother is strong .	my dentist scares my brother is strong .
April thinks that your father is curious .	April talks to your father is curious .
Stephanie says that your daughter is tall .	Stephanie works with your daughter is tall .
Jill thinks that your cousin is excited .	Jill talks to your cousin is excited .
Wendy knows that my mother is hungry .	Wendy talks to my mother is hungry .
the customer knows that my sister is wrong .	the customer talks to my sister is wrong .
the customer thinks that my mother is quiet .	the customer works with my mother is quiet .
Steve says that your brother is excited .	Steve scares your brother is excited .
Linda thinks that your dad is gentle .	Linda helps your dad is gentle .
the patient says that your daughter is quiet .	the patient talks to your daughter is quiet .
Wendy says that your grandmother is boring .	Wendy talks to your grandmother is boring .
Marie knows that my dad is excited .	Marie talks to my dad is excited .
your teacher says that my brother is smart .	your teacher talks to my brother is smart .
your dentist says that your brother is friendly .	your dentist talks to your brother is friendly .
your teacher knows that your doctor is angry .	your teacher scares your doctor is angry .
my boss knows that your grandmother is curious .	my boss works with your grandmother is curious .
Steve thinks that your dad is nice .	Steve scares your dad is nice .
Thomas knows that my boss is curious .	Thomas scares my boss is curious .
your teacher says that my mom is strong .	your teacher helps my mom is strong .
Martin knows that your wife is surprised .	Martin helps your wife is surprised .
your boss thinks that my sister is busy .	your boss helps my sister is busy .
Gregory thinks that your wife is nice .	Gregory scares your wife is nice .
Julia thinks that your dad is young .	Julia scares your dad is young .
Nicole thinks that my mother is smart .	Nicole works with my mother is smart .
the dancer says that my dad is gentle .	the dancer helps my dad is gentle .
Thomas says that my wife is nice .	Thomas helps my wife is nice .
the customer says that my brother is excited .	the customer works with my brother is excited .
Brett knows that my wife is excited .	Brett talks to my wife is excited .
Aaron thinks that my sister is bored .	Aaron talks to my sister is bored .
Nancy says that my sister is angry .	Nancy works with my sister is angry .
my friend says that my son is friendly .	my friend scares my son is friendly .
Julie knows that my husband is tall .	Julie talks to my husband is tall .
Naomi thinks that your wife is careful .	Naomi works with your wife is careful .
your doctor says that your husband is kind .	your doctor helps your husband is kind .
Amelia thinks that your friend is tall .	Amelia scares your friend is tall .
the child says that your grandmother is hungry .	the child works with your grandmother is hungry .
the driver says that my boss is quiet .	the driver works with my boss is quiet .
the dentist knows that my friend is busy .	the dentist talks to my friend is busy .
Deborah knows that my sister is boring .	Deborah helps my sister is boring .
my teacher thinks that my doctor is friendly .	my teacher scares my doctor is friendly .
Ronald thinks that my father is surprised .	Ronald talks to my father is surprised .
Nina says that my boss is strong .	Nina helps my boss is strong .
the teacher thinks that your sister is boring .	the teacher talks to your sister is boring .
Travis thinks that your mother is friendly .	Travis works with your mother is friendly .
Peter thinks that my dentist is kind .	Peter helps my dentist is kind .
Sarah knows that my cousin is nice .	Sarah works with my cousin is nice .
Karen knows that my wife is busy .	Karen talks to my wife is busy .
your friend thinks that my daughter is confused .	your friend scares my daughter is confused .
my dentist says that your grandmother is quiet .	my dentist works with your grandmother is quiet .
the patient knows that my dentist is excited .	the patient works with my dentist is excited .
Nina knows that my grandmother is upset .	Nina works with my grandmother is upset .
the customer knows that my daughter is confused .	the customer helps my daughter is confused .
Thomas knows that your teacher is happy .	Thomas scares your teacher is happy .
the customer thinks that my doctor is wrong .	the customer scares my doctor is wrong .
your dentist says that your dad is angry .	your dentist scares your dad is angry .
Alexander says that your husband is strong .	Alexander works with your husband is strong .
the teacher knows that your doctor is upset .	the teacher helps your doctor is upset .
your friend knows that your father is confused .	your friend scares your father is confused .
my teacher thinks that your grandmother is nice .	my teacher scares your grandmother is nice .
Gregory thinks that my grandmother is excited .	Gregory scares my grandmother is excited .
my boss knows that my friend is young .	my boss scares my friend is young .
your friend knows that my father is young .	your friend works with my father is young .
my dentist knows that your friend is surprised .	my dentist helps your friend is surprised .
my dentist knows that your dentist is hungry .	my dentist works with your dentist is hungry .
the teacher says that your wife is curious .	the teacher scares your wife is curious .
my friend says that your daughter is healthy .	my friend works with your daughter is healthy .
the child thinks that your sister is helpful .	the child helps your sister is helpful .
my friend thinks that your dad is tired .	my friend scares your dad is tired .
the teacher thinks that my boss is surprised .	the teacher works with my boss is surprised .
your doctor knows that my teacher is smart .	your doctor talks to my teacher is smart .
the child knows that your son is smart .	the child talks to your son is smart .
my teacher thinks that my doctor is kind .	my teacher helps my doctor is kind .
Renee thinks that your wife is angry .	Renee talks to your wife is angry .
the doctor says that my daughter is bored .	the doctor works with my daughter is bored .
Brett knows that your husband is busy .	Brett helps your husband is busy .
the dentist says that your teacher is upset .	the dentist scares your teacher is upset .
my dentist knows that my father is quiet .	my dentist works with my father is quiet .
Rachel says that my dad is tall .	Rachel scares my dad is tall .
my cousin says that your father is boring .	my cousin talks to your father is boring .
my dentist says that your daughter is happy .	my dentist works with your daughter is happy .
my teacher says that your sister is kind .	my teacher talks to your sister is kind .
Carl says that your dentist is sleepy .	Carl talks to your dentist is sleepy .
Denise says that your father is excited .	Denise works with your father is excited .
your friend thinks that my husband is wrong .	your friend works with my husband is wrong .
the dentist knows that my cousin is quiet .	the dentist works with my cousin is quiet .
the person knows that your friend is clever .	the person works with your friend is clever .
the patient says that my dad is busy .	the patient scares my dad is busy .
your doctor knows that my husband is lucky .	your doctor works with my husband is lucky .
Donna thinks that my friend is busy .	Donna scares my friend is busy .
the adult knows that your son is angry .	the adult scares your son is angry .
Janet thinks that my sister is happy .	Janet works with my sister is happy .
the person says that your son is lucky .	the person talks to your son is lucky .
Nina thinks that my son is important .	Nina talks to my son is important .
your friend thinks that my dentist is strong .	your friend scares my dentist is strong .
Carol thinks that your sister is friendly .	Carol helps your sister is friendly .
your cousin says that your brother is friendly .	your cousin helps your brother is friendly .
Jill knows that your sister is happy .	Jill talks to your sister is happy .
Deborah thinks that your wife is healthy .	Deborah talks to your wife is healthy .
Steven knows that my dentist is strong .	Steven works with my dentist is strong .
Marie thinks that your brother is quiet .	Marie scares your brother is quiet .
your boss says that your son is wrong .	your boss works with your son is wrong .
Patrick says that your wife is nice .	Patrick helps your wife is nice .
my dentist thinks that your dad is nice .	my dentist talks to your dad is nice .
the customer knows that my father is happy .	the customer works with my father is happy .
Becca thinks that my teacher is bored .	Becca works with my teacher is bored .
the customer says that your sister is careful .	the customer scares your sister is careful .
John thinks that your friend is strong .	John helps your friend is strong .
my dentist knows that your boss is lucky .	my dentist scares your boss is lucky .
my friend says that my mother is happy .	my friend works with my mother is happy .
my teacher knows that my mother is quiet .	my teacher talks to my mother is quiet .
your doctor knows that my brother is nice .	your doctor helps my brother is nice .
Melissa knows that your mom is friendly .	Melissa scares your mom is friendly .
the driver knows that my dad is angry .	the driver works with my dad is angry .
the person says that your doctor is tall .	the person scares your doctor is tall .
my doctor thinks that my dentist is smart .	my doctor scares my dentist is smart .
Andrew knows that your doctor is clever .	Andrew talks to your doctor is clever .
the customer thinks that my doctor is important .	the customer talks to my doctor is important .
my boss knows that your friend is bored .	my boss scares your friend is bored .
Wendy knows that my sister is angry .	Wendy works with my sister is angry .
Michael thinks that my husband is clever .	Michael scares my husband is clever .
Aaron thinks that your boss is excited .	Aaron works with your boss is excited .
the dancer says that my dad is friendly .	the dancer works with my dad is friendly .
my boss knows that your cousin is bored .	my boss talks to your cousin is bored .
Adam thinks that my wife is angry .	Adam works with my wife is angry .
Eric thinks that your sister is upset .	Eric works with your sister is upset .
William says that my brother is confused .	William talks to my brother is confused .
my teacher says that your son is quiet .	my teacher works with your son is quiet .
the child knows that my mom is clever .	the child works with my mom is clever .
the customer knows that my dentist is excited .	the customer helps my dentist is excited .
Dan thinks that my teacher is strong .	Dan helps my teacher is strong .
Ann knows that your brother is gentle .	Ann helps your brother is gentle .
my dentist knows that your father is angry .	my dentist talks to your father is angry .
Becky knows that your boss is curious .	Becky works with your boss is curious .
the dentist knows that my dentist is nice .	the dentist talks to my dentist is nice .
Alexander knows that my father is kind .	Alexander scares my father is kind .
my cousin says that your son is sleepy .	my cousin works with your son is sleepy .
Scott says that my wife is lucky .	Scott works with my wife is lucky .
Jill thinks that my husband is angry .	Jill talks to my husband is angry .
my doctor thinks that my dad is surprised .	my doctor talks to my dad is surprised .
the child says that your dad is hungry .	the child works with your dad is hungry .
the patient knows that your sister is tired .	the patient helps your sister is tired .
Steve says that my friend is nice .	Steve works with my friend is nice .
Julia knows that your son is helpful .	Julia scares your son is helpful .
Anna knows that your father is friendly .	Anna talks to your father is friendly .
Liam knows that your mother is gentle .	Liam talks to your mother is gentle .
Liam thinks that your boss is nice .	Liam works with your boss is nice .
the driver says that your wife is curious .	the driver talks to your wife is curious .
Ann thinks that your dentist is strong .	Ann helps your dentist is strong .
the adult thinks that my dad is smart .	the adult helps my dad is smart .
Nina knows that my daughter is nice .	Nina works with my daughter is nice .
the adult knows that my daughter is tall .	the adult talks to my daughter is tall .
Michael knows that my grandmother is boring .	Michael talks to my grandmother is boring .
Andrew thinks that my wife is clever .	Andrew talks to my wife is clever .
Anna says that your dentist is angry .	Anna scares your dentist is angry .
the dentist knows that your boss is curious .	the dentist talks to your boss is curious .
Guy thinks that your dad is nice .	Guy scares your dad is nice .
the doctor says that your grandmother is happy .	the doctor talks to your grandmother is happy .
my teacher knows that your dentist is strong .	my teacher talks to your dentist is strong .
my dentist knows that my wife is happy .	my dentist works with my wife is happy .
Todd thinks that my husband is tired .	Todd works with my husband is tired .
the customer says that my doctor is important .	the customer scares my doctor is important .
Laurie says that my father is important .	Laurie scares my father is important .
Adam says that your son is healthy .	Adam helps your son is healthy .
George says that my dad is surprised .	George talks to my dad is surprised .
Robert thinks that my boss is curious .	Robert works with my boss is curious .
my boss says that my dentist is nice .	my boss helps my dentist is nice .
Carol knows that your dentist is lucky .	Carol talks to your dentist is lucky .
Timothy thinks that my sister is lucky .	Timothy talks to my sister is lucky .
Naomi thinks that my doctor is boring .	Naomi talks to my doctor is boring .
my cousin says that your sister is hungry .	my cousin talks to your sister is hungry .
the teacher says that my son is quiet .	the teacher scares my son is quiet .
the teacher thinks that my father is curious .	the teacher works with my father is curious .
my boss knows that my husband is happy .	my boss works with my husband is happy .
my friend knows that your grandmother is wrong .	my friend talks to your grandmother is wrong .
the dentist thinks that my mom is confused .	the dentist works with my mom is confused .
the dancer says that your father is bored .	the dancer scares your father is bored .
your boss thinks that your dad is nice .	your boss works with your dad is nice .
your cousin says that your brother is helpful .	your cousin works with your brother is helpful .
my cousin thinks that your son is hungry .	my cousin scares your son is hungry .
George knows that your boss is curious .	George talks to your boss is curious .
my boss knows that my son is healthy .	my boss works with my son is healthy .
Daniel thinks that your mother is excited .	Daniel helps your mother is excited .
my boss says that your grandmother is tall .	my boss talks to your grandmother is tall .
the dancer knows that your teacher is kind .	the dancer works with your teacher is kind .
Alexander knows that your husband is tired .	Alexander talks to your husband is tired .
your friend thinks that my teacher is sleepy .	your friend scares my teacher is sleepy .
your cousin says that your cousin is helpful .	your cousin talks to your cousin is helpful .
the adult thinks that your father is strong .	the adult works with your father is strong .
your friend says that your teacher is lucky .	your friend helps your teacher is lucky .
Elizabeth says that my grandmother is helpful .	Elizabeth scares my grandmother is helpful .
the doctor says that my dad is bored .	the doctor helps my dad is bored .
the customer thinks that my boss is happy .	the customer works with my boss is happy .
my boss says that my dentist is angry .	my boss talks to my dentist is angry .
Linda says that your friend is sleepy .	Linda works with your friend is sleepy .
Stephanie thinks that your son is wrong .	Stephanie helps your son is wrong .
Becca says that your teacher is confused .	Becca talks to your teacher is confused .
the dentist knows that my son is friendly .	the dentist helps my son is friendly .
the person knows that your son is confused .	the person talks to your son is confused .
my teacher says that your husband is boring .	my teacher works with your husband is boring .
the adult knows that my friend is confused .	the adult helps my friend is confused .
the doctor thinks that your doctor is excited .	the doctor helps your doctor is excited .
your cousin thinks that your father is smart .	your cousin helps your father is smart .
Jill knows that your boss is helpful .	Jill talks to your boss is helpful .
Timothy knows that my doctor is gentle .	Timothy scares my doctor is gentle .
the patient knows that my daughter is sleepy .	the patient scares my daughter is sleepy .
my dentist thinks that your teacher is tired .	my dentist talks to your teacher is tired .
Adam knows that my grandmother is upset .	Adam works with my grandmother is upset .
the dentist thinks that your son is curious .	the dentist scares your son is curious .
Stephanie says that my wife is busy .	Stephanie talks to my wife is busy .
the dancer says that my cousin is surprised .	the dancer talks to my cousin is surprised .
the teacher says that my daughter is sleepy .	the teacher helps my daughter is sleepy .
the adult says that my father is careful .	the adult helps my father is careful .
Brian knows that my cousin is quiet .	Brian talks to my cousin is quiet .
my dentist knows that your friend is hungry .	my dentist works with your friend is hungry .
the customer says that your father is helpful .	the customer helps your father is helpful .
your dentist thinks that my wife is kind .	your dentist scares my wife is kind .
Denise thinks that your mom is happy .	Denise works with your mom is happy .
your boss knows that your grandmother is surprised .	your boss works with your grandmother is surprised .
your doctor says that your daughter is bored .	your doctor scares your daughter is bored .
the customer thinks that your son is angry .	the customer talks to your son is angry .
the child says that my dentist is kind .	the child works with my dentist is kind .
Daniel says that your cousin is tall .	Daniel helps your cousin is tall .
your teacher says that my daughter is strong .	your teacher helps my daughter is strong .
your friend says that your cousin is important .	your friend scares your cousin is important .
Jerry says that your grandmother is wrong .	Jerry talks to your grandmother is wrong .
your dentist says that your daughter is upset .	your dentist helps your daughter is upset .
your cousin thinks that your brother is angry .	your cousin helps your brother is angry .
the dancer knows that your teacher is gentle .	the dancer scares your teacher is gentle .
Deborah says that my cousin is important .	Deborah talks to my cousin is important .
my friend says that my brother is nice .	my friend helps my brother is nice .
your cousin thinks that my daughter is kind .	your cousin works with my daughter is kind .
the doctor knows that my teacher is boring .	the doctor helps my teacher is boring .
Renee knows that your wife is smart .	Renee talks to your wife is smart .
your cousin says that my mother is angry .	your cousin helps my mother is angry .
Steve says that my husband is happy .	Steve talks to my husband is happy .
Janet knows that your father is excited .	Janet helps your father is excited .
my dentist says that your boss is confused .	my dentist works with your boss is confused .
the doctor says that your dentist is clever .	the doctor talks to your dentist is clever .
your cousin knows that your sister is confused .	your cousin talks to your sister is confused .
your teacher thinks that your dad is tall .	your teacher helps your dad is tall .
the patient thinks that your grandmother is curious .	the patient scares your grandmother is curious .
the patient says that my doctor is busy .	the patient works with my doctor is busy .
my dentist says that my cousin is helpful .	my dentist talks to my cousin is helpful .
your dentist says that my boss is bored .	your dentist scares my boss is bored .
Stephanie says that my sister is lucky .	Stephanie talks to my sister is lucky .
Jill thinks that my dad is careful .	Jill works with my dad is careful .
the customer knows that your boss is angry .	the customer talks to your boss is angry .
the person thinks that my sister is quiet .	the person scares my sister is quiet .
the driver says that my grandmother is gentle .	the driver scares my grandmother is gentle .
your friend knows that my dentist is excited .	your friend scares my dentist is excited .
your boss knows that my father is important .	your boss scares my father is important .
your doctor knows that my dentist is nice .	your doctor works with my dentist is nice .
Michael says that my doctor is angry .	Michael talks to my doctor is angry .
your friend says that your daughter is quiet .	your friend works with your daughter is quiet .
your teacher thinks that my husband is confused .	your teacher scares my husband is confused .
Donna says that my grandmother is careful .	Donna works with my grandmother is careful .
William says that your dentist is bored .	William works with your dentist is bored .
the customer knows that my son is wrong .	the customer helps my son is wrong .
Ann knows that your husband is boring .	Ann helps your husband is boring .
Paul says that your sister is gentle .	Paul helps your sister is gentle .
my boss says that your son is lucky .	my boss talks to your son is lucky .
Becky knows that your dentist is important .	Becky talks to your dentist is important .
Erin knows that your dad is happy .	Erin works with your dad is happy .
Erin thinks that your cousin is strong .	Erin works with your cousin is strong .
Eric knows that my boss is kind .	Eric works with my boss is kind .
my cousin knows that your son is smart .	my cousin scares your son is smart .
your friend says that your friend is surprised .	your friend helps your friend is surprised .
your dentist knows that my husband is curious .	your dentist scares my husband is curious .
Allison thinks that my brother is curious .	Allison talks to my brother is curious .
the teacher says that my father is important .	the teacher helps my father is important .
the patient thinks that your brother is friendly .	the patient scares your brother is friendly .
the adult thinks that your dentist is sleepy .	the adult talks to your dentist is sleepy .
the customer knows that your mom is angry .	the customer works with your mom is angry .
Steve says that my wife is bored .	Steve helps my wife is bored .
the doctor says that my brother is bored .	the doctor talks to my brother is bored .
my doctor says that my grandmother is happy .	my doctor works with my grandmother is happy .
Thomas thinks that my grandmother is friendly .	Thomas works with my grandmother is friendly .
my friend thinks that your mom is angry .	my friend works with your mom is angry .
my cousin says that your dentist is healthy .	my cousin scares your dentist is healthy .
Aaron thinks that my son is smart .	Aaron works with my son is smart .
the adult knows that my dad is healthy .	the adult scares my dad is healthy .
your friend thinks that my dentist is upset .	your friend works with my dentist is upset .
Todd says that my doctor is tired .	Todd scares my doctor is tired .
my dentist thinks that my boss is upset .	my dentist helps my boss is upset .
my boss says that your son is angry .	my boss talks to your son is angry .
the child thinks that your daughter is young .	the child scares your daughter is young .
your dentist says that my daughter is young .	your dentist works with my daughter is young .
your doctor knows that my dad is gentle .	your doctor works with my dad is gentle .
Amy thinks that your boss is tall .	Amy talks to your boss is tall .
the person knows that my daughter is confused .	the person talks to my daughter is confused .
the child thinks that your father is healthy .	the child helps your father is healthy .
Alexander knows that your sister is tall .	Alexander helps your sister is tall .
Timothy thinks that your husband is wrong .	Timothy talks to your husband is wrong .
the person knows that your friend is angry .	the person talks to your friend is angry .
Jennifer thinks that my brother is smart .	Jennifer works with my brother is smart .
your doctor knows that your sister is tired .	your doctor scares your sister is tired .
Richard thinks that your mother is young .	Richard scares your mother is young .
Peter knows that your wife is friendly .	Peter talks to your wife is friendly .
my cousin knows that my teacher is careful .	my cousin talks to my teacher is careful .
the adult knows that my mom is quiet .	the adult works with my mom is quiet .
Steven knows that my doctor is busy .	Steven scares my doctor is busy .
the doctor knows that my husband is gentle .	the doctor helps my husband is gentle .
your dentist says that my grandmother is young .	your dentist scares my grandmother is young .
Stephanie thinks that my dentist is confused .	Stephanie scares my dentist is confused .
your teacher thinks that your dad is clever .	your teacher scares your dad is clever .
the driver thinks that your mom is confused .	the driver helps your mom is confused .
my dentist thinks that my mother is angry .	my dentist helps my mother is angry .
your cousin thinks that my teacher is important .	your cousin scares my teacher is important .
Nina says that my father is clever .	Nina helps my father is clever .
Nina knows that my daughter is gentle .	Nina helps my daughter is gentle .
the child says that your mom is surprised .	the child helps your mom is surprised .
my teacher knows that your brother is lucky .	my teacher talks to your brother is lucky .
the teacher says that my teacher is angry .	the teacher scares my teacher is angry .
your teacher knows that my mom is wrong .	your teacher talks to my mom is wrong .
your boss knows that your doctor is nice .	your boss talks to your doctor is nice .
the doctor thinks that my son is happy .	the doctor works with my son is happy .
your cousin thinks that your daughter is nice .	your cousin works with your daughter is nice .
your cousin says that my cousin is confused .	your cousin works with my cousin is confused .
the patient says that your grandmother is curious .	the patient helps your grandmother is curious .
my friend knows that my cousin is strong .	my friend helps my cousin is strong .
my cousin says that my dad is surprised .	my cousin helps my dad is surprised .
my boss knows that my sister is clever .	my boss talks to my sister is clever .
the driver thinks that your boss is healthy .	the driver talks to your boss is healthy .
Dan knows that my husband is lucky .	Dan works with my husband is lucky .
James knows that your friend is upset .	James scares your friend is upset .
the driver says that my husband is quiet .	the driver scares my husband is quiet .
Naomi says that your wife is hungry .	Naomi talks to your wife is hungry .
Nancy thinks that my mother is busy .	Nancy scares my mother is busy .
the customer says that my dentist is wrong .	the customer talks to my dentist is wrong .
the adult knows that your sister is confused .	the adult talks to your sister is confused .
Timothy thinks that your dad is quiet .	Timothy helps your dad is quiet .
the child says that my friend is bored .	the child scares my friend is bored .
the dancer says that your husband is important .	the dancer helps your husband is important .
Scott knows that my teacher is sleepy .	Scott works with my teacher is sleepy .
Sarah knows that your father is hungry .	Sarah talks to your father is hungry .
my teacher says that your boss is happy .	my teacher scares your boss is happy .
the dentist thinks that my husband is smart .	the dentist talks to my husband is smart .
the teacher thinks that my sister is angry .	the teacher works with my sister is angry .
my cousin knows that your son is upset .	my cousin helps your son is upset .
the dentist knows that my wife is excited .	the dentist works with my wife is excited .
David thinks that your boss is wrong .	David helps your boss is wrong .
my friend knows that my dentist is angry .	my friend helps my dentist is angry .
the adult says that my boss is busy .	the adult works with my boss is busy .
the person thinks that my friend is smart .	the person works with my friend is smart .
Noah knows that your wife is hungry .	Noah talks to your wife is hungry .
your boss says that my mother is kind .	your boss works with my mother is kind .
your friend says that my dentist is friendly .	your friend works with my dentist is friendly .
Joseph says that your dad is busy .	Joseph scares your dad is busy .
the driver knows that your mother is helpful .	the driver talks to your mother is helpful .
Todd thinks that your cousin is lucky .	Todd scares your cousin is lucky .
Sandra says that your friend is busy .	Sandra talks to your friend is busy .
Becky knows that my grandmother is excited .	Becky works with my grandmother is excited .
the doctor knows that my son is angry .	the doctor works with my son is angry .
Carl knows that your husband is friendly .	Carl scares your husband is friendly .
Marie says that your sister is confused .	Marie helps your sister is confused .
your boss says that my father is upset .	your boss scares my father is upset .
the adult thinks that your brother is happy .	the adult works with your brother is happy .
Jill knows that your mom is friendly .	Jill works with your mom is friendly .
the teacher knows that your teacher is tall .	the teacher scares your teacher is tall .
Jane thinks that my father is tired .	Jane talks to my father is tired .
my cousin thinks that my friend is hungry .	my cousin helps my friend is hungry .
my teacher says that your wife is tall .	my teacher scares your wife is tall .
the patient thinks that my sister is strong .	the patient works with my sister is strong .
Amelia knows that my son is busy .	Amelia works with my son is busy .
my doctor thinks that your boss is curious .	my doctor talks to your boss is curious .
Marie says that my boss is upset .	Marie works with my boss is upset .
my teacher says that my daughter is busy .	my teacher works with my daughter is busy .
the customer thinks that my father is curious .	the customer scares my father is curious .
my friend knows that my boss is bored .	my friend helps my boss is bored .
the driver says that my grandmother is busy .	the driver works with my grandmother is busy .
Julia says that my brother is tall .	Julia works with my brother is tall .
my doctor thinks that my father is lucky .	my doctor scares my father is lucky .
your friend says that my husband is important .	your friend helps my husband is important .
your doctor says that my dad is excited .	your doctor helps my dad is excited .
Julie thinks that my grandmother is tall .	Julie helps my grandmother is tall .
my friend thinks that my cousin is friendly .	my friend scares my cousin is friendly .
Nicole knows that my son is quiet .	Nicole works with my son is quiet .
my friend says that your wife is healthy .	my friend talks to your wife is healthy .
the doctor knows that your dad is excited .	the doctor scares your dad is excited .
the person knows that my doctor is quiet .	the person helps my doctor is quiet .
your doctor thinks that my doctor is bored .	your doctor talks to my doctor is bored .
your dentist says that my sister is busy .	your dentist talks to my sister is busy .
Judy knows that your grandmother is surprised .	Judy works with your grandmother is surprised .
the adult thinks that your son is bored .	the adult works with your son is bored .
the adult says that my father is wrong .	the adult scares my father is wrong .
Linda knows that your sister is happy .	Linda works with your sister is happy .
Anne thinks that your mother is wrong .	Anne works with your mother is wrong .
Barbara knows that my dad is boring .	Barbara works with my dad is boring .
Amelia says that your dentist is careful .	Amelia works with your dentist is careful .
your boss says that your wife is helpful .	your boss talks to your wife is helpful .
the teacher says that my dad is busy .	the teacher talks to my dad is busy .
the child says that my mom is lucky .	the child helps my mom is lucky .
Susan knows that your father is quiet .	Susan works with your father is quiet .
the adult knows that my father is bored .	the adult scares my father is bored .
Timothy says that your friend is friendly .	Timothy helps your friend is friendly .
your teacher knows that my doctor is angry .	your teacher talks to my doctor is angry .
the person thinks that your grandmother is sleepy .	the person works with your grandmother is sleepy .
Sally knows that my doctor is bored .	Sally talks to my doctor is bored .
the child thinks that my father is healthy .	the child talks to my father is healthy .
Donna thinks that your cousin is upset .	Donna helps your cousin is upset .
Deborah knows that my son is careful .	Deborah works with my son is careful .
Julia thinks that your brother is strong .	Julia talks to your brother is strong .
the customer thinks that your cousin is upset .	the customer works with your cousin is upset .
my boss thinks that my brother is tired .	my boss works with my brother is tired .
the driver thinks that my boss is quiet .	the driver helps my boss is quiet .
Karen says that my dentist is nice .	Karen scares my dentist is nice .
the person knows that your dentist is tired .	the person works with your dentist is tired .
your dentist thinks that your dentist is quiet .	your dentist works with your dentist is quiet .
your boss knows that my husband is important .	your boss talks to my husband is important .
Adam thinks that your teacher is gentle .	Adam talks to your teacher is gentle .
the doctor thinks that my daughter is clever .	the doctor works with my daughter is clever .
the dentist says that my mom is important .	the dentist works with my mom is important .
your dentist says that my wife is sleepy .	your dentist scares my wife is sleepy .
William thinks that your son is helpful .	William helps your son is helpful .
your dentist knows that my brother is wrong .	your dentist talks to my brother is wrong .
your doctor knows that my boss is upset .	your doctor works with my boss is upset .
my cousin thinks that my father is curious .	my cousin talks to my father is curious .
Samantha thinks that my grandmother is surprised .	Samantha talks to my grandmother is surprised .
my cousin says that your boss is lucky .	my cousin helps your boss is lucky .
the teacher knows that my son is confused .	the teacher scares my son is confused .
Becca thinks that my wife is lucky .	Becca works with my wife is lucky .
the driver says that your father is surprised .	the driver scares your father is surprised .
my boss thinks that your son is excited .	my boss talks to your son is excited .
Kayla knows that your dentist is angry .	Kayla talks to your dentist is angry .
Karen thinks that my daughter is surprised .	Karen scares my daughter is surprised .
the patient knows that my sister is careful .	the patient talks to my sister is careful .
your boss thinks that my brother is important .	your boss helps my brother is important .
Jessica says that your wife is busy .	Jessica scares your wife is busy .
my cousin thinks that your teacher is bored .	my cousin talks to your teacher is bored .
Travis thinks that your teacher is strong .	Travis works with your teacher is strong .
the dancer thinks that my boss is surprised .	the dancer helps my boss is surprised .
Judy thinks that your brother is happy .	Judy scares your brother is happy .
Liam thinks that my mom is young .	Liam talks to my mom is young .
the dentist says that my cousin is important .	the dentist talks to my cousin is important .
my friend knows that your doctor is important .	my friend works with your doctor is important .
my dentist says that my father is sleepy .	my dentist scares my father is sleepy .
my cousin thinks that your daughter is upset .	my cousin scares your daughter is upset .
your doctor thinks that your boss is boring .	your doctor helps your boss is boring .
my boss says that your teacher is busy .	my boss scares your teacher is busy .
George says that your husband is careful .	George talks to your husband is careful .
my dentist thinks that my brother is healthy .	my dentist helps my brother is healthy .
your doctor knows that your dentist is healthy .	your doctor helps your dentist is healthy .
Ann thinks that my teacher is strong .	Ann talks to my teacher is strong .
the teacher knows that my mom is excited .	the teacher works with my mom is excited .
my boss says that your wife is healthy .	my boss helps your wife is healthy .
your doctor thinks that my grandmother is quiet .	your doctor scares my grandmother is quiet .
your boss knows that your grandmother is careful .	your boss works with your grandmother is careful .
your teacher thinks that your wife is lucky .	your teacher talks to your wife is lucky .
your boss knows that my sister is excited .	your boss helps my sister is excited .
Denise thinks that your dentist is smart .	Denise scares your dentist is smart .
your teacher says that your wife is strong .	your teacher helps your wife is strong .
April knows that my husband is happy .	April talks to my husband is happy .
my teacher thinks that my wife is gentle .	my teacher scares my wife is gentle .
Naomi thinks that your brother is young .	Naomi works with your brother is young .
Amelia knows that my teacher is helpful .	Amelia scares my teacher is helpful .
the doctor thinks that your son is wrong .	the doctor scares your son is wrong .
Donna thinks that your teacher is helpful .	Donna scares your teacher is helpful .
the driver thinks that my grandmother is friendly .	the driver talks to my grandmother is friendly .
your cousin says that my sister is healthy .	your cousin works with my sister is healthy .
your boss thinks that your son is tired .	your boss talks to your son is tired .
the customer knows that my wife is gentle .	the customer helps my wife is gentle .
the child says that your mother is helpful .	the child helps your mother is helpful .
the dentist thinks that my dad is kind .	the dentist helps my dad is kind .
my cousin thinks that my wife is nice .	my cousin helps my wife is nice .
my friend thinks that your cousin is kind .	my friend scares your cousin is kind .
the adult knows that my dentist is young .	the adult talks to my dentist is young .
my boss knows that my sister is excited .	my boss helps my sister is excited .
Mary thinks that my dentist is wrong .	Mary works with my dentist is wrong .
your doctor knows that my wife is clever .	your doctor helps my wife is clever .
the person says that my mother is kind .	the person talks to my mother is kind .
your dentist thinks that my mom is tired .	your dentist helps my mom is tired .
Michelle says that your wife is excited .	Michelle talks to your wife is excited .
the customer says that your mother is excited .	the customer helps your mother is excited .
Julia thinks that your teacher is boring .	Julia helps your teacher is boring .
Alexander says that your friend is boring .	Alexander scares your friend is boring .
my doctor says that my cousin is angry .	my doctor talks to my cousin is angry .
Jennifer knows that my wife is kind .	Jennifer works with my wife is kind .
the dentist thinks that my son is confused .	the dentist helps my son is confused .
the child thinks that your brother is happy .	the child talks to your brother is happy .
my teacher thinks that your dad is hungry .	my teacher scares your dad is hungry .
Brett knows that your mom is clever .	Brett scares your mom is clever .
the child thinks that my wife is happy .	the child helps my wife is happy .
the teacher knows that your dad is important .	the teacher helps your dad is important .
your friend knows that your sister is wrong .	your friend helps your sister is wrong .
the driver thinks that my son is wrong .	the driver works with my son is wrong .
my doctor knows that your dad is smart .	my doctor helps your dad is smart .
your doctor says that your grandmother is tired .	your doctor talks to your grandmother is tired .
the person says that my husband is boring .	the person scares my husband is boring .
your cousin thinks that my friend is lucky .	your cousin scares my friend is lucky .
Marie knows that your son is gentle .	Marie talks to your son is gentle .
Jerry knows that your brother is healthy .	Jerry helps your brother is healthy .
my teacher thinks that your wife is gentle .	my teacher helps your wife is gentle .
my boss says that your son is excited .	my boss works with your son is excited .
the dancer says that my sister is tired .	the dancer scares my sister is tired .
Denise says that your dentist is tall .	Denise scares your dentist is tall .
the customer knows that your friend is bored .	the customer talks to your friend is bored .
the dancer says that my sister is hungry .	the dancer works with my sister is hungry .
the patient thinks that your brother is young .	the patient works with your brother is young .
Nina says that your teacher is quiet .	Nina helps your teacher is quiet .
my dentist thinks that my father is busy .	my dentist helps my father is busy .
Jane knows that your daughter is friendly .	Jane scares your daughter is friendly .
my dentist knows that your daughter is upset .	my dentist works with your daughter is upset .
my cousin says that my wife is important .	my cousin works with my wife is important .
Nancy thinks that your friend is angry .	Nancy scares your friend is angry .
Dan thinks that your doctor is wrong .	Dan scares your doctor is wrong .
Bill thinks that your brother is strong .	Bill works with your brother is strong .
Robert says that my doctor is tired .	Robert talks to my doctor is tired .
my boss thinks that my daughter is gentle .	my boss talks to my daughter is gentle .
the child thinks that your mother is quiet .	the child scares your mother is quiet .
the teacher thinks that my father is healthy .	the teacher scares my father is healthy .
your friend thinks that my cousin is important .	your friend talks to my cousin is important .
Naomi thinks that your mother is young .	Naomi helps your mother is young .
your teacher says that my friend is tall .	your teacher works with my friend is tall .
your boss thinks that your teacher is angry .	your boss helps your teacher is angry .
the patient thinks that my mom is busy .	the patient talks to my mom is busy .
the dancer says that my son is angry .	the dancer scares my son is angry .
your doctor thinks that your father is strong .	your doctor talks to your father is strong .
Rachel thinks that your cousin is hungry .	Rachel scares your cousin is hungry .
Marie knows that my son is happy .	Marie talks to my son is happy .
Michelle knows that your mother is healthy .	Michelle helps your mother is healthy .
James knows that my teacher is curious .	James works with my teacher is curious .
the teacher says that your husband is happy .	the teacher scares your husband is happy .
Liam thinks that your cousin is gentle .	Liam works with your cousin is gentle .
Guy says that my father is tall .	Guy works with my father is tall .
my doctor knows that your mother is curious .	my doctor talks to your mother is curious .
Sarah thinks that my doctor is healthy .	Sarah works with my doctor is healthy .
Christopher says that your mother is bored .	Christopher helps your mother is bored .
Rebecca thinks that my sister is quiet .	Rebecca helps my sister is quiet .
my boss says that your mother is excited .	my boss works with your mother is excited .
Kevin thinks that my son is friendly .	Kevin works with my son is friendly .
the driver knows that my friend is wrong .	the driver helps my friend is wrong .
the customer thinks that my dad is nice .	the customer helps my dad is nice .
my friend knows that my son is excited .	my friend talks to my son is excited .
the person knows that my mom is lucky .	the person scares my mom is lucky .
your cousin says that my teacher is boring .	your cousin works with my teacher is boring .
the patient knows that my doctor is nice .	the patient talks to my doctor is nice .
Scott thinks that your brother is busy .	Scott scares your brother is busy .
your dentist says that my cousin is quiet .	your dentist helps my cousin is quiet .
my teacher says that your brother is clever .	my teacher scares your brother is clever .
the dentist thinks that my teacher is hungry .	the dentist scares my teacher is hungry .
your dentist says that my boss is clever .	your dentist talks to my boss is clever .
Wendy knows that your son is tired .	Wendy talks to your son is tired .
your doctor thinks that my husband is upset .	your doctor scares my husband is upset .
the teacher knows that your wife is surprised .	the teacher works with your wife is surprised .
your boss knows that your husband is helpful .	your boss works with your husband is helpful .
my doctor thinks that my friend is hungry .	my doctor works with my friend is hungry .
your friend knows that my teacher is happy .	your friend talks to my teacher is happy .
your dentist thinks that your wife is quiet .	your dentist scares your wife is quiet .
the child thinks that my mom is tired .	the child talks to my mom is tired .
your teacher knows that your husband is quiet .	your teacher works with your husband is quiet .
my boss says that your sister is happy .	my boss talks to your sister is happy .
my teacher says that my boss is healthy .	my teacher helps my boss is healthy .
my friend thinks that your friend is nice .	my friend talks to your friend is nice .
my doctor knows that your doctor is happy .	my doctor works with your doctor is happy .
Aaron thinks that your father is lucky .	Aaron scares your father is lucky .
the teacher says that your boss is tired .	the teacher works with your boss is tired .
your cousin knows that my dad is confused .	your cousin helps my dad is confused .
Mark thinks that my dad is bored .	Mark works with my dad is bored .
the customer knows that my cousin is helpful .	the customer scares my cousin is helpful .
Richard thinks that your father is tall .	Richard scares your father is tall .
my friend thinks that your brother is tired .	my friend talks to your brother is tired .
Alice knows that your doctor is bored .	Alice talks to your doctor is bored .
the patient thinks that my husband is smart .	the patient helps my husband is smart .
my teacher thinks that your father is surprised .	my teacher talks to your father is surprised .
the child says that your mom is strong .	the child helps your mom is strong .
Becca says that my daughter is careful .	Becca helps my daughter is careful .
your doctor says that your son is boring .	your doctor helps your son is boring .
the doctor knows that your husband is happy .	the doctor scares your husband is happy .
the dancer says that my friend is happy .	the dancer talks to my friend is happy .
your cousin thinks that my mother is hungry .	your cousin talks to my mother is hungry .
the teacher thinks that your mother is careful .	the teacher works with your mother is careful .
the driver thinks that my mother is excited .	the driver talks to my mother is excited .
my dentist says that your doctor is hungry .	my dentist scares your doctor is hungry .
Donald knows that my teacher is important .	Donald works with my teacher is important .
your boss knows that my mother is healthy .	your boss scares my mother is healthy .
the driver thinks that my mother is boring .	the driver helps my mother is boring .
your friend thinks that my grandmother is wrong .	your friend works with my grandmother is wrong .
the patient says that my doctor is quiet .	the patient helps my doctor is quiet .
the teacher knows that your dad is lucky .	the teacher works with your dad is lucky .
Christopher thinks that your dad is smart .	Christopher talks to your dad is smart .
Judy says that your mom is gentle .	Judy scares your mom is gentle .
the person thinks that my boss is wrong .	the person works with my boss is wrong .
the person says that your mother is careful .	the person works with your mother is careful .
Sandra knows that my brother is helpful .	Sandra helps my brother is helpful .
David thinks that your cousin is bored .	David works with your cousin is bored .
my teacher knows that my doctor is angry .	my teacher helps my doctor is angry .
the customer says that my wife is careful .	the customer scares my wife is careful .
Donna says that my doctor is healthy .	Donna talks to my doctor is healthy .
the child thinks that your father is tall .	the child scares your father is tall .
the dancer knows that my friend is excited .	the dancer scares my friend is excited .
Renee knows that my brother is nice .	Renee works with my brother is nice .
Cindy thinks that your boss is upset .	Cindy helps your boss is upset .
Scott thinks that my father is strong .	Scott helps my father is strong .
your teacher thinks that my mother is tall .	your teacher works with my mother is tall .
your cousin says that my wife is healthy .	your cousin works with my wife is healthy .
the customer knows that my son is upset .	the customer works with my son is upset .
the adult knows that your doctor is friendly .	the adult works with your doctor is friendly .
Steven thinks that my mother is smart .	Steven scares my mother is smart .
the customer thinks that your cousin is healthy .	the customer talks to your cousin is healthy .
your dentist knows that my wife is surprised .	your dentist scares my wife is surprised .
my dentist thinks that your wife is angry .	my dentist scares your wife is angry .
the dancer says that my grandmother is kind .	the dancer works with my grandmother is kind .
Ronald thinks that your doctor is sleepy .	Ronald works with your doctor is sleepy .
John knows that my boss is nice .	John scares my boss is nice .
the dancer knows that your friend is friendly .	the dancer talks to your friend is friendly .
my teacher says that your teacher is helpful .	my teacher scares your teacher is helpful .
my dentist thinks that my dad is surprised .	my dentist scares my dad is surprised .
your boss knows that your daughter is busy .	your boss scares your daughter is busy .
your friend knows that my doctor is sleepy .	your friend helps my doctor is sleepy .
your friend thinks that my daughter is boring .	your friend works with my daughter is boring .
Daniel thinks that my teacher is clever .	Daniel helps my teacher is clever .
my dentist thinks that my cousin is bored .	my dentist helps my cousin is bored .
the customer says that my cousin is curious .	the customer talks to my cousin is curious .
my doctor thinks that my wife is confused .	my doctor works with my wife is confused .
the child knows that my son is boring .	the child helps my son is boring .
my teacher knows that my teacher is kind .	my teacher talks to my teacher is kind .
your doctor says that your doctor is lucky .	your doctor talks to your doctor is lucky .
your teacher says that my son is boring .	your teacher helps my son is boring .
the dentist says that my sister is bored .	the dentist works with my sister is bored .
the customer says that my brother is clever .	the customer talks to my brother is clever .
Sandra knows that your father is wrong .	Sandra talks to your father is wrong .
my dentist says that my father is friendly .	my dentist talks to my father is friendly .
my doctor thinks that my doctor is tired .	my doctor helps my doctor is tired .
my friend knows that my doctor is quiet .	my friend scares my doctor is quiet .
Naomi says that my teacher is careful .	Naomi helps my teacher is careful .
Rachel thinks that my father is surprised .	Rachel works with my father is surprised .
the driver knows that my mother is careful .	the driver helps my mother is careful .
your boss knows that your father is busy .	your boss talks to your father is busy .
the teacher thinks that your father is gentle .	the teacher helps your father is gentle .
Travis says that your father is curious .	Travis works with your father is curious .
my boss knows that my dentist is strong .	my boss helps my dentist is strong .
Rebecca thinks that your dentist is confused .	Rebecca scares your dentist is confused .
Allison says that my daughter is angry .	Allison helps my daughter is angry .
your friend thinks that your friend is happy .	your friend works with your friend is happy .
the person thinks that my daughter is wrong .	the person works with my daughter is wrong .
the driver knows that my cousin is careful .	the driver talks to my cousin is careful .
Eric thinks that my dentist is angry .	Eric works with my dentist is angry .
Anna thinks that your father is young .	Anna talks to your father is young .
the teacher knows that my dentist is happy .	the teacher scares my dentist is happy .
the teacher says that my teacher is surprised .	the teacher helps my teacher is surprised .
the child says that my cousin is wrong .	the child helps my cousin is wrong .
Judy thinks that my wife is clever .	Judy scares my wife is clever .
the patient thinks that your doctor is lucky .	the patient helps your doctor is lucky .
Frank says that your daughter is lucky .	Frank works with your daughter is lucky .
Vanessa knows that my doctor is careful .	Vanessa talks to my doctor is careful .
my friend thinks that my mother is confused .	my friend scares my mother is confused .
the teacher thinks that my father is healthy .	the teacher talks to my father is healthy .
Sara knows that your cousin is sleepy .	Sara works with your cousin is sleepy .
your doctor says that my friend is busy .	your doctor scares my friend is busy .
the doctor thinks that your husband is happy .	the doctor works with your husband is happy .
Dan says that your daughter is lucky .	Dan works with your daughter is lucky .
the child knows that my teacher is hungry .	the child helps my teacher is hungry .
Jessica knows that my grandmother is upset .	Jessica helps my grandmother is upset .
your cousin thinks that your boss is young .	your cousin helps your boss is young .
your cousin says that your wife is nice .	your cousin helps your wife is nice .
Aaron thinks that my son is gentle .	Aaron works with my son is gentle .
the adult knows that my mother is confused .	the adult helps my mother is confused .
my doctor knows that my husband is upset .	my doctor scares my husband is upset .
Vanessa knows that your father is quiet .	Vanessa talks to your father is quiet .
Jason says that my grandmother is hungry .	Jason works with my grandmother is hungry .
your cousin says that my wife is confused .	your cousin helps my wife is confused .
your boss knows that my father is wrong .	your boss talks to my father is wrong .
my dentist says that your boss is happy .	my dentist talks to your boss is happy .
Steven knows that my cousin is upset .	Steven helps my cousin is upset .
my boss says that your father is bored .	my boss works with your father is bored .
the customer says that my sister is confused .	the customer helps my sister is confused .
John thinks that your cousin is happy .	John helps your cousin is happy .
the person thinks that my son is friendly .	the person helps my son is friendly .
Frank says that my grandmother is strong .	Frank talks to my grandmother is strong .
Alexander knows that my doctor is kind .	Alexander helps my doctor is kind .
the adult thinks that my brother is boring .	the adult helps my brother is boring .
Andrew knows that your husband is confused .	Andrew talks to your husband is confused .
Travis knows that your mother is upset .	Travis talks to your mother is upset .
the doctor thinks that my mom is important .	the doctor helps my mom is important .
the person knows that your sister is wrong .	the person talks to your sister is wrong .
Jill says that your daughter is angry .	Jill helps your daughter is angry .
your cousin thinks that my mother is sleepy .	your cousin works with my mother is sleepy .
the driver knows that your doctor is bored .	the driver scares your doctor is bored .
your friend says that your grandmother is boring .	your friend works with your grandmother is boring .
my teacher says that my daughter is friendly .	my teacher talks to my daughter is friendly .
my teacher knows that my mom is tall .	my teacher helps my mom is tall .
your cousin knows that my cousin is curious .	your cousin talks to my cousin is curious .
your dentist knows that my dentist is friendly .	your dentist talks to my dentist is friendly .
my doctor thinks that your dentist is clever .	my doctor talks to your dentist is clever .
Paul knows that my mom is wrong .	Paul helps my mom is wrong .
Laura knows that your dad is clever .	Laura works with your dad is clever .
the dancer thinks that my boss is busy .	the dancer works with my boss is busy .
my cousin says that my wife is gentle .	my cousin talks to my wife is gentle .
Jason knows that your grandmother is gentle .	Jason works with your grandmother is gentle .
your boss knows that your mother is surprised .	your boss helps your mother is surprised .
your doctor knows that my friend is sleepy .	your doctor helps my friend is sleepy .
your teacher knows that my dad is tall .	your teacher helps my dad is tall .
your friend thinks that your cousin is curious .	your friend scares your cousin is curious .
Patrick knows that your boss is careful .	Patrick talks to your boss is careful .
Timothy thinks that my grandmother is busy .	Timothy talks to my grandmother is busy .
Naomi says that my friend is young .	Naomi scares my friend is young .
the adult thinks that your daughter is hungry .	the adult talks to your daughter is hungry .
