the adult is tall .	the adult exercises tall .
the adult is sleepy .	the adult paints sleepy .
the lady is smart .	the lady exercises smart .
the woman is important .	the woman waves important .
the dancer was confused .	the dancer talks confused .
the doctor is busy .	the doctor sings busy .
the customer was quiet .	the customer sings quiet .
the dancer was tall .	the dancer reads tall .
the driver is curious .	the driver cries curious .
the boy was boring .	the boy waves boring .
the queen is sleepy .	the queen waves sleepy .
the driver is young .	the driver cries young .
the girl was boring .	the girl sings boring .
the teacher was angry .	the teacher exercises angry .
the girl was strong .	the girl reads strong .
the adult was important .	the adult waves important .
the driver was quiet .	the driver sings quiet .
the adult was upset .	the adult paints upset .
the king was curious .	the king reads curious .
the lady is excited .	the lady paints excited .
the child was angry .	the child sings angry .
the driver was upset .	the driver paints upset .
the teacher was bored .	the teacher cries bored .
the boy was young .	the boy waves young .
the woman was young .	the woman waves young .
the person was wrong .	the person waves wrong .
the driver is excited .	the driver exercises excited .
the woman is smart .	the woman sings smart .
the customer is excited .	the customer waves excited .
the child was quiet .	the child talks quiet .
the boy was bored .	the boy cries bored .
the queen is young .	the queen reads young .
the adult is sleepy .	the adult waves sleepy .
the queen is angry .	the queen waves angry .
the dentist was hungry .	the dentist paints hungry .
the customer was tall .	the customer exercises tall .
the child was hungry .	the child cries hungry .
the dentist is smart .	the dentist talks smart .
the king was smart .	the king paints smart .
the dancer is confused .	the dancer sings confused .
the woman is kind .	the woman exercises kind .
the boy was friendly .	the boy talks friendly .
the adult is boring .	the adult sings boring .
the boy is important .	the boy exercises important .
the queen is curious .	the queen reads curious .
the doctor was friendly .	the doctor cries friendly .
the teacher was tired .	the teacher sings tired .
the dentist is wrong .	the dentist waves wrong .
the guy was kind .	the guy talks kind .
the queen was excited .	the queen cries excited .
the woman is careful .	the woman sings careful .
the woman is careful .	the woman cries careful .
the woman was bored .	the woman reads bored .
the dentist is young .	the dentist waves young .
the doctor is wrong .	the doctor waves wrong .
the adult is lucky .	the adult reads lucky .
the patient was hungry .	the patient exercises hungry .
the king is curious .	the king talks curious .
the teacher was busy .	the teacher talks busy .
the guy was tired .	the guy cries tired .
the doctor was tall .	the doctor cries tall .
the king is tall .	the king cries tall .
the woman was nice .	the woman paints nice .
the driver is smart .	the driver reads smart .
the child was tired .	the child sings tired .
the queen is curious .	the queen paints curious .
the dancer is careful .	the dancer paints careful .
the person is excited .	the person paints excited .
the lady was tall .	the lady cries tall .
the dancer is surprised .	the dancer talks surprised .
the king is surprised .	the king sings surprised .
the guy was lucky .	the guy waves lucky .
the boy is tired .	the boy cries tired .
the person was surprised .	the person talks surprised .
the girl is friendly .	the girl cries friendly .
the child is boring .	the child reads boring .
the patient is important .	the patient talks important .
the doctor was important .	the doctor reads important .
the person was tired .	the person exercises tired .
the guy is confused .	the guy waves confused .
the dentist was important .	the dentist cries important .
the queen is wrong .	the queen reads wrong .
the driver was clever .	the driver reads clever .
the teacher was boring .	the teacher sings boring .
the boy is gentle .	the boy sings gentle .
the adult was boring .	the adult sings boring .
the girl was surprised .	the girl cries surprised .
the driver is quiet .	the driver sings quiet .
the queen is friendly .	the queen reads friendly .
the person was busy .	the person waves busy .
the patient was clever .	the patient reads clever .
the customer was confused .	the customer paints confused .
the person was quiet .	the person paints quiet .
the person is upset .	the person waves upset .
the guy is strong .	the guy exercises strong .
the driver is clever .	the driver paints clever .
the driver is young .	the driver waves young .
the king is angry .	the king sings angry .
the girl is boring .	the girl talks boring .
the teacher is friendly .	the teacher talks friendly .
the guy is careful .	the guy exercises careful .
the man was excited .	the man paints excited .
the man is curious .	the man exercises curious .
the woman was angry .	the woman sings angry .
the person was angry .	the person paints angry .
the dancer was smart .	the dancer paints smart .
the doctor was lucky .	the doctor cries lucky .
the child is angry .	the child waves angry .
the child is upset .	the child cries upset .
the doctor is healthy .	the doctor cries healthy .
the adult was nice .	the adult reads nice .
the driver was quiet .	the driver waves quiet .
the lady is strong .	the lady paints strong .
the doctor is gentle .	the doctor cries gentle .
the teacher is tall .	the teacher waves tall .
the guy is happy .	the guy cries happy .
the child is excited .	the child reads excited .
the dentist was careful .	the dentist exercises careful .
the person is careful .	the person exercises careful .
the guy is boring .	the guy sings boring .
the driver is excited .	the driver paints excited .
the dancer was tired .	the dancer talks tired .
the teacher was surprised .	the teacher waves surprised .
the man is nice .	the man sings nice .
the doctor is helpful .	the doctor reads helpful .
the adult was tired .	the adult talks tired .
the man was busy .	the man exercises busy .
the queen was friendly .	the queen waves friendly .
the king is upset .	the king paints upset .
the dancer was quiet .	the dancer talks quiet .
the customer was kind .	the customer cries kind .
the king is nice .	the king cries nice .
the man was upset .	the man talks upset .
the dentist is upset .	the dentist reads upset .
the boy is upset .	the boy cries upset .
the adult was important .	the adult talks important .
the dancer was lucky .	the dancer talks lucky .
the patient is sleepy .	the patient exercises sleepy .
the dancer was kind .	the dancer sings kind .
the person was strong .	the person waves strong .
the queen was happy .	the queen cries happy .
the patient is lucky .	the patient cries lucky .
the teacher was healthy .	the teacher reads healthy .
the child is strong .	the child talks strong .
the boy was quiet .	the boy reads quiet .
the dentist is hungry .	the dentist paints hungry .
the adult was clever .	the adult paints clever .
the adult was helpful .	the adult talks helpful .
the boy was excited .	the boy sings excited .
the person is gentle .	the person talks gentle .
the guy was strong .	the guy waves strong .
the customer is careful .	the customer sings careful .
the patient was curious .	the patient waves curious .
the dancer was helpful .	the dancer exercises helpful .
the boy was confused .	the boy talks confused .
the driver is smart .	the driver exercises smart .
the boy is angry .	the boy exercises angry .
the dancer is happy .	the dancer talks happy .
the girl is excited .	the girl sings excited .
the person was curious .	the person paints curious .
the doctor was bored .	the doctor cries bored .
the driver was nice .	the driver reads nice .
the person is busy .	the person sings busy .
the dancer is helpful .	the dancer talks helpful .
the dancer is healthy .	the dancer sings healthy .
the guy is careful .	the guy paints careful .
the patient is busy .	the patient sings busy .
the adult was upset .	the adult sings upset .
the doctor was angry .	the doctor cries angry .
the teacher was smart .	the teacher exercises smart .
the boy was quiet .	the boy cries quiet .
the queen was important .	the queen talks important .
the dentist is hungry .	the dentist cries hungry .
the king was healthy .	the king reads healthy .
the lady is healthy .	the lady cries healthy .
the dancer is quiet .	the dancer paints quiet .
the dentist was bored .	the dentist paints bored .
the guy was surprised .	the guy talks surprised .
the girl was helpful .	the girl cries helpful .
the man is helpful .	the man cries helpful .
the adult is helpful .	the adult exercises helpful .
the queen was clever .	the queen talks clever .
the queen is happy .	the queen exercises happy .
the adult is surprised .	the adult waves surprised .
the woman was angry .	the woman paints angry .
the dentist was tired .	the dentist waves tired .
the patient was bored .	the patient paints bored .
the man is lucky .	the man sings lucky .
the person was curious .	the person exercises curious .
the guy is wrong .	the guy exercises wrong .
the customer was important .	the customer paints important .
the boy was confused .	the boy paints confused .
the king was strong .	the king cries strong .
the lady was sleepy .	the lady reads sleepy .
the customer was important .	the customer cries important .
the driver is tall .	the driver exercises tall .
the guy is smart .	the guy talks smart .
the teacher is helpful .	the teacher cries helpful .
the doctor was careful .	the doctor cries careful .
the customer is healthy .	the customer talks healthy .
the doctor is gentle .	the doctor reads gentle .
the child was lucky .	the child exercises lucky .
the customer is tall .	the customer paints tall .
the queen is boring .	the queen reads boring .
the girl is quiet .	the girl paints quiet .
the dentist was tall .	the dentist reads tall .
the adult is hungry .	the adult cries hungry .
the driver was curious .	the driver exercises curious .
the queen was wrong .	the queen exercises wrong .
the driver was clever .	the driver talks clever .
the customer is gentle .	the customer cries gentle .
the guy was angry .	the guy paints angry .
the person is sleepy .	the person cries sleepy .
the driver is careful .	the driver paints careful .
the dentist was angry .	the dentist sings angry .
the customer was curious .	the customer talks curious .
the child is busy .	the child reads busy .
the adult is curious .	the adult reads curious .
the queen is important .	the queen exercises important .
the teacher was boring .	the teacher exercises boring .
the boy was sleepy .	the boy waves sleepy .
the woman was hungry .	the woman talks hungry .
the patient was boring .	the patient sings boring .
the patient was tired .	the patient paints tired .
the child was wrong .	the child exercises wrong .
the king was tall .	the king talks tall .
the doctor was lucky .	the doctor sings lucky .
the king was busy .	the king cries busy .
the woman was bored .	the woman cries bored .
the teacher is surprised .	the teacher reads surprised .
the dentist was nice .	the dentist sings nice .
the child was quiet .	the child cries quiet .
the woman was happy .	the woman waves happy .
the adult is strong .	the adult sings strong .
the patient was angry .	the patient talks angry .
the doctor was upset .	the doctor cries upset .
the patient was young .	the patient paints young .
the child is nice .	the child exercises nice .
the dancer is sleepy .	the dancer exercises sleepy .
the man was curious .	the man sings curious .
the adult was tired .	the adult sings tired .
the dentist is gentle .	the dentist talks gentle .
the driver is kind .	the driver exercises kind .
the doctor was sleepy .	the doctor cries sleepy .
the guy is bored .	the guy sings bored .
the king was clever .	the king waves clever .
the lady was sleepy .	the lady exercises sleepy .
the girl was sleepy .	the girl waves sleepy .
the girl is tired .	the girl exercises tired .
the guy was quiet .	the guy talks quiet .
the dancer was boring .	the dancer talks boring .
the guy was gentle .	the guy exercises gentle .
the woman is hungry .	the woman waves hungry .
the king was young .	the king cries young .
the person is boring .	the person talks boring .
the driver is angry .	the driver reads angry .
the queen is boring .	the queen exercises boring .
the teacher is tired .	the teacher sings tired .
the lady was angry .	the lady exercises angry .
the dancer is friendly .	the dancer waves friendly .
the dancer was wrong .	the dancer waves wrong .
the man was curious .	the man waves curious .
the customer was friendly .	the customer waves friendly .
the person is smart .	the person sings smart .
the person was bored .	the person cries bored .
the dentist is healthy .	the dentist exercises healthy .
the queen was tall .	the queen reads tall .
the queen is smart .	the queen sings smart .
the man was angry .	the man sings angry .
the child was helpful .	the child sings helpful .
the person is healthy .	the person sings healthy .
the patient is hungry .	the patient reads hungry .
the woman was hungry .	the woman cries hungry .
the girl was upset .	the girl sings upset .
the child was smart .	the child paints smart .
the doctor is careful .	the doctor cries careful .
the king is curious .	the king waves curious .
the dancer was gentle .	the dancer paints gentle .
the driver was gentle .	the driver talks gentle .
the patient was smart .	the patient paints smart .
the woman is helpful .	the woman waves helpful .
the lady is strong .	the lady cries strong .
the dancer is gentle .	the dancer sings gentle .
the queen was excited .	the queen talks excited .
the woman is smart .	the woman waves smart .
the person was lucky .	the person talks lucky .
the queen was surprised .	the queen talks surprised .
the dancer was happy .	the dancer talks happy .
the person was clever .	the person talks clever .
the doctor was gentle .	the doctor sings gentle .
the guy is important .	the guy exercises important .
the dentist was helpful .	the dentist talks helpful .
the woman was quiet .	the woman paints quiet .
the boy is curious .	the boy exercises curious .
the dancer is bored .	the dancer paints bored .
the child is curious .	the child cries curious .
the patient was gentle .	the patient exercises gentle .
the man is hungry .	the man cries hungry .
the girl is hungry .	the girl exercises hungry .
the man was clever .	the man paints clever .
the man is quiet .	the man exercises quiet .
the boy is careful .	the boy waves careful .
the doctor is curious .	the doctor exercises curious .
the teacher was hungry .	the teacher waves hungry .
the doctor is excited .	the doctor talks excited .
the girl was confused .	the girl paints confused .
the queen was kind .	the queen exercises kind .
the adult is gentle .	the adult reads gentle .
the teacher is happy .	the teacher talks happy .
the guy is quiet .	the guy waves quiet .
the dentist was angry .	the dentist talks angry .
the queen is quiet .	the queen reads quiet .
the driver is curious .	the driver talks curious .
the woman was careful .	the woman sings careful .
the person is clever .	the person cries clever .
the child is sleepy .	the child talks sleepy .
the dancer was busy .	the dancer exercises busy .
the doctor was happy .	the doctor exercises happy .
the woman was friendly .	the woman waves friendly .
the dancer was wrong .	the dancer sings wrong .
the guy is important .	the guy waves important .
the man is curious .	the man reads curious .
the teacher was gentle .	the teacher cries gentle .
the dentist was careful .	the dentist paints careful .
the person is wrong .	the person waves wrong .
the child was gentle .	the child sings gentle .
the man was quiet .	the man sings quiet .
the dancer was kind .	the dancer paints kind .
the queen is confused .	the queen waves confused .
the dentist was surprised .	the dentist sings surprised .
the driver was helpful .	the driver sings helpful .
the driver was friendly .	the driver reads friendly .
the man is strong .	the man sings strong .
the patient is upset .	the patient reads upset .
the teacher is boring .	the teacher cries boring .
the king was quiet .	the king cries quiet .
the woman was gentle .	the woman talks gentle .
the lady is boring .	the lady paints boring .
the dentist was angry .	the dentist exercises angry .
the lady is smart .	the lady reads smart .
the child was young .	the child paints young .
the queen was helpful .	the queen exercises helpful .
the queen was clever .	the queen paints clever .
the boy was helpful .	the boy paints helpful .
the patient was helpful .	the patient sings helpful .
the adult was wrong .	the adult exercises wrong .
the woman was confused .	the woman sings confused .
the customer is tired .	the customer cries tired .
the boy was busy .	the boy paints busy .
the lady is confused .	the lady paints confused .
the dentist is happy .	the dentist paints happy .
the dentist was healthy .	the dentist reads healthy .
the dancer was sleepy .	the dancer waves sleepy .
the woman was busy .	the woman reads busy .
the adult is strong .	the adult reads strong .
the person is hungry .	the person reads hungry .
the child is careful .	the child reads careful .
the boy is important .	the boy waves important .
the child was surprised .	the child cries surprised .
the person was boring .	the person reads boring .
the woman is excited .	the woman talks excited .
the queen was tired .	the queen waves tired .
the adult is kind .	the adult waves kind .
the boy is surprised .	the boy reads surprised .
the man is busy .	the man sings busy .
the lady was important .	the lady talks important .
the woman is happy .	the woman exercises happy .
the adult was sleepy .	the adult exercises sleepy .
the dancer is sleepy .	the dancer cries sleepy .
the man was helpful .	the man reads helpful .
the patient is nice .	the patient waves nice .
the guy is careful .	the guy reads careful .
the dancer is curious .	the dancer sings curious .
the dancer was curious .	the dancer sings curious .
the child was clever .	the child exercises clever .
the doctor was friendly .	the doctor talks friendly .
the adult was friendly .	the adult sings friendly .
the person was tired .	the person reads tired .
the person is curious .	the person talks curious .
the child was young .	the child sings young .
the king was curious .	the king cries curious .
the king was smart .	the king exercises smart .
the dentist is tall .	the dentist cries tall .
the teacher is bored .	the teacher talks bored .
the teacher was surprised .	the teacher sings surprised .
the queen is happy .	the queen reads happy .
the teacher was surprised .	the teacher reads surprised .
the queen is surprised .	the queen cries surprised .
the person was gentle .	the person talks gentle .
the man was wrong .	the man talks wrong .
the woman was curious .	the woman paints curious .
the teacher was important .	the teacher paints important .
the patient is sleepy .	the patient sings sleepy .
the boy is busy .	the boy paints busy .
the girl was friendly .	the girl cries friendly .
the driver is excited .	the driver cries excited .
the girl was kind .	the girl cries kind .
the driver was healthy .	the driver cries healthy .
the doctor was strong .	the doctor paints strong .
the child was wrong .	the child sings wrong .
the man was happy .	the man sings happy .
the driver was tall .	the driver reads tall .
the boy was confused .	the boy sings confused .
the dancer is quiet .	the dancer exercises quiet .
the king was happy .	the king exercises happy .
the adult is gentle .	the adult talks gentle .
the adult is upset .	the adult cries upset .
the queen was boring .	the queen reads boring .
the lady was lucky .	the lady paints lucky .
the lady was tall .	the lady reads tall .
the patient is boring .	the patient talks boring .
the king is tired .	the king exercises tired .
the king was clever .	the king sings clever .
the teacher is kind .	the teacher reads kind .
the dancer is curious .	the dancer paints curious .
the dancer was busy .	the dancer sings busy .
the lady was helpful .	the lady waves helpful .
the queen is busy .	the queen exercises busy .
the child was happy .	the child reads happy .
the man is sleepy .	the man cries sleepy .
the customer was busy .	the customer talks busy .
the guy was smart .	the guy reads smart .
the man is angry .	the man exercises angry .
the dancer is clever .	the dancer waves clever .
the dentist was excited .	the dentist reads excited .
the driver is sleepy .	the driver exercises sleepy .
the lady is healthy .	the lady waves healthy .
the person was happy .	the person sings happy .
the teacher is upset .	the teacher talks upset .
the guy was friendly .	the guy cries friendly .
the woman is gentle .	the woman sings gentle .
the queen is careful .	the queen cries careful .
the teacher was tall .	the teacher reads tall .
the queen is bored .	the queen sings bored .
the lady is gentle .	the lady exercises gentle .
the girl was tired .	the girl waves tired .
the patient was nice .	the patient paints nice .
the dentist was helpful .	the dentist sings helpful .
the king was wrong .	the king cries wrong .
the dancer was curious .	the dancer cries curious .
the girl was kind .	the girl exercises kind .
the dancer was smart .	the dancer sings smart .
the guy was tired .	the guy talks tired .
the king is curious .	the king sings curious .
the guy is tired .	the guy paints tired .
the driver is clever .	the driver cries clever .
the boy was clever .	the boy reads clever .
the child was friendly .	the child sings friendly .
the guy is surprised .	the guy sings surprised .
the adult was nice .	the adult paints nice .
the patient is important .	the patient waves important .
the doctor is careful .	the doctor reads careful .
the adult is gentle .	the adult exercises gentle .
the king was busy .	the king sings busy .
the woman was young .	the woman reads young .
the girl was excited .	the girl reads excited .
the child was kind .	the child paints kind .
the adult is upset .	the adult paints upset .
the doctor is helpful .	the doctor paints helpful .
the patient is smart .	the patient waves smart .
the dancer is tall .	the dancer paints tall .
the person is tall .	the person talks tall .
the queen was curious .	the queen sings curious .
the customer was healthy .	the customer waves healthy .
the woman is tired .	the woman waves tired .
the doctor is important .	the doctor talks important .
the dancer was important .	the dancer waves important .
the dancer is young .	the dancer talks young .
the queen is happy .	the queen waves happy .
the person was helpful .	the person paints helpful .
the driver was important .	the driver exercises important .
the woman was tired .	the woman reads tired .
the woman is tall .	the woman reads tall .
the queen was clever .	the queen waves clever .
the girl was smart .	the girl sings smart .
the customer is angry .	the customer paints angry .
the doctor was important .	the doctor paints important .
the patient was happy .	the patient paints happy .
the guy was young .	the guy exercises young .
the lady is kind .	the lady paints kind .
the teacher was upset .	the teacher exercises upset .
the king is wrong .	the king cries wrong .
the adult is bored .	the adult talks bored .
the queen is friendly .	the queen cries friendly .
the queen is smart .	the queen talks smart .
the teacher was gentle .	the teacher sings gentle .
the man was clever .	the man talks clever .
the queen was quiet .	the queen sings quiet .
the customer was excited .	the customer paints excited .
the person is quiet .	the person exercises quiet .
the girl was important .	the girl talks important .
the adult is nice .	the adult sings nice .
the person is hungry .	the person talks hungry .
the teacher is sleepy .	the teacher sings sleepy .
the teacher was friendly .	the teacher talks friendly .
the patient is tall .	the patient exercises tall .
the girl is quiet .	the girl talks quiet .
the adult was angry .	the adult exercises angry .
the king was happy .	the king sings happy .
the adult was nice .	the adult exercises nice .
the guy was hungry .	the guy exercises hungry .
the boy was smart .	the boy reads smart .
the woman was confused .	the woman reads confused .
the dentist is happy .	the dentist sings happy .
the lady is kind .	the lady exercises kind .
the boy is young .	the boy talks young .
the doctor is excited .	the doctor cries excited .
the woman was wrong .	the woman exercises wrong .
the boy is wrong .	the boy sings wrong .
the queen is young .	the queen sings young .
the dancer is strong .	the dancer reads strong .
the doctor was excited .	the doctor talks excited .
the person is healthy .	the person exercises healthy .
the child was helpful .	the child cries helpful .
the girl was surprised .	the girl paints surprised .
the person was bored .	the person sings bored .
the teacher is young .	the teacher talks young .
the boy was hungry .	the boy reads hungry .
the child is tall .	the child sings tall .
the woman is smart .	the woman exercises smart .
the doctor is helpful .	the doctor cries helpful .
the driver was important .	the driver waves important .
the boy was confused .	the boy reads confused .
the teacher was kind .	the teacher talks kind .
the guy was excited .	the guy paints excited .
the queen is hungry .	the queen exercises hungry .
the woman was busy .	the woman sings busy .
the guy was busy .	the guy sings busy .
the doctor was boring .	the doctor reads boring .
the man was young .	the man exercises young .
the teacher was young .	the teacher paints young .
the adult is sleepy .	the adult exercises sleepy .
the king was helpful .	the king reads helpful .
the teacher is quiet .	the teacher paints quiet .
the person was important .	the person cries important .
the driver was happy .	the driver talks happy .
the adult is strong .	the adult paints strong .
the patient was nice .	the patient exercises nice .
the king is kind .	the king exercises kind .
the lady is nice .	the lady paints nice .
the boy was happy .	the boy paints happy .
the adult was upset .	the adult exercises upset .
the doctor was upset .	the doctor reads upset .
the guy is angry .	the guy exercises angry .
the person was healthy .	the person cries healthy .
the patient was surprised .	the patient talks surprised .
the man is helpful .	the man waves helpful .
the doctor was wrong .	the doctor reads wrong .
the dancer is lucky .	the dancer exercises lucky .
the guy was tired .	the guy paints tired .
the teacher is excited .	the teacher exercises excited .
the teacher is bored .	the teacher paints bored .
the dancer is quiet .	the dancer reads quiet .
the child was happy .	the child talks happy .
the child was tall .	the child exercises tall .
the lady is important .	the lady reads important .
the adult is hungry .	the adult sings hungry .
the child is helpful .	the child talks helpful .
the queen was tired .	the queen sings tired .
the driver was tired .	the driver sings tired .
the king is sleepy .	the king cries sleepy .
the guy is careful .	the guy sings careful .
the driver is quiet .	the driver paints quiet .
the child is young .	the child sings young .
the man was lucky .	the man cries lucky .
the lady is busy .	the lady reads busy .
the man was busy .	the man paints busy .
the dancer is upset .	the dancer sings upset .
the dentist was friendly .	the dentist talks friendly .
the guy was sleepy .	the guy waves sleepy .
the teacher was quiet .	the teacher talks quiet .
the child was quiet .	the child paints quiet .
the girl was nice .	the girl waves nice .
the lady is kind .	the lady waves kind .
the queen was tall .	the queen waves tall .
the boy is excited .	the boy exercises excited .
the lady was nice .	the lady cries nice .
the king is kind .	the king cries kind .
the boy is happy .	the boy waves happy .
the patient is boring .	the patient cries boring .
the driver is surprised .	the driver talks surprised .
the guy is friendly .	the guy talks friendly .
the queen is boring .	the queen talks boring .
the teacher was tall .	the teacher waves tall .
the dentist was tired .	the dentist sings tired .
the person is friendly .	the person exercises friendly .
the dancer was strong .	the dancer talks strong .
the boy is healthy .	the boy talks healthy .
the girl was tired .	the girl reads tired .
the lady was bored .	the lady cries bored .
the lady was clever .	the lady reads clever .
the king was tall .	the king waves tall .
the guy was important .	the guy sings important .
the customer was careful .	the customer cries careful .
the teacher was careful .	the teacher cries careful .
the customer is strong .	the customer talks strong .
the adult is upset .	the adult exercises upset .
the dentist was gentle .	the dentist sings gentle .
the person was smart .	the person reads smart .
the lady is nice .	the lady sings nice .
the guy is bored .	the guy talks bored .
the king is young .	the king paints young .
the boy was busy .	the boy sings busy .
the patient was surprised .	the patient paints surprised .
the girl is excited .	the girl paints excited .
the doctor is healthy .	the doctor reads healthy .
the doctor was careful .	the doctor talks careful .
the dentist was clever .	the dentist sings clever .
the dentist is upset .	the dentist talks upset .
the doctor is confused .	the doctor paints confused .
the woman is kind .	the woman sings kind .
the woman is wrong .	the woman paints wrong .
the dancer was bored .	the dancer reads bored .
the woman is wrong .	the woman waves wrong .
the guy was quiet .	the guy cries quiet .
the teacher is upset .	the teacher exercises upset .
the child was upset .	the child waves upset .
the dentist is gentle .	the dentist sings gentle .
the dentist is sleepy .	the dentist sings sleepy .
the man is lucky .	the man reads lucky .
the dentist was happy .	the dentist sings happy .
the lady was bored .	the lady talks bored .
the dancer was angry .	the dancer talks angry .
the woman was upset .	the woman waves upset .
the teacher was surprised .	the teacher paints surprised .
the driver is confused .	the driver sings confused .
the guy is hungry .	the guy talks hungry .
the patient is curious .	the patient talks curious .
the person is bored .	the person sings bored .
the dancer was surprised .	the dancer talks surprised .
the queen is excited .	the queen waves excited .
the teacher was curious .	the teacher reads curious .
the king was tall .	the king cries tall .
the man was angry .	the man cries angry .
the boy was upset .	the boy cries upset .
the teacher was tired .	the teacher waves tired .
the king was lucky .	the king sings lucky .
the queen was hungry .	the queen reads hungry .
the king is happy .	the king reads happy .
the driver was confused .	the driver paints confused .
the driver was excited .	the driver cries excited .
the person was healthy .	the person reads healthy .
the patient was nice .	the patient cries nice .
the customer is confused .	the customer reads confused .
the dentist is happy .	the dentist exercises happy .
the adult is nice .	the adult reads nice .
the adult is wrong .	the adult exercises wrong .
the child was wrong .	the child paints wrong .
the person is wrong .	the person exercises wrong .
the adult was strong .	the adult talks strong .
the doctor was confused .	the doctor exercises confused .
the man was gentle .	the man paints gentle .
the doctor is nice .	the doctor sings nice .
the patient was wrong .	the patient sings wrong .
the patient is curious .	the patient exercises curious .
the dentist was tall .	the dentist waves tall .
the adult is strong .	the adult cries strong .
the lady was healthy .	the lady talks healthy .
the woman is friendly .	the woman cries friendly .
the child was tired .	the child exercises tired .
the child was quiet .	the child exercises quiet .
the person was curious .	the person reads curious .
the customer was strong .	the customer sings strong .
the child is helpful .	the child reads helpful .
the queen was wrong .	the queen talks wrong .
the queen is strong .	the queen talks strong .
the boy is kind .	the boy reads kind .
the patient was helpful .	the patient exercises helpful .
the doctor was angry .	the doctor paints angry .
the queen is healthy .	the queen talks healthy .
the dentist was nice .	the dentist reads nice .
the dentist was nice .	the dentist waves nice .
the dentist is nice .	the dentist talks nice .
the adult was tall .	the adult talks tall .
the adult is tired .	the adult waves tired .
the patient was kind .	the patient paints kind .
the man was lucky .	the man paints lucky .
the child was surprised .	the child waves surprised .
the child is excited .	the child cries excited .
the woman is clever .	the woman exercises clever .
the dancer is gentle .	the dancer reads gentle .
the woman is surprised .	the woman cries surprised .
the child is young .	the child waves young .
the lady was gentle .	the lady reads gentle .
the girl is friendly .	the girl exercises friendly .
the woman is gentle .	the woman waves gentle .
the teacher was excited .	the teacher waves excited .
the woman was excited .	the woman cries excited .
the king is hungry .	the king paints hungry .
the adult is confused .	the adult paints confused .
the driver is quiet .	the driver waves quiet .
the patient was careful .	the patient talks careful .
the king was quiet .	the king reads quiet .
the woman is young .	the woman reads young .
the child was young .	the child cries young .
the person was angry .	the person cries angry .
the teacher was friendly .	the teacher cries friendly .
the dentist was boring .	the dentist sings boring .
the lady was young .	the lady cries young .
the dancer was healthy .	the dancer sings healthy .
the child was sleepy .	the child waves sleepy .
the person is busy .	the person reads busy .
the person is tired .	the person talks tired .
the customer was gentle .	the customer paints gentle .
the teacher was confused .	the teacher sings confused .
the king was important .	the king waves important .
the patient was tall .	the patient waves tall .
the boy is hungry .	the boy paints hungry .
the person is upset .	the person paints upset .
the dentist is important .	the dentist talks important .
the adult was helpful .	the adult reads helpful .
the child is curious .	the child exercises curious .
the person is nice .	the person cries nice .
the boy was happy .	the boy cries happy .
the queen was upset .	the queen paints upset .
the boy was wrong .	the boy sings wrong .
the queen was smart .	the queen talks smart .
the queen is busy .	the queen reads busy .
the driver was busy .	the driver paints busy .
the adult was helpful .	the adult sings helpful .
the man is sleepy .	the man exercises sleepy .
the guy was lucky .	the guy exercises lucky .
the queen was angry .	the queen reads angry .
the boy is boring .	the boy cries boring .
the lady was important .	the lady exercises important .
the person was lucky .	the person reads lucky .
the lady was helpful .	the lady reads helpful .
the customer was quiet .	the customer waves quiet .
the king was angry .	the king cries angry .
the guy was curious .	the guy talks curious .
the driver was busy .	the driver waves busy .
the teacher is curious .	the teacher reads curious .
the dancer is nice .	the dancer sings nice .
the teacher is careful .	the teacher exercises careful .
the king is friendly .	the king cries friendly .
the teacher was careful .	the teacher exercises careful .
the man is tired .	the man cries tired .
the dancer is tired .	the dancer paints tired .
the doctor is important .	the doctor exercises important .
the boy is bored .	the boy talks bored .
the person was hungry .	the person reads hungry .
the king is hungry .	the king talks hungry .
the woman is tired .	the woman talks tired .
the queen was smart .	the queen exercises smart .
the dentist was healthy .	the dentist talks healthy .
the guy is smart .	the guy exercises smart .
the lady was curious .	the lady cries curious .
the boy is careful .	the boy sings careful .
the woman is happy .	the woman sings happy .
the patient is quiet .	the patient paints quiet .
the dancer is boring .	the dancer waves boring .
the child was excited .	the child paints excited .
the child is angry .	the child sings angry .
the teacher was upset .	the teacher cries upset .
the dancer was healthy .	the dancer exercises healthy .
the girl is helpful .	the girl waves helpful .
the doctor is kind .	the doctor talks kind .
the doctor was strong .	the doctor talks strong .
the adult was strong .	the adult waves strong .
the queen was friendly .	the queen reads friendly .
the king is happy .	the king paints happy .
the teacher was curious .	the teacher talks curious .
the woman was tired .	the woman exercises tired .
the king was angry .	the king exercises angry .
the person is surprised .	the person waves surprised .
the boy was curious .	the boy reads curious .
the driver was angry .	the driver exercises angry .
the girl is tall .	the girl cries tall .
the adult is excited .	the adult waves excited .
the queen is careful .	the queen exercises careful .
the dancer was angry .	the dancer cries angry .
the guy is healthy .	the guy waves healthy .
the guy was helpful .	the guy sings helpful .
the patient is surprised .	the patient cries surprised .
the dentist was healthy .	the dentist exercises healthy .
the doctor was sleepy .	the doctor waves sleepy .
the doctor was kind .	the doctor sings kind .
the lady was curious .	the lady sings curious .
the queen is friendly .	the queen talks friendly .
the girl was curious .	the girl talks curious .
the doctor is sleepy .	the doctor cries sleepy .
the king is tired .	the king talks tired .
the patient was important .	the patient paints important .
the customer was wrong .	the customer reads wrong .
the child is bored .	the child cries bored .
the doctor was gentle .	the doctor paints gentle .
the guy is tired .	the guy talks tired .
the patient was angry .	the patient paints angry .
the dancer was curious .	the dancer talks curious .
the king is lucky .	the king cries lucky .
the patient is friendly .	the patient cries friendly .
the person was busy .	the person talks busy .
the child was lucky .	the child sings lucky .
the guy is gentle .	the guy talks gentle .
the boy was excited .	the boy paints excited .
the girl is gentle .	the girl exercises gentle .
the king is boring .	the king talks boring .
the king is important .	the king waves important .
the child is nice .	the child talks nice .
the customer was healthy .	the customer paints healthy .
the lady is quiet .	the lady reads quiet .
the guy is careful .	the guy cries careful .
the woman is boring .	the woman exercises boring .
the person is lucky .	the person paints lucky .
the man was hungry .	the man waves hungry .
the boy is confused .	the boy exercises confused .
the customer was young .	the customer sings young .
the boy was angry .	the boy paints angry .
the customer was confused .	the customer sings confused .
the woman is helpful .	the woman cries helpful .
the doctor is kind .	the doctor reads kind .
the woman was nice .	the woman sings nice .
the girl was smart .	the girl reads smart .
the lady was strong .	the lady exercises strong .
the man is important .	the man cries important .
the doctor was boring .	the doctor cries boring .
the doctor is nice .	the doctor waves nice .
the man was boring .	the man waves boring .
the driver was angry .	the driver cries angry .
the lady was bored .	the lady paints bored .
the driver was wrong .	the driver paints wrong .
the child is upset .	the child sings upset .
the driver is gentle .	the driver talks gentle .
the teacher was friendly .	the teacher exercises friendly .
the customer was boring .	the customer talks boring .
the man is friendly .	the man reads friendly .
the guy is boring .	the guy talks boring .
the doctor was excited .	the doctor sings excited .
the child is clever .	the child exercises clever .
the boy is gentle .	the boy exercises gentle .
the lady was happy .	the lady sings happy .
the boy is strong .	the boy exercises strong .
the doctor was boring .	the doctor exercises boring .
the boy was healthy .	the boy talks healthy .
the teacher is busy .	the teacher reads busy .
the king is clever .	the king cries clever .
the doctor was quiet .	the doctor reads quiet .
the girl was careful .	the girl sings careful .
the adult was careful .	the adult reads careful .
the doctor was strong .	the doctor reads strong .
the lady is angry .	the lady paints angry .
the adult was smart .	the adult cries smart .
the driver was smart .	the driver sings smart .
the guy is curious .	the guy cries curious .
the lady is clever .	the lady exercises clever .
the man is careful .	the man cries careful .
the adult was hungry .	the adult sings hungry .
the queen is clever .	the queen paints clever .
the customer was excited .	the customer waves excited .
the girl was wrong .	the girl sings wrong .
the dancer is helpful .	the dancer cries helpful .
the customer is bored .	the customer reads bored .
the dancer is busy .	the dancer talks busy .
the adult is tall .	the adult waves tall .
the queen is busy .	the queen cries busy .
the woman is lucky .	the woman waves lucky .
the king was friendly .	the king exercises friendly .
the customer was healthy .	the customer sings healthy .
the dentist is boring .	the dentist cries boring .
the lady is clever .	the lady sings clever .
the driver is nice .	the driver reads nice .
the boy is surprised .	the boy exercises surprised .
the girl was clever .	the girl talks clever .
the guy was friendly .	the guy talks friendly .
the man was kind .	the man talks kind .
the king was gentle .	the king reads gentle .
the dentist was lucky .	the dentist waves lucky .
the adult was busy .	the adult paints busy .
the driver is important .	the driver paints important .
the king is lucky .	the king paints lucky .
the dentist was tired .	the dentist cries tired .
the customer was smart .	the customer reads smart .
the king was confused .	the king waves confused .
the woman was gentle .	the woman cries gentle .
the teacher is important .	the teacher reads important .
the lady is strong .	the lady reads strong .
the dancer is young .	the dancer reads young .
the woman was upset .	the woman cries upset .
the adult is important .	the adult exercises important .
the person is kind .	the person reads kind .
the queen is bored .	the queen cries bored .
the boy is young .	the boy exercises young .
the boy is wrong .	the boy cries wrong .
the boy is excited .	the boy paints excited .
the adult was lucky .	the adult talks lucky .
the teacher was upset .	the teacher talks upset .
the person was smart .	the person cries smart .
the guy was important .	the guy reads important .
the boy is smart .	the boy reads smart .
the queen was busy .	the queen paints busy .
the patient was quiet .	the patient reads quiet .
the woman was clever .	the woman exercises clever .
the woman was kind .	the woman talks kind .
the queen was young .	the queen sings young .
the dentist was tall .	the dentist exercises tall .
the man was lucky .	the man sings lucky .
the child was sleepy .	the child cries sleepy .
the person is careful .	the person reads careful .
the woman is nice .	the woman paints nice .
the boy was lucky .	the boy cries lucky .
the dancer was tired .	the dancer waves tired .
the dentist was clever .	the dentist paints clever .
the teacher is nice .	the teacher cries nice .
the teacher was curious .	the teacher paints curious .
the king is friendly .	the king paints friendly .
the driver was curious .	the driver waves curious .
the man is surprised .	the man waves surprised .
the king was busy .	the king talks busy .
the patient is tired .	the patient cries tired .
the doctor is gentle .	the doctor sings gentle .
the girl was clever .	the girl sings clever .
the doctor is confused .	the doctor reads confused .
the adult was upset .	the adult cries upset .
the dancer is kind .	the dancer exercises kind .
the guy is happy .	the guy talks happy .
the customer is surprised .	the customer reads surprised .
the queen was happy .	the queen paints happy .
the child was excited .	the child reads excited .
the woman was sleepy .	the woman paints sleepy .
the child is smart .	the child sings smart .
the king was friendly .	the king paints friendly .
the woman was upset .	the woman exercises upset .
the adult is strong .	the adult exercises strong .
the boy was kind .	the boy waves kind .
the person is helpful .	the person sings helpful .
the dancer is kind .	the dancer waves kind .
the king is angry .	the king talks angry .
the woman is excited .	the woman sings excited .
the teacher is confused .	the teacher reads confused .
the man is surprised .	the man reads surprised .
the queen is clever .	the queen cries clever .
the adult is young .	the adult cries young .
the customer was sleepy .	the customer paints sleepy .
the king was nice .	the king talks nice .
the guy was clever .	the guy cries clever .
the teacher is hungry .	the teacher reads hungry .
the adult is busy .	the adult sings busy .
the woman is quiet .	the woman cries quiet .
the king was quiet .	the king waves quiet .
the patient is tired .	the patient reads tired .
the doctor is curious .	the doctor cries curious .
the person is important .	the person sings important .
the person was sleepy .	the person talks sleepy .
the dancer is curious .	the dancer exercises curious .
the patient is sleepy .	the patient reads sleepy .
the guy was tall .	the guy reads tall .
the king was young .	the king paints young .
the girl is hungry .	the girl sings hungry .
the guy is excited .	the guy cries excited .
the guy is lucky .	the guy sings lucky .
the queen was gentle .	the queen talks gentle .
the person was important .	the person talks important .
the boy is sleepy .	the boy sings sleepy .
the guy is boring .	the guy exercises boring .
the customer is busy .	the customer sings busy .
the girl is clever .	the girl talks clever .
the patient is surprised .	the patient reads surprised .
the customer was clever .	the customer talks clever .
the patient was quiet .	the patient waves quiet .
the guy was friendly .	the guy reads friendly .
the customer was clever .	the customer cries clever .
the woman is surprised .	the woman talks surprised .
the driver is angry .	the driver talks angry .
the adult is hungry .	the adult exercises hungry .
the queen was angry .	the queen sings angry .
the driver was bored .	the driver waves bored .
the guy is lucky .	the guy talks lucky .
the patient is young .	the patient waves young .
the queen was boring .	the queen talks boring .
the driver is tired .	the driver talks tired .
the lady was excited .	the lady talks excited .
the person was tall .	the person sings tall .
the dancer is boring .	the dancer sings boring .
the woman was curious .	the woman waves curious .
the boy is confused .	the boy waves confused .
the customer is important .	the customer reads important .
the woman is clever .	the woman reads clever .
the woman was hungry .	the woman paints hungry .
the child is sleepy .	the child paints sleepy .
the king was excited .	the king paints excited .
the patient is boring .	the patient exercises boring .
the teacher was nice .	the teacher paints nice .
the lady was sleepy .	the lady waves sleepy .
the dentist is young .	the dentist sings young .
the person was gentle .	the person sings gentle .
the woman was boring .	the woman cries boring .
the adult was young .	the adult exercises young .
the boy is kind .	the boy cries kind .
the teacher is smart .	the teacher exercises smart .
the child is wrong .	the child reads wrong .
the guy is smart .	the guy sings smart .
the doctor was angry .	the doctor talks angry .
the driver was helpful .	the driver waves helpful .
the woman is healthy .	the woman sings healthy .
the dentist was young .	the dentist reads young .
the driver is confused .	the driver reads confused .
the person is busy .	the person cries busy .
the boy was strong .	the boy paints strong .
the driver is nice .	the driver paints nice .
the child is bored .	the child waves bored .
