the ship sitting on the table on the ground by the glass is old .	the ship sits on the table on the ground by the glass is old .
the box sitting in the kitchen by the button in the kitchen is cute .	the box sits in the kitchen by the button in the kitchen is cute .
the glass sitting by the rocket in the park in the library is big .	the glass sits by the rocket in the park in the library is big .
the chair sitting on the table by the button by the doll is purple .	the chair sits on the table by the button by the doll is purple .
the rocket sitting on the bed by the toy in the mall is white .	the rocket sits on the bed by the toy in the mall is white .
the ship sitting by the car on the street on the bed is cool .	the ship sits by the car on the street on the bed is cool .
the bottle sitting in the restaurant in the library by the window is yellow .	the bottle sits in the restaurant in the library by the window is yellow .
the window sitting on the street on the floor by the picture is white .	the window sits on the street on the floor by the picture is white .
the glass sitting by the crayon in the hospital by the door is red .	the glass sits by the crayon in the hospital by the door is red .
the book sitting on the ground on the bed in the library is cold .	the book sits on the ground on the bed in the library is cold .
the boat sitting in the library by the ship by the car is black .	the boat sits in the library by the ship by the car is black .
the shoe sitting by the bag in the park by the bowl is white .	the shoe sits by the bag in the park by the bowl is white .
the fork sitting by the car by the shoe in the hospital is brown .	the fork sits by the car by the shoe in the hospital is brown .
the fork sitting in the school by the candle in the hospital is blue .	the fork sits in the school by the candle in the hospital is blue .
the mirror sitting in the mall on the chair by the bottle is old .	the mirror sits in the mall on the chair by the bottle is old .
the rug sitting in the school by the couch in the mall is old .	the rug sits in the school by the couch in the mall is old .
the fork sitting on the stool on the floor in the school is big .	the fork sits on the stool on the floor in the school is big .
the plate sitting in the mall in the hospital by the chair is fine .	the plate sits in the mall in the hospital by the chair is fine .
the plate sitting by the spoon on the floor in the room is missing .	the plate sits by the spoon on the floor in the room is missing .
the plane sitting on the stool by the glass on the chair is important .	the plane sits on the stool by the glass on the chair is important .
the boat sitting in the restaurant in the restaurant by the glass is missing .	the boat sits in the restaurant in the restaurant by the glass is missing .
the book sitting by the dish on the ground by the rocket is red .	the book sits by the dish on the ground by the rocket is red .
the dish sitting in the mall by the plate on the stool is dry .	the dish sits in the mall by the plate on the stool is dry .
the shirt sitting on the table on the street in the mall is missing .	the shirt sits on the table on the street in the mall is missing .
the fork sitting on the table in the school in the restaurant is big .	the fork sits on the table in the school in the restaurant is big .
the doll sitting by the chair by the book by the bicycle is gray .	the doll sits by the chair by the book by the bicycle is gray .
the boat sitting on the stool on the stool on the bed is whole .	the boat sits on the stool on the stool on the bed is whole .
the shoe sitting on the chair by the bowl on the couch is green .	the shoe sits on the chair by the bowl on the couch is green .
the rocket sitting on the chair in the hospital in the school is big .	the rocket sits on the chair in the hospital in the school is big .
the boat sitting in the kitchen in the room by the glass is boring .	the boat sits in the kitchen in the room by the glass is boring .
the door sitting by the truck on the chair in the school is awesome .	the door sits by the truck on the chair in the school is awesome .
the bowl sitting by the hat in the park on the couch is cool .	the bowl sits by the hat in the park on the couch is cool .
the box sitting by the chair on the bed in the kitchen is whole .	the box sits by the chair on the bed in the kitchen is whole .
the car sitting by the box in the hospital on the street is gray .	the car sits by the box in the hospital on the street is gray .
the shoe sitting on the couch on the stool by the shoe is yellow .	the shoe sits on the couch on the stool by the shoe is yellow .
the mirror sitting by the rug in the kitchen by the picture is important .	the mirror sits by the rug in the kitchen by the picture is important .
the rug sitting in the hospital in the school by the bowl is amazing .	the rug sits in the hospital in the school by the bowl is amazing .
the toy sitting in the park by the candle in the hospital is new .	the toy sits in the park by the candle in the hospital is new .
the fork sitting in the museum in the kitchen in the library is important .	the fork sits in the museum in the kitchen in the library is important .
the plate sitting by the ship in the bank by the crayon is fine .	the plate sits by the ship in the bank by the crayon is fine .
the rocket sitting on the street in the park on the couch is small .	the rocket sits on the street in the park on the couch is small .
the rug sitting on the couch in the school on the ground is boring .	the rug sits on the couch in the school on the ground is boring .
the book sitting on the bed on the bed by the candle is big .	the book sits on the bed on the bed by the candle is big .
the bicycle sitting in the park by the plane in the bank is small .	the bicycle sits in the park by the plane in the bank is small .
the box sitting in the museum by the rug on the floor is whole .	the box sits in the museum by the rug on the floor is whole .
the chair sitting on the stool on the table in the mall is orange .	the chair sits on the stool on the table in the mall is orange .
the hat sitting in the library in the bank on the floor is fine .	the hat sits in the library in the bank on the floor is fine .
the candle sitting by the candle in the school by the glass is white .	the candle sits by the candle in the school by the glass is white .
the plate sitting by the hat by the picture in the room is white .	the plate sits by the hat by the picture in the room is white .
the window sitting by the plane by the boat by the chair is gray .	the window sits by the plane by the boat by the chair is gray .
the ship sitting in the park on the table in the park is expensive .	the ship sits in the park on the table in the park is expensive .
the mirror sitting by the door in the hospital on the floor is awesome .	the mirror sits by the door in the hospital on the floor is awesome .
the picture sitting in the park by the truck on the floor is cool .	the picture sits in the park by the truck on the floor is cool .
the shoe sitting on the bed in the hospital by the book is hot .	the shoe sits on the bed in the hospital by the book is hot .
the doll sitting by the bottle on the street in the library is amazing .	the doll sits by the bottle on the street in the library is amazing .
the toy sitting in the library in the hospital by the rug is black .	the toy sits in the library in the hospital by the rug is black .
the door sitting by the rug by the crayon by the book is hot .	the door sits by the rug by the crayon by the book is hot .
the shirt sitting on the bed on the couch by the dish is important .	the shirt sits on the bed on the couch by the dish is important .
the book sitting by the hat on the stool in the school is hot .	the book sits by the hat on the stool in the school is hot .
the dish sitting by the hat by the book by the crayon is fine .	the dish sits by the hat by the book by the crayon is fine .
the toy sitting by the plane on the floor by the fork is dry .	the toy sits by the plane on the floor by the fork is dry .
the mirror sitting on the stool on the ground by the plate is orange .	the mirror sits on the stool on the ground by the plate is orange .
the picture sitting on the stool on the ground in the kitchen is red .	the picture sits on the stool on the ground in the kitchen is red .
the car sitting in the school on the table on the table is big .	the car sits in the school on the table on the table is big .
the dish sitting on the couch on the bed by the rocket is great .	the dish sits on the couch on the bed by the rocket is great .
the rug sitting in the school on the chair in the school is small .	the rug sits in the school on the chair in the school is small .
the bed sitting by the bottle on the couch in the mall is amazing .	the bed sits by the bottle on the couch in the mall is amazing .
the window sitting on the street on the stool on the stool is black .	the window sits on the street on the stool on the stool is black .
the chair sitting on the ground by the boat by the toy is cold .	the chair sits on the ground by the boat by the toy is cold .
the ring sitting by the picture in the library on the couch is gray .	the ring sits by the picture in the library on the couch is gray .
the hat sitting in the kitchen by the truck in the mall is purple .	the hat sits in the kitchen by the truck in the mall is purple .
the shoe sitting on the table in the bank in the museum is awesome .	the shoe sits on the table in the bank in the museum is awesome .
the hat sitting by the picture on the stool on the chair is black .	the hat sits by the picture on the stool on the chair is black .
the door sitting in the hospital on the street by the chair is broken .	the door sits in the hospital on the street by the chair is broken .
the toy sitting on the bed on the floor on the bed is blue .	the toy sits on the bed on the floor on the bed is blue .
the book sitting by the bottle on the chair by the bag is dry .	the book sits by the bottle on the chair by the bag is dry .
the glass sitting on the chair in the room in the mall is orange .	the glass sits on the chair in the room in the mall is orange .
the bowl sitting on the stool by the door on the bed is important .	the bowl sits on the stool by the door on the bed is important .
the rocket sitting in the hospital in the bank on the street is brown .	the rocket sits in the hospital in the bank on the street is brown .
the plate sitting on the bed on the street by the candle is red .	the plate sits on the bed on the street by the candle is red .
the spoon sitting on the bed on the table in the mall is blue .	the spoon sits on the bed on the table in the mall is blue .
the bottle sitting on the couch on the stool on the stool is dry .	the bottle sits on the couch on the stool on the stool is dry .
the boat sitting in the mall by the picture on the bed is awesome .	the boat sits in the mall by the picture on the bed is awesome .
the chair sitting on the floor on the street on the stool is yellow .	the chair sits on the floor on the street on the stool is yellow .
the car sitting by the bag in the bank in the room is missing .	the car sits by the bag in the bank in the room is missing .
the fork sitting by the box in the hospital on the street is old .	the fork sits by the box in the hospital on the street is old .
the book sitting on the ground in the library in the library is big .	the book sits on the ground in the library in the library is big .
the crayon sitting on the chair by the boat in the hospital is hot .	the crayon sits on the chair by the boat in the hospital is hot .
the rocket sitting by the glass on the bed on the stool is broken .	the rocket sits by the glass on the bed on the stool is broken .
the truck sitting in the room on the couch on the chair is red .	the truck sits in the room on the couch on the chair is red .
the couch sitting by the toy by the hat in the park is small .	the couch sits by the toy by the hat in the park is small .
the bottle sitting in the school in the mall by the spoon is expensive .	the bottle sits in the school in the mall by the spoon is expensive .
the candle sitting by the plane on the floor in the museum is brown .	the candle sits by the plane on the floor in the museum is brown .
the doll sitting by the car on the bed by the ship is blue .	the doll sits by the car on the bed by the ship is blue .
the boat sitting by the bicycle in the library on the couch is missing .	the boat sits by the bicycle in the library on the couch is missing .
the button sitting by the hat in the hospital on the table is white .	the button sits by the hat in the hospital on the table is white .
the shirt sitting on the floor in the library by the chair is new .	the shirt sits on the floor in the library by the chair is new .
the cup sitting on the chair in the mall in the restaurant is fine .	the cup sits on the chair in the mall in the restaurant is fine .
the window sitting by the mirror by the box in the bank is old .	the window sits by the mirror by the box in the bank is old .
the book sitting in the school in the library on the ground is cute .	the book sits in the school in the library on the ground is cute .
the glass sitting by the boat on the street in the room is blue .	the glass sits by the boat on the street in the room is blue .
the spoon sitting on the couch by the bag in the school is expensive .	the spoon sits on the couch by the bag in the school is expensive .
the toy sitting on the stool on the street on the couch is big .	the toy sits on the stool on the street on the couch is big .
the ship sitting by the crayon by the truck by the glass is cute .	the ship sits by the crayon by the truck by the glass is cute .
the rug sitting in the museum by the bicycle in the hospital is great .	the rug sits in the museum by the bicycle in the hospital is great .
the bag sitting by the book in the kitchen on the floor is blue .	the bag sits by the book in the kitchen on the floor is blue .
the box sitting on the ground in the museum in the kitchen is small .	the box sits on the ground in the museum in the kitchen is small .
the plate sitting on the floor in the school on the bed is green .	the plate sits on the floor in the school on the bed is green .
the rocket sitting in the park on the chair on the stool is brown .	the rocket sits in the park on the chair on the stool is brown .
the hat sitting by the crayon on the table in the park is whole .	the hat sits by the crayon on the table in the park is whole .
the chair sitting by the bottle on the ground on the floor is gray .	the chair sits by the bottle on the ground on the floor is gray .
the bowl sitting by the picture on the street in the hospital is great .	the bowl sits by the picture on the street in the hospital is great .
the toy sitting by the car by the spoon in the school is small .	the toy sits by the car by the spoon in the school is small .
the chair sitting by the truck in the museum in the school is white .	the chair sits by the truck in the museum in the school is white .
the rug sitting in the mall by the plate by the ship is cool .	the rug sits in the mall by the plate by the ship is cool .
the bowl sitting in the restaurant on the chair on the couch is great .	the bowl sits in the restaurant on the chair on the couch is great .
the couch sitting on the stool in the school in the restaurant is new .	the couch sits on the stool in the school in the restaurant is new .
the mirror sitting on the bed on the street in the room is old .	the mirror sits on the bed on the street in the room is old .
the ship sitting in the library by the chair by the book is old .	the ship sits in the library by the chair by the book is old .
the book sitting on the street in the mall by the toy is important .	the book sits on the street in the mall by the toy is important .
the hat sitting on the street in the kitchen by the candle is old .	the hat sits on the street in the kitchen by the candle is old .
the button sitting on the chair in the kitchen by the ship is new .	the button sits on the chair in the kitchen by the ship is new .
the crayon sitting in the museum by the door on the stool is awesome .	the crayon sits in the museum by the door on the stool is awesome .
the car sitting on the chair on the bed by the shirt is black .	the car sits on the chair on the bed by the shirt is black .
the door sitting on the table in the school by the picture is red .	the door sits on the table in the school by the picture is red .
the crayon sitting on the stool in the restaurant in the room is big .	the crayon sits on the stool in the restaurant in the room is big .
the crayon sitting in the hospital by the bottle in the park is orange .	the crayon sits in the hospital by the bottle in the park is orange .
the shoe sitting on the floor in the museum in the park is expensive .	the shoe sits on the floor in the museum in the park is expensive .
the box sitting in the restaurant on the bed by the ship is brown .	the box sits in the restaurant on the bed by the ship is brown .
the bag sitting on the ground on the bed on the ground is cute .	the bag sits on the ground on the bed on the ground is cute .
the truck sitting by the couch by the mirror on the bed is new .	the truck sits by the couch by the mirror on the bed is new .
the truck sitting in the mall by the plane on the couch is hot .	the truck sits in the mall by the plane on the couch is hot .
the spoon sitting on the chair in the room on the ground is fine .	the spoon sits on the chair in the room on the ground is fine .
the candle sitting by the couch by the plate on the couch is blue .	the candle sits by the couch by the plate on the couch is blue .
the toy sitting by the bowl on the street by the plate is black .	the toy sits by the bowl on the street by the plate is black .
the shoe sitting on the floor on the floor in the bank is black .	the shoe sits on the floor on the floor in the bank is black .
the hat sitting in the bank on the table in the park is hot .	the hat sits in the bank on the table in the park is hot .
the toy sitting by the shoe in the museum in the school is red .	the toy sits by the shoe in the museum in the school is red .
the door sitting by the truck in the school on the couch is old .	the door sits by the truck in the school on the couch is old .
the rug sitting in the bank on the bed on the floor is cool .	the rug sits in the bank on the bed on the floor is cool .
the bicycle sitting in the restaurant on the street in the school is cold .	the bicycle sits in the restaurant on the street in the school is cold .
the bicycle sitting in the museum by the button by the ship is orange .	the bicycle sits in the museum by the button by the ship is orange .
the car sitting by the fork in the restaurant by the button is red .	the car sits by the fork in the restaurant by the button is red .
the shirt sitting on the table by the bowl on the chair is blue .	the shirt sits on the table by the bowl on the chair is blue .
the boat sitting by the bag in the room on the floor is hot .	the boat sits by the bag in the room on the floor is hot .
the picture sitting on the bed by the truck on the couch is black .	the picture sits on the bed by the truck on the couch is black .
the plate sitting on the street on the bed by the dish is cute .	the plate sits on the street on the bed by the dish is cute .
the crayon sitting by the hat in the hospital by the car is cold .	the crayon sits by the hat in the hospital by the car is cold .
the glass sitting by the boat in the museum in the bank is green .	the glass sits by the boat in the museum in the bank is green .
the glass sitting by the car in the park on the couch is missing .	the glass sits by the car in the park on the couch is missing .
the window sitting by the book in the school by the car is red .	the window sits by the book in the school by the car is red .
the truck sitting by the mirror in the museum by the hat is red .	the truck sits by the mirror in the museum by the hat is red .
the bottle sitting in the restaurant by the plane in the kitchen is cute .	the bottle sits in the restaurant by the plane in the kitchen is cute .
the chair sitting by the hat by the spoon by the bag is whole .	the chair sits by the hat by the spoon by the bag is whole .
the bed sitting by the box on the table in the hospital is white .	the bed sits by the box on the table in the hospital is white .
the ring sitting by the door in the school by the bed is whole .	the ring sits by the door in the school by the bed is whole .
the bicycle sitting in the kitchen in the school in the room is important .	the bicycle sits in the kitchen in the school in the room is important .
the book sitting on the street on the table by the car is missing .	the book sits on the street on the table by the car is missing .
the chair sitting by the plate in the restaurant on the floor is yellow .	the chair sits by the plate in the restaurant on the floor is yellow .
the button sitting in the kitchen in the restaurant by the plate is big .	the button sits in the kitchen in the restaurant by the plate is big .
the plane sitting on the floor on the ground in the park is white .	the plane sits on the floor on the ground in the park is white .
the plate sitting in the museum in the hospital in the kitchen is great .	the plate sits in the museum in the hospital in the kitchen is great .
the fork sitting by the car in the park on the stool is important .	the fork sits by the car in the park on the stool is important .
the rug sitting by the plane on the ground on the ground is important .	the rug sits by the plane on the ground on the ground is important .
the truck sitting in the school in the school on the floor is black .	the truck sits in the school in the school on the floor is black .
the shirt sitting by the fork by the bed in the museum is boring .	the shirt sits by the fork by the bed in the museum is boring .
the rocket sitting in the room in the school by the ship is great .	the rocket sits in the room in the school by the ship is great .
the door sitting by the cup in the room in the mall is missing .	the door sits by the cup in the room in the mall is missing .
the shoe sitting in the library on the ground in the hospital is old .	the shoe sits in the library on the ground in the hospital is old .
the chair sitting in the kitchen on the bed by the spoon is awesome .	the chair sits in the kitchen on the bed by the spoon is awesome .
the plate sitting by the hat by the mirror on the bed is big .	the plate sits by the hat by the mirror on the bed is big .
the rocket sitting by the bicycle in the school in the restaurant is orange .	the rocket sits by the bicycle in the school in the restaurant is orange .
the box sitting in the school on the floor in the restaurant is red .	the box sits in the school on the floor in the restaurant is red .
the picture sitting by the shirt in the kitchen on the couch is amazing .	the picture sits by the shirt in the kitchen on the couch is amazing .
the plate sitting on the table by the glass by the bed is awesome .	the plate sits on the table by the glass by the bed is awesome .
the shirt sitting by the car in the restaurant by the hat is important .	the shirt sits by the car in the restaurant by the hat is important .
the car sitting in the mall on the chair by the hat is big .	the car sits in the mall on the chair by the hat is big .
the fork sitting by the box in the park by the plane is hot .	the fork sits by the box in the park by the plane is hot .
the book sitting by the dish in the kitchen in the bank is cold .	the book sits by the dish in the kitchen in the bank is cold .
the bed sitting by the boat on the bed on the table is old .	the bed sits by the boat on the bed on the table is old .
the plane sitting by the truck by the car on the bed is boring .	the plane sits by the truck by the car on the bed is boring .
the toy sitting by the dish by the hat on the bed is orange .	the toy sits by the dish by the hat on the bed is orange .
the bag sitting by the bed by the shirt on the chair is cool .	the bag sits by the bed by the shirt on the chair is cool .
the car sitting by the dish by the bag on the floor is missing .	the car sits by the dish by the bag on the floor is missing .
the mirror sitting on the stool on the couch on the ground is hot .	the mirror sits on the stool on the couch on the ground is hot .
the candle sitting on the floor on the street on the floor is gray .	the candle sits on the floor on the street on the floor is gray .
the mirror sitting in the museum by the shoe in the restaurant is old .	the mirror sits in the museum by the shoe in the restaurant is old .
the door sitting in the room by the bicycle on the chair is hot .	the door sits in the room by the bicycle on the chair is hot .
the glass sitting in the bank by the hat in the kitchen is gray .	the glass sits in the bank by the hat in the kitchen is gray .
the rocket sitting in the school by the bicycle by the boat is old .	the rocket sits in the school by the bicycle by the boat is old .
the mirror sitting on the couch by the candle by the mirror is white .	the mirror sits on the couch by the candle by the mirror is white .
the crayon sitting by the shirt in the school in the room is cold .	the crayon sits by the shirt in the school in the room is cold .
the picture sitting by the book in the bank in the school is dry .	the picture sits by the book in the bank in the school is dry .
the picture sitting in the park on the couch in the park is gray .	the picture sits in the park on the couch in the park is gray .
the box sitting by the shirt by the mirror on the bed is expensive .	the box sits by the shirt by the mirror on the bed is expensive .
the ring sitting by the mirror in the library in the school is missing .	the ring sits by the mirror in the library in the school is missing .
the shoe sitting in the school by the truck in the room is cool .	the shoe sits in the school by the truck in the room is cool .
the couch sitting on the couch on the table in the museum is cute .	the couch sits on the couch on the table in the museum is cute .
the plate sitting by the truck by the rug on the bed is yellow .	the plate sits by the truck by the rug on the bed is yellow .
the hat sitting by the bag by the fork on the bed is small .	the hat sits by the bag by the fork on the bed is small .
the box sitting by the bag on the table by the plane is gray .	the box sits by the bag on the table by the plane is gray .
the car sitting on the bed in the library on the street is big .	the car sits on the bed in the library on the street is big .
the candle sitting by the plate by the plate by the rug is old .	the candle sits by the plate by the plate by the rug is old .
the couch sitting in the library in the hospital in the room is small .	the couch sits in the library in the hospital in the room is small .
the bottle sitting in the park by the fork on the table is big .	the bottle sits in the park by the fork on the table is big .
the bowl sitting by the book by the car by the cup is red .	the bowl sits by the book by the car by the cup is red .
the bowl sitting in the school on the bed on the chair is old .	the bowl sits in the school on the bed on the chair is old .
the mirror sitting in the hospital on the floor in the library is big .	the mirror sits in the hospital on the floor in the library is big .
the chair sitting by the box on the street on the chair is cool .	the chair sits by the box on the street on the chair is cool .
the book sitting on the ground in the bank on the table is blue .	the book sits on the ground in the bank on the table is blue .
the shirt sitting by the crayon on the couch on the table is new .	the shirt sits by the crayon on the couch on the table is new .
the hat sitting by the truck by the bottle on the table is whole .	the hat sits by the truck by the bottle on the table is whole .
the plane sitting on the couch by the doll by the bicycle is gray .	the plane sits on the couch by the doll by the bicycle is gray .
the shoe sitting on the bed on the street on the table is hot .	the shoe sits on the bed on the street on the table is hot .
the box sitting in the school by the book on the stool is small .	the box sits in the school by the book on the stool is small .
the hat sitting in the park by the dish in the mall is awesome .	the hat sits in the park by the dish in the mall is awesome .
the toy sitting on the floor by the door on the table is fine .	the toy sits on the floor by the door on the table is fine .
the doll sitting by the book in the hospital on the couch is big .	the doll sits by the book in the hospital on the couch is big .
the bed sitting by the boat in the library on the table is yellow .	the bed sits by the boat in the library on the table is yellow .
the plane sitting by the bicycle in the mall on the street is whole .	the plane sits by the bicycle in the mall on the street is whole .
the couch sitting in the hospital by the glass on the ground is important .	the couch sits in the hospital by the glass on the ground is important .
the doll sitting by the rug by the car on the couch is boring .	the doll sits by the rug by the car on the couch is boring .
the candle sitting in the school on the bed in the school is blue .	the candle sits in the school on the bed in the school is blue .
the bottle sitting on the couch on the bed on the ground is cute .	the bottle sits on the couch on the bed on the ground is cute .
the hat sitting in the hospital on the street in the room is gray .	the hat sits in the hospital on the street in the room is gray .
the shoe sitting on the stool by the window in the kitchen is awesome .	the shoe sits on the stool by the window in the kitchen is awesome .
the fork sitting on the ground on the ground in the library is purple .	the fork sits on the ground on the ground in the library is purple .
the doll sitting on the table on the chair in the room is white .	the doll sits on the table on the chair in the room is white .
the shirt sitting in the bank by the bowl in the bank is big .	the shirt sits in the bank by the bowl in the bank is big .
the truck sitting on the floor by the candle on the couch is brown .	the truck sits on the floor by the candle on the couch is brown .
the car sitting on the street in the restaurant on the street is missing .	the car sits on the street in the restaurant on the street is missing .
the box sitting by the book in the school by the dish is amazing .	the box sits by the book in the school by the dish is amazing .
the plane sitting on the chair on the chair on the ground is white .	the plane sits on the chair on the chair on the ground is white .
the car sitting in the hospital on the street on the chair is dry .	the car sits in the hospital on the street on the chair is dry .
the button sitting on the floor in the museum by the candle is new .	the button sits on the floor in the museum by the candle is new .
the chair sitting by the box by the cup on the table is big .	the chair sits by the box by the cup on the table is big .
the window sitting on the chair on the ground by the chair is fine .	the window sits on the chair on the ground by the chair is fine .
the plane sitting on the street on the couch on the couch is old .	the plane sits on the street on the couch on the couch is old .
the shoe sitting on the ground on the ground in the school is purple .	the shoe sits on the ground on the ground in the school is purple .
the mirror sitting by the bicycle in the library in the park is gray .	the mirror sits by the bicycle in the library in the park is gray .
the plate sitting by the picture on the floor by the door is dry .	the plate sits by the picture on the floor by the door is dry .
the rug sitting on the floor on the street in the bank is white .	the rug sits on the floor on the street in the bank is white .
the book sitting on the bed on the floor by the car is old .	the book sits on the bed on the floor by the car is old .
the bottle sitting by the dish on the chair by the plate is cold .	the bottle sits by the dish on the chair by the plate is cold .
the candle sitting on the stool in the museum on the ground is small .	the candle sits on the stool in the museum on the ground is small .
the bag sitting on the table on the couch in the library is brown .	the bag sits on the table on the couch in the library is brown .
the toy sitting by the book by the door by the picture is expensive .	the toy sits by the book by the door by the picture is expensive .
the cup sitting in the park on the table on the floor is whole .	the cup sits in the park on the table on the floor is whole .
the rocket sitting in the room in the room by the button is yellow .	the rocket sits in the room in the room by the button is yellow .
the picture sitting in the bank by the rug by the rug is old .	the picture sits in the bank by the rug by the rug is old .
the box sitting by the truck on the bed on the bed is cool .	the box sits by the truck on the bed on the bed is cool .
the rocket sitting by the chair on the ground in the bank is orange .	the rocket sits by the chair on the ground in the bank is orange .
the shoe sitting on the ground on the stool in the hospital is cute .	the shoe sits on the ground on the stool in the hospital is cute .
the door sitting on the chair by the candle by the couch is white .	the door sits on the chair by the candle by the couch is white .
the plate sitting in the mall on the stool in the mall is green .	the plate sits in the mall on the stool in the mall is green .
the crayon sitting in the library in the museum in the school is expensive .	the crayon sits in the library in the museum in the school is expensive .
the rocket sitting by the couch in the room on the street is brown .	the rocket sits by the couch in the room on the street is brown .
the shirt sitting by the rug on the chair by the window is green .	the shirt sits by the rug on the chair by the window is green .
the plane sitting by the bottle in the hospital by the spoon is cool .	the plane sits by the bottle in the hospital by the spoon is cool .
the glass sitting by the rug on the stool in the kitchen is great .	the glass sits by the rug on the stool in the kitchen is great .
the crayon sitting on the street by the truck on the couch is brown .	the crayon sits on the street by the truck on the couch is brown .
the box sitting on the couch in the hospital on the bed is small .	the box sits on the couch in the hospital on the bed is small .
the bed sitting on the street in the school in the room is missing .	the bed sits on the street in the school in the room is missing .
the shoe sitting on the ground on the stool on the floor is fine .	the shoe sits on the ground on the stool on the floor is fine .
the shirt sitting in the bank in the hospital by the candle is whole .	the shirt sits in the bank in the hospital by the candle is whole .
the chair sitting on the bed in the mall by the shirt is cold .	the chair sits on the bed in the mall by the shirt is cold .
the door sitting by the ship by the plate on the chair is great .	the door sits by the ship by the plate on the chair is great .
the car sitting by the window in the park on the bed is hot .	the car sits by the window in the park on the bed is hot .
the candle sitting in the hospital in the school in the school is great .	the candle sits in the hospital in the school in the school is great .
the crayon sitting on the street in the park in the restaurant is small .	the crayon sits on the street in the park in the restaurant is small .
the ring sitting in the library in the library in the school is broken .	the ring sits in the library in the library in the school is broken .
the bottle sitting on the stool in the restaurant by the chair is red .	the bottle sits on the stool in the restaurant by the chair is red .
the door sitting in the restaurant on the table on the floor is dry .	the door sits in the restaurant on the table on the floor is dry .
the hat sitting by the dish on the ground on the street is orange .	the hat sits by the dish on the ground on the street is orange .
the couch sitting in the museum by the shoe on the street is purple .	the couch sits in the museum by the shoe on the street is purple .
the cup sitting by the bag in the room by the car is expensive .	the cup sits by the bag in the room by the car is expensive .
the car sitting on the street in the hospital by the mirror is amazing .	the car sits on the street in the hospital by the mirror is amazing .
the crayon sitting by the car in the museum on the street is expensive .	the crayon sits by the car in the museum on the street is expensive .
the chair sitting in the mall by the plate by the ship is yellow .	the chair sits in the mall by the plate by the ship is yellow .
the toy sitting on the street by the glass on the ground is black .	the toy sits on the street by the glass on the ground is black .
the doll sitting by the truck on the chair on the bed is dry .	the doll sits by the truck on the chair on the bed is dry .
the shoe sitting on the ground in the restaurant on the bed is important .	the shoe sits on the ground in the restaurant on the bed is important .
the cup sitting on the chair on the street by the toy is small .	the cup sits on the chair on the street by the toy is small .
the truck sitting in the restaurant by the bowl by the car is fine .	the truck sits in the restaurant by the bowl by the car is fine .
the rug sitting by the fork by the car in the museum is yellow .	the rug sits by the fork by the car in the museum is yellow .
the candle sitting by the book in the library by the plane is expensive .	the candle sits by the book in the library by the plane is expensive .
the mirror sitting on the ground by the plate in the museum is important .	the mirror sits on the ground by the plate in the museum is important .
the bicycle sitting in the school in the school on the ground is big .	the bicycle sits in the school in the school on the ground is big .
the mirror sitting in the bank in the restaurant on the chair is broken .	the mirror sits in the bank in the restaurant on the chair is broken .
the plane sitting on the street on the chair by the cup is big .	the plane sits on the street on the chair by the cup is big .
the rug sitting on the street in the kitchen by the bed is purple .	the rug sits on the street in the kitchen by the bed is purple .
the chair sitting by the doll in the mall by the picture is gray .	the chair sits by the doll in the mall by the picture is gray .
the bicycle sitting in the kitchen by the shirt in the school is white .	the bicycle sits in the kitchen by the shirt in the school is white .
the box sitting in the library in the hospital by the ring is fine .	the box sits in the library in the hospital by the ring is fine .
the glass sitting by the window in the park by the shirt is new .	the glass sits by the window in the park by the shirt is new .
the button sitting in the school by the box on the bed is missing .	the button sits in the school by the box on the bed is missing .
the bed sitting on the bed on the ground on the ground is whole .	the bed sits on the bed on the ground on the ground is whole .
the toy sitting in the hospital in the library by the ring is expensive .	the toy sits in the hospital in the library by the ring is expensive .
the cup sitting by the mirror on the chair in the museum is new .	the cup sits by the mirror on the chair in the museum is new .
the cup sitting on the table on the ground on the floor is small .	the cup sits on the table on the ground on the floor is small .
the truck sitting on the chair by the shoe by the spoon is amazing .	the truck sits on the chair by the shoe by the spoon is amazing .
the truck sitting in the school by the bicycle in the park is great .	the truck sits in the school by the bicycle in the park is great .
the bowl sitting by the ring by the chair on the table is old .	the bowl sits by the ring by the chair on the table is old .
the plate sitting on the floor on the ground in the museum is orange .	the plate sits on the floor on the ground in the museum is orange .
the glass sitting by the glass on the chair on the stool is awesome .	the glass sits by the glass on the chair on the stool is awesome .
the dish sitting on the bed by the boat on the floor is yellow .	the dish sits on the bed by the boat on the floor is yellow .
the boat sitting on the ground on the table in the room is amazing .	the boat sits on the ground on the table in the room is amazing .
the door sitting in the room by the book on the chair is broken .	the door sits in the room by the book on the chair is broken .
the crayon sitting by the couch in the library by the button is small .	the crayon sits by the couch in the library by the button is small .
the spoon sitting by the cup by the bowl on the chair is awesome .	the spoon sits by the cup by the bowl on the chair is awesome .
the glass sitting in the bank on the street on the bed is small .	the glass sits in the bank on the street on the bed is small .
the window sitting in the room by the box in the hospital is yellow .	the window sits in the room by the box in the hospital is yellow .
the box sitting by the book on the couch by the shirt is cold .	the box sits by the book on the couch by the shirt is cold .
the bowl sitting in the mall on the floor on the ground is white .	the bowl sits in the mall on the floor on the ground is white .
the ship sitting in the restaurant on the couch by the boat is white .	the ship sits in the restaurant on the couch by the boat is white .
the bed sitting in the restaurant by the car in the school is orange .	the bed sits in the restaurant by the car in the school is orange .
the rug sitting on the table by the spoon by the book is black .	the rug sits on the table by the spoon by the book is black .
the crayon sitting by the book on the floor in the park is cool .	the crayon sits by the book on the floor in the park is cool .
the book sitting on the ground by the plate on the street is gray .	the book sits on the ground by the plate on the street is gray .
the bed sitting in the bank in the school by the plate is amazing .	the bed sits in the bank in the school by the plate is amazing .
the mirror sitting on the street on the stool on the couch is broken .	the mirror sits on the street on the stool on the couch is broken .
the car sitting on the ground in the room on the couch is purple .	the car sits on the ground in the room on the couch is purple .
the bag sitting by the fork in the restaurant in the hospital is old .	the bag sits by the fork in the restaurant in the hospital is old .
the car sitting by the glass on the couch in the school is great .	the car sits by the glass on the couch in the school is great .
the boat sitting on the table by the couch on the couch is important .	the boat sits on the table by the couch on the couch is important .
the box sitting on the table by the doll by the boat is big .	the box sits on the table by the doll by the boat is big .
the chair sitting by the crayon by the ship by the book is cool .	the chair sits by the crayon by the ship by the book is cool .
the toy sitting by the bag in the restaurant on the table is new .	the toy sits by the bag in the restaurant on the table is new .
the door sitting on the chair in the library by the mirror is new .	the door sits on the chair in the library by the mirror is new .
the picture sitting in the library in the library by the doll is important .	the picture sits in the library in the library by the doll is important .
the book sitting in the room in the mall on the table is missing .	the book sits in the room in the mall on the table is missing .
the door sitting by the mirror on the stool in the hospital is orange .	the door sits by the mirror on the stool in the hospital is orange .
the ring sitting by the spoon in the restaurant in the library is whole .	the ring sits by the spoon in the restaurant in the library is whole .
the book sitting by the candle by the plane on the chair is important .	the book sits by the candle by the plane on the chair is important .
the couch sitting in the room on the floor by the doll is great .	the couch sits in the room on the floor by the doll is great .
the rug sitting by the fork in the park by the crayon is cute .	the rug sits by the fork in the park by the crayon is cute .
the rocket sitting in the museum by the cup in the bank is red .	the rocket sits in the museum by the cup in the bank is red .
the dish sitting by the toy by the dish by the box is awesome .	the dish sits by the toy by the dish by the box is awesome .
the truck sitting in the bank on the stool on the bed is red .	the truck sits in the bank on the stool on the bed is red .
the window sitting in the restaurant in the museum on the stool is purple .	the window sits in the restaurant in the museum on the stool is purple .
the bag sitting on the chair in the museum on the bed is fine .	the bag sits on the chair in the museum on the bed is fine .
the doll sitting by the book on the chair in the bank is important .	the doll sits by the book on the chair in the bank is important .
the ship sitting on the ground in the restaurant in the mall is boring .	the ship sits on the ground in the restaurant in the mall is boring .
the candle sitting on the street in the library on the table is yellow .	the candle sits on the street in the library on the table is yellow .
the car sitting by the mirror on the floor in the kitchen is fine .	the car sits by the mirror on the floor in the kitchen is fine .
the spoon sitting by the plane in the park in the restaurant is red .	the spoon sits by the plane in the park in the restaurant is red .
the car sitting in the hospital in the school on the street is blue .	the car sits in the hospital in the school on the street is blue .
the toy sitting in the museum on the street on the stool is purple .	the toy sits in the museum on the street on the stool is purple .
the truck sitting in the restaurant in the bank in the school is gray .	the truck sits in the restaurant in the bank in the school is gray .
the couch sitting in the kitchen by the window in the museum is missing .	the couch sits in the kitchen by the window in the museum is missing .
the box sitting by the bicycle in the mall on the ground is yellow .	the box sits by the bicycle in the mall on the ground is yellow .
the spoon sitting by the window in the room in the park is red .	the spoon sits by the window in the room in the park is red .
the mirror sitting on the bed in the hospital on the ground is whole .	the mirror sits on the bed in the hospital on the ground is whole .
the crayon sitting by the bottle in the school on the street is old .	the crayon sits by the bottle in the school on the street is old .
the couch sitting by the doll by the bag on the street is awesome .	the couch sits by the doll by the bag on the street is awesome .
the ship sitting on the couch on the table by the crayon is purple .	the ship sits on the couch on the table by the crayon is purple .
the bag sitting on the chair by the ring by the bicycle is missing .	the bag sits on the chair by the ring by the bicycle is missing .
the door sitting in the room on the floor on the table is amazing .	the door sits in the room on the floor on the table is amazing .
the window sitting by the plane in the school by the crayon is dry .	the window sits by the plane in the school by the crayon is dry .
the cup sitting by the rug on the bed by the ring is orange .	the cup sits by the rug on the bed by the ring is orange .
the bottle sitting in the restaurant in the park in the school is small .	the bottle sits in the restaurant in the park in the school is small .
the picture sitting on the bed by the plane in the mall is gray .	the picture sits on the bed by the plane in the mall is gray .
the cup sitting by the spoon on the bed by the window is purple .	the cup sits by the spoon on the bed by the window is purple .
the book sitting in the school in the room in the bank is cool .	the book sits in the school in the room in the bank is cool .
the couch sitting on the chair on the street by the car is cold .	the couch sits on the chair on the street by the car is cold .
the bottle sitting on the floor by the picture in the school is fine .	the bottle sits on the floor by the picture in the school is fine .
the window sitting in the kitchen on the ground in the school is purple .	the window sits in the kitchen on the ground in the school is purple .
the mirror sitting by the plate by the ship by the spoon is whole .	the mirror sits by the plate by the ship by the spoon is whole .
the spoon sitting by the toy by the toy by the door is boring .	the spoon sits by the toy by the toy by the door is boring .
the chair sitting by the crayon by the mirror by the crayon is brown .	the chair sits by the crayon by the mirror by the crayon is brown .
the rocket sitting in the restaurant in the hospital by the bicycle is cold .	the rocket sits in the restaurant in the hospital by the bicycle is cold .
the bicycle sitting by the plate by the spoon by the toy is new .	the bicycle sits by the plate by the spoon by the toy is new .
the bag sitting by the shoe on the chair on the stool is small .	the bag sits by the shoe on the chair on the stool is small .
the boat sitting in the hospital by the candle on the couch is black .	the boat sits in the hospital by the candle on the couch is black .
the chair sitting in the museum in the kitchen on the floor is new .	the chair sits in the museum in the kitchen on the floor is new .
the shirt sitting by the picture by the mirror on the stool is cool .	the shirt sits by the picture by the mirror on the stool is cool .
the doll sitting on the ground by the hat by the shirt is great .	the doll sits on the ground by the hat by the shirt is great .
the toy sitting on the stool on the couch by the bowl is red .	the toy sits on the stool on the couch by the bowl is red .
the fork sitting in the restaurant on the table on the table is boring .	the fork sits in the restaurant on the table on the table is boring .
the crayon sitting by the couch by the door on the ground is brown .	the crayon sits by the couch by the door on the ground is brown .
the fork sitting by the fork in the library in the museum is fine .	the fork sits by the fork in the library in the museum is fine .
the chair sitting on the floor in the hospital on the stool is great .	the chair sits on the floor in the hospital on the stool is great .
the mirror sitting in the park on the table by the bottle is red .	the mirror sits in the park on the table by the bottle is red .
the doll sitting by the candle by the button on the floor is dry .	the doll sits by the candle by the button on the floor is dry .
the shirt sitting by the car by the couch in the park is old .	the shirt sits by the car by the couch in the park is old .
the mirror sitting by the crayon on the couch in the bank is blue .	the mirror sits by the crayon on the couch in the bank is blue .
the doll sitting by the rug by the car on the couch is fine .	the doll sits by the rug by the car on the couch is fine .
the fork sitting on the bed on the ground on the ground is awesome .	the fork sits on the bed on the ground on the ground is awesome .
the button sitting on the ground on the couch by the bicycle is blue .	the button sits on the ground on the couch by the bicycle is blue .
the candle sitting in the restaurant by the truck by the spoon is blue .	the candle sits in the restaurant by the truck by the spoon is blue .
the truck sitting on the chair on the couch on the floor is hot .	the truck sits on the chair on the couch on the floor is hot .
the ship sitting by the fork in the bank by the crayon is boring .	the ship sits by the fork in the bank by the crayon is boring .
the book sitting on the bed on the floor on the stool is cool .	the book sits on the bed on the floor on the stool is cool .
the book sitting on the table in the museum by the plate is white .	the book sits on the table in the museum by the plate is white .
the picture sitting in the school on the stool by the plane is hot .	the picture sits in the school on the stool by the plane is hot .
the car sitting on the table by the shoe by the toy is broken .	the car sits on the table by the shoe by the toy is broken .
the spoon sitting in the room on the stool by the fork is white .	the spoon sits in the room on the stool by the fork is white .
the toy sitting on the table on the stool on the table is cute .	the toy sits on the table on the stool on the table is cute .
the bicycle sitting in the hospital by the dish on the chair is small .	the bicycle sits in the hospital by the dish on the chair is small .
the bed sitting by the bicycle by the hat in the park is brown .	the bed sits by the bicycle by the hat in the park is brown .
the cup sitting by the dish on the street in the library is boring .	the cup sits by the dish on the street in the library is boring .
the shoe sitting on the street by the couch on the bed is orange .	the shoe sits on the street by the couch on the bed is orange .
the bicycle sitting in the museum by the box by the box is important .	the bicycle sits in the museum by the box by the box is important .
the couch sitting by the bag in the school by the hat is awesome .	the couch sits by the bag in the school by the hat is awesome .
the boat sitting on the stool in the kitchen in the library is expensive .	the boat sits on the stool in the kitchen in the library is expensive .
the button sitting in the park on the floor on the chair is white .	the button sits in the park on the floor on the chair is white .
the bed sitting in the school on the couch by the box is orange .	the bed sits in the school on the couch by the box is orange .
the plane sitting in the school by the cup in the kitchen is awesome .	the plane sits in the school by the cup in the kitchen is awesome .
the car sitting in the kitchen on the stool by the shoe is new .	the car sits in the kitchen on the stool by the shoe is new .
the car sitting in the mall on the table in the hospital is red .	the car sits in the mall on the table in the hospital is red .
the car sitting on the bed on the ground on the bed is cool .	the car sits on the bed on the ground on the bed is cool .
the ring sitting by the spoon on the street by the ring is green .	the ring sits by the spoon on the street by the ring is green .
the cup sitting in the mall on the stool on the chair is black .	the cup sits in the mall on the stool on the chair is black .
the rug sitting by the glass on the chair on the table is expensive .	the rug sits by the glass on the chair on the table is expensive .
the spoon sitting by the shoe by the ship in the mall is purple .	the spoon sits by the shoe by the ship in the mall is purple .
the picture sitting on the table on the table in the museum is black .	the picture sits on the table on the table in the museum is black .
the ship sitting by the bottle on the bed by the plane is cold .	the ship sits by the bottle on the bed by the plane is cold .
the bicycle sitting by the shirt on the floor on the bed is whole .	the bicycle sits by the shirt on the floor on the bed is whole .
the bed sitting on the stool on the stool on the table is boring .	the bed sits on the stool on the stool on the table is boring .
the shoe sitting by the dish on the bed on the bed is orange .	the shoe sits by the dish on the bed on the bed is orange .
the dish sitting on the bed in the hospital by the car is yellow .	the dish sits on the bed in the hospital by the car is yellow .
the boat sitting in the museum in the kitchen on the bed is amazing .	the boat sits in the museum in the kitchen on the bed is amazing .
the button sitting by the box by the dish in the kitchen is green .	the button sits by the box by the dish in the kitchen is green .
the ship sitting on the chair by the window in the school is amazing .	the ship sits on the chair by the window in the school is amazing .
the fork sitting on the street on the couch by the dish is orange .	the fork sits on the street on the couch by the dish is orange .
the ship sitting on the ground on the floor by the spoon is hot .	the ship sits on the ground on the floor by the spoon is hot .
the crayon sitting on the ground by the dish by the ship is red .	the crayon sits on the ground by the dish by the ship is red .
the toy sitting on the street by the candle in the mall is whole .	the toy sits on the street by the candle in the mall is whole .
the plane sitting in the bank on the floor on the table is gray .	the plane sits in the bank on the floor on the table is gray .
the shirt sitting by the car in the hospital on the floor is green .	the shirt sits by the car in the hospital on the floor is green .
the bicycle sitting on the couch in the museum in the school is blue .	the bicycle sits on the couch in the museum in the school is blue .
the ship sitting on the floor on the table in the restaurant is cool .	the ship sits on the floor on the table in the restaurant is cool .
the bed sitting on the floor in the restaurant by the shoe is black .	the bed sits on the floor in the restaurant by the shoe is black .
the bottle sitting by the toy on the street by the book is amazing .	the bottle sits by the toy on the street by the book is amazing .
the spoon sitting on the bed by the door by the bag is boring .	the spoon sits on the bed by the door by the bag is boring .
the car sitting by the chair on the floor in the park is black .	the car sits by the chair on the floor in the park is black .
the doll sitting by the box by the spoon in the restaurant is amazing .	the doll sits by the box by the spoon in the restaurant is amazing .
the rug sitting in the room in the park in the hospital is new .	the rug sits in the room in the park in the hospital is new .
the car sitting on the chair on the chair in the school is orange .	the car sits on the chair on the chair in the school is orange .
the crayon sitting by the shirt on the street in the school is blue .	the crayon sits by the shirt on the street in the school is blue .
the car sitting on the table by the shoe on the street is white .	the car sits on the table by the shoe on the street is white .
the bicycle sitting on the table on the ground by the book is broken .	the bicycle sits on the table on the ground by the book is broken .
the button sitting in the mall on the chair by the bag is old .	the button sits in the mall on the chair by the bag is old .
the cup sitting in the mall on the couch on the table is hot .	the cup sits in the mall on the couch on the table is hot .
the plane sitting in the school on the stool by the chair is orange .	the plane sits in the school on the stool by the chair is orange .
the rocket sitting in the museum in the museum on the street is small .	the rocket sits in the museum in the museum on the street is small .
the plate sitting on the floor by the shoe in the mall is missing .	the plate sits on the floor by the shoe in the mall is missing .
the candle sitting in the bank on the couch on the chair is new .	the candle sits in the bank on the couch on the chair is new .
the rocket sitting by the chair by the ship on the stool is awesome .	the rocket sits by the chair by the ship on the stool is awesome .
the cup sitting on the street by the box on the bed is black .	the cup sits on the street by the box on the bed is black .
the couch sitting on the chair by the button by the bowl is dry .	the couch sits on the chair by the button by the bowl is dry .
the ship sitting in the restaurant by the ring on the stool is awesome .	the ship sits in the restaurant by the ring on the stool is awesome .
the car sitting on the stool on the ground in the school is green .	the car sits on the stool on the ground in the school is green .
the hat sitting on the couch by the book in the park is blue .	the hat sits on the couch by the book in the park is blue .
the plate sitting in the room on the stool in the school is dry .	the plate sits in the room on the stool in the school is dry .
the hat sitting by the boat on the chair by the shoe is cold .	the hat sits by the boat on the chair by the shoe is cold .
the rocket sitting by the button by the glass in the bank is hot .	the rocket sits by the button by the glass in the bank is hot .
the picture sitting in the restaurant in the restaurant in the library is amazing .	the picture sits in the restaurant in the restaurant in the library is amazing .
the ring sitting by the candle in the park on the table is yellow .	the ring sits by the candle in the park on the table is yellow .
the fork sitting in the school on the chair by the crayon is brown .	the fork sits in the school on the chair by the crayon is brown .
the chair sitting by the candle on the chair in the hospital is yellow .	the chair sits by the candle on the chair in the hospital is yellow .
the shoe sitting by the ring by the rug by the ship is cool .	the shoe sits by the ring by the rug by the ship is cool .
the shirt sitting on the street on the table in the park is orange .	the shirt sits on the street on the table in the park is orange .
the glass sitting on the stool by the chair in the kitchen is hot .	the glass sits on the stool by the chair in the kitchen is hot .
the door sitting by the glass in the school on the couch is amazing .	the door sits by the glass in the school on the couch is amazing .
the button sitting on the street by the spoon on the couch is big .	the button sits on the street by the spoon on the couch is big .
the book sitting in the restaurant on the chair in the school is awesome .	the book sits in the restaurant on the chair in the school is awesome .
the car sitting on the stool on the stool on the bed is cool .	the car sits on the stool on the stool on the bed is cool .
the rug sitting in the bank by the bottle by the book is cold .	the rug sits in the bank by the bottle by the book is cold .
the button sitting on the bed on the stool in the room is big .	the button sits on the bed on the stool in the room is big .
the hat sitting in the mall by the car on the bed is gray .	the hat sits in the mall by the car on the bed is gray .
the chair sitting on the table by the spoon on the couch is whole .	the chair sits on the table by the spoon on the couch is whole .
the chair sitting by the box on the ground by the bag is yellow .	the chair sits by the box on the ground by the bag is yellow .
the toy sitting in the restaurant in the room in the hospital is red .	the toy sits in the restaurant in the room in the hospital is red .
the mirror sitting by the car in the park by the bag is purple .	the mirror sits by the car in the park by the bag is purple .
the door sitting on the couch by the window in the kitchen is small .	the door sits on the couch by the window in the kitchen is small .
the car sitting by the bicycle by the book in the school is new .	the car sits by the bicycle by the book in the school is new .
the boat sitting in the museum on the street in the hospital is new .	the boat sits in the museum on the street in the hospital is new .
the mirror sitting on the bed on the bed by the crayon is great .	the mirror sits on the bed on the bed by the crayon is great .
the fork sitting in the restaurant on the street by the hat is cold .	the fork sits in the restaurant on the street by the hat is cold .
the car sitting in the park in the library on the bed is purple .	the car sits in the park in the library on the bed is purple .
the box sitting in the school by the mirror in the kitchen is orange .	the box sits in the school by the mirror in the kitchen is orange .
the rocket sitting in the library by the bed by the truck is big .	the rocket sits in the library by the bed by the truck is big .
the ring sitting on the bed on the stool on the street is old .	the ring sits on the bed on the stool on the street is old .
the plate sitting by the window on the couch by the button is red .	the plate sits by the window on the couch by the button is red .
the chair sitting by the hat in the room in the kitchen is new .	the chair sits by the hat in the room in the kitchen is new .
the rocket sitting by the truck by the bag in the hospital is big .	the rocket sits by the truck by the bag in the hospital is big .
the rocket sitting by the plane in the school by the fork is gray .	the rocket sits by the plane in the school by the fork is gray .
the spoon sitting on the street on the chair in the restaurant is small .	the spoon sits on the street on the chair in the restaurant is small .
the plane sitting by the mirror in the hospital by the crayon is cool .	the plane sits by the mirror in the hospital by the crayon is cool .
the crayon sitting in the mall by the box on the stool is black .	the crayon sits in the mall by the box on the stool is black .
the hat sitting on the table in the bank in the library is white .	the hat sits on the table in the bank in the library is white .
the button sitting by the toy by the candle in the kitchen is boring .	the button sits by the toy by the candle in the kitchen is boring .
the couch sitting in the school on the stool by the glass is green .	the couch sits in the school on the stool by the glass is green .
the book sitting in the hospital by the window in the room is cute .	the book sits in the hospital by the window in the room is cute .
the door sitting by the bicycle on the stool by the picture is missing .	the door sits by the bicycle on the stool by the picture is missing .
the car sitting by the truck on the street in the school is green .	the car sits by the truck on the street in the school is green .
the ship sitting in the hospital by the boat by the mirror is black .	the ship sits in the hospital by the boat by the mirror is black .
the spoon sitting on the ground in the hospital by the ring is brown .	the spoon sits on the ground in the hospital by the ring is brown .
the bottle sitting by the plane by the bed by the hat is orange .	the bottle sits by the plane by the bed by the hat is orange .
the truck sitting in the school on the stool by the cup is important .	the truck sits in the school on the stool by the cup is important .
the boat sitting on the street on the table in the library is big .	the boat sits on the street on the table in the library is big .
the car sitting in the bank by the window on the bed is whole .	the car sits in the bank by the window on the bed is whole .
the car sitting by the door in the room by the door is awesome .	the car sits by the door in the room by the door is awesome .
the book sitting in the school by the ring by the shoe is fine .	the book sits in the school by the ring by the shoe is fine .
the car sitting on the chair on the couch by the ship is boring .	the car sits on the chair on the couch by the ship is boring .
the book sitting in the hospital in the mall on the table is hot .	the book sits in the hospital in the mall on the table is hot .
the candle sitting by the dish by the book on the street is black .	the candle sits by the dish by the book on the street is black .
the chair sitting in the library in the school by the bottle is blue .	the chair sits in the library in the school by the bottle is blue .
the hat sitting by the fork on the bed on the couch is boring .	the hat sits by the fork on the bed on the couch is boring .
the shirt sitting in the hospital in the school by the hat is expensive .	the shirt sits in the hospital in the school by the hat is expensive .
the cup sitting in the mall on the floor in the mall is boring .	the cup sits in the mall on the floor in the mall is boring .
the hat sitting in the room in the hospital by the ring is broken .	the hat sits in the room in the hospital by the ring is broken .
the candle sitting in the school by the shirt in the room is fine .	the candle sits in the school by the shirt in the room is fine .
the shoe sitting on the chair by the rug on the couch is purple .	the shoe sits on the chair by the rug on the couch is purple .
the cup sitting by the car in the room in the school is blue .	the cup sits by the car in the room in the school is blue .
the cup sitting in the mall by the plate in the kitchen is dry .	the cup sits in the mall by the plate in the kitchen is dry .
the spoon sitting on the couch on the chair in the mall is boring .	the spoon sits on the couch on the chair in the mall is boring .
the plane sitting on the street on the ground in the park is cool .	the plane sits on the street on the ground in the park is cool .
the chair sitting in the school by the mirror in the room is hot .	the chair sits in the school by the mirror in the room is hot .
the car sitting in the library in the museum by the rocket is cute .	the car sits in the library in the museum by the rocket is cute .
the truck sitting in the bank on the floor on the floor is dry .	the truck sits in the bank on the floor on the floor is dry .
the ship sitting in the library by the door by the ship is boring .	the ship sits in the library by the door by the ship is boring .
the book sitting by the fork by the car by the bicycle is cold .	the book sits by the fork by the car by the bicycle is cold .
the bowl sitting in the kitchen by the glass on the table is red .	the bowl sits in the kitchen by the glass on the table is red .
the book sitting by the hat in the kitchen by the ship is fine .	the book sits by the hat in the kitchen by the ship is fine .
the car sitting by the truck in the museum in the museum is old .	the car sits by the truck in the museum in the museum is old .
the book sitting by the chair by the shirt by the cup is hot .	the book sits by the chair by the shirt by the cup is hot .
the bicycle sitting by the car in the library on the table is whole .	the bicycle sits by the car in the library on the table is whole .
the doll sitting on the stool by the mirror by the truck is small .	the doll sits on the stool by the mirror by the truck is small .
the hat sitting on the stool by the ring in the room is cool .	the hat sits on the stool by the ring in the room is cool .
the ring sitting by the box in the restaurant on the stool is broken .	the ring sits by the box in the restaurant on the stool is broken .
the bicycle sitting on the street by the picture by the candle is purple .	the bicycle sits on the street by the picture by the candle is purple .
the plate sitting in the school by the couch in the mall is whole .	the plate sits in the school by the couch in the mall is whole .
the plate sitting in the park on the table on the bed is cool .	the plate sits in the park on the table on the bed is cool .
the bag sitting by the car on the couch by the cup is small .	the bag sits by the car on the couch by the cup is small .
the rug sitting by the bed on the couch by the ship is yellow .	the rug sits by the bed on the couch by the ship is yellow .
the window sitting by the fork by the plate in the school is broken .	the window sits by the fork by the plate in the school is broken .
the ship sitting in the kitchen by the boat in the restaurant is new .	the ship sits in the kitchen by the boat in the restaurant is new .
the mirror sitting by the plate by the dish in the room is hot .	the mirror sits by the plate by the dish in the room is hot .
the toy sitting by the bottle in the school on the ground is white .	the toy sits by the bottle in the school on the ground is white .
the plate sitting in the room in the kitchen by the book is broken .	the plate sits in the room in the kitchen by the book is broken .
the bag sitting on the couch on the chair on the chair is new .	the bag sits on the couch on the chair on the chair is new .
the couch sitting by the dish in the museum on the chair is cool .	the couch sits by the dish in the museum on the chair is cool .
the rocket sitting on the floor in the museum by the candle is yellow .	the rocket sits on the floor in the museum by the candle is yellow .
the bag sitting in the school in the mall on the table is black .	the bag sits in the school in the mall on the table is black .
the book sitting in the park on the stool by the shoe is blue .	the book sits in the park on the stool by the shoe is blue .
the bicycle sitting by the toy on the street in the bank is amazing .	the bicycle sits by the toy on the street in the bank is amazing .
the bed sitting on the chair on the ground in the mall is important .	the bed sits on the chair on the ground in the mall is important .
the book sitting in the school by the ship on the stool is whole .	the book sits in the school by the ship on the stool is whole .
the shirt sitting in the school by the couch on the table is fine .	the shirt sits in the school by the couch on the table is fine .
the car sitting by the ship on the chair by the bed is small .	the car sits by the ship on the chair by the bed is small .
the hat sitting in the park by the bicycle in the room is dry .	the hat sits in the park by the bicycle in the room is dry .
the button sitting on the bed in the school by the toy is broken .	the button sits on the bed in the school by the toy is broken .
the cup sitting in the restaurant on the bed on the street is new .	the cup sits in the restaurant on the bed on the street is new .
the chair sitting by the couch by the picture by the car is gray .	the chair sits by the couch by the picture by the car is gray .
the shirt sitting on the chair on the couch on the stool is hot .	the shirt sits on the chair on the couch on the stool is hot .
the rocket sitting in the hospital in the school on the stool is fine .	the rocket sits in the hospital in the school on the stool is fine .
the plate sitting on the table in the kitchen in the mall is blue .	the plate sits on the table in the kitchen in the mall is blue .
the dish sitting on the floor in the restaurant on the ground is great .	the dish sits on the floor in the restaurant on the ground is great .
the doll sitting in the hospital by the door in the restaurant is important .	the doll sits in the hospital by the door in the restaurant is important .
the book sitting by the doll on the table by the button is expensive .	the book sits by the doll on the table by the button is expensive .
the ship sitting by the mirror in the restaurant on the bed is black .	the ship sits by the mirror in the restaurant on the bed is black .
the car sitting by the plate by the bicycle by the spoon is missing .	the car sits by the plate by the bicycle by the spoon is missing .
the plane sitting in the museum on the street in the library is red .	the plane sits in the museum on the street in the library is red .
the book sitting in the hospital on the stool by the glass is big .	the book sits in the hospital on the stool by the glass is big .
the book sitting by the mirror on the ground on the table is white .	the book sits by the mirror on the ground on the table is white .
the bicycle sitting on the table on the couch in the park is great .	the bicycle sits on the table on the couch in the park is great .
the couch sitting on the table on the stool on the floor is important .	the couch sits on the table on the stool on the floor is important .
the shoe sitting by the bicycle on the couch on the stool is small .	the shoe sits by the bicycle on the couch on the stool is small .
the book sitting by the boat by the ring in the school is big .	the book sits by the boat by the ring in the school is big .
the bottle sitting by the doll by the ring on the couch is dry .	the bottle sits by the doll by the ring on the couch is dry .
the button sitting on the chair in the bank by the plate is purple .	the button sits on the chair in the bank by the plate is purple .
the bottle sitting on the couch by the chair by the mirror is white .	the bottle sits on the couch by the chair by the mirror is white .
the hat sitting in the kitchen in the school by the rocket is old .	the hat sits in the kitchen in the school by the rocket is old .
the window sitting by the bag in the bank in the mall is boring .	the window sits by the bag in the bank in the mall is boring .
the book sitting by the ship by the window on the floor is black .	the book sits by the ship by the window on the floor is black .
the shirt sitting on the chair by the ship on the street is purple .	the shirt sits on the chair by the ship on the street is purple .
the bicycle sitting in the school in the school by the ring is green .	the bicycle sits in the school in the school by the ring is green .
the bicycle sitting on the table on the table by the rug is small .	the bicycle sits on the table on the table by the rug is small .
the shoe sitting in the hospital by the door in the bank is red .	the shoe sits in the hospital by the door in the bank is red .
the window sitting in the restaurant on the floor by the bag is fine .	the window sits in the restaurant on the floor by the bag is fine .
the bag sitting by the bed on the floor by the book is brown .	the bag sits by the bed on the floor by the book is brown .
the spoon sitting in the restaurant by the ship on the ground is missing .	the spoon sits in the restaurant by the ship on the ground is missing .
the chair sitting in the hospital on the table on the stool is expensive .	the chair sits in the hospital on the table on the stool is expensive .
the car sitting on the chair in the mall in the hospital is awesome .	the car sits on the chair in the mall in the hospital is awesome .
the toy sitting on the chair on the chair on the bed is important .	the toy sits on the chair on the chair on the bed is important .
the boat sitting on the ground by the ring by the bicycle is important .	the boat sits on the ground by the ring by the bicycle is important .
the book sitting in the bank on the table by the ring is small .	the book sits in the bank on the table by the ring is small .
the spoon sitting by the hat on the chair in the bank is important .	the spoon sits by the hat on the chair in the bank is important .
the boat sitting by the button on the floor by the truck is missing .	the boat sits by the button on the floor by the truck is missing .
the candle sitting on the table on the table by the box is important .	the candle sits on the table on the table by the box is important .
the candle sitting on the floor in the kitchen on the ground is cute .	the candle sits on the floor in the kitchen on the ground is cute .
the box sitting by the car by the plate by the candle is purple .	the box sits by the car by the plate by the candle is purple .
the bowl sitting in the bank by the shoe by the picture is yellow .	the bowl sits in the bank by the shoe by the picture is yellow .
the box sitting in the room by the mirror by the fork is cold .	the box sits in the room by the mirror by the fork is cold .
the plane sitting in the bank on the stool on the floor is purple .	the plane sits in the bank on the stool on the floor is purple .
the plate sitting in the room in the school on the ground is old .	the plate sits in the room in the school on the ground is old .
the glass sitting by the boat by the shirt on the table is green .	the glass sits by the boat by the shirt on the table is green .
the glass sitting by the bowl in the school on the street is fine .	the glass sits by the bowl in the school on the street is fine .
the box sitting on the couch in the park in the museum is gray .	the box sits on the couch in the park in the museum is gray .
the chair sitting by the mirror by the bag in the school is missing .	the chair sits by the mirror by the bag in the school is missing .
the bag sitting on the couch on the ground by the book is cute .	the bag sits on the couch on the ground by the book is cute .
the rug sitting in the park on the street on the bed is new .	the rug sits in the park on the street on the bed is new .
the spoon sitting in the school by the mirror in the park is amazing .	the spoon sits in the school by the mirror in the park is amazing .
the truck sitting on the bed on the chair in the school is awesome .	the truck sits on the bed on the chair in the school is awesome .
the candle sitting by the bicycle by the toy by the car is hot .	the candle sits by the bicycle by the toy by the car is hot .
the toy sitting on the chair by the shirt in the hospital is fine .	the toy sits on the chair by the shirt in the hospital is fine .
the spoon sitting in the library by the couch on the chair is black .	the spoon sits in the library by the couch on the chair is black .
the plate sitting by the car in the library in the hospital is blue .	the plate sits by the car in the library in the hospital is blue .
the ship sitting by the bottle on the couch in the park is red .	the ship sits by the bottle on the couch in the park is red .
the window sitting on the couch on the floor on the stool is boring .	the window sits on the couch on the floor on the stool is boring .
the book sitting in the hospital in the kitchen by the button is cool .	the book sits in the hospital in the kitchen by the button is cool .
the toy sitting by the bowl by the bed by the door is important .	the toy sits by the bowl by the bed by the door is important .
the book sitting on the chair by the toy by the mirror is awesome .	the book sits on the chair by the toy by the mirror is awesome .
the mirror sitting by the rocket in the restaurant by the glass is amazing .	the mirror sits by the rocket in the restaurant by the glass is amazing .
the bag sitting in the restaurant in the library in the bank is yellow .	the bag sits in the restaurant in the library in the bank is yellow .
the truck sitting in the bank in the room on the stool is boring .	the truck sits in the bank in the room on the stool is boring .
the cup sitting by the dish by the hat on the street is big .	the cup sits by the dish by the hat on the street is big .
the crayon sitting by the plate on the floor in the school is old .	the crayon sits by the plate on the floor in the school is old .
the fork sitting by the mirror by the plane by the mirror is awesome .	the fork sits by the mirror by the plane by the mirror is awesome .
the bowl sitting in the school on the ground in the room is big .	the bowl sits in the school on the ground in the room is big .
the shirt sitting on the couch on the ground by the button is cute .	the shirt sits on the couch on the ground by the button is cute .
the book sitting on the floor by the ring in the museum is orange .	the book sits on the floor by the ring in the museum is orange .
the door sitting on the floor in the kitchen in the mall is old .	the door sits on the floor in the kitchen in the mall is old .
the book sitting in the mall on the floor by the glass is dry .	the book sits in the mall on the floor by the glass is dry .
the button sitting by the doll in the room on the couch is brown .	the button sits by the doll in the room on the couch is brown .
the candle sitting in the kitchen by the bed on the bed is orange .	the candle sits in the kitchen by the bed on the bed is orange .
the box sitting on the street by the car in the school is cute .	the box sits on the street by the car in the school is cute .
the toy sitting in the school in the kitchen by the box is blue .	the toy sits in the school in the kitchen by the box is blue .
the bicycle sitting in the library in the school by the truck is green .	the bicycle sits in the library in the school by the truck is green .
the chair sitting on the floor in the bank in the room is white .	the chair sits on the floor in the bank in the room is white .
the spoon sitting in the museum by the glass in the hospital is black .	the spoon sits in the museum by the glass in the hospital is black .
the shirt sitting in the room by the plane on the ground is cool .	the shirt sits in the room by the plane on the ground is cool .
the button sitting by the dish by the toy by the car is expensive .	the button sits by the dish by the toy by the car is expensive .
the shirt sitting in the park in the kitchen by the rug is small .	the shirt sits in the park in the kitchen by the rug is small .
the crayon sitting in the museum by the book in the park is new .	the crayon sits in the museum by the book in the park is new .
the rug sitting in the kitchen on the bed by the couch is small .	the rug sits in the kitchen on the bed by the couch is small .
the shoe sitting by the hat on the street by the shoe is brown .	the shoe sits by the hat on the street by the shoe is brown .
the plane sitting by the shoe in the museum in the restaurant is important .	the plane sits by the shoe in the museum in the restaurant is important .
the doll sitting by the book on the couch in the restaurant is great .	the doll sits by the book on the couch in the restaurant is great .
the car sitting in the bank in the restaurant in the room is white .	the car sits in the bank in the restaurant in the room is white .
the shirt sitting in the park by the picture in the hospital is important .	the shirt sits in the park by the picture in the hospital is important .
the doll sitting in the mall in the kitchen on the bed is orange .	the doll sits in the mall in the kitchen on the bed is orange .
the ring sitting by the car on the couch by the couch is blue .	the ring sits by the car on the couch by the couch is blue .
the rug sitting on the bed in the kitchen by the picture is big .	the rug sits on the bed in the kitchen by the picture is big .
the plane sitting on the chair by the ring on the stool is fine .	the plane sits on the chair by the ring on the stool is fine .
the bicycle sitting on the ground on the stool by the truck is expensive .	the bicycle sits on the ground on the stool by the truck is expensive .
the car sitting on the street by the spoon in the park is new .	the car sits on the street by the spoon in the park is new .
the crayon sitting by the bicycle on the chair in the restaurant is old .	the crayon sits by the bicycle on the chair in the restaurant is old .
the hat sitting by the toy on the ground in the library is dry .	the hat sits by the toy on the ground in the library is dry .
the glass sitting in the restaurant by the truck on the floor is green .	the glass sits in the restaurant by the truck on the floor is green .
the ship sitting by the rocket by the hat in the hospital is red .	the ship sits by the rocket by the hat in the hospital is red .
the plate sitting on the floor on the chair by the picture is expensive .	the plate sits on the floor on the chair by the picture is expensive .
the rocket sitting on the ground by the bed on the street is missing .	the rocket sits on the ground by the bed on the street is missing .
the shirt sitting on the stool by the toy by the toy is boring .	the shirt sits on the stool by the toy by the toy is boring .
the ship sitting by the boat in the restaurant by the plate is missing .	the ship sits by the boat in the restaurant by the plate is missing .
the plate sitting in the kitchen by the bicycle by the cup is white .	the plate sits in the kitchen by the bicycle by the cup is white .
the shoe sitting by the spoon in the kitchen on the floor is fine .	the shoe sits by the spoon in the kitchen on the floor is fine .
the ship sitting by the glass on the street in the hospital is black .	the ship sits by the glass on the street in the hospital is black .
the door sitting by the couch in the park on the ground is hot .	the door sits by the couch in the park on the ground is hot .
the rug sitting on the street on the floor by the dish is cool .	the rug sits on the street on the floor by the dish is cool .
the spoon sitting on the street by the truck on the couch is cute .	the spoon sits on the street by the truck on the couch is cute .
the window sitting by the dish by the ship by the spoon is whole .	the window sits by the dish by the ship by the spoon is whole .
the book sitting in the mall in the park on the street is expensive .	the book sits in the mall in the park on the street is expensive .
the button sitting by the car in the mall by the glass is cute .	the button sits by the car in the mall by the glass is cute .
the mirror sitting in the hospital on the stool by the box is green .	the mirror sits in the hospital on the stool by the box is green .
the toy sitting in the library by the picture in the park is important .	the toy sits in the library by the picture in the park is important .
the chair sitting in the hospital by the chair by the mirror is blue .	the chair sits in the hospital by the chair by the mirror is blue .
the book sitting by the book by the truck on the street is old .	the book sits by the book by the truck on the street is old .
the doll sitting in the school in the bank in the hospital is dry .	the doll sits in the school in the bank in the hospital is dry .
the candle sitting on the ground on the street on the chair is hot .	the candle sits on the ground on the street on the chair is hot .
the shoe sitting by the door by the cup by the truck is purple .	the shoe sits by the door by the cup by the truck is purple .
the fork sitting on the chair in the bank on the stool is whole .	the fork sits on the chair in the bank on the stool is whole .
the cup sitting in the restaurant on the chair on the chair is new .	the cup sits in the restaurant on the chair on the chair is new .
the shirt sitting by the bed on the table by the boat is brown .	the shirt sits by the bed on the table by the boat is brown .
the rug sitting on the bed in the bank on the stool is white .	the rug sits on the bed in the bank on the stool is white .
the window sitting in the park by the car on the table is gray .	the window sits in the park by the car on the table is gray .
the chair sitting on the table on the chair in the hospital is brown .	the chair sits on the table on the chair in the hospital is brown .
the button sitting in the hospital in the school on the floor is white .	the button sits in the hospital in the school on the floor is white .
the dish sitting by the glass on the floor by the box is cold .	the dish sits by the glass on the floor by the box is cold .
the button sitting on the ground on the floor on the ground is dry .	the button sits on the ground on the floor on the ground is dry .
the ring sitting on the couch on the street by the ship is great .	the ring sits on the couch on the street by the ship is great .
the bowl sitting by the doll in the library in the school is white .	the bowl sits by the doll in the library in the school is white .
the mirror sitting in the library by the bag by the bottle is great .	the mirror sits in the library by the bag by the bottle is great .
the fork sitting on the stool by the button on the stool is fine .	the fork sits on the stool by the button on the stool is fine .
the book sitting on the ground by the picture by the mirror is amazing .	the book sits on the ground by the picture by the mirror is amazing .
the rocket sitting on the ground in the mall in the bank is cute .	the rocket sits on the ground in the mall in the bank is cute .
the shirt sitting by the glass in the room by the hat is dry .	the shirt sits by the glass in the room by the hat is dry .
the picture sitting on the bed by the cup in the school is yellow .	the picture sits on the bed by the cup in the school is yellow .
the ring sitting on the table by the shirt by the ship is whole .	the ring sits on the table by the shirt by the ship is whole .
the cup sitting by the box by the box by the dish is important .	the cup sits by the box by the box by the dish is important .
the bag sitting in the school on the stool in the mall is orange .	the bag sits in the school on the stool in the mall is orange .
the crayon sitting on the stool on the bed by the button is broken .	the crayon sits on the stool on the bed by the button is broken .
the bottle sitting in the library in the school in the bank is fine .	the bottle sits in the library in the school in the bank is fine .
the rug sitting in the school on the stool by the ring is hot .	the rug sits in the school on the stool by the ring is hot .
the couch sitting on the couch by the hat in the museum is orange .	the couch sits on the couch by the hat in the museum is orange .
the hat sitting in the library on the stool by the spoon is fine .	the hat sits in the library on the stool by the spoon is fine .
the rocket sitting on the floor by the hat on the bed is cold .	the rocket sits on the floor by the hat on the bed is cold .
the door sitting in the kitchen in the kitchen in the museum is white .	the door sits in the kitchen in the kitchen in the museum is white .
the toy sitting in the school on the stool by the fork is black .	the toy sits in the school on the stool by the fork is black .
the car sitting on the couch on the chair on the chair is amazing .	the car sits on the couch on the chair on the chair is amazing .
the button sitting on the ground in the hospital in the restaurant is orange .	the button sits on the ground in the hospital in the restaurant is orange .
the book sitting on the ground by the rocket on the bed is awesome .	the book sits on the ground by the rocket on the bed is awesome .
the car sitting by the rocket by the ship on the floor is black .	the car sits by the rocket by the ship on the floor is black .
the cup sitting by the shoe by the crayon in the hospital is small .	the cup sits by the shoe by the crayon in the hospital is small .
the truck sitting by the doll in the hospital on the bed is orange .	the truck sits by the doll in the hospital on the bed is orange .
the fork sitting on the ground on the street by the plane is missing .	the fork sits on the ground on the street by the plane is missing .
the chair sitting by the picture by the car on the street is purple .	the chair sits by the picture by the car on the street is purple .
the bicycle sitting by the bed on the floor in the bank is red .	the bicycle sits by the bed on the floor in the bank is red .
the doll sitting by the car by the door by the plane is blue .	the doll sits by the car by the door by the plane is blue .
the glass sitting by the chair by the hat on the bed is broken .	the glass sits by the chair by the hat on the bed is broken .
the boat sitting by the chair by the rocket on the street is blue .	the boat sits by the chair by the rocket on the street is blue .
the shoe sitting by the shoe in the mall by the bicycle is broken .	the shoe sits by the shoe in the mall by the bicycle is broken .
the chair sitting on the ground in the museum in the bank is amazing .	the chair sits on the ground in the museum in the bank is amazing .
the spoon sitting by the bowl by the book in the museum is cute .	the spoon sits by the bowl by the book in the museum is cute .
the book sitting in the museum in the restaurant on the ground is brown .	the book sits in the museum in the restaurant on the ground is brown .
the picture sitting by the bed by the shoe in the school is gray .	the picture sits by the bed by the shoe in the school is gray .
the rug sitting on the stool on the ground in the hospital is purple .	the rug sits on the stool on the ground in the hospital is purple .
the book sitting on the chair in the library on the bed is cool .	the book sits on the chair in the library on the bed is cool .
the book sitting by the couch on the ground on the street is yellow .	the book sits by the couch on the ground on the street is yellow .
the glass sitting on the street in the restaurant on the ground is awesome .	the glass sits on the street in the restaurant on the ground is awesome .
the spoon sitting on the chair by the window in the hospital is cool .	the spoon sits on the chair by the window in the hospital is cool .
the dish sitting on the bed by the car on the bed is big .	the dish sits on the bed by the car on the bed is big .
the spoon sitting by the car on the table in the school is orange .	the spoon sits by the car on the table in the school is orange .
the book sitting in the park on the bed by the plate is white .	the book sits in the park on the bed by the plate is white .
the bottle sitting by the rocket on the floor in the museum is red .	the bottle sits by the rocket on the floor in the museum is red .
the door sitting in the mall on the floor by the plane is old .	the door sits in the mall on the floor by the plane is old .
the truck sitting on the street by the couch on the table is old .	the truck sits on the street by the couch on the table is old .
the picture sitting by the box in the school on the street is broken .	the picture sits by the box in the school on the street is broken .
the bicycle sitting by the truck by the ship on the ground is missing .	the bicycle sits by the truck by the ship on the ground is missing .
the car sitting by the rug in the park on the street is gray .	the car sits by the rug in the park on the street is gray .
the hat sitting in the park by the ring on the street is awesome .	the hat sits in the park by the ring on the street is awesome .
the plate sitting on the street by the couch on the chair is cold .	the plate sits on the street by the couch on the chair is cold .
the plane sitting by the rug by the plate in the school is brown .	the plane sits by the rug by the plate in the school is brown .
the plane sitting by the candle in the mall on the stool is new .	the plane sits by the candle in the mall on the stool is new .
the spoon sitting by the picture in the bank in the restaurant is old .	the spoon sits by the picture in the bank in the restaurant is old .
the shirt sitting by the couch in the mall on the chair is great .	the shirt sits by the couch in the mall on the chair is great .
the cup sitting in the room by the picture on the ground is blue .	the cup sits in the room by the picture on the ground is blue .
the bowl sitting by the bottle on the chair by the truck is brown .	the bowl sits by the bottle on the chair by the truck is brown .
the ring sitting in the hospital on the floor by the bowl is small .	the ring sits in the hospital on the floor by the bowl is small .
the cup sitting by the doll in the park in the school is hot .	the cup sits by the doll in the park in the school is hot .
the boat sitting in the room by the book by the dish is dry .	the boat sits in the room by the book by the dish is dry .
the toy sitting in the park in the library on the table is purple .	the toy sits in the park in the library on the table is purple .
the boat sitting in the school by the doll in the school is old .	the boat sits in the school by the doll in the school is old .
the dish sitting on the floor by the crayon in the park is important .	the dish sits on the floor by the crayon in the park is important .
the cup sitting on the ground on the stool in the room is cool .	the cup sits on the ground on the stool in the room is cool .
the glass sitting by the glass on the street by the door is black .	the glass sits by the glass on the street by the door is black .
the candle sitting by the fork in the museum on the stool is orange .	the candle sits by the fork in the museum on the stool is orange .
the cup sitting on the bed on the ground by the ring is black .	the cup sits on the bed on the ground by the ring is black .
the window sitting in the hospital in the bank on the couch is new .	the window sits in the hospital in the bank on the couch is new .
the car sitting by the chair in the school by the button is big .	the car sits by the chair in the school by the button is big .
the crayon sitting in the room on the bed on the bed is cool .	the crayon sits in the room on the bed on the bed is cool .
the fork sitting on the chair on the stool by the car is big .	the fork sits on the chair on the stool by the car is big .
the rocket sitting in the bank on the street on the stool is big .	the rocket sits in the bank on the street on the stool is big .
the mirror sitting in the museum by the bed by the ring is whole .	the mirror sits in the museum by the bed by the ring is whole .
the bicycle sitting by the boat on the ground by the car is black .	the bicycle sits by the boat on the ground by the car is black .
the picture sitting on the floor on the stool by the door is new .	the picture sits on the floor on the stool by the door is new .
the picture sitting on the street by the shirt in the bank is dry .	the picture sits on the street by the shirt in the bank is dry .
the glass sitting on the bed by the shirt by the car is great .	the glass sits on the bed by the shirt by the car is great .
the car sitting on the street by the door by the crayon is small .	the car sits on the street by the door by the crayon is small .
the mirror sitting by the chair by the doll in the kitchen is blue .	the mirror sits by the chair by the doll in the kitchen is blue .
the bottle sitting by the book by the spoon on the table is cool .	the bottle sits by the book by the spoon on the table is cool .
the box sitting in the school by the bottle on the street is purple .	the box sits in the school by the bottle on the street is purple .
the window sitting in the restaurant on the bed on the chair is white .	the window sits in the restaurant on the bed on the chair is white .
the truck sitting on the chair by the bicycle on the floor is gray .	the truck sits on the chair by the bicycle on the floor is gray .
the book sitting on the ground by the picture by the toy is small .	the book sits on the ground by the picture by the toy is small .
the shoe sitting in the room in the bank in the mall is dry .	the shoe sits in the room in the bank in the mall is dry .
the picture sitting on the stool on the chair in the bank is great .	the picture sits on the stool on the chair in the bank is great .
the car sitting in the restaurant by the ring by the dish is expensive .	the car sits in the restaurant by the ring by the dish is expensive .
the button sitting on the table on the floor by the bag is white .	the button sits on the table on the floor by the bag is white .
the book sitting by the doll in the room on the chair is small .	the book sits by the doll in the room on the chair is small .
the door sitting by the shoe on the couch on the ground is cool .	the door sits by the shoe on the couch on the ground is cool .
the car sitting on the bed on the stool by the doll is big .	the car sits on the bed on the stool by the doll is big .
the truck sitting in the park by the rocket by the shirt is broken .	the truck sits in the park by the rocket by the shirt is broken .
the bed sitting by the dish in the room in the restaurant is red .	the bed sits by the dish in the room in the restaurant is red .
the mirror sitting on the table by the ring in the park is hot .	the mirror sits on the table by the ring in the park is hot .
the dish sitting by the plane by the plane in the school is expensive .	the dish sits by the plane by the plane in the school is expensive .
the bed sitting by the truck on the stool on the bed is awesome .	the bed sits by the truck on the stool on the bed is awesome .
the crayon sitting by the window by the box on the street is red .	the crayon sits by the window by the box on the street is red .
the doll sitting by the rug in the hospital in the hospital is big .	the doll sits by the rug in the hospital in the hospital is big .
the shoe sitting on the floor in the museum on the floor is dry .	the shoe sits on the floor in the museum on the floor is dry .
the couch sitting by the boat in the restaurant in the hospital is fine .	the couch sits by the boat in the restaurant in the hospital is fine .
the book sitting by the glass on the chair by the bed is blue .	the book sits by the glass on the chair by the bed is blue .
the bag sitting in the park by the ring on the couch is amazing .	the bag sits in the park by the ring on the couch is amazing .
the bed sitting by the doll on the table by the glass is blue .	the bed sits by the doll on the table by the glass is blue .
the ring sitting by the plane by the bicycle by the car is gray .	the ring sits by the plane by the bicycle by the car is gray .
the crayon sitting by the rug in the room by the plate is cold .	the crayon sits by the rug in the room by the plate is cold .
the rocket sitting by the fork on the chair by the bicycle is red .	the rocket sits by the fork on the chair by the bicycle is red .
the rocket sitting on the table by the cup in the mall is broken .	the rocket sits on the table by the cup in the mall is broken .
the plate sitting by the door in the museum in the museum is missing .	the plate sits by the door in the museum in the museum is missing .
the book sitting on the chair by the window on the street is big .	the book sits on the chair by the window on the street is big .
the ring sitting by the door on the street on the stool is important .	the ring sits by the door on the street on the stool is important .
the dish sitting by the toy on the floor on the chair is old .	the dish sits by the toy on the floor on the chair is old .
the rug sitting in the library on the street on the stool is whole .	the rug sits in the library on the street on the stool is whole .
the ring sitting by the car by the shirt on the ground is cute .	the ring sits by the car by the shirt on the ground is cute .
the truck sitting by the rocket by the candle by the candle is black .	the truck sits by the rocket by the candle by the candle is black .
the bed sitting in the room in the bank in the hospital is old .	the bed sits in the room in the bank in the hospital is old .
the car sitting on the bed by the bag on the ground is purple .	the car sits on the bed by the bag on the ground is purple .
the book sitting on the street on the couch in the mall is boring .	the book sits on the street on the couch in the mall is boring .
the bicycle sitting on the table by the glass by the plate is cute .	the bicycle sits on the table by the glass by the plate is cute .
the toy sitting in the library by the mirror on the bed is gray .	the toy sits in the library by the mirror on the bed is gray .
the bowl sitting on the chair in the mall in the room is cold .	the bowl sits on the chair in the mall in the room is cold .
the bag sitting by the rug by the plane on the floor is small .	the bag sits by the rug by the plane on the floor is small .
the chair sitting on the street by the cup by the shirt is hot .	the chair sits on the street by the cup by the shirt is hot .
the ship sitting by the car in the bank by the ship is red .	the ship sits by the car in the bank by the ship is red .
the bowl sitting by the doll in the mall on the bed is orange .	the bowl sits by the doll in the mall on the bed is orange .
the book sitting on the couch by the book in the bank is boring .	the book sits on the couch by the book in the bank is boring .
the chair sitting on the couch in the room in the mall is important .	the chair sits on the couch in the room in the mall is important .
the mirror sitting by the bicycle by the ship in the school is big .	the mirror sits by the bicycle by the ship in the school is big .
the hat sitting on the bed on the bed on the stool is hot .	the hat sits on the bed on the bed on the stool is hot .
the crayon sitting by the cup by the bowl in the mall is cute .	the crayon sits by the cup by the bowl in the mall is cute .
the car sitting on the bed on the street by the ship is blue .	the car sits on the bed on the street by the ship is blue .
the crayon sitting in the mall by the plate on the ground is white .	the crayon sits in the mall by the plate on the ground is white .
the couch sitting by the bowl by the car in the restaurant is brown .	the couch sits by the bowl by the car in the restaurant is brown .
the bowl sitting in the library by the bed in the museum is broken .	the bowl sits in the library by the bed in the museum is broken .
the shirt sitting by the toy in the museum by the ring is fine .	the shirt sits by the toy in the museum by the ring is fine .
the shirt sitting by the window on the ground by the cup is gray .	the shirt sits by the window on the ground by the cup is gray .
the chair sitting on the stool on the chair by the rug is cool .	the chair sits on the stool on the chair by the rug is cool .
the door sitting in the museum in the hospital by the book is whole .	the door sits in the museum in the hospital by the book is whole .
the toy sitting on the chair in the school in the school is missing .	the toy sits on the chair in the school in the school is missing .
the bicycle sitting in the school on the street on the ground is awesome .	the bicycle sits in the school on the street on the ground is awesome .
the dish sitting by the toy on the street in the kitchen is cold .	the dish sits by the toy on the street in the kitchen is cold .
the bag sitting on the street on the street by the rocket is whole .	the bag sits on the street on the street by the rocket is whole .
the ring sitting on the stool by the rocket by the truck is big .	the ring sits on the stool by the rocket by the truck is big .
the crayon sitting on the street in the kitchen on the bed is cool .	the crayon sits on the street in the kitchen on the bed is cool .
the ship sitting on the couch on the chair on the stool is brown .	the ship sits on the couch on the chair on the stool is brown .
the shirt sitting on the ground by the spoon on the couch is gray .	the shirt sits on the ground by the spoon on the couch is gray .
the rocket sitting on the ground on the couch on the ground is expensive .	the rocket sits on the ground on the couch on the ground is expensive .
the glass sitting on the stool on the floor on the floor is cool .	the glass sits on the stool on the floor on the floor is cool .
the bag sitting by the cup by the truck in the bank is hot .	the bag sits by the cup by the truck in the bank is hot .
the toy sitting on the table in the bank by the plate is cold .	the toy sits on the table in the bank by the plate is cold .
the boat sitting on the ground by the window on the ground is black .	the boat sits on the ground by the window on the ground is black .
the door sitting by the picture by the plate by the rocket is purple .	the door sits by the picture by the plate by the rocket is purple .
the bottle sitting by the picture on the chair in the restaurant is gray .	the bottle sits by the picture on the chair in the restaurant is gray .
the box sitting in the park on the floor on the chair is new .	the box sits in the park on the floor on the chair is new .
the book sitting by the box by the toy in the park is whole .	the book sits by the box by the toy in the park is whole .
the toy sitting on the floor in the park on the street is green .	the toy sits on the floor in the park on the street is green .
the rug sitting by the car on the stool in the restaurant is old .	the rug sits by the car on the stool in the restaurant is old .
the bowl sitting on the bed in the library by the door is white .	the bowl sits on the bed in the library by the door is white .
the glass sitting on the chair by the doll on the couch is great .	the glass sits on the chair by the doll on the couch is great .
the shirt sitting by the hat on the street in the library is boring .	the shirt sits by the hat on the street in the library is boring .
the boat sitting in the room by the bicycle by the picture is awesome .	the boat sits in the room by the bicycle by the picture is awesome .
the boat sitting by the car on the ground on the chair is gray .	the boat sits by the car on the ground on the chair is gray .
the car sitting on the stool in the restaurant in the park is cold .	the car sits on the stool in the restaurant in the park is cold .
the fork sitting by the crayon in the hospital by the crayon is broken .	the fork sits by the crayon in the hospital by the crayon is broken .
the ring sitting on the floor in the school on the street is brown .	the ring sits on the floor in the school on the street is brown .
the couch sitting on the bed in the mall by the bowl is white .	the couch sits on the bed in the mall by the bowl is white .
the car sitting in the mall by the plate in the school is amazing .	the car sits in the mall by the plate in the school is amazing .
the chair sitting by the candle by the boat on the floor is yellow .	the chair sits by the candle by the boat on the floor is yellow .
the crayon sitting by the plane by the boat by the book is awesome .	the crayon sits by the plane by the boat by the book is awesome .
the ring sitting on the floor in the library in the park is missing .	the ring sits on the floor in the library in the park is missing .
the bicycle sitting by the box by the bed on the street is boring .	the bicycle sits by the box by the bed on the street is boring .
the boat sitting in the school on the ground by the chair is cute .	the boat sits in the school on the ground by the chair is cute .
the glass sitting in the hospital on the stool by the rocket is big .	the glass sits in the hospital on the stool by the rocket is big .
the car sitting on the ground on the chair in the library is cool .	the car sits on the ground on the chair in the library is cool .
the shirt sitting by the couch on the couch by the car is new .	the shirt sits by the couch on the couch by the car is new .
the hat sitting in the restaurant in the restaurant in the mall is fine .	the hat sits in the restaurant in the restaurant in the mall is fine .
the shoe sitting in the school in the mall on the floor is whole .	the shoe sits in the school in the mall on the floor is whole .
the dish sitting by the car by the doll on the chair is yellow .	the dish sits by the car by the doll on the chair is yellow .
the bowl sitting in the hospital on the ground in the kitchen is missing .	the bowl sits in the hospital on the ground in the kitchen is missing .
the bottle sitting on the ground in the school in the school is missing .	the bottle sits on the ground in the school in the school is missing .
the box sitting by the rocket in the room in the room is black .	the box sits by the rocket in the room in the room is black .
the dish sitting in the hospital on the ground in the hospital is important .	the dish sits in the hospital on the ground in the hospital is important .
the toy sitting in the restaurant in the hospital in the mall is white .	the toy sits in the restaurant in the hospital in the mall is white .
the spoon sitting on the street on the couch in the school is cool .	the spoon sits on the street on the couch in the school is cool .
the hat sitting by the shoe by the bed by the dish is brown .	the hat sits by the shoe by the bed by the dish is brown .
the bicycle sitting by the boat in the museum by the bottle is new .	the bicycle sits by the boat in the museum by the bottle is new .
the ship sitting on the bed by the car in the museum is black .	the ship sits on the bed by the car in the museum is black .
the car sitting in the bank on the ground on the street is missing .	the car sits in the bank on the ground on the street is missing .
the bottle sitting by the book on the ground on the chair is hot .	the bottle sits by the book on the ground on the chair is hot .
the bed sitting by the rug on the stool in the school is cool .	the bed sits by the rug on the stool in the school is cool .
the shoe sitting in the museum by the plate on the stool is green .	the shoe sits in the museum by the plate on the stool is green .
the box sitting in the room in the museum in the room is hot .	the box sits in the room in the museum in the room is hot .
the crayon sitting on the chair by the plate on the bed is purple .	the crayon sits on the chair by the plate on the bed is purple .
the picture sitting in the kitchen by the window on the floor is blue .	the picture sits in the kitchen by the window on the floor is blue .
the truck sitting by the box on the chair by the bicycle is great .	the truck sits by the box on the chair by the bicycle is great .
the rug sitting by the glass in the school in the museum is amazing .	the rug sits by the glass in the school in the museum is amazing .
the picture sitting in the mall on the couch on the bed is broken .	the picture sits in the mall on the couch on the bed is broken .
the truck sitting by the cup on the couch in the restaurant is blue .	the truck sits by the cup on the couch in the restaurant is blue .
the window sitting in the school on the bed in the school is dry .	the window sits in the school on the bed in the school is dry .
the shoe sitting in the hospital on the chair on the couch is cute .	the shoe sits in the hospital on the chair on the couch is cute .
the rocket sitting by the doll in the kitchen by the toy is amazing .	the rocket sits by the doll in the kitchen by the toy is amazing .
the car sitting in the room in the bank by the truck is important .	the car sits in the room in the bank by the truck is important .
the box sitting in the restaurant in the school on the floor is blue .	the box sits in the restaurant in the school on the floor is blue .
the glass sitting on the couch by the hat on the ground is dry .	the glass sits on the couch by the hat on the ground is dry .
the window sitting on the stool by the shirt in the park is cool .	the window sits on the stool by the shirt in the park is cool .
the spoon sitting by the mirror in the museum by the window is boring .	the spoon sits by the mirror in the museum by the window is boring .
the rocket sitting on the table on the floor in the bank is red .	the rocket sits on the table on the floor in the bank is red .
the ring sitting on the table by the ship by the candle is broken .	the ring sits on the table by the ship by the candle is broken .
the bed sitting by the door in the school on the table is blue .	the bed sits by the door in the school on the table is blue .
the bed sitting on the street on the table on the stool is cool .	the bed sits on the street on the table on the stool is cool .
the bottle sitting by the couch on the bed on the chair is cute .	the bottle sits by the couch on the bed on the chair is cute .
the picture sitting in the mall by the plate on the table is boring .	the picture sits in the mall by the plate on the table is boring .
the book sitting by the fork by the bag by the bicycle is hot .	the book sits by the fork by the bag by the bicycle is hot .
the plate sitting on the table on the stool on the stool is blue .	the plate sits on the table on the stool on the stool is blue .
the plane sitting on the bed on the table by the door is old .	the plane sits on the bed on the table by the door is old .
the crayon sitting by the spoon in the restaurant in the library is awesome .	the crayon sits by the spoon in the restaurant in the library is awesome .
the picture sitting on the couch on the street on the ground is new .	the picture sits on the couch on the street on the ground is new .
the couch sitting in the school in the museum on the couch is black .	the couch sits in the school in the museum on the couch is black .
the bag sitting by the book by the bottle on the stool is whole .	the bag sits by the book by the bottle on the stool is whole .
the truck sitting by the book by the shoe in the library is brown .	the truck sits by the book by the shoe in the library is brown .
the spoon sitting in the kitchen by the couch on the bed is red .	the spoon sits in the kitchen by the couch on the bed is red .
the bed sitting by the hat on the floor in the restaurant is white .	the bed sits by the hat on the floor in the restaurant is white .
the plane sitting on the floor by the car in the kitchen is blue .	the plane sits on the floor by the car in the kitchen is blue .
the shirt sitting on the couch on the table by the car is orange .	the shirt sits on the couch on the table by the car is orange .
the bicycle sitting by the candle on the bed on the chair is red .	the bicycle sits by the candle on the bed on the chair is red .
the door sitting by the bowl by the cup on the stool is amazing .	the door sits by the bowl by the cup on the stool is amazing .
the couch sitting on the ground on the chair by the cup is whole .	the couch sits on the ground on the chair by the cup is whole .
the button sitting by the dish on the table by the bag is yellow .	the button sits by the dish on the table by the bag is yellow .
the shoe sitting by the button on the stool on the stool is red .	the shoe sits by the button on the stool on the stool is red .
the rocket sitting by the picture on the table on the chair is awesome .	the rocket sits by the picture on the table on the chair is awesome .
the spoon sitting in the school in the park on the bed is cold .	the spoon sits in the school in the park on the bed is cold .
the doll sitting by the ship in the park on the street is hot .	the doll sits by the ship in the park on the street is hot .
the rocket sitting in the room by the candle on the floor is green .	the rocket sits in the room by the candle on the floor is green .
the plane sitting in the museum on the chair on the stool is dry .	the plane sits in the museum on the chair on the stool is dry .
the bicycle sitting in the restaurant in the park by the bed is broken .	the bicycle sits in the restaurant in the park by the bed is broken .
the mirror sitting by the plane on the ground on the table is cold .	the mirror sits by the plane on the ground on the table is cold .
the car sitting on the bed on the ground on the bed is boring .	the car sits on the bed on the ground on the bed is boring .
the doll sitting by the mirror on the stool by the toy is orange .	the doll sits by the mirror on the stool by the toy is orange .
the hat sitting on the floor by the ship on the stool is blue .	the hat sits on the floor by the ship on the stool is blue .
the ship sitting by the candle in the school by the candle is orange .	the ship sits by the candle in the school by the candle is orange .
the book sitting in the mall by the cup in the restaurant is broken .	the book sits in the mall by the cup in the restaurant is broken .
the book sitting in the school by the rocket in the mall is hot .	the book sits in the school by the rocket in the mall is hot .
the ring sitting on the couch in the park on the stool is whole .	the ring sits on the couch in the park on the stool is whole .
the rug sitting in the mall on the couch on the floor is orange .	the rug sits in the mall on the couch on the floor is orange .
the dish sitting on the street in the restaurant by the cup is great .	the dish sits on the street in the restaurant by the cup is great .
the rocket sitting by the bottle in the school on the couch is cold .	the rocket sits by the bottle in the school on the couch is cold .
the glass sitting on the couch in the mall in the room is small .	the glass sits on the couch in the mall in the room is small .
the car sitting on the table by the bottle by the rug is brown .	the car sits on the table by the bottle by the rug is brown .
the boat sitting on the stool on the ground on the street is gray .	the boat sits on the stool on the ground on the street is gray .
the book sitting on the street in the school on the floor is black .	the book sits on the street in the school on the floor is black .
the picture sitting by the ring by the mirror in the school is yellow .	the picture sits by the ring by the mirror in the school is yellow .
the bottle sitting on the table in the restaurant by the doll is cool .	the bottle sits on the table in the restaurant by the doll is cool .
the candle sitting by the boat in the school on the floor is new .	the candle sits by the boat in the school on the floor is new .
the picture sitting by the hat on the ground by the ring is gray .	the picture sits by the hat on the ground by the ring is gray .
the shirt sitting in the school by the shoe in the mall is old .	the shirt sits in the school by the shoe in the mall is old .
the rocket sitting in the museum on the couch in the park is great .	the rocket sits in the museum on the couch in the park is great .
the fork sitting by the candle on the table on the couch is old .	the fork sits by the candle on the table on the couch is old .
the couch sitting on the ground by the fork by the car is gray .	the couch sits on the ground by the fork by the car is gray .
the truck sitting on the bed by the dish by the toy is awesome .	the truck sits on the bed by the dish by the toy is awesome .
the picture sitting by the door by the chair in the library is broken .	the picture sits by the door by the chair in the library is broken .
the bed sitting on the bed on the table by the book is brown .	the bed sits on the bed on the table by the book is brown .
the plane sitting in the school in the restaurant on the street is orange .	the plane sits in the school in the restaurant on the street is orange .
the car sitting by the couch on the bed in the restaurant is green .	the car sits by the couch on the bed in the restaurant is green .
the glass sitting in the park in the hospital by the rug is dry .	the glass sits in the park in the hospital by the rug is dry .
the bed sitting on the ground on the ground on the floor is white .	the bed sits on the ground on the ground on the floor is white .
the fork sitting in the museum on the couch by the shirt is gray .	the fork sits in the museum on the couch by the shirt is gray .
the hat sitting on the floor in the mall by the window is old .	the hat sits on the floor in the mall by the window is old .
the cup sitting by the shirt by the cup on the couch is cool .	the cup sits by the shirt by the cup on the couch is cool .
the fork sitting on the chair in the hospital by the button is brown .	the fork sits on the chair in the hospital by the button is brown .
the window sitting on the stool on the street on the bed is fine .	the window sits on the stool on the street on the bed is fine .
the door sitting by the button in the library in the library is black .	the door sits by the button in the library in the library is black .
the plane sitting in the park in the mall by the toy is broken .	the plane sits in the park in the mall by the toy is broken .
the bicycle sitting by the bottle by the doll on the couch is old .	the bicycle sits by the bottle by the doll on the couch is old .
the plane sitting in the hospital in the mall by the car is blue .	the plane sits in the hospital in the mall by the car is blue .
the mirror sitting in the library by the couch on the couch is fine .	the mirror sits in the library by the couch on the couch is fine .
the glass sitting on the stool by the spoon on the floor is cool .	the glass sits on the stool by the spoon on the floor is cool .
the spoon sitting on the floor by the window in the hospital is cool .	the spoon sits on the floor by the window in the hospital is cool .
the bag sitting by the car by the fork in the hospital is purple .	the bag sits by the car by the fork in the hospital is purple .
the car sitting in the kitchen in the hospital on the table is expensive .	the car sits in the kitchen in the hospital on the table is expensive .
the book sitting on the street on the chair by the button is purple .	the book sits on the street on the chair by the button is purple .
the plate sitting on the couch by the rocket in the bank is orange .	the plate sits on the couch by the rocket in the bank is orange .
the ring sitting in the library by the glass in the mall is purple .	the ring sits in the library by the glass in the mall is purple .
the candle sitting in the kitchen by the rocket on the table is hot .	the candle sits in the kitchen by the rocket on the table is hot .
the button sitting in the school by the dish on the street is important .	the button sits in the school by the dish on the street is important .
the window sitting by the doll in the mall by the plate is blue .	the window sits by the doll in the mall by the plate is blue .
the plate sitting on the chair on the ground by the ship is cold .	the plate sits on the chair on the ground by the ship is cold .
the bed sitting on the table on the floor by the bed is white .	the bed sits on the table on the floor by the bed is white .
the book sitting by the spoon by the candle in the bank is brown .	the book sits by the spoon by the candle in the bank is brown .
the hat sitting in the kitchen on the street on the table is yellow .	the hat sits in the kitchen on the street on the table is yellow .
the bowl sitting by the bag in the school by the crayon is amazing .	the bowl sits by the bag in the school by the crayon is amazing .
the spoon sitting by the button by the chair on the stool is expensive .	the spoon sits by the button by the chair on the stool is expensive .
the bed sitting on the chair on the floor by the chair is great .	the bed sits on the chair on the floor by the chair is great .
the plate sitting in the kitchen on the couch by the bottle is missing .	the plate sits in the kitchen on the couch by the bottle is missing .
the plane sitting by the bed in the mall by the dish is awesome .	the plane sits by the bed in the mall by the dish is awesome .
the dish sitting on the stool by the plate in the school is fine .	the dish sits on the stool by the plate in the school is fine .
the toy sitting by the window by the truck by the bed is red .	the toy sits by the window by the truck by the bed is red .
the picture sitting on the table in the kitchen in the school is cold .	the picture sits on the table in the kitchen in the school is cold .
the bed sitting on the street on the ground by the ring is orange .	the bed sits on the street on the ground by the ring is orange .
the picture sitting on the street in the park on the couch is cute .	the picture sits on the street in the park on the couch is cute .
the candle sitting by the picture in the library by the rug is cool .	the candle sits by the picture in the library by the rug is cool .
the shoe sitting on the table on the bed in the school is amazing .	the shoe sits on the table on the bed in the school is amazing .
the book sitting by the door in the bank on the couch is red .	the book sits by the door in the bank on the couch is red .
the doll sitting by the couch in the restaurant on the floor is cold .	the doll sits by the couch in the restaurant on the floor is cold .
the glass sitting in the hospital in the hospital by the couch is cute .	the glass sits in the hospital in the hospital by the couch is cute .
the boat sitting on the table by the toy on the stool is old .	the boat sits on the table by the toy on the stool is old .
the cup sitting in the museum by the boat on the ground is awesome .	the cup sits in the museum by the boat on the ground is awesome .
the shoe sitting by the door on the table on the street is cute .	the shoe sits by the door on the table on the street is cute .
the bottle sitting on the bed in the room on the chair is yellow .	the bottle sits on the bed in the room on the chair is yellow .
the rug sitting on the street on the stool on the table is new .	the rug sits on the street on the stool on the table is new .
the fork sitting by the bottle by the chair in the bank is cool .	the fork sits by the bottle by the chair in the bank is cool .
the book sitting by the rug on the stool on the street is cold .	the book sits by the rug on the stool on the street is cold .
the dish sitting on the street on the stool by the candle is important .	the dish sits on the street on the stool by the candle is important .
the button sitting by the boat on the floor on the bed is cute .	the button sits by the boat on the floor on the bed is cute .
the car sitting on the street by the car on the street is whole .	the car sits on the street by the car on the street is whole .
the bed sitting on the floor on the ground in the restaurant is broken .	the bed sits on the floor on the ground in the restaurant is broken .
the mirror sitting by the plate on the bed on the ground is missing .	the mirror sits by the plate on the bed on the ground is missing .
the hat sitting by the bed by the rocket on the ground is old .	the hat sits by the bed by the rocket on the ground is old .
the window sitting by the picture in the library by the truck is big .	the window sits by the picture in the library by the truck is big .
