the plane sitting by the rocket in the school is cute .	the plane sits by the rocket in the school is cute .
the ring sitting on the chair in the museum is important .	the ring sits on the chair in the museum is important .
the glass sitting by the book by the crayon is black .	the glass sits by the book by the crayon is black .
the shoe sitting on the table on the stool is black .	the shoe sits on the table on the stool is black .
the doll sitting on the table on the street is brown .	the doll sits on the table on the street is brown .
the plate sitting by the car by the button is hot .	the plate sits by the car by the button is hot .
the book sitting on the stool in the mall is old .	the book sits on the stool in the mall is old .
the cup sitting by the shoe by the bowl is great .	the cup sits by the shoe by the bowl is great .
the book sitting in the bank in the kitchen is yellow .	the book sits in the bank in the kitchen is yellow .
the ship sitting by the candle by the bowl is white .	the ship sits by the candle by the bowl is white .
the car sitting by the hat in the mall is broken .	the car sits by the hat in the mall is broken .
the dish sitting on the ground by the chair is old .	the dish sits on the ground by the chair is old .
the candle sitting in the kitchen on the couch is dry .	the candle sits in the kitchen on the couch is dry .
the toy sitting by the fork in the library is boring .	the toy sits by the fork in the library is boring .
the hat sitting on the table on the bed is old .	the hat sits on the table on the bed is old .
the bowl sitting in the mall by the book is broken .	the bowl sits in the mall by the book is broken .
the chair sitting in the room in the park is red .	the chair sits in the room in the park is red .
the spoon sitting in the park by the book is blue .	the spoon sits in the park by the book is blue .
the bed sitting by the mirror by the car is red .	the bed sits by the mirror by the car is red .
the door sitting on the stool in the museum is cute .	the door sits on the stool in the museum is cute .
the crayon sitting by the dish on the table is white .	the crayon sits by the dish on the table is white .
the couch sitting in the park on the street is gray .	the couch sits in the park on the street is gray .
the fork sitting by the rocket by the shirt is dry .	the fork sits by the rocket by the shirt is dry .
the dish sitting on the bed by the shoe is black .	the dish sits on the bed by the shoe is black .
the box sitting in the library in the library is purple .	the box sits in the library in the library is purple .
the bowl sitting on the street in the school is dry .	the bowl sits on the street in the school is dry .
the bed sitting in the school by the bottle is orange .	the bed sits in the school by the bottle is orange .
the truck sitting by the bag in the kitchen is green .	the truck sits by the bag in the kitchen is green .
the button sitting in the park by the doll is broken .	the button sits in the park by the doll is broken .
the book sitting on the chair by the chair is cool .	the book sits on the chair by the chair is cool .
the door sitting in the library by the plane is black .	the door sits in the library by the plane is black .
the bottle sitting in the room on the bed is amazing .	the bottle sits in the room on the bed is amazing .
the book sitting in the hospital on the chair is dry .	the book sits in the hospital on the chair is dry .
the plane sitting in the restaurant by the button is fine .	the plane sits in the restaurant by the button is fine .
the picture sitting on the bed by the bottle is great .	the picture sits on the bed by the bottle is great .
the box sitting on the stool on the chair is black .	the box sits on the stool on the chair is black .
the rug sitting in the museum by the crayon is blue .	the rug sits in the museum by the crayon is blue .
the ring sitting on the chair on the ground is green .	the ring sits on the chair on the ground is green .
the shirt sitting in the hospital by the shirt is missing .	the shirt sits in the hospital by the shirt is missing .
the hat sitting by the bag in the restaurant is fine .	the hat sits by the bag in the restaurant is fine .
the bowl sitting by the toy by the book is amazing .	the bowl sits by the toy by the book is amazing .
the box sitting on the bed by the button is blue .	the box sits on the bed by the button is blue .
the dish sitting on the floor on the street is broken .	the dish sits on the floor on the street is broken .
the mirror sitting in the bank by the ring is new .	the mirror sits in the bank by the ring is new .
the ring sitting in the school on the street is white .	the ring sits in the school on the street is white .
the car sitting on the street by the ship is missing .	the car sits on the street by the ship is missing .
the book sitting on the street by the plane is green .	the book sits on the street by the plane is green .
the glass sitting in the school by the boat is blue .	the glass sits in the school by the boat is blue .
the book sitting in the mall on the ground is whole .	the book sits in the mall on the ground is whole .
the car sitting by the couch on the street is green .	the car sits by the couch on the street is green .
the rocket sitting on the couch by the doll is old .	the rocket sits on the couch by the doll is old .
the door sitting on the floor in the hospital is big .	the door sits on the floor in the hospital is big .
the rug sitting by the bowl in the mall is amazing .	the rug sits by the bowl in the mall is amazing .
the boat sitting by the bed by the rug is black .	the boat sits by the bed by the rug is black .
the fork sitting on the street by the bag is brown .	the fork sits on the street by the bag is brown .
the bag sitting on the chair by the ring is whole .	the bag sits on the chair by the ring is whole .
the book sitting in the hospital in the room is orange .	the book sits in the hospital in the room is orange .
the cup sitting on the ground in the room is big .	the cup sits on the ground in the room is big .
the spoon sitting in the library on the couch is orange .	the spoon sits in the library on the couch is orange .
the bowl sitting on the floor by the door is missing .	the bowl sits on the floor by the door is missing .
the car sitting by the rug by the couch is green .	the car sits by the rug by the couch is green .
the plate sitting by the book in the mall is brown .	the plate sits by the book in the mall is brown .
the bottle sitting by the glass on the stool is big .	the bottle sits by the glass on the stool is big .
the book sitting in the restaurant by the shirt is blue .	the book sits in the restaurant by the shirt is blue .
the book sitting by the plane in the mall is great .	the book sits by the plane in the mall is great .
the car sitting on the floor by the shoe is cute .	the car sits on the floor by the shoe is cute .
the doll sitting by the ship on the chair is cute .	the doll sits by the ship on the chair is cute .
the hat sitting by the toy on the couch is yellow .	the hat sits by the toy on the couch is yellow .
the rocket sitting on the chair by the rug is cool .	the rocket sits on the chair by the rug is cool .
the picture sitting on the chair in the museum is whole .	the picture sits on the chair in the museum is whole .
the ship sitting on the stool on the street is awesome .	the ship sits on the stool on the street is awesome .
the glass sitting in the restaurant by the bed is amazing .	the glass sits in the restaurant by the bed is amazing .
the car sitting by the bottle by the spoon is cold .	the car sits by the bottle by the spoon is cold .
the rug sitting on the street on the chair is black .	the rug sits on the street on the chair is black .
the toy sitting in the museum on the stool is white .	the toy sits in the museum on the stool is white .
the plate sitting in the mall on the bed is hot .	the plate sits in the mall on the bed is hot .
the rug sitting on the ground by the candle is whole .	the rug sits on the ground by the candle is whole .
the button sitting on the stool by the box is orange .	the button sits on the stool by the box is orange .
the picture sitting by the boat by the truck is orange .	the picture sits by the boat by the truck is orange .
the glass sitting on the ground in the school is green .	the glass sits on the ground in the school is green .
the plane sitting in the park in the bank is broken .	the plane sits in the park in the bank is broken .
the box sitting in the mall in the museum is big .	the box sits in the mall in the museum is big .
the candle sitting in the park on the street is blue .	the candle sits in the park on the street is blue .
the picture sitting by the boat on the couch is dry .	the picture sits by the boat on the couch is dry .
the ring sitting by the ring in the park is great .	the ring sits by the ring in the park is great .
the plane sitting on the floor by the ship is new .	the plane sits on the floor by the ship is new .
the book sitting in the mall in the room is gray .	the book sits in the mall in the room is gray .
the car sitting on the bed in the hospital is purple .	the car sits on the bed in the hospital is purple .
the doll sitting in the mall by the toy is big .	the doll sits in the mall by the toy is big .
the window sitting by the toy in the restaurant is cool .	the window sits by the toy in the restaurant is cool .
the dish sitting on the ground by the box is black .	the dish sits on the ground by the box is black .
the ring sitting in the mall in the room is orange .	the ring sits in the mall in the room is orange .
the boat sitting on the ground by the car is gray .	the boat sits on the ground by the car is gray .
the spoon sitting by the button by the bicycle is red .	the spoon sits by the button by the bicycle is red .
the book sitting by the plane by the box is blue .	the book sits by the plane by the box is blue .
the rug sitting by the plate on the chair is boring .	the rug sits by the plate on the chair is boring .
the bed sitting on the ground in the hospital is black .	the bed sits on the ground in the hospital is black .
the dish sitting by the glass by the bag is black .	the dish sits by the glass by the bag is black .
the chair sitting on the bed by the dish is big .	the chair sits on the bed by the dish is big .
the rug sitting on the floor on the ground is amazing .	the rug sits on the floor on the ground is amazing .
the rocket sitting in the park on the street is fine .	the rocket sits in the park on the street is fine .
the candle sitting on the bed on the table is black .	the candle sits on the bed on the table is black .
the shoe sitting in the kitchen by the bag is big .	the shoe sits in the kitchen by the bag is big .
the fork sitting on the ground by the rug is yellow .	the fork sits on the ground by the rug is yellow .
the book sitting by the door by the picture is amazing .	the book sits by the door by the picture is amazing .
the car sitting in the school on the chair is important .	the car sits in the school on the chair is important .
the window sitting by the bag on the table is boring .	the window sits by the bag on the table is boring .
the fork sitting on the couch by the mirror is awesome .	the fork sits on the couch by the mirror is awesome .
the book sitting in the school by the bottle is big .	the book sits in the school by the bottle is big .
the ship sitting on the bed by the ship is boring .	the ship sits on the bed by the ship is boring .
the door sitting on the stool in the museum is cool .	the door sits on the stool in the museum is cool .
the spoon sitting by the car on the table is expensive .	the spoon sits by the car on the table is expensive .
the bottle sitting on the floor in the hospital is small .	the bottle sits on the floor in the hospital is small .
the couch sitting by the window by the chair is hot .	the couch sits by the window by the chair is hot .
the boat sitting by the glass by the ship is old .	the boat sits by the glass by the ship is old .
the plane sitting by the hat on the couch is brown .	the plane sits by the hat on the couch is brown .
the doll sitting by the window by the box is cute .	the doll sits by the window by the box is cute .
the plate sitting on the floor in the restaurant is cold .	the plate sits on the floor in the restaurant is cold .
the window sitting in the room on the chair is hot .	the window sits in the room on the chair is hot .
the fork sitting in the kitchen on the ground is amazing .	the fork sits in the kitchen on the ground is amazing .
the car sitting on the table by the dish is important .	the car sits on the table by the dish is important .
the bowl sitting on the chair on the street is cute .	the bowl sits on the chair on the street is cute .
the bag sitting by the rug on the floor is important .	the bag sits by the rug on the floor is important .
the window sitting by the ship by the crayon is boring .	the window sits by the ship by the crayon is boring .
the couch sitting by the bowl by the picture is small .	the couch sits by the bowl by the picture is small .
the bowl sitting in the park in the library is cold .	the bowl sits in the park in the library is cold .
the book sitting on the street in the park is yellow .	the book sits on the street in the park is yellow .
the ring sitting on the bed by the candle is orange .	the ring sits on the bed by the candle is orange .
the spoon sitting by the bicycle on the stool is cool .	the spoon sits by the bicycle on the stool is cool .
the spoon sitting in the school on the floor is brown .	the spoon sits in the school on the floor is brown .
the bed sitting in the school by the boat is missing .	the bed sits in the school by the boat is missing .
the truck sitting in the museum by the candle is black .	the truck sits in the museum by the candle is black .
the bottle sitting by the doll on the chair is orange .	the bottle sits by the doll on the chair is orange .
the bowl sitting by the doll in the school is broken .	the bowl sits by the doll in the school is broken .
the bicycle sitting on the bed by the chair is blue .	the bicycle sits on the bed by the chair is blue .
the fork sitting by the couch on the ground is cute .	the fork sits by the couch on the ground is cute .
the couch sitting on the stool by the glass is blue .	the couch sits on the stool by the glass is blue .
the couch sitting on the bed on the street is new .	the couch sits on the bed on the street is new .
the ship sitting by the bowl on the ground is fine .	the ship sits by the bowl on the ground is fine .
the toy sitting by the ship on the chair is cute .	the toy sits by the ship on the chair is cute .
the cup sitting in the school on the ground is white .	the cup sits in the school on the ground is white .
the toy sitting on the table in the library is amazing .	the toy sits on the table in the library is amazing .
the book sitting on the ground on the ground is orange .	the book sits on the ground on the ground is orange .
the door sitting on the bed by the boat is hot .	the door sits on the bed by the boat is hot .
the hat sitting by the doll in the museum is amazing .	the hat sits by the doll in the museum is amazing .
the picture sitting by the plane in the mall is orange .	the picture sits by the plane in the mall is orange .
the rug sitting in the museum in the school is big .	the rug sits in the museum in the school is big .
the couch sitting on the street in the museum is big .	the couch sits on the street in the museum is big .
the button sitting by the bag on the chair is expensive .	the button sits by the bag on the chair is expensive .
the shoe sitting by the plate by the plane is expensive .	the shoe sits by the plate by the plane is expensive .
the mirror sitting in the hospital in the park is small .	the mirror sits in the hospital in the park is small .
the plane sitting in the mall on the couch is black .	the plane sits in the mall on the couch is black .
the bowl sitting on the table in the school is yellow .	the bowl sits on the table in the school is yellow .
the mirror sitting in the bank in the library is old .	the mirror sits in the bank in the library is old .
the shirt sitting by the truck on the chair is red .	the shirt sits by the truck on the chair is red .
the cup sitting on the ground by the box is yellow .	the cup sits on the ground by the box is yellow .
the bag sitting in the hospital by the crayon is cute .	the bag sits in the hospital by the crayon is cute .
the plane sitting on the floor by the bicycle is fine .	the plane sits on the floor by the bicycle is fine .
the couch sitting in the room by the truck is expensive .	the couch sits in the room by the truck is expensive .
the car sitting by the shirt on the table is broken .	the car sits by the shirt on the table is broken .
the window sitting by the plate by the bed is broken .	the window sits by the plate by the bed is broken .
the door sitting in the hospital by the boat is dry .	the door sits in the hospital by the boat is dry .
the spoon sitting on the street by the cup is fine .	the spoon sits on the street by the cup is fine .
the fork sitting in the hospital on the ground is broken .	the fork sits in the hospital on the ground is broken .
the book sitting on the ground by the book is whole .	the book sits on the ground by the book is whole .
the shoe sitting in the restaurant in the library is cold .	the shoe sits in the restaurant in the library is cold .
the button sitting on the couch on the floor is green .	the button sits on the couch on the floor is green .
the rug sitting on the bed in the park is purple .	the rug sits on the bed in the park is purple .
the rocket sitting by the plate in the room is new .	the rocket sits by the plate in the room is new .
the ship sitting in the library on the street is missing .	the ship sits in the library on the street is missing .
the rug sitting by the crayon in the kitchen is missing .	the rug sits by the crayon in the kitchen is missing .
the fork sitting by the dish by the shirt is hot .	the fork sits by the dish by the shirt is hot .
the truck sitting on the table in the library is yellow .	the truck sits on the table in the library is yellow .
the crayon sitting on the ground on the chair is yellow .	the crayon sits on the ground on the chair is yellow .
the toy sitting on the stool by the ship is brown .	the toy sits on the stool by the ship is brown .
the button sitting on the floor on the bed is red .	the button sits on the floor on the bed is red .
the bottle sitting in the museum in the museum is hot .	the bottle sits in the museum in the museum is hot .
the bag sitting on the floor in the kitchen is dry .	the bag sits on the floor in the kitchen is dry .
the toy sitting on the table in the library is new .	the toy sits on the table in the library is new .
the picture sitting on the floor in the school is big .	the picture sits on the floor in the school is big .
the shirt sitting by the plane by the book is green .	the shirt sits by the plane by the book is green .
the shirt sitting on the floor on the chair is cool .	the shirt sits on the floor on the chair is cool .
the doll sitting in the library on the ground is small .	the doll sits in the library on the ground is small .
the ring sitting by the couch in the hospital is important .	the ring sits by the couch in the hospital is important .
the shirt sitting on the couch on the floor is expensive .	the shirt sits on the couch on the floor is expensive .
the shirt sitting by the button in the room is cool .	the shirt sits by the button in the room is cool .
the crayon sitting by the couch on the chair is missing .	the crayon sits by the couch on the chair is missing .
the candle sitting in the park in the museum is yellow .	the candle sits in the park in the museum is yellow .
the fork sitting on the chair in the mall is cool .	the fork sits on the chair in the mall is cool .
the car sitting by the hat by the picture is great .	the car sits by the hat by the picture is great .
the plate sitting in the school by the cup is missing .	the plate sits in the school by the cup is missing .
the box sitting in the bank by the fork is important .	the box sits in the bank by the fork is important .
the cup sitting on the ground in the restaurant is old .	the cup sits on the ground in the restaurant is old .
the shoe sitting in the school on the chair is cold .	the shoe sits in the school on the chair is cold .
the crayon sitting by the cup on the couch is big .	the crayon sits by the cup on the couch is big .
the candle sitting on the stool on the table is brown .	the candle sits on the stool on the table is brown .
the plate sitting in the kitchen in the mall is white .	the plate sits in the kitchen in the mall is white .
the book sitting by the truck in the library is purple .	the book sits by the truck in the library is purple .
the picture sitting by the bowl on the chair is orange .	the picture sits by the bowl on the chair is orange .
the plate sitting on the ground by the bowl is boring .	the plate sits on the ground by the bowl is boring .
the ship sitting in the school in the mall is gray .	the ship sits in the school in the mall is gray .
the toy sitting in the mall on the street is boring .	the toy sits in the mall on the street is boring .
the plane sitting in the park in the room is broken .	the plane sits in the park in the room is broken .
the doll sitting by the bicycle by the bottle is big .	the doll sits by the bicycle by the bottle is big .
the door sitting by the bottle by the mirror is cold .	the door sits by the bottle by the mirror is cold .
the shoe sitting by the cup by the car is important .	the shoe sits by the cup by the car is important .
the crayon sitting by the toy on the street is brown .	the crayon sits by the toy on the street is brown .
the box sitting on the street by the chair is cute .	the box sits on the street by the chair is cute .
the plate sitting on the stool by the spoon is broken .	the plate sits on the stool by the spoon is broken .
the hat sitting by the crayon on the couch is great .	the hat sits by the crayon on the couch is great .
the candle sitting by the plane on the ground is expensive .	the candle sits by the plane on the ground is expensive .
the dish sitting on the chair on the stool is yellow .	the dish sits on the chair on the stool is yellow .
the plane sitting in the school by the rug is white .	the plane sits in the school by the rug is white .
the fork sitting by the fork by the picture is fine .	the fork sits by the fork by the picture is fine .
the book sitting on the stool by the plane is black .	the book sits on the stool by the plane is black .
the glass sitting on the ground by the mirror is cold .	the glass sits on the ground by the mirror is cold .
the chair sitting in the museum on the couch is hot .	the chair sits in the museum on the couch is hot .
the window sitting on the table by the boat is gray .	the window sits on the table by the boat is gray .
the rug sitting by the doll by the window is orange .	the rug sits by the doll by the window is orange .
the bicycle sitting by the car in the bank is expensive .	the bicycle sits by the car in the bank is expensive .
the cup sitting in the room on the street is white .	the cup sits in the room on the street is white .
the glass sitting on the floor in the restaurant is amazing .	the glass sits on the floor in the restaurant is amazing .
the ring sitting in the restaurant on the couch is brown .	the ring sits in the restaurant on the couch is brown .
the picture sitting in the library on the ground is broken .	the picture sits in the library on the ground is broken .
the bag sitting on the bed in the restaurant is boring .	the bag sits on the bed in the restaurant is boring .
the shoe sitting on the couch in the kitchen is purple .	the shoe sits on the couch in the kitchen is purple .
the car sitting by the fork in the mall is whole .	the car sits by the fork in the mall is whole .
the glass sitting on the table on the stool is amazing .	the glass sits on the table on the stool is amazing .
the ring sitting on the street by the plane is orange .	the ring sits on the street by the plane is orange .
the shoe sitting by the bag in the school is green .	the shoe sits by the bag in the school is green .
the plane sitting in the museum on the floor is small .	the plane sits in the museum on the floor is small .
the fork sitting by the box in the restaurant is boring .	the fork sits by the box in the restaurant is boring .
the button sitting on the couch in the park is important .	the button sits on the couch in the park is important .
the bed sitting by the button by the candle is broken .	the bed sits by the button by the candle is broken .
the spoon sitting in the hospital on the table is gray .	the spoon sits in the hospital on the table is gray .
the dish sitting in the mall in the room is broken .	the dish sits in the mall in the room is broken .
the chair sitting in the school on the couch is white .	the chair sits in the school on the couch is white .
the ship sitting by the window in the hospital is purple .	the ship sits by the window in the hospital is purple .
the plane sitting on the street on the table is great .	the plane sits on the street on the table is great .
the bed sitting on the chair by the candle is big .	the bed sits on the chair by the candle is big .
the bowl sitting in the bank by the candle is black .	the bowl sits in the bank by the candle is black .
the candle sitting by the ship in the mall is hot .	the candle sits by the ship in the mall is hot .
the book sitting on the chair by the car is red .	the book sits on the chair by the car is red .
the bottle sitting in the school on the table is blue .	the bottle sits in the school on the table is blue .
the fork sitting by the crayon by the bowl is new .	the fork sits by the crayon by the bowl is new .
the shirt sitting in the library in the kitchen is fine .	the shirt sits in the library in the kitchen is fine .
the door sitting by the bicycle by the shirt is black .	the door sits by the bicycle by the shirt is black .
the picture sitting in the museum in the mall is cute .	the picture sits in the museum in the mall is cute .
the shoe sitting by the window by the book is hot .	the shoe sits by the window by the book is hot .
the ring sitting by the bicycle on the stool is cold .	the ring sits by the bicycle on the stool is cold .
the boat sitting in the park on the ground is white .	the boat sits in the park on the ground is white .
the plate sitting on the stool on the couch is purple .	the plate sits on the stool on the couch is purple .
the car sitting in the museum in the mall is blue .	the car sits in the museum in the mall is blue .
the cup sitting by the fork by the doll is awesome .	the cup sits by the fork by the doll is awesome .
the picture sitting on the chair on the couch is white .	the picture sits on the chair on the couch is white .
the plate sitting by the mirror by the shirt is hot .	the plate sits by the mirror by the shirt is hot .
the glass sitting by the button on the table is brown .	the glass sits by the button on the table is brown .
the door sitting in the kitchen by the glass is expensive .	the door sits in the kitchen by the glass is expensive .
the candle sitting by the button by the rocket is whole .	the candle sits by the button by the rocket is whole .
the rug sitting on the table in the school is amazing .	the rug sits on the table in the school is amazing .
the rocket sitting on the couch on the stool is old .	the rocket sits on the couch on the stool is old .
the hat sitting on the table by the box is old .	the hat sits on the table by the box is old .
the window sitting in the mall in the bank is big .	the window sits in the mall in the bank is big .
the book sitting by the car in the park is great .	the book sits by the car in the park is great .
the bed sitting on the table on the chair is old .	the bed sits on the table on the chair is old .
the shirt sitting on the bed in the park is big .	the shirt sits on the bed in the park is big .
the toy sitting by the car by the dish is yellow .	the toy sits by the car by the dish is yellow .
the doll sitting in the park by the book is hot .	the doll sits in the park by the book is hot .
the ship sitting in the museum on the table is green .	the ship sits in the museum on the table is green .
the book sitting in the school by the car is gray .	the book sits in the school by the car is gray .
the bag sitting in the school in the library is hot .	the bag sits in the school in the library is hot .
the plate sitting in the hospital on the bed is gray .	the plate sits in the hospital on the bed is gray .
the book sitting by the plane on the ground is cool .	the book sits by the plane on the ground is cool .
the fork sitting in the hospital in the school is brown .	the fork sits in the hospital in the school is brown .
the cup sitting by the button on the chair is awesome .	the cup sits by the button on the chair is awesome .
the car sitting on the street in the restaurant is boring .	the car sits on the street in the restaurant is boring .
the bicycle sitting on the floor on the couch is new .	the bicycle sits on the floor on the couch is new .
the bag sitting on the ground by the glass is white .	the bag sits on the ground by the glass is white .
the ship sitting in the mall in the kitchen is cold .	the ship sits in the mall in the kitchen is cold .
the car sitting by the boat by the window is broken .	the car sits by the boat by the window is broken .
the box sitting on the couch by the bag is big .	the box sits on the couch by the bag is big .
the dish sitting in the hospital by the bowl is yellow .	the dish sits in the hospital by the bowl is yellow .
the bicycle sitting by the plane in the mall is white .	the bicycle sits by the plane in the mall is white .
the hat sitting on the couch by the chair is boring .	the hat sits on the couch by the chair is boring .
the bed sitting on the ground in the library is red .	the bed sits on the ground in the library is red .
the car sitting on the chair on the bed is yellow .	the car sits on the chair on the bed is yellow .
the ring sitting by the crayon by the box is brown .	the ring sits by the crayon by the box is brown .
the plane sitting by the doll in the park is cold .	the plane sits by the doll in the park is cold .
the book sitting in the museum by the bed is boring .	the book sits in the museum by the bed is boring .
the window sitting on the table on the chair is fine .	the window sits on the table on the chair is fine .
the candle sitting on the floor by the rug is gray .	the candle sits on the floor by the rug is gray .
the spoon sitting by the plane in the bank is broken .	the spoon sits by the plane in the bank is broken .
the car sitting on the bed in the mall is cold .	the car sits on the bed in the mall is cold .
the picture sitting in the school by the plate is dry .	the picture sits in the school by the plate is dry .
the chair sitting by the window in the school is broken .	the chair sits by the window in the school is broken .
the boat sitting by the rocket on the table is brown .	the boat sits by the rocket on the table is brown .
the bicycle sitting by the boat on the table is amazing .	the bicycle sits by the boat on the table is amazing .
the box sitting on the ground in the museum is big .	the box sits on the ground in the museum is big .
the fork sitting in the mall by the toy is orange .	the fork sits in the mall by the toy is orange .
the box sitting by the glass by the crayon is amazing .	the box sits by the glass by the crayon is amazing .
the hat sitting by the spoon in the library is expensive .	the hat sits by the spoon in the library is expensive .
the shoe sitting in the hospital by the box is cool .	the shoe sits in the hospital by the box is cool .
the rug sitting by the chair on the stool is hot .	the rug sits by the chair on the stool is hot .
the crayon sitting on the street on the bed is expensive .	the crayon sits on the street on the bed is expensive .
the picture sitting on the chair by the car is boring .	the picture sits on the chair by the car is boring .
the couch sitting on the couch in the museum is small .	the couch sits on the couch in the museum is small .
the bottle sitting by the rocket on the floor is cold .	the bottle sits by the rocket on the floor is cold .
the box sitting on the floor on the stool is amazing .	the box sits on the floor on the stool is amazing .
the candle sitting on the bed in the bank is broken .	the candle sits on the bed in the bank is broken .
the shirt sitting in the library on the street is gray .	the shirt sits in the library on the street is gray .
the truck sitting in the mall by the toy is boring .	the truck sits in the mall by the toy is boring .
the door sitting by the shirt on the table is gray .	the door sits by the shirt on the table is gray .
the picture sitting in the school in the park is old .	the picture sits in the school in the park is old .
the shoe sitting in the museum by the fork is white .	the shoe sits in the museum by the fork is white .
the bag sitting in the school by the button is cool .	the bag sits in the school by the button is cool .
the rug sitting on the street in the mall is missing .	the rug sits on the street in the mall is missing .
the couch sitting on the table by the bag is fine .	the couch sits on the table by the bag is fine .
the chair sitting by the bowl on the floor is green .	the chair sits by the bowl on the floor is green .
the bicycle sitting on the street in the kitchen is yellow .	the bicycle sits on the street in the kitchen is yellow .
the hat sitting on the chair on the street is big .	the hat sits on the chair on the street is big .
the plate sitting on the bed in the hospital is whole .	the plate sits on the bed in the hospital is whole .
the hat sitting in the bank in the room is awesome .	the hat sits in the bank in the room is awesome .
the doll sitting by the fork on the bed is broken .	the doll sits by the fork on the bed is broken .
the book sitting on the street by the spoon is red .	the book sits on the street by the spoon is red .
the bottle sitting on the couch on the bed is missing .	the bottle sits on the couch on the bed is missing .
the door sitting in the library in the room is gray .	the door sits in the library in the room is gray .
the crayon sitting in the park on the ground is small .	the crayon sits in the park on the ground is small .
the ship sitting on the chair by the bowl is boring .	the ship sits on the chair by the bowl is boring .
the car sitting on the couch on the couch is blue .	the car sits on the couch on the couch is blue .
the chair sitting in the museum in the mall is black .	the chair sits in the museum in the mall is black .
the fork sitting in the school by the button is blue .	the fork sits in the school by the button is blue .
the dish sitting by the bowl by the couch is important .	the dish sits by the bowl by the couch is important .
the bag sitting in the hospital on the stool is new .	the bag sits in the hospital on the stool is new .
the picture sitting in the park on the ground is green .	the picture sits in the park on the ground is green .
the bicycle sitting on the chair by the bag is fine .	the bicycle sits on the chair by the bag is fine .
the shirt sitting in the restaurant on the couch is hot .	the shirt sits in the restaurant on the couch is hot .
the crayon sitting by the fork on the bed is important .	the crayon sits by the fork on the bed is important .
the bowl sitting on the chair in the museum is hot .	the bowl sits on the chair in the museum is hot .
the spoon sitting in the hospital by the hat is green .	the spoon sits in the hospital by the hat is green .
the plate sitting in the room in the bank is expensive .	the plate sits in the room in the bank is expensive .
the toy sitting by the bag in the bank is whole .	the toy sits by the bag in the bank is whole .
the glass sitting by the ring in the restaurant is green .	the glass sits by the ring in the restaurant is green .
the door sitting on the bed on the floor is great .	the door sits on the bed on the floor is great .
the bicycle sitting in the park by the shoe is white .	the bicycle sits in the park by the shoe is white .
the truck sitting by the couch by the couch is cute .	the truck sits by the couch by the couch is cute .
the ship sitting by the shirt in the room is purple .	the ship sits by the shirt in the room is purple .
the book sitting on the bed in the park is great .	the book sits on the bed in the park is great .
the shirt sitting in the bank in the school is green .	the shirt sits in the bank in the school is green .
the book sitting on the couch by the window is red .	the book sits on the couch by the window is red .
the shirt sitting in the library in the museum is broken .	the shirt sits in the library in the museum is broken .
the dish sitting by the shirt on the bed is great .	the dish sits by the shirt on the bed is great .
the bicycle sitting by the crayon by the ship is amazing .	the bicycle sits by the crayon by the ship is amazing .
the window sitting by the crayon by the glass is cool .	the window sits by the crayon by the glass is cool .
the book sitting in the kitchen on the ground is boring .	the book sits in the kitchen on the ground is boring .
the mirror sitting on the stool on the street is small .	the mirror sits on the stool on the street is small .
the couch sitting on the couch on the street is missing .	the couch sits on the couch on the street is missing .
the window sitting on the street in the bank is brown .	the window sits on the street in the bank is brown .
the truck sitting in the kitchen by the candle is cute .	the truck sits in the kitchen by the candle is cute .
the ring sitting on the floor in the mall is gray .	the ring sits on the floor in the mall is gray .
the car sitting on the stool by the cup is boring .	the car sits on the stool by the cup is boring .
the ship sitting by the mirror in the museum is great .	the ship sits by the mirror in the museum is great .
the ship sitting on the ground on the floor is expensive .	the ship sits on the ground on the floor is expensive .
the doll sitting in the hospital in the mall is red .	the doll sits in the hospital in the mall is red .
the car sitting by the crayon on the chair is cold .	the car sits by the crayon on the chair is cold .
the bicycle sitting by the plate in the mall is great .	the bicycle sits by the plate in the mall is great .
the doll sitting on the table in the library is new .	the doll sits on the table in the library is new .
the rug sitting by the picture on the chair is important .	the rug sits by the picture on the chair is important .
the door sitting on the chair by the boat is gray .	the door sits on the chair by the boat is gray .
the car sitting in the museum in the bank is black .	the car sits in the museum in the bank is black .
the doll sitting on the couch on the chair is big .	the doll sits on the couch on the chair is big .
the chair sitting on the stool on the stool is broken .	the chair sits on the stool on the stool is broken .
the candle sitting in the museum in the school is gray .	the candle sits in the museum in the school is gray .
the door sitting in the kitchen by the plate is missing .	the door sits in the kitchen by the plate is missing .
the cup sitting on the bed on the ground is blue .	the cup sits on the bed on the ground is blue .
the bicycle sitting on the table in the school is important .	the bicycle sits on the table in the school is important .
the window sitting on the bed in the kitchen is amazing .	the window sits on the bed in the kitchen is amazing .
the hat sitting in the library in the restaurant is hot .	the hat sits in the library in the restaurant is hot .
the bottle sitting by the hat in the restaurant is yellow .	the bottle sits by the hat in the restaurant is yellow .
the plane sitting on the floor in the park is dry .	the plane sits on the floor in the park is dry .
the mirror sitting in the kitchen on the floor is whole .	the mirror sits in the kitchen on the floor is whole .
the chair sitting by the boat by the ring is missing .	the chair sits by the boat by the ring is missing .
the dish sitting in the hospital in the park is fine .	the dish sits in the hospital in the park is fine .
the plate sitting by the fork on the couch is cute .	the plate sits by the fork on the couch is cute .
the boat sitting on the table by the bottle is white .	the boat sits on the table by the bottle is white .
the candle sitting by the car in the museum is cute .	the candle sits by the car in the museum is cute .
the chair sitting in the park on the floor is brown .	the chair sits in the park on the floor is brown .
the truck sitting on the couch by the car is awesome .	the truck sits on the couch by the car is awesome .
the cup sitting in the restaurant by the ship is red .	the cup sits in the restaurant by the ship is red .
the rug sitting by the truck in the bank is amazing .	the rug sits by the truck in the bank is amazing .
the fork sitting by the bag in the school is missing .	the fork sits by the bag in the school is missing .
the couch sitting on the couch on the couch is yellow .	the couch sits on the couch on the couch is yellow .
the candle sitting on the ground on the ground is orange .	the candle sits on the ground on the ground is orange .
the boat sitting by the rug on the table is orange .	the boat sits by the rug on the table is orange .
the car sitting in the park by the plane is important .	the car sits in the park by the plane is important .
the bowl sitting on the stool on the floor is amazing .	the bowl sits on the stool on the floor is amazing .
the mirror sitting by the car in the room is broken .	the mirror sits by the car in the room is broken .
the cup sitting on the street on the chair is black .	the cup sits on the street on the chair is black .
the candle sitting on the floor on the floor is orange .	the candle sits on the floor on the floor is orange .
the car sitting on the ground in the mall is cold .	the car sits on the ground in the mall is cold .
the couch sitting on the street by the shirt is yellow .	the couch sits on the street by the shirt is yellow .
the button sitting on the bed on the floor is cold .	the button sits on the bed on the floor is cold .
the ring sitting by the truck in the bank is cute .	the ring sits by the truck in the bank is cute .
the picture sitting in the library in the mall is orange .	the picture sits in the library in the mall is orange .
the dish sitting on the couch in the bank is red .	the dish sits on the couch in the bank is red .
the fork sitting by the bed in the park is important .	the fork sits by the bed in the park is important .
the shirt sitting in the school in the room is dry .	the shirt sits in the school in the room is dry .
the bag sitting by the car on the couch is orange .	the bag sits by the car on the couch is orange .
the chair sitting by the crayon by the car is fine .	the chair sits by the crayon by the car is fine .
the truck sitting on the couch by the shirt is important .	the truck sits on the couch by the shirt is important .
the dish sitting by the box in the room is fine .	the dish sits by the box in the room is fine .
the couch sitting on the ground on the bed is orange .	the couch sits on the ground on the bed is orange .
the car sitting in the hospital in the hospital is small .	the car sits in the hospital in the hospital is small .
the dish sitting on the bed by the chair is expensive .	the dish sits on the bed by the chair is expensive .
the mirror sitting on the table in the hospital is missing .	the mirror sits on the table in the hospital is missing .
the button sitting in the bank on the ground is awesome .	the button sits in the bank on the ground is awesome .
the fork sitting by the spoon on the ground is cold .	the fork sits by the spoon on the ground is cold .
the toy sitting on the table by the truck is small .	the toy sits on the table by the truck is small .
the dish sitting in the park in the school is red .	the dish sits in the park in the school is red .
the glass sitting in the park in the library is great .	the glass sits in the park in the library is great .
the boat sitting on the couch on the street is important .	the boat sits on the couch on the street is important .
the shoe sitting on the street on the ground is important .	the shoe sits on the street on the ground is important .
the box sitting by the truck on the street is white .	the box sits by the truck on the street is white .
the shoe sitting by the car on the bed is green .	the shoe sits by the car on the bed is green .
the toy sitting by the cup in the museum is gray .	the toy sits by the cup in the museum is gray .
the car sitting on the street on the bed is orange .	the car sits on the street on the bed is orange .
the shoe sitting by the truck in the room is great .	the shoe sits by the truck in the room is great .
the bag sitting on the chair in the room is purple .	the bag sits on the chair in the room is purple .
the window sitting on the ground in the room is cute .	the window sits on the ground in the room is cute .
the glass sitting by the ring in the restaurant is old .	the glass sits by the ring in the restaurant is old .
the car sitting by the truck in the kitchen is gray .	the car sits by the truck in the kitchen is gray .
the plane sitting by the couch by the car is boring .	the plane sits by the couch by the car is boring .
the doll sitting by the plate by the doll is fine .	the doll sits by the plate by the doll is fine .
the hat sitting by the boat on the floor is orange .	the hat sits by the boat on the floor is orange .
the truck sitting in the museum in the bank is cool .	the truck sits in the museum in the bank is cool .
the fork sitting by the door by the dish is awesome .	the fork sits by the door by the dish is awesome .
the dish sitting on the street in the restaurant is great .	the dish sits on the street in the restaurant is great .
the door sitting by the bag on the chair is red .	the door sits by the bag on the chair is red .
the box sitting in the room in the library is green .	the box sits in the room in the library is green .
the rug sitting on the table in the room is brown .	the rug sits on the table in the room is brown .
the doll sitting by the bag by the fork is expensive .	the doll sits by the bag by the fork is expensive .
the crayon sitting on the street on the couch is boring .	the crayon sits on the street on the couch is boring .
the bag sitting by the button in the hospital is great .	the bag sits by the button in the hospital is great .
the bag sitting by the candle by the toy is big .	the bag sits by the candle by the toy is big .
the box sitting by the window by the mirror is orange .	the box sits by the window by the mirror is orange .
the rocket sitting in the museum by the window is red .	the rocket sits in the museum by the window is red .
the chair sitting by the window by the truck is gray .	the chair sits by the window by the truck is gray .
the bowl sitting by the mirror in the kitchen is cold .	the bowl sits by the mirror in the kitchen is cold .
the cup sitting in the restaurant by the toy is boring .	the cup sits in the restaurant by the toy is boring .
the mirror sitting on the floor by the shirt is cute .	the mirror sits on the floor by the shirt is cute .
the dish sitting by the toy on the bed is blue .	the dish sits by the toy on the bed is blue .
the plane sitting on the stool by the ring is purple .	the plane sits on the stool by the ring is purple .
the glass sitting by the car on the chair is gray .	the glass sits by the car on the chair is gray .
the ring sitting by the cup on the couch is whole .	the ring sits by the cup on the couch is whole .
the chair sitting in the restaurant on the stool is great .	the chair sits in the restaurant on the stool is great .
the button sitting in the bank on the table is hot .	the button sits in the bank on the table is hot .
the plane sitting on the stool on the street is green .	the plane sits on the stool on the street is green .
the chair sitting in the room by the mirror is important .	the chair sits in the room by the mirror is important .
the bed sitting on the ground by the ship is hot .	the bed sits on the ground by the ship is hot .
the bag sitting on the stool in the school is new .	the bag sits on the stool in the school is new .
the book sitting in the library in the bank is cute .	the book sits in the library in the bank is cute .
the door sitting by the cup on the chair is cold .	the door sits by the cup on the chair is cold .
the candle sitting by the glass on the chair is black .	the candle sits by the glass on the chair is black .
the plane sitting on the ground on the stool is cool .	the plane sits on the ground on the stool is cool .
the bowl sitting by the plate on the bed is cool .	the bowl sits by the plate on the bed is cool .
the book sitting on the couch on the ground is amazing .	the book sits on the couch on the ground is amazing .
the door sitting on the stool in the mall is yellow .	the door sits on the stool in the mall is yellow .
the ship sitting on the street on the ground is new .	the ship sits on the street on the ground is new .
the shirt sitting in the kitchen by the hat is new .	the shirt sits in the kitchen by the hat is new .
the fork sitting on the street in the school is orange .	the fork sits on the street in the school is orange .
the ring sitting in the library in the restaurant is awesome .	the ring sits in the library in the restaurant is awesome .
the book sitting in the museum on the chair is orange .	the book sits in the museum on the chair is orange .
the bed sitting in the library by the car is big .	the bed sits in the library by the car is big .
the bicycle sitting by the ring in the bank is important .	the bicycle sits by the ring in the bank is important .
the car sitting by the toy in the park is red .	the car sits by the toy in the park is red .
the ship sitting on the table in the restaurant is great .	the ship sits on the table in the restaurant is great .
the cup sitting by the book on the street is old .	the cup sits by the book on the street is old .
the window sitting on the floor by the toy is green .	the window sits on the floor by the toy is green .
the boat sitting on the chair by the shoe is whole .	the boat sits on the chair by the shoe is whole .
the shirt sitting in the park on the couch is expensive .	the shirt sits in the park on the couch is expensive .
the candle sitting on the ground in the hospital is old .	the candle sits on the ground in the hospital is old .
the shirt sitting in the school by the plate is small .	the shirt sits in the school by the plate is small .
the window sitting in the school by the shirt is cute .	the window sits in the school by the shirt is cute .
the glass sitting on the street in the museum is fine .	the glass sits on the street in the museum is fine .
the ship sitting in the library on the stool is blue .	the ship sits in the library on the stool is blue .
the spoon sitting by the bowl by the book is old .	the spoon sits by the bowl by the book is old .
the plate sitting on the street by the ship is fine .	the plate sits on the street by the ship is fine .
the chair sitting in the park on the street is small .	the chair sits in the park on the street is small .
the crayon sitting by the spoon on the table is white .	the crayon sits by the spoon on the table is white .
the bed sitting on the table on the ground is cute .	the bed sits on the table on the ground is cute .
the mirror sitting in the hospital by the chair is awesome .	the mirror sits in the hospital by the chair is awesome .
the ship sitting by the dish by the mirror is cute .	the ship sits by the dish by the mirror is cute .
the fork sitting on the ground in the park is big .	the fork sits on the ground in the park is big .
the bag sitting on the street by the car is whole .	the bag sits on the street by the car is whole .
the truck sitting on the ground by the rug is black .	the truck sits on the ground by the rug is black .
the button sitting in the restaurant on the floor is new .	the button sits in the restaurant on the floor is new .
the shoe sitting in the library by the glass is whole .	the shoe sits in the library by the glass is whole .
the candle sitting on the table by the hat is important .	the candle sits on the table by the hat is important .
the car sitting by the truck in the restaurant is missing .	the car sits by the truck in the restaurant is missing .
the cup sitting in the library in the mall is amazing .	the cup sits in the library in the mall is amazing .
the shoe sitting in the hospital by the book is yellow .	the shoe sits in the hospital by the book is yellow .
the bicycle sitting on the floor in the mall is whole .	the bicycle sits on the floor in the mall is whole .
the bowl sitting by the shirt by the car is expensive .	the bowl sits by the shirt by the car is expensive .
the rocket sitting by the bicycle in the museum is cute .	the rocket sits by the bicycle in the museum is cute .
the shirt sitting in the school by the picture is black .	the shirt sits in the school by the picture is black .
the truck sitting in the mall on the ground is amazing .	the truck sits in the mall on the ground is amazing .
the rocket sitting on the couch on the chair is big .	the rocket sits on the couch on the chair is big .
the rug sitting by the button in the room is brown .	the rug sits by the button in the room is brown .
the crayon sitting by the glass by the ship is missing .	the crayon sits by the glass by the ship is missing .
the fork sitting by the picture by the toy is orange .	the fork sits by the picture by the toy is orange .
the glass sitting by the rocket in the museum is cool .	the glass sits by the rocket in the museum is cool .
the ship sitting on the chair by the rug is important .	the ship sits on the chair by the rug is important .
the rocket sitting by the candle on the table is old .	the rocket sits by the candle on the table is old .
the dish sitting by the bicycle by the picture is old .	the dish sits by the bicycle by the picture is old .
the chair sitting by the ship in the park is big .	the chair sits by the ship in the park is big .
the chair sitting by the chair on the bed is red .	the chair sits by the chair on the bed is red .
the book sitting in the museum in the park is old .	the book sits in the museum in the park is old .
the crayon sitting by the bowl in the museum is great .	the crayon sits by the bowl in the museum is great .
the glass sitting by the bag on the chair is fine .	the glass sits by the bag on the chair is fine .
the plate sitting by the ship by the dish is boring .	the plate sits by the ship by the dish is boring .
the door sitting on the floor on the floor is yellow .	the door sits on the floor on the floor is yellow .
the boat sitting by the ship on the bed is brown .	the boat sits by the ship on the bed is brown .
the shirt sitting by the ring by the bag is dry .	the shirt sits by the ring by the bag is dry .
the car sitting on the street on the table is new .	the car sits on the street on the table is new .
the box sitting by the cup in the mall is small .	the box sits by the cup in the mall is small .
the rug sitting in the library on the chair is missing .	the rug sits in the library on the chair is missing .
the mirror sitting by the bag by the toy is awesome .	the mirror sits by the bag by the toy is awesome .
the bag sitting in the bank on the street is gray .	the bag sits in the bank on the street is gray .
the mirror sitting by the window in the school is great .	the mirror sits by the window in the school is great .
the car sitting on the chair on the ground is fine .	the car sits on the chair on the ground is fine .
the bottle sitting on the ground on the bed is dry .	the bottle sits on the ground on the bed is dry .
the book sitting in the library by the bowl is small .	the book sits in the library by the bowl is small .
the mirror sitting on the table by the rug is purple .	the mirror sits on the table by the rug is purple .
the plate sitting by the glass on the chair is broken .	the plate sits by the glass on the chair is broken .
the hat sitting in the room on the couch is black .	the hat sits in the room on the couch is black .
the plane sitting by the plane in the library is small .	the plane sits by the plane in the library is small .
the rug sitting by the spoon in the mall is red .	the rug sits by the spoon in the mall is red .
the dish sitting by the shirt in the hospital is great .	the dish sits by the shirt in the hospital is great .
the truck sitting on the chair on the bed is gray .	the truck sits on the chair on the bed is gray .
the couch sitting in the museum by the book is old .	the couch sits in the museum by the book is old .
the crayon sitting in the mall by the crayon is purple .	the crayon sits in the mall by the crayon is purple .
the car sitting on the floor by the rocket is white .	the car sits on the floor by the rocket is white .
the door sitting on the couch by the book is green .	the door sits on the couch by the book is green .
the window sitting on the stool by the bowl is expensive .	the window sits on the stool by the bowl is expensive .
the bottle sitting on the stool on the couch is whole .	the bottle sits on the stool on the couch is whole .
the crayon sitting in the park by the dish is great .	the crayon sits in the park by the dish is great .
the couch sitting by the car by the bowl is gray .	the couch sits by the car by the bowl is gray .
the window sitting on the floor in the bank is green .	the window sits on the floor in the bank is green .
the book sitting on the bed on the stool is dry .	the book sits on the bed on the stool is dry .
the ring sitting in the school in the museum is yellow .	the ring sits in the school in the museum is yellow .
the boat sitting by the bicycle on the bed is yellow .	the boat sits by the bicycle on the bed is yellow .
the shoe sitting on the bed on the street is whole .	the shoe sits on the bed on the street is whole .
the bag sitting on the couch by the dish is hot .	the bag sits on the couch by the dish is hot .
the doll sitting on the chair on the chair is hot .	the doll sits on the chair on the chair is hot .
the bed sitting on the couch on the couch is orange .	the bed sits on the couch on the couch is orange .
the plane sitting by the couch on the ground is dry .	the plane sits by the couch on the ground is dry .
the rug sitting in the library in the school is small .	the rug sits in the library in the school is small .
the hat sitting by the door on the floor is red .	the hat sits by the door on the floor is red .
the picture sitting on the floor by the bag is awesome .	the picture sits on the floor by the bag is awesome .
the shirt sitting on the table by the rug is awesome .	the shirt sits on the table by the rug is awesome .
the mirror sitting on the stool on the stool is amazing .	the mirror sits on the stool on the stool is amazing .
the chair sitting in the mall by the cup is blue .	the chair sits in the mall by the cup is blue .
the shirt sitting in the restaurant on the floor is new .	the shirt sits in the restaurant on the floor is new .
the ship sitting in the park by the dish is boring .	the ship sits in the park by the dish is boring .
the ring sitting on the table by the crayon is cold .	the ring sits on the table by the crayon is cold .
the bottle sitting in the room by the car is whole .	the bottle sits in the room by the car is whole .
the glass sitting on the table on the stool is missing .	the glass sits on the table on the stool is missing .
the window sitting on the floor on the ground is yellow .	the window sits on the floor on the ground is yellow .
the rocket sitting by the car in the room is red .	the rocket sits by the car in the room is red .
the hat sitting in the school in the room is awesome .	the hat sits in the school in the room is awesome .
the bed sitting by the cup in the restaurant is yellow .	the bed sits by the cup in the restaurant is yellow .
the rocket sitting on the table by the chair is small .	the rocket sits on the table by the chair is small .
the ship sitting on the street in the hospital is dry .	the ship sits on the street in the hospital is dry .
the bottle sitting on the couch on the floor is red .	the bottle sits on the couch on the floor is red .
the mirror sitting in the kitchen in the school is hot .	the mirror sits in the kitchen in the school is hot .
the fork sitting on the bed by the truck is orange .	the fork sits on the bed by the truck is orange .
the couch sitting by the truck in the park is blue .	the couch sits by the truck in the park is blue .
the chair sitting in the hospital by the ship is awesome .	the chair sits in the hospital by the ship is awesome .
the door sitting by the picture by the truck is black .	the door sits by the picture by the truck is black .
the spoon sitting on the ground in the park is hot .	the spoon sits on the ground in the park is hot .
the truck sitting by the ring by the shirt is cool .	the truck sits by the ring by the shirt is cool .
the candle sitting by the glass on the couch is awesome .	the candle sits by the glass on the couch is awesome .
the plane sitting on the chair on the table is gray .	the plane sits on the chair on the table is gray .
the bicycle sitting in the school by the rocket is green .	the bicycle sits in the school by the rocket is green .
the car sitting in the bank in the library is orange .	the car sits in the bank in the library is orange .
the rug sitting on the ground in the school is orange .	the rug sits on the ground in the school is orange .
the mirror sitting in the library by the crayon is green .	the mirror sits in the library by the crayon is green .
the glass sitting on the chair on the couch is yellow .	the glass sits on the chair on the couch is yellow .
the book sitting in the museum in the mall is cold .	the book sits in the museum in the mall is cold .
the plane sitting by the car by the ship is gray .	the plane sits by the car by the ship is gray .
the plate sitting by the fork by the chair is yellow .	the plate sits by the fork by the chair is yellow .
the candle sitting on the ground on the floor is gray .	the candle sits on the ground on the floor is gray .
the bottle sitting on the table by the candle is green .	the bottle sits on the table by the candle is green .
the glass sitting on the couch in the museum is cute .	the glass sits on the couch in the museum is cute .
the couch sitting in the restaurant in the mall is missing .	the couch sits in the restaurant in the mall is missing .
the shirt sitting in the park on the floor is red .	the shirt sits in the park on the floor is red .
the bed sitting by the chair on the floor is dry .	the bed sits by the chair on the floor is dry .
the ship sitting by the book by the bowl is cute .	the ship sits by the book by the bowl is cute .
the book sitting by the toy on the table is blue .	the book sits by the toy on the table is blue .
the boat sitting by the book on the street is black .	the boat sits by the book on the street is black .
the car sitting in the hospital by the mirror is broken .	the car sits in the hospital by the mirror is broken .
the shoe sitting in the school on the couch is cold .	the shoe sits in the school on the couch is cold .
the shirt sitting by the plane by the rug is cold .	the shirt sits by the plane by the rug is cold .
the window sitting in the mall by the plate is great .	the window sits in the mall by the plate is great .
the couch sitting in the restaurant by the bed is brown .	the couch sits in the restaurant by the bed is brown .
the picture sitting by the dish by the mirror is old .	the picture sits by the dish by the mirror is old .
the candle sitting on the ground by the truck is small .	the candle sits on the ground by the truck is small .
the box sitting in the kitchen in the museum is purple .	the box sits in the kitchen in the museum is purple .
the book sitting on the street in the room is important .	the book sits on the street in the room is important .
the truck sitting by the car on the bed is dry .	the truck sits by the car on the bed is dry .
the picture sitting in the school on the table is purple .	the picture sits in the school on the table is purple .
the mirror sitting on the ground in the room is gray .	the mirror sits on the ground in the room is gray .
the book sitting in the room in the school is important .	the book sits in the room in the school is important .
the door sitting on the bed in the museum is missing .	the door sits on the bed in the museum is missing .
the window sitting in the bank by the rocket is yellow .	the window sits in the bank by the rocket is yellow .
the truck sitting in the mall by the window is blue .	the truck sits in the mall by the window is blue .
the book sitting on the couch on the ground is broken .	the book sits on the couch on the ground is broken .
the bag sitting on the bed in the hospital is black .	the bag sits on the bed in the hospital is black .
the rocket sitting on the ground on the floor is amazing .	the rocket sits on the ground on the floor is amazing .
the candle sitting in the school on the chair is whole .	the candle sits in the school on the chair is whole .
the fork sitting by the fork in the bank is missing .	the fork sits by the fork in the bank is missing .
the candle sitting on the ground on the street is green .	the candle sits on the ground on the street is green .
the toy sitting in the library by the window is whole .	the toy sits in the library by the window is whole .
the bottle sitting in the kitchen by the ring is yellow .	the bottle sits in the kitchen by the ring is yellow .
the bed sitting by the hat in the museum is blue .	the bed sits by the hat in the museum is blue .
the candle sitting by the hat in the library is great .	the candle sits by the hat in the library is great .
the button sitting on the street on the floor is dry .	the button sits on the street on the floor is dry .
the door sitting on the stool on the floor is blue .	the door sits on the stool on the floor is blue .
the shirt sitting in the park on the table is new .	the shirt sits in the park on the table is new .
the window sitting by the boat on the couch is dry .	the window sits by the boat on the couch is dry .
the truck sitting in the library by the crayon is brown .	the truck sits in the library by the crayon is brown .
the button sitting by the chair on the stool is red .	the button sits by the chair on the stool is red .
the dish sitting by the box on the ground is orange .	the dish sits by the box on the ground is orange .
the rug sitting on the chair in the park is yellow .	the rug sits on the chair in the park is yellow .
the rug sitting in the park on the chair is blue .	the rug sits in the park on the chair is blue .
the book sitting by the ring on the chair is important .	the book sits by the ring on the chair is important .
the bowl sitting in the park on the street is expensive .	the bowl sits in the park on the street is expensive .
the ring sitting on the chair by the rug is red .	the ring sits on the chair by the rug is red .
the crayon sitting on the ground in the museum is cute .	the crayon sits on the ground in the museum is cute .
the chair sitting by the book on the stool is important .	the chair sits by the book on the stool is important .
the box sitting on the stool by the bicycle is brown .	the box sits on the stool by the bicycle is brown .
the box sitting on the floor on the table is dry .	the box sits on the floor on the table is dry .
the car sitting by the bicycle on the couch is gray .	the car sits by the bicycle on the couch is gray .
the ring sitting by the bed on the ground is great .	the ring sits by the bed on the ground is great .
the shirt sitting on the bed by the picture is fine .	the shirt sits on the bed by the picture is fine .
the crayon sitting on the street by the shirt is broken .	the crayon sits on the street by the shirt is broken .
the glass sitting by the chair in the museum is amazing .	the glass sits by the chair in the museum is amazing .
the cup sitting by the spoon by the candle is gray .	the cup sits by the spoon by the candle is gray .
the mirror sitting on the ground by the door is broken .	the mirror sits on the ground by the door is broken .
the rug sitting in the mall on the chair is green .	the rug sits in the mall on the chair is green .
the bed sitting by the boat by the dish is boring .	the bed sits by the boat by the dish is boring .
the mirror sitting on the street by the book is new .	the mirror sits on the street by the book is new .
the toy sitting by the car on the street is big .	the toy sits by the car on the street is big .
the cup sitting by the window by the shoe is cute .	the cup sits by the window by the shoe is cute .
the boat sitting by the bed by the button is hot .	the boat sits by the bed by the button is hot .
the car sitting in the museum in the mall is dry .	the car sits in the museum in the mall is dry .
the cup sitting on the couch in the room is orange .	the cup sits on the couch in the room is orange .
the toy sitting on the couch by the plane is green .	the toy sits on the couch by the plane is green .
the book sitting by the bed by the fork is amazing .	the book sits by the bed by the fork is amazing .
the bicycle sitting in the park in the museum is broken .	the bicycle sits in the park in the museum is broken .
the crayon sitting on the floor on the street is gray .	the crayon sits on the floor on the street is gray .
the cup sitting by the plane by the plane is cute .	the cup sits by the plane by the plane is cute .
the bicycle sitting in the restaurant by the doll is brown .	the bicycle sits in the restaurant by the doll is brown .
the crayon sitting in the kitchen by the plane is orange .	the crayon sits in the kitchen by the plane is orange .
the couch sitting on the couch in the school is green .	the couch sits on the couch in the school is green .
the bag sitting by the couch on the chair is cute .	the bag sits by the couch on the chair is cute .
the window sitting on the chair on the bed is missing .	the window sits on the chair on the bed is missing .
the rocket sitting in the school by the doll is gray .	the rocket sits in the school by the doll is gray .
the book sitting by the shirt on the chair is awesome .	the book sits by the shirt on the chair is awesome .
the bottle sitting by the bed in the room is purple .	the bottle sits by the bed in the room is purple .
the glass sitting by the boat by the candle is purple .	the glass sits by the boat by the candle is purple .
the chair sitting by the mirror on the ground is whole .	the chair sits by the mirror on the ground is whole .
the hat sitting on the table by the car is purple .	the hat sits on the table by the car is purple .
the bottle sitting on the chair on the ground is old .	the bottle sits on the chair on the ground is old .
the plate sitting by the crayon by the bed is broken .	the plate sits by the crayon by the bed is broken .
the spoon sitting in the room on the couch is black .	the spoon sits in the room on the couch is black .
the book sitting by the shoe by the glass is blue .	the book sits by the shoe by the glass is blue .
the hat sitting by the rocket in the kitchen is small .	the hat sits by the rocket in the kitchen is small .
the boat sitting on the stool on the couch is red .	the boat sits on the stool on the couch is red .
the mirror sitting by the bottle on the couch is whole .	the mirror sits by the bottle on the couch is whole .
the bicycle sitting by the truck on the street is small .	the bicycle sits by the truck on the street is small .
the crayon sitting on the stool on the stool is black .	the crayon sits on the stool on the stool is black .
the door sitting by the chair on the couch is black .	the door sits by the chair on the couch is black .
the chair sitting on the street on the table is red .	the chair sits on the street on the table is red .
the bed sitting on the table on the ground is missing .	the bed sits on the table on the ground is missing .
the book sitting on the floor on the bed is new .	the book sits on the floor on the bed is new .
the shirt sitting on the ground in the kitchen is purple .	the shirt sits on the ground in the kitchen is purple .
the picture sitting by the bed by the box is important .	the picture sits by the bed by the box is important .
the ship sitting by the ring by the ring is important .	the ship sits by the ring by the ring is important .
the box sitting in the library in the kitchen is awesome .	the box sits in the library in the kitchen is awesome .
the car sitting in the school by the dish is blue .	the car sits in the school by the dish is blue .
the door sitting in the bank by the boat is red .	the door sits in the bank by the boat is red .
the candle sitting by the rocket on the ground is new .	the candle sits by the rocket on the ground is new .
the toy sitting on the couch on the floor is awesome .	the toy sits on the couch on the floor is awesome .
the button sitting by the bag by the book is black .	the button sits by the bag by the book is black .
the plate sitting on the bed on the couch is cold .	the plate sits on the bed on the couch is cold .
the spoon sitting in the mall in the mall is red .	the spoon sits in the mall in the mall is red .
the box sitting on the bed by the shirt is brown .	the box sits on the bed by the shirt is brown .
the ship sitting in the bank on the chair is cool .	the ship sits in the bank on the chair is cool .
the window sitting on the stool on the floor is purple .	the window sits on the stool on the floor is purple .
the bicycle sitting by the rug by the glass is cold .	the bicycle sits by the rug by the glass is cold .
the glass sitting on the table by the ship is purple .	the glass sits on the table by the ship is purple .
the boat sitting by the truck in the restaurant is missing .	the boat sits by the truck in the restaurant is missing .
the ring sitting in the library by the rocket is missing .	the ring sits in the library by the rocket is missing .
the box sitting on the ground by the dish is old .	the box sits on the ground by the dish is old .
the bed sitting by the truck in the room is important .	the bed sits by the truck in the room is important .
the ring sitting by the truck by the bag is cool .	the ring sits by the truck by the bag is cool .
the bottle sitting on the ground on the chair is blue .	the bottle sits on the ground on the chair is blue .
the chair sitting in the museum by the fork is expensive .	the chair sits in the museum by the fork is expensive .
the bag sitting by the toy by the shoe is cold .	the bag sits by the toy by the shoe is cold .
the mirror sitting on the chair on the table is expensive .	the mirror sits on the chair on the table is expensive .
the window sitting by the shoe in the library is green .	the window sits by the shoe in the library is green .
the ship sitting on the couch on the stool is dry .	the ship sits on the couch on the stool is dry .
the rocket sitting by the rocket in the park is green .	the rocket sits by the rocket in the park is green .
the shoe sitting in the kitchen on the stool is cool .	the shoe sits in the kitchen on the stool is cool .
the fork sitting on the couch by the bottle is brown .	the fork sits on the couch by the bottle is brown .
the ring sitting on the couch on the chair is awesome .	the ring sits on the couch on the chair is awesome .
the bicycle sitting in the library in the bank is important .	the bicycle sits in the library in the bank is important .
the rug sitting by the couch on the chair is awesome .	the rug sits by the couch on the chair is awesome .
the glass sitting by the button by the rug is red .	the glass sits by the button by the rug is red .
the hat sitting by the hat in the hospital is old .	the hat sits by the hat in the hospital is old .
the plane sitting on the chair by the toy is cold .	the plane sits on the chair by the toy is cold .
the bed sitting in the mall in the school is important .	the bed sits in the mall in the school is important .
the mirror sitting by the bowl on the street is missing .	the mirror sits by the bowl on the street is missing .
the car sitting by the bottle in the school is old .	the car sits by the bottle in the school is old .
the door sitting on the table by the spoon is missing .	the door sits on the table by the spoon is missing .
the book sitting on the ground by the button is fine .	the book sits on the ground by the button is fine .
the chair sitting on the bed on the bed is small .	the chair sits on the bed on the bed is small .
the car sitting on the ground by the mirror is black .	the car sits on the ground by the mirror is black .
the candle sitting on the ground by the plate is expensive .	the candle sits on the ground by the plate is expensive .
the mirror sitting on the floor on the street is white .	the mirror sits on the floor on the street is white .
the toy sitting on the chair in the library is whole .	the toy sits on the chair in the library is whole .
the bowl sitting by the bicycle on the couch is great .	the bowl sits by the bicycle on the couch is great .
the ship sitting on the bed by the cup is purple .	the ship sits on the bed by the cup is purple .
the door sitting by the doll by the door is dry .	the door sits by the doll by the door is dry .
the ring sitting on the ground in the museum is purple .	the ring sits on the ground in the museum is purple .
the glass sitting by the crayon on the couch is big .	the glass sits by the crayon on the couch is big .
the truck sitting on the stool on the street is awesome .	the truck sits on the stool on the street is awesome .
the car sitting by the bottle on the ground is awesome .	the car sits by the bottle on the ground is awesome .
the truck sitting by the shirt on the bed is great .	the truck sits by the shirt on the bed is great .
the book sitting in the restaurant on the chair is amazing .	the book sits in the restaurant on the chair is amazing .
the candle sitting on the chair by the doll is red .	the candle sits on the chair by the doll is red .
the bowl sitting in the museum by the button is amazing .	the bowl sits in the museum by the button is amazing .
the hat sitting on the bed by the glass is small .	the hat sits on the bed by the glass is small .
the toy sitting by the bicycle on the ground is new .	the toy sits by the bicycle on the ground is new .
the truck sitting on the floor by the candle is black .	the truck sits on the floor by the candle is black .
the shirt sitting on the floor on the bed is purple .	the shirt sits on the floor on the bed is purple .
the toy sitting in the hospital in the hospital is great .	the toy sits in the hospital in the hospital is great .
the ship sitting by the plate by the doll is awesome .	the ship sits by the plate by the doll is awesome .
the glass sitting in the museum on the table is great .	the glass sits in the museum on the table is great .
the mirror sitting on the bed on the chair is cool .	the mirror sits on the bed on the chair is cool .
the shirt sitting in the school on the chair is awesome .	the shirt sits in the school on the chair is awesome .
the shoe sitting by the truck in the restaurant is boring .	the shoe sits by the truck in the restaurant is boring .
the toy sitting on the chair by the bottle is expensive .	the toy sits on the chair by the bottle is expensive .
the ship sitting in the mall by the rug is cool .	the ship sits in the mall by the rug is cool .
the window sitting on the table in the restaurant is green .	the window sits on the table in the restaurant is green .
the shoe sitting by the truck in the bank is fine .	the shoe sits by the truck in the bank is fine .
the ship sitting by the rug in the room is black .	the ship sits by the rug in the room is black .
the bed sitting on the floor by the rocket is purple .	the bed sits on the floor by the rocket is purple .
the book sitting in the museum in the hospital is red .	the book sits in the museum in the hospital is red .
the bicycle sitting in the kitchen in the restaurant is big .	the bicycle sits in the kitchen in the restaurant is big .
the ship sitting by the bag in the school is blue .	the ship sits by the bag in the school is blue .
the ring sitting on the street on the ground is white .	the ring sits on the street on the ground is white .
the door sitting on the bed on the couch is big .	the door sits on the bed on the couch is big .
the couch sitting on the stool in the room is dry .	the couch sits on the stool in the room is dry .
the door sitting on the floor by the book is whole .	the door sits on the floor by the book is whole .
the car sitting on the street by the candle is small .	the car sits on the street by the candle is small .
the mirror sitting by the glass in the mall is boring .	the mirror sits by the glass in the mall is boring .
the picture sitting on the table in the bank is small .	the picture sits on the table in the bank is small .
the plane sitting in the museum in the museum is old .	the plane sits in the museum in the museum is old .
the bicycle sitting on the street by the truck is broken .	the bicycle sits on the street by the truck is broken .
the rug sitting in the school on the chair is red .	the rug sits in the school on the chair is red .
the ship sitting by the fork on the ground is red .	the ship sits by the fork on the ground is red .
the doll sitting by the shoe by the book is white .	the doll sits by the shoe by the book is white .
the book sitting on the chair on the couch is hot .	the book sits on the chair on the couch is hot .
the shoe sitting on the couch on the stool is expensive .	the shoe sits on the couch on the stool is expensive .
the shoe sitting on the couch by the candle is small .	the shoe sits on the couch by the candle is small .
the window sitting on the ground on the floor is boring .	the window sits on the ground on the floor is boring .
the car sitting on the street in the park is great .	the car sits on the street in the park is great .
the chair sitting on the street by the spoon is blue .	the chair sits on the street by the spoon is blue .
the rocket sitting by the ship by the bowl is black .	the rocket sits by the ship by the bowl is black .
the truck sitting by the bowl by the ship is big .	the truck sits by the bowl by the ship is big .
the door sitting by the picture on the ground is missing .	the door sits by the picture on the ground is missing .
the mirror sitting by the candle in the mall is cool .	the mirror sits by the candle in the mall is cool .
the doll sitting on the bed on the table is broken .	the doll sits on the bed on the table is broken .
the bicycle sitting in the mall in the museum is cold .	the bicycle sits in the mall in the museum is cold .
the door sitting in the museum on the street is expensive .	the door sits in the museum on the street is expensive .
the ring sitting in the museum on the floor is fine .	the ring sits in the museum on the floor is fine .
the button sitting on the stool by the glass is amazing .	the button sits on the stool by the glass is amazing .
the doll sitting by the rocket on the table is purple .	the doll sits by the rocket on the table is purple .
the plate sitting by the cup by the crayon is purple .	the plate sits by the cup by the crayon is purple .
the toy sitting on the ground on the table is big .	the toy sits on the ground on the table is big .
the candle sitting by the ring by the bowl is expensive .	the candle sits by the ring by the bowl is expensive .
the glass sitting on the table by the ring is orange .	the glass sits on the table by the ring is orange .
the bag sitting by the plane on the bed is white .	the bag sits by the plane on the bed is white .
the cup sitting in the library by the bag is yellow .	the cup sits in the library by the bag is yellow .
the doll sitting in the mall in the library is broken .	the doll sits in the mall in the library is broken .
the book sitting on the table on the stool is yellow .	the book sits on the table on the stool is yellow .
the book sitting on the couch on the bed is hot .	the book sits on the couch on the bed is hot .
the fork sitting by the mirror on the chair is hot .	the fork sits by the mirror on the chair is hot .
the shoe sitting on the floor by the box is red .	the shoe sits on the floor by the box is red .
the mirror sitting on the bed by the mirror is white .	the mirror sits on the bed by the mirror is white .
the bag sitting on the couch by the button is orange .	the bag sits on the couch by the button is orange .
the dish sitting in the park by the dish is yellow .	the dish sits in the park by the dish is yellow .
the glass sitting by the bag by the spoon is cool .	the glass sits by the bag by the spoon is cool .
the car sitting in the kitchen on the couch is black .	the car sits in the kitchen on the couch is black .
the bowl sitting by the button by the book is awesome .	the bowl sits by the button by the book is awesome .
the truck sitting by the book on the ground is fine .	the truck sits by the book on the ground is fine .
the car sitting by the cup in the school is purple .	the car sits by the cup in the school is purple .
the mirror sitting on the bed in the room is brown .	the mirror sits on the bed in the room is brown .
the bowl sitting by the doll in the kitchen is brown .	the bowl sits by the doll in the kitchen is brown .
the bag sitting by the bowl in the library is cool .	the bag sits by the bowl in the library is cool .
the boat sitting by the rug by the picture is red .	the boat sits by the rug by the picture is red .
the dish sitting on the ground on the street is great .	the dish sits on the ground on the street is great .
the toy sitting by the button on the ground is cool .	the toy sits by the button on the ground is cool .
the ship sitting by the button in the museum is big .	the ship sits by the button in the museum is big .
the ring sitting by the spoon on the floor is new .	the ring sits by the spoon on the floor is new .
the bowl sitting in the hospital on the street is gray .	the bowl sits in the hospital on the street is gray .
the window sitting by the spoon in the museum is yellow .	the window sits by the spoon in the museum is yellow .
the window sitting on the stool in the museum is blue .	the window sits on the stool in the museum is blue .
the bicycle sitting on the couch on the chair is orange .	the bicycle sits on the couch on the chair is orange .
the bed sitting on the table on the chair is purple .	the bed sits on the table on the chair is purple .
the couch sitting in the library in the mall is boring .	the couch sits in the library in the mall is boring .
the bicycle sitting on the chair on the stool is yellow .	the bicycle sits on the chair on the stool is yellow .
the candle sitting on the street by the door is big .	the candle sits on the street by the door is big .
the bed sitting on the street by the truck is great .	the bed sits on the street by the truck is great .
the candle sitting in the bank in the restaurant is gray .	the candle sits in the bank in the restaurant is gray .
the bicycle sitting in the school by the picture is red .	the bicycle sits in the school by the picture is red .
the crayon sitting in the kitchen by the ring is awesome .	the crayon sits in the kitchen by the ring is awesome .
the button sitting by the shirt on the ground is green .	the button sits by the shirt on the ground is green .
the spoon sitting on the bed by the bag is broken .	the spoon sits on the bed by the bag is broken .
the plate sitting in the restaurant on the table is broken .	the plate sits in the restaurant on the table is broken .
the bottle sitting by the boat in the room is white .	the bottle sits by the boat in the room is white .
the car sitting on the chair in the bank is fine .	the car sits on the chair in the bank is fine .
the boat sitting in the school on the floor is great .	the boat sits in the school on the floor is great .
the picture sitting on the table in the restaurant is important .	the picture sits on the table in the restaurant is important .
the bottle sitting by the ship in the restaurant is expensive .	the bottle sits by the ship in the restaurant is expensive .
the fork sitting by the car on the ground is red .	the fork sits by the car on the ground is red .
the dish sitting in the school by the bowl is broken .	the dish sits in the school by the bowl is broken .
the doll sitting by the bag by the book is black .	the doll sits by the bag by the book is black .
the picture sitting on the stool on the table is cold .	the picture sits on the stool on the table is cold .
the door sitting in the restaurant on the ground is yellow .	the door sits in the restaurant on the ground is yellow .
the couch sitting on the floor by the ring is old .	the couch sits on the floor by the ring is old .
the shirt sitting by the dish by the doll is new .	the shirt sits by the dish by the doll is new .
the shoe sitting on the stool in the room is hot .	the shoe sits on the stool in the room is hot .
the box sitting by the bowl by the boat is red .	the box sits by the bowl by the boat is red .
the ship sitting by the bottle in the library is missing .	the ship sits by the bottle in the library is missing .
the car sitting on the table on the table is new .	the car sits on the table on the table is new .
the window sitting on the table by the car is amazing .	the window sits on the table by the car is amazing .
the truck sitting on the table by the couch is brown .	the truck sits on the table by the couch is brown .
the car sitting on the bed on the floor is yellow .	the car sits on the bed on the floor is yellow .
the candle sitting in the kitchen in the school is cute .	the candle sits in the kitchen in the school is cute .
the bottle sitting in the kitchen in the library is blue .	the bottle sits in the kitchen in the library is blue .
the toy sitting by the dish in the museum is blue .	the toy sits by the dish in the museum is blue .
the book sitting by the truck in the mall is old .	the book sits by the truck in the mall is old .
the chair sitting on the floor on the chair is purple .	the chair sits on the floor on the chair is purple .
the ring sitting on the floor in the park is big .	the ring sits on the floor in the park is big .
the car sitting in the library by the shoe is red .	the car sits in the library by the shoe is red .
the car sitting in the museum on the table is big .	the car sits in the museum on the table is big .
the car sitting on the chair by the spoon is green .	the car sits on the chair by the spoon is green .
the ring sitting on the bed on the table is black .	the ring sits on the bed on the table is black .
the shirt sitting on the bed on the table is blue .	the shirt sits on the bed on the table is blue .
the book sitting in the school on the bed is cool .	the book sits in the school on the bed is cool .
the shoe sitting on the table by the door is green .	the shoe sits on the table by the door is green .
the car sitting in the school in the park is hot .	the car sits in the school in the park is hot .
the box sitting on the floor in the bank is missing .	the box sits on the floor in the bank is missing .
the couch sitting on the couch by the bowl is great .	the couch sits on the couch by the bowl is great .
the door sitting by the bicycle by the crayon is dry .	the door sits by the bicycle by the crayon is dry .
the car sitting in the school in the bank is purple .	the car sits in the school in the bank is purple .
the couch sitting on the chair in the park is old .	the couch sits on the chair in the park is old .
the bed sitting by the mirror in the park is cute .	the bed sits by the mirror in the park is cute .
the couch sitting in the museum on the stool is important .	the couch sits in the museum on the stool is important .
the truck sitting in the park by the chair is cool .	the truck sits in the park by the chair is cool .
the car sitting by the box by the couch is cold .	the car sits by the box by the couch is cold .
the rocket sitting in the school on the table is hot .	the rocket sits in the school on the table is hot .
the book sitting on the floor in the room is orange .	the book sits on the floor in the room is orange .
the crayon sitting on the street in the hospital is cool .	the crayon sits on the street in the hospital is cool .
the doll sitting in the kitchen on the ground is cute .	the doll sits in the kitchen on the ground is cute .
the glass sitting in the park in the school is great .	the glass sits in the park in the school is great .
the fork sitting on the table by the toy is cute .	the fork sits on the table by the toy is cute .
the glass sitting by the window in the museum is fine .	the glass sits by the window in the museum is fine .
the shoe sitting in the bank on the ground is boring .	the shoe sits in the bank on the ground is boring .
the car sitting on the chair on the stool is brown .	the car sits on the chair on the stool is brown .
the toy sitting on the couch in the museum is broken .	the toy sits on the couch in the museum is broken .
the ship sitting on the bed by the mirror is big .	the ship sits on the bed by the mirror is big .
the car sitting by the box in the hospital is yellow .	the car sits by the box in the hospital is yellow .
the bottle sitting by the candle on the bed is gray .	the bottle sits by the candle on the bed is gray .
the bottle sitting in the school in the room is awesome .	the bottle sits in the school in the room is awesome .
the cup sitting by the rocket by the shoe is blue .	the cup sits by the rocket by the shoe is blue .
the bed sitting by the button by the mirror is blue .	the bed sits by the button by the mirror is blue .
the dish sitting by the car by the mirror is cool .	the dish sits by the car by the mirror is cool .
the ship sitting on the street on the bed is cool .	the ship sits on the street on the bed is cool .
the mirror sitting on the chair in the room is big .	the mirror sits on the chair in the room is big .
the shoe sitting on the table by the boat is cool .	the shoe sits on the table by the boat is cool .
the ring sitting by the plate in the school is yellow .	the ring sits by the plate in the school is yellow .
the box sitting on the ground by the candle is boring .	the box sits on the ground by the candle is boring .
the truck sitting in the kitchen by the bed is cool .	the truck sits in the kitchen by the bed is cool .
the window sitting by the bag by the spoon is purple .	the window sits by the bag by the spoon is purple .
the book sitting on the stool in the school is hot .	the book sits on the stool in the school is hot .
the shoe sitting on the table on the chair is boring .	the shoe sits on the table on the chair is boring .
the dish sitting on the bed in the school is whole .	the dish sits on the bed in the school is whole .
the button sitting by the bed by the rocket is gray .	the button sits by the bed by the rocket is gray .
the dish sitting in the restaurant by the box is gray .	the dish sits in the restaurant by the box is gray .
the door sitting by the door in the hospital is great .	the door sits by the door in the hospital is great .
the car sitting on the table by the shoe is cold .	the car sits on the table by the shoe is cold .
the dish sitting in the school in the mall is old .	the dish sits in the school in the mall is old .
the ring sitting in the school by the plate is yellow .	the ring sits in the school by the plate is yellow .
the book sitting in the school by the rocket is dry .	the book sits in the school by the rocket is dry .
the picture sitting in the hospital by the glass is hot .	the picture sits in the hospital by the glass is hot .
the bicycle sitting in the park by the fork is orange .	the bicycle sits in the park by the fork is orange .
the chair sitting by the plate on the ground is whole .	the chair sits by the plate on the ground is whole .
the spoon sitting by the rocket in the school is boring .	the spoon sits by the rocket in the school is boring .
the rug sitting on the ground on the street is amazing .	the rug sits on the ground on the street is amazing .
the box sitting in the school in the library is fine .	the box sits in the school in the library is fine .
the door sitting on the street by the chair is broken .	the door sits on the street by the chair is broken .
the book sitting by the chair on the chair is cute .	the book sits by the chair on the chair is cute .
the rug sitting by the window by the door is fine .	the rug sits by the window by the door is fine .
the box sitting in the restaurant by the ring is gray .	the box sits in the restaurant by the ring is gray .
the dish sitting by the rocket by the bowl is black .	the dish sits by the rocket by the bowl is black .
the cup sitting on the floor by the doll is orange .	the cup sits on the floor by the doll is orange .
the crayon sitting on the floor on the street is cold .	the crayon sits on the floor on the street is cold .
the mirror sitting on the ground in the restaurant is cute .	the mirror sits on the ground in the restaurant is cute .
the fork sitting on the bed on the couch is important .	the fork sits on the bed on the couch is important .
the glass sitting in the mall on the stool is brown .	the glass sits in the mall on the stool is brown .
the shoe sitting by the plate by the bottle is missing .	the shoe sits by the plate by the bottle is missing .
the plane sitting in the school by the rocket is small .	the plane sits in the school by the rocket is small .
the fork sitting on the table by the crayon is black .	the fork sits on the table by the crayon is black .
the shirt sitting by the box by the boat is cold .	the shirt sits by the box by the boat is cold .
the shoe sitting on the table on the ground is green .	the shoe sits on the table on the ground is green .
the shirt sitting by the rug on the street is cold .	the shirt sits by the rug on the street is cold .
the door sitting on the chair in the library is white .	the door sits on the chair in the library is white .
the box sitting by the shoe on the chair is great .	the box sits by the shoe on the chair is great .
the glass sitting on the street in the mall is cute .	the glass sits on the street in the mall is cute .
the dish sitting on the stool by the crayon is old .	the dish sits on the stool by the crayon is old .
the truck sitting on the table on the couch is cold .	the truck sits on the table on the couch is cold .
the boat sitting on the couch by the plane is big .	the boat sits on the couch by the plane is big .
the rocket sitting in the hospital by the plate is big .	the rocket sits in the hospital by the plate is big .
the book sitting on the floor in the kitchen is important .	the book sits on the floor in the kitchen is important .
the book sitting by the plate on the stool is white .	the book sits by the plate on the stool is white .
the mirror sitting on the table by the hat is important .	the mirror sits on the table by the hat is important .
the spoon sitting by the crayon by the bottle is boring .	the spoon sits by the crayon by the bottle is boring .
the crayon sitting in the school on the table is green .	the crayon sits in the school on the table is green .
the book sitting on the floor in the school is cool .	the book sits on the floor in the school is cool .
the doll sitting in the restaurant by the spoon is cool .	the doll sits in the restaurant by the spoon is cool .
the picture sitting on the table on the couch is cool .	the picture sits on the table on the couch is cool .
the ring sitting on the stool in the room is cool .	the ring sits on the stool in the room is cool .
the bicycle sitting on the stool by the cup is great .	the bicycle sits on the stool by the cup is great .
the car sitting by the box on the ground is brown .	the car sits by the box on the ground is brown .
the shirt sitting by the spoon by the car is hot .	the shirt sits by the spoon by the car is hot .
the mirror sitting by the bicycle by the rocket is broken .	the mirror sits by the bicycle by the rocket is broken .
the chair sitting on the stool in the hospital is blue .	the chair sits on the stool in the hospital is blue .
the picture sitting by the mirror by the glass is big .	the picture sits by the mirror by the glass is big .
the doll sitting in the hospital by the car is red .	the doll sits in the hospital by the car is red .
the spoon sitting on the floor on the couch is missing .	the spoon sits on the floor on the couch is missing .
the truck sitting on the chair by the car is expensive .	the truck sits on the chair by the car is expensive .
the couch sitting by the car on the street is brown .	the couch sits by the car on the street is brown .
the shoe sitting in the mall by the doll is cool .	the shoe sits in the mall by the doll is cool .
the glass sitting in the bank by the spoon is boring .	the glass sits in the bank by the spoon is boring .
the button sitting in the school in the bank is yellow .	the button sits in the school in the bank is yellow .
the candle sitting by the book on the stool is white .	the candle sits by the book on the stool is white .
the spoon sitting by the bicycle on the chair is blue .	the spoon sits by the bicycle on the chair is blue .
the ship sitting in the school by the ship is new .	the ship sits in the school by the ship is new .
the car sitting by the bag on the chair is cold .	the car sits by the bag on the chair is cold .
the bag sitting by the bowl by the glass is hot .	the bag sits by the bowl by the glass is hot .
the toy sitting by the rug by the plane is hot .	the toy sits by the rug by the plane is hot .
the doll sitting on the stool by the fork is important .	the doll sits on the stool by the fork is important .
the button sitting by the bed by the ring is blue .	the button sits by the bed by the ring is blue .
the picture sitting on the ground in the restaurant is important .	the picture sits on the ground in the restaurant is important .
the fork sitting on the chair in the park is expensive .	the fork sits on the chair in the park is expensive .
the hat sitting on the ground in the museum is big .	the hat sits on the ground in the museum is big .
the truck sitting on the stool on the chair is old .	the truck sits on the stool on the chair is old .
the boat sitting in the restaurant on the floor is amazing .	the boat sits in the restaurant on the floor is amazing .
the plane sitting in the museum by the ring is big .	the plane sits in the museum by the ring is big .
the button sitting by the box by the dish is red .	the button sits by the box by the dish is red .
the bed sitting on the ground on the stool is great .	the bed sits on the ground on the stool is great .
the car sitting by the boat by the car is white .	the car sits by the boat by the car is white .
the couch sitting in the museum in the restaurant is awesome .	the couch sits in the museum in the restaurant is awesome .
the spoon sitting in the museum on the couch is cute .	the spoon sits in the museum on the couch is cute .
the picture sitting by the door in the restaurant is dry .	the picture sits by the door in the restaurant is dry .
the dish sitting by the toy on the stool is brown .	the dish sits by the toy on the stool is brown .
the cup sitting on the street on the bed is broken .	the cup sits on the street on the bed is broken .
the crayon sitting by the plate on the stool is hot .	the crayon sits by the plate on the stool is hot .
the candle sitting by the bed in the restaurant is dry .	the candle sits by the bed in the restaurant is dry .
the book sitting on the couch in the museum is new .	the book sits on the couch in the museum is new .
the shirt sitting on the table in the room is black .	the shirt sits on the table in the room is black .
the box sitting by the cup by the door is broken .	the box sits by the cup by the door is broken .
the picture sitting in the kitchen by the ring is white .	the picture sits in the kitchen by the ring is white .
the ship sitting by the rocket in the mall is small .	the ship sits by the rocket in the mall is small .
the couch sitting in the hospital on the bed is missing .	the couch sits in the hospital on the bed is missing .
the candle sitting by the ship by the bicycle is cold .	the candle sits by the ship by the bicycle is cold .
the plane sitting on the stool by the bed is red .	the plane sits on the stool by the bed is red .
the rocket sitting in the bank by the couch is fine .	the rocket sits in the bank by the couch is fine .
the ship sitting on the chair in the school is old .	the ship sits on the chair in the school is old .
the plane sitting on the street in the library is brown .	the plane sits on the street in the library is brown .
the plane sitting on the street on the bed is dry .	the plane sits on the street on the bed is dry .
the car sitting by the book by the shoe is green .	the car sits by the book by the shoe is green .
the dish sitting by the window by the bicycle is green .	the dish sits by the window by the bicycle is green .
the picture sitting by the car by the toy is old .	the picture sits by the car by the toy is old .
the mirror sitting by the chair in the mall is dry .	the mirror sits by the chair in the mall is dry .
the mirror sitting by the doll on the bed is black .	the mirror sits by the doll on the bed is black .
the shoe sitting by the bowl in the mall is expensive .	the shoe sits by the bowl in the mall is expensive .
