the door is very very very very very very very very very nice .	the door sings very very very very very very very very very nice .
the rocket is very very very very very very very very very confused .	the rocket cries very very very very very very very very very confused .
the box is really really really really really really really really really important .	the box paints really really really really really really really really really important .
the bowl is really really really really really really really really really important .	the bowl waves really really really really really really really really really important .
the button was very very very very very very very very very confused .	the button reads very very very very very very very very very confused .
the plate is very very very very very very very very very surprised .	the plate reads very very very very very very very very very surprised .
the spoon is really really really really really really really really really smart .	the spoon paints really really really really really really really really really smart .
the shoe is really really really really really really really really really curious .	the shoe paints really really really really really really really really really curious .
the cup is very very very very very very very very very strong .	the cup talks very very very very very very very very very strong .
the glass is really really really really really really really really really boring .	the glass paints really really really really really really really really really boring .
the crayon is really really really really really really really really really kind .	the crayon waves really really really really really really really really really kind .
the spoon was really really really really really really really really really kind .	the spoon cries really really really really really really really really really kind .
the toy was really really really really really really really really really friendly .	the toy paints really really really really really really really really really friendly .
the ship is really really really really really really really really really healthy .	the ship reads really really really really really really really really really healthy .
the rug is very very very very very very very very very angry .	the rug waves very very very very very very very very very angry .
the cup is very very very very very very very very very nice .	the cup cries very very very very very very very very very nice .
the candle was very very very very very very very very very nice .	the candle sings very very very very very very very very very nice .
the spoon is very very very very very very very very very hungry .	the spoon talks very very very very very very very very very hungry .
the button was very very very very very very very very very young .	the button reads very very very very very very very very very young .
the rocket is really really really really really really really really really hungry .	the rocket cries really really really really really really really really really hungry .
the bag is really really really really really really really really really angry .	the bag waves really really really really really really really really really angry .
the bottle is really really really really really really really really really busy .	the bottle waves really really really really really really really really really busy .
the dish is very very very very very very very very very nice .	the dish waves very very very very very very very very very nice .
the mirror is really really really really really really really really really kind .	the mirror paints really really really really really really really really really kind .
the plate is very very very very very very very very very lucky .	the plate exercises very very very very very very very very very lucky .
the toy is really really really really really really really really really upset .	the toy talks really really really really really really really really really upset .
the ship was really really really really really really really really really surprised .	the ship cries really really really really really really really really really surprised .
the chair is very very very very very very very very very curious .	the chair reads very very very very very very very very very curious .
the button is very very very very very very very very very excited .	the button talks very very very very very very very very very excited .
the chair is very very very very very very very very very wrong .	the chair exercises very very very very very very very very very wrong .
the crayon was really really really really really really really really really upset .	the crayon waves really really really really really really really really really upset .
the fork is really really really really really really really really really clever .	the fork exercises really really really really really really really really really clever .
the rug is really really really really really really really really really kind .	the rug exercises really really really really really really really really really kind .
the button was really really really really really really really really really friendly .	the button reads really really really really really really really really really friendly .
the cup was very very very very very very very very very nice .	the cup cries very very very very very very very very very nice .
the couch is very very very very very very very very very tall .	the couch paints very very very very very very very very very tall .
the bottle was really really really really really really really really really careful .	the bottle talks really really really really really really really really really careful .
the plane is really really really really really really really really really careful .	the plane waves really really really really really really really really really careful .
the plane was really really really really really really really really really confused .	the plane cries really really really really really really really really really confused .
the chair was really really really really really really really really really quiet .	the chair talks really really really really really really really really really quiet .
the ring is really really really really really really really really really confused .	the ring paints really really really really really really really really really confused .
the bed is really really really really really really really really really tall .	the bed talks really really really really really really really really really tall .
the plane was really really really really really really really really really angry .	the plane exercises really really really really really really really really really angry .
the doll is very very very very very very very very very quiet .	the doll cries very very very very very very very very very quiet .
the dish is very very very very very very very very very excited .	the dish cries very very very very very very very very very excited .
the picture is very very very very very very very very very wrong .	the picture exercises very very very very very very very very very wrong .
the bowl is really really really really really really really really really curious .	the bowl reads really really really really really really really really really curious .
the chair was very very very very very very very very very sleepy .	the chair waves very very very very very very very very very sleepy .
the chair was really really really really really really really really really busy .	the chair waves really really really really really really really really really busy .
the chair is really really really really really really really really really boring .	the chair reads really really really really really really really really really boring .
the chair was very very very very very very very very very angry .	the chair talks very very very very very very very very very angry .
the glass is really really really really really really really really really busy .	the glass cries really really really really really really really really really busy .
the crayon was very very very very very very very very very busy .	the crayon reads very very very very very very very very very busy .
the cup is very very very very very very very very very excited .	the cup paints very very very very very very very very very excited .
the ship is really really really really really really really really really careful .	the ship exercises really really really really really really really really really careful .
the mirror was very very very very very very very very very excited .	the mirror paints very very very very very very very very very excited .
the book is really really really really really really really really really sleepy .	the book waves really really really really really really really really really sleepy .
the bottle is very very very very very very very very very busy .	the bottle cries very very very very very very very very very busy .
the toy is really really really really really really really really really healthy .	the toy cries really really really really really really really really really healthy .
the car was really really really really really really really really really bored .	the car sings really really really really really really really really really bored .
the plane was really really really really really really really really really curious .	the plane exercises really really really really really really really really really curious .
the picture is very very very very very very very very very gentle .	the picture sings very very very very very very very very very gentle .
the fork is very very very very very very very very very curious .	the fork reads very very very very very very very very very curious .
the picture is very very very very very very very very very wrong .	the picture reads very very very very very very very very very wrong .
the plate was really really really really really really really really really friendly .	the plate sings really really really really really really really really really friendly .
the truck is very very very very very very very very very curious .	the truck exercises very very very very very very very very very curious .
the cup was very very very very very very very very very healthy .	the cup paints very very very very very very very very very healthy .
the glass is really really really really really really really really really young .	the glass waves really really really really really really really really really young .
the bicycle was really really really really really really really really really upset .	the bicycle exercises really really really really really really really really really upset .
the car was very very very very very very very very very tired .	the car waves very very very very very very very very very tired .
the rocket was very very very very very very very very very confused .	the rocket sings very very very very very very very very very confused .
the mirror is very very very very very very very very very hungry .	the mirror paints very very very very very very very very very hungry .
the bottle was really really really really really really really really really lucky .	the bottle talks really really really really really really really really really lucky .
the truck was very very very very very very very very very boring .	the truck waves very very very very very very very very very boring .
the ring is really really really really really really really really really gentle .	the ring paints really really really really really really really really really gentle .
the box is really really really really really really really really really curious .	the box reads really really really really really really really really really curious .
the bottle was really really really really really really really really really tired .	the bottle sings really really really really really really really really really tired .
the bag is really really really really really really really really really confused .	the bag waves really really really really really really really really really confused .
the shirt was really really really really really really really really really bored .	the shirt sings really really really really really really really really really bored .
the spoon was really really really really really really really really really kind .	the spoon sings really really really really really really really really really kind .
the plate is very very very very very very very very very helpful .	the plate talks very very very very very very very very very helpful .
the book is really really really really really really really really really friendly .	the book waves really really really really really really really really really friendly .
the bottle is really really really really really really really really really friendly .	the bottle waves really really really really really really really really really friendly .
the ring was very very very very very very very very very gentle .	the ring exercises very very very very very very very very very gentle .
the candle is very very very very very very very very very quiet .	the candle waves very very very very very very very very very quiet .
the cup is really really really really really really really really really clever .	the cup paints really really really really really really really really really clever .
the book was really really really really really really really really really upset .	the book exercises really really really really really really really really really upset .
the door was very very very very very very very very very tall .	the door cries very very very very very very very very very tall .
the window is really really really really really really really really really smart .	the window reads really really really really really really really really really smart .
the bag is very very very very very very very very very nice .	the bag reads very very very very very very very very very nice .
the bowl is really really really really really really really really really curious .	the bowl cries really really really really really really really really really curious .
the hat was very very very very very very very very very wrong .	the hat paints very very very very very very very very very wrong .
the truck is really really really really really really really really really helpful .	the truck paints really really really really really really really really really helpful .
the car is very very very very very very very very very boring .	the car talks very very very very very very very very very boring .
the bag is very very very very very very very very very young .	the bag paints very very very very very very very very very young .
the couch is really really really really really really really really really strong .	the couch talks really really really really really really really really really strong .
the candle was really really really really really really really really really curious .	the candle waves really really really really really really really really really curious .
the bed is very very very very very very very very very boring .	the bed sings very very very very very very very very very boring .
the shoe was very very very very very very very very very confused .	the shoe paints very very very very very very very very very confused .
the fork is really really really really really really really really really quiet .	the fork cries really really really really really really really really really quiet .
the book was really really really really really really really really really confused .	the book paints really really really really really really really really really confused .
the rocket was really really really really really really really really really wrong .	the rocket sings really really really really really really really really really wrong .
the mirror was really really really really really really really really really tall .	the mirror talks really really really really really really really really really tall .
the doll was very very very very very very very very very nice .	the doll exercises very very very very very very very very very nice .
the rocket is really really really really really really really really really upset .	the rocket paints really really really really really really really really really upset .
the glass was very very very very very very very very very excited .	the glass talks very very very very very very very very very excited .
the bag was very very very very very very very very very happy .	the bag paints very very very very very very very very very happy .
the glass was very very very very very very very very very strong .	the glass sings very very very very very very very very very strong .
the bag is very very very very very very very very very happy .	the bag sings very very very very very very very very very happy .
the hat is very very very very very very very very very careful .	the hat reads very very very very very very very very very careful .
the candle was really really really really really really really really really kind .	the candle talks really really really really really really really really really kind .
the couch was very very very very very very very very very tall .	the couch cries very very very very very very very very very tall .
the book is really really really really really really really really really clever .	the book exercises really really really really really really really really really clever .
the box is very very very very very very very very very happy .	the box paints very very very very very very very very very happy .
the bottle is really really really really really really really really really excited .	the bottle exercises really really really really really really really really really excited .
the box is very very very very very very very very very important .	the box reads very very very very very very very very very important .
the bottle was very very very very very very very very very sleepy .	the bottle reads very very very very very very very very very sleepy .
the window was really really really really really really really really really friendly .	the window reads really really really really really really really really really friendly .
the book is very very very very very very very very very gentle .	the book reads very very very very very very very very very gentle .
the plate was really really really really really really really really really happy .	the plate waves really really really really really really really really really happy .
the rocket is really really really really really really really really really friendly .	the rocket waves really really really really really really really really really friendly .
the picture was very very very very very very very very very busy .	the picture sings very very very very very very very very very busy .
the shoe is really really really really really really really really really angry .	the shoe talks really really really really really really really really really angry .
the box is very very very very very very very very very healthy .	the box sings very very very very very very very very very healthy .
the ring was very very very very very very very very very sleepy .	the ring reads very very very very very very very very very sleepy .
the rug is really really really really really really really really really bored .	the rug reads really really really really really really really really really bored .
the glass is really really really really really really really really really happy .	the glass cries really really really really really really really really really happy .
the plane was very very very very very very very very very upset .	the plane talks very very very very very very very very very upset .
the window is really really really really really really really really really strong .	the window sings really really really really really really really really really strong .
the plane was really really really really really really really really really important .	the plane paints really really really really really really really really really important .
the candle was really really really really really really really really really tired .	the candle sings really really really really really really really really really tired .
the button is really really really really really really really really really excited .	the button reads really really really really really really really really really excited .
the rocket was really really really really really really really really really happy .	the rocket reads really really really really really really really really really happy .
the car is really really really really really really really really really upset .	the car exercises really really really really really really really really really upset .
the candle was really really really really really really really really really angry .	the candle talks really really really really really really really really really angry .
the car is very very very very very very very very very curious .	the car talks very very very very very very very very very curious .
the spoon is really really really really really really really really really smart .	the spoon exercises really really really really really really really really really smart .
the picture is really really really really really really really really really quiet .	the picture reads really really really really really really really really really quiet .
the shirt is very very very very very very very very very hungry .	the shirt exercises very very very very very very very very very hungry .
the book is very very very very very very very very very sleepy .	the book waves very very very very very very very very very sleepy .
the shirt is very very very very very very very very very quiet .	the shirt cries very very very very very very very very very quiet .
the button was very very very very very very very very very curious .	the button cries very very very very very very very very very curious .
the book was really really really really really really really really really careful .	the book waves really really really really really really really really really careful .
the car is really really really really really really really really really sleepy .	the car paints really really really really really really really really really sleepy .
the bag was very very very very very very very very very sleepy .	the bag reads very very very very very very very very very sleepy .
the chair was very very very very very very very very very surprised .	the chair cries very very very very very very very very very surprised .
the car was really really really really really really really really really happy .	the car talks really really really really really really really really really happy .
the bowl was really really really really really really really really really lucky .	the bowl sings really really really really really really really really really lucky .
the rug is really really really really really really really really really busy .	the rug exercises really really really really really really really really really busy .
the crayon is very very very very very very very very very lucky .	the crayon paints very very very very very very very very very lucky .
the crayon was very very very very very very very very very bored .	the crayon reads very very very very very very very very very bored .
the spoon was very very very very very very very very very strong .	the spoon cries very very very very very very very very very strong .
the book was really really really really really really really really really confused .	the book talks really really really really really really really really really confused .
the window is really really really really really really really really really smart .	the window exercises really really really really really really really really really smart .
the boat was really really really really really really really really really hungry .	the boat talks really really really really really really really really really hungry .
the shirt was very very very very very very very very very important .	the shirt cries very very very very very very very very very important .
the spoon is really really really really really really really really really friendly .	the spoon talks really really really really really really really really really friendly .
the book is really really really really really really really really really careful .	the book waves really really really really really really really really really careful .
the couch was really really really really really really really really really tired .	the couch cries really really really really really really really really really tired .
the doll was very very very very very very very very very busy .	the doll sings very very very very very very very very very busy .
the chair is really really really really really really really really really clever .	the chair exercises really really really really really really really really really clever .
the bowl is really really really really really really really really really confused .	the bowl cries really really really really really really really really really confused .
the shoe was really really really really really really really really really wrong .	the shoe waves really really really really really really really really really wrong .
the boat is really really really really really really really really really bored .	the boat cries really really really really really really really really really bored .
the car is really really really really really really really really really angry .	the car reads really really really really really really really really really angry .
the bag is really really really really really really really really really confused .	the bag reads really really really really really really really really really confused .
the button is really really really really really really really really really gentle .	the button talks really really really really really really really really really gentle .
the hat was very very very very very very very very very important .	the hat paints very very very very very very very very very important .
the doll was very very very very very very very very very boring .	the doll waves very very very very very very very very very boring .
the car was very very very very very very very very very sleepy .	the car exercises very very very very very very very very very sleepy .
the chair was really really really really really really really really really lucky .	the chair exercises really really really really really really really really really lucky .
the door is very very very very very very very very very confused .	the door exercises very very very very very very very very very confused .
the ship was really really really really really really really really really important .	the ship exercises really really really really really really really really really important .
the mirror was really really really really really really really really really quiet .	the mirror cries really really really really really really really really really quiet .
the book is really really really really really really really really really upset .	the book paints really really really really really really really really really upset .
the rug was very very very very very very very very very kind .	the rug talks very very very very very very very very very kind .
the chair was very very very very very very very very very bored .	the chair talks very very very very very very very very very bored .
the fork was very very very very very very very very very friendly .	the fork cries very very very very very very very very very friendly .
the hat was really really really really really really really really really curious .	the hat exercises really really really really really really really really really curious .
the crayon is very very very very very very very very very clever .	the crayon sings very very very very very very very very very clever .
the door is very very very very very very very very very wrong .	the door sings very very very very very very very very very wrong .
the truck was really really really really really really really really really young .	the truck waves really really really really really really really really really young .
the dish is really really really really really really really really really angry .	the dish sings really really really really really really really really really angry .
the bed is very very very very very very very very very lucky .	the bed exercises very very very very very very very very very lucky .
the bottle is really really really really really really really really really nice .	the bottle waves really really really really really really really really really nice .
the couch is very very very very very very very very very clever .	the couch exercises very very very very very very very very very clever .
the spoon was very very very very very very very very very clever .	the spoon cries very very very very very very very very very clever .
the couch is really really really really really really really really really hungry .	the couch cries really really really really really really really really really hungry .
the window is very very very very very very very very very happy .	the window paints very very very very very very very very very happy .
the ship was really really really really really really really really really friendly .	the ship paints really really really really really really really really really friendly .
the picture was really really really really really really really really really boring .	the picture reads really really really really really really really really really boring .
the bowl was very very very very very very very very very careful .	the bowl reads very very very very very very very very very careful .
the plate is very very very very very very very very very hungry .	the plate exercises very very very very very very very very very hungry .
the doll is very very very very very very very very very quiet .	the doll paints very very very very very very very very very quiet .
the mirror was very very very very very very very very very friendly .	the mirror talks very very very very very very very very very friendly .
the book is very very very very very very very very very happy .	the book reads very very very very very very very very very happy .
the picture is really really really really really really really really really smart .	the picture reads really really really really really really really really really smart .
the ship is very very very very very very very very very clever .	the ship talks very very very very very very very very very clever .
the shoe was very very very very very very very very very boring .	the shoe reads very very very very very very very very very boring .
the candle was really really really really really really really really really wrong .	the candle sings really really really really really really really really really wrong .
the bicycle is really really really really really really really really really smart .	the bicycle exercises really really really really really really really really really smart .
the window was very very very very very very very very very quiet .	the window talks very very very very very very very very very quiet .
the boat was really really really really really really really really really tired .	the boat paints really really really really really really really really really tired .
the rug was very very very very very very very very very angry .	the rug reads very very very very very very very very very angry .
the spoon is very very very very very very very very very angry .	the spoon paints very very very very very very very very very angry .
the toy was very very very very very very very very very lucky .	the toy exercises very very very very very very very very very lucky .
the rocket was really really really really really really really really really tall .	the rocket cries really really really really really really really really really tall .
the bag is very very very very very very very very very young .	the bag exercises very very very very very very very very very young .
the bowl is very very very very very very very very very clever .	the bowl sings very very very very very very very very very clever .
the glass is really really really really really really really really really tall .	the glass sings really really really really really really really really really tall .
the plane was really really really really really really really really really bored .	the plane talks really really really really really really really really really bored .
the rug was really really really really really really really really really strong .	the rug waves really really really really really really really really really strong .
the ship is very very very very very very very very very confused .	the ship reads very very very very very very very very very confused .
the ship is really really really really really really really really really excited .	the ship exercises really really really really really really really really really excited .
the car was very very very very very very very very very boring .	the car sings very very very very very very very very very boring .
the window was very very very very very very very very very wrong .	the window reads very very very very very very very very very wrong .
the plane was very very very very very very very very very careful .	the plane talks very very very very very very very very very careful .
the shoe was really really really really really really really really really gentle .	the shoe cries really really really really really really really really really gentle .
the boat was really really really really really really really really really gentle .	the boat sings really really really really really really really really really gentle .
the box is very very very very very very very very very surprised .	the box talks very very very very very very very very very surprised .
the hat was very very very very very very very very very quiet .	the hat cries very very very very very very very very very quiet .
the bicycle is really really really really really really really really really smart .	the bicycle cries really really really really really really really really really smart .
the toy is very very very very very very very very very wrong .	the toy reads very very very very very very very very very wrong .
the shirt is very very very very very very very very very hungry .	the shirt paints very very very very very very very very very hungry .
the glass was very very very very very very very very very helpful .	the glass waves very very very very very very very very very helpful .
the picture is very very very very very very very very very careful .	the picture paints very very very very very very very very very careful .
the hat was very very very very very very very very very careful .	the hat paints very very very very very very very very very careful .
the crayon was really really really really really really really really really kind .	the crayon talks really really really really really really really really really kind .
the dish was really really really really really really really really really tired .	the dish paints really really really really really really really really really tired .
the doll is really really really really really really really really really excited .	the doll cries really really really really really really really really really excited .
the mirror is very very very very very very very very very happy .	the mirror talks very very very very very very very very very happy .
the car is very very very very very very very very very kind .	the car waves very very very very very very very very very kind .
the shoe is really really really really really really really really really busy .	the shoe waves really really really really really really really really really busy .
the doll was really really really really really really really really really confused .	the doll paints really really really really really really really really really confused .
the boat was very very very very very very very very very clever .	the boat sings very very very very very very very very very clever .
the dish is very very very very very very very very very confused .	the dish paints very very very very very very very very very confused .
the doll was very very very very very very very very very friendly .	the doll reads very very very very very very very very very friendly .
the couch is very very very very very very very very very angry .	the couch reads very very very very very very very very very angry .
the truck was very very very very very very very very very boring .	the truck reads very very very very very very very very very boring .
the boat was really really really really really really really really really upset .	the boat waves really really really really really really really really really upset .
the spoon is very very very very very very very very very smart .	the spoon cries very very very very very very very very very smart .
the ship was very very very very very very very very very angry .	the ship sings very very very very very very very very very angry .
the bicycle is very very very very very very very very very tired .	the bicycle reads very very very very very very very very very tired .
the rug was really really really really really really really really really boring .	the rug waves really really really really really really really really really boring .
the bottle was very very very very very very very very very happy .	the bottle cries very very very very very very very very very happy .
the book was really really really really really really really really really young .	the book talks really really really really really really really really really young .
the candle was really really really really really really really really really sleepy .	the candle sings really really really really really really really really really sleepy .
the window was very very very very very very very very very boring .	the window exercises very very very very very very very very very boring .
the ship is very very very very very very very very very excited .	the ship sings very very very very very very very very very excited .
the fork is very very very very very very very very very happy .	the fork reads very very very very very very very very very happy .
the candle is really really really really really really really really really clever .	the candle exercises really really really really really really really really really clever .
the car is really really really really really really really really really kind .	the car exercises really really really really really really really really really kind .
the car is really really really really really really really really really boring .	the car waves really really really really really really really really really boring .
the shirt is really really really really really really really really really confused .	the shirt reads really really really really really really really really really confused .
the plane was really really really really really really really really really excited .	the plane exercises really really really really really really really really really excited .
the spoon is very very very very very very very very very quiet .	the spoon waves very very very very very very very very very quiet .
the shoe was very very very very very very very very very happy .	the shoe exercises very very very very very very very very very happy .
the bed was very very very very very very very very very helpful .	the bed waves very very very very very very very very very helpful .
the fork is very very very very very very very very very angry .	the fork talks very very very very very very very very very angry .
the car was really really really really really really really really really sleepy .	the car cries really really really really really really really really really sleepy .
the shoe is really really really really really really really really really young .	the shoe talks really really really really really really really really really young .
the door is really really really really really really really really really lucky .	the door paints really really really really really really really really really lucky .
the doll is very very very very very very very very very tall .	the doll cries very very very very very very very very very tall .
the toy is really really really really really really really really really kind .	the toy cries really really really really really really really really really kind .
the bed was really really really really really really really really really busy .	the bed reads really really really really really really really really really busy .
the bowl was very very very very very very very very very upset .	the bowl cries very very very very very very very very very upset .
the doll was very very very very very very very very very tall .	the doll sings very very very very very very very very very tall .
the picture was very very very very very very very very very busy .	the picture waves very very very very very very very very very busy .
the bowl is very very very very very very very very very angry .	the bowl sings very very very very very very very very very angry .
the shirt is very very very very very very very very very quiet .	the shirt exercises very very very very very very very very very quiet .
the picture was very very very very very very very very very sleepy .	the picture reads very very very very very very very very very sleepy .
the fork is very very very very very very very very very hungry .	the fork reads very very very very very very very very very hungry .
the spoon was really really really really really really really really really young .	the spoon talks really really really really really really really really really young .
the plane was very very very very very very very very very healthy .	the plane waves very very very very very very very very very healthy .
the rocket is really really really really really really really really really boring .	the rocket waves really really really really really really really really really boring .
the rocket was really really really really really really really really really helpful .	the rocket waves really really really really really really really really really helpful .
the box is really really really really really really really really really kind .	the box talks really really really really really really really really really kind .
the doll is really really really really really really really really really bored .	the doll paints really really really really really really really really really bored .
the bag was really really really really really really really really really surprised .	the bag exercises really really really really really really really really really surprised .
the candle is really really really really really really really really really excited .	the candle waves really really really really really really really really really excited .
the door is very very very very very very very very very confused .	the door waves very very very very very very very very very confused .
the door is very very very very very very very very very strong .	the door sings very very very very very very very very very strong .
the boat was really really really really really really really really really lucky .	the boat exercises really really really really really really really really really lucky .
the book is really really really really really really really really really tired .	the book exercises really really really really really really really really really tired .
the couch is really really really really really really really really really busy .	the couch cries really really really really really really really really really busy .
the ship is really really really really really really really really really tall .	the ship exercises really really really really really really really really really tall .
the toy is really really really really really really really really really upset .	the toy sings really really really really really really really really really upset .
the plate was really really really really really really really really really quiet .	the plate paints really really really really really really really really really quiet .
the doll was really really really really really really really really really lucky .	the doll paints really really really really really really really really really lucky .
the bottle was really really really really really really really really really curious .	the bottle talks really really really really really really really really really curious .
the bowl is really really really really really really really really really boring .	the bowl waves really really really really really really really really really boring .
the shirt was very very very very very very very very very healthy .	the shirt sings very very very very very very very very very healthy .
the truck was very very very very very very very very very helpful .	the truck talks very very very very very very very very very helpful .
the cup is really really really really really really really really really surprised .	the cup exercises really really really really really really really really really surprised .
the candle is very very very very very very very very very boring .	the candle reads very very very very very very very very very boring .
the rug was really really really really really really really really really surprised .	the rug exercises really really really really really really really really really surprised .
the hat is really really really really really really really really really excited .	the hat talks really really really really really really really really really excited .
the truck is very very very very very very very very very bored .	the truck talks very very very very very very very very very bored .
the spoon was very very very very very very very very very hungry .	the spoon cries very very very very very very very very very hungry .
the spoon was really really really really really really really really really bored .	the spoon cries really really really really really really really really really bored .
the shirt was very very very very very very very very very excited .	the shirt sings very very very very very very very very very excited .
the bag is very very very very very very very very very angry .	the bag cries very very very very very very very very very angry .
the candle was really really really really really really really really really tired .	the candle talks really really really really really really really really really tired .
the spoon is really really really really really really really really really quiet .	the spoon cries really really really really really really really really really quiet .
the rocket is really really really really really really really really really careful .	the rocket exercises really really really really really really really really really careful .
the chair was really really really really really really really really really quiet .	the chair reads really really really really really really really really really quiet .
the truck is very very very very very very very very very curious .	the truck talks very very very very very very very very very curious .
the bed was very very very very very very very very very helpful .	the bed reads very very very very very very very very very helpful .
the boat is really really really really really really really really really happy .	the boat paints really really really really really really really really really happy .
the spoon was really really really really really really really really really curious .	the spoon reads really really really really really really really really really curious .
the boat is very very very very very very very very very happy .	the boat waves very very very very very very very very very happy .
the toy was very very very very very very very very very boring .	the toy sings very very very very very very very very very boring .
the chair was very very very very very very very very very bored .	the chair exercises very very very very very very very very very bored .
the couch is really really really really really really really really really angry .	the couch sings really really really really really really really really really angry .
the ship was very very very very very very very very very clever .	the ship exercises very very very very very very very very very clever .
the couch was really really really really really really really really really sleepy .	the couch cries really really really really really really really really really sleepy .
the bowl was very very very very very very very very very surprised .	the bowl reads very very very very very very very very very surprised .
the bed is really really really really really really really really really bored .	the bed sings really really really really really really really really really bored .
the truck was really really really really really really really really really upset .	the truck paints really really really really really really really really really upset .
the glass is really really really really really really really really really clever .	the glass sings really really really really really really really really really clever .
the couch is very very very very very very very very very kind .	the couch sings very very very very very very very very very kind .
the cup is very very very very very very very very very careful .	the cup waves very very very very very very very very very careful .
the crayon was really really really really really really really really really busy .	the crayon sings really really really really really really really really really busy .
the cup was very very very very very very very very very gentle .	the cup exercises very very very very very very very very very gentle .
the chair was really really really really really really really really really careful .	the chair sings really really really really really really really really really careful .
the fork was very very very very very very very very very hungry .	the fork exercises very very very very very very very very very hungry .
the couch was really really really really really really really really really helpful .	the couch talks really really really really really really really really really helpful .
the bottle was really really really really really really really really really angry .	the bottle paints really really really really really really really really really angry .
the rug is really really really really really really really really really excited .	the rug sings really really really really really really really really really excited .
the ship is very very very very very very very very very strong .	the ship sings very very very very very very very very very strong .
the crayon was very very very very very very very very very nice .	the crayon waves very very very very very very very very very nice .
the picture was very very very very very very very very very boring .	the picture cries very very very very very very very very very boring .
the plate is really really really really really really really really really sleepy .	the plate waves really really really really really really really really really sleepy .
the door was really really really really really really really really really kind .	the door waves really really really really really really really really really kind .
the bicycle was really really really really really really really really really nice .	the bicycle reads really really really really really really really really really nice .
the button is really really really really really really really really really busy .	the button waves really really really really really really really really really busy .
the cup was very very very very very very very very very friendly .	the cup paints very very very very very very very very very friendly .
the cup was really really really really really really really really really smart .	the cup talks really really really really really really really really really smart .
the bicycle is very very very very very very very very very sleepy .	the bicycle talks very very very very very very very very very sleepy .
the toy is really really really really really really really really really hungry .	the toy exercises really really really really really really really really really hungry .
the picture was very very very very very very very very very young .	the picture reads very very very very very very very very very young .
the boat is really really really really really really really really really kind .	the boat exercises really really really really really really really really really kind .
the bowl was very very very very very very very very very angry .	the bowl sings very very very very very very very very very angry .
the bowl is really really really really really really really really really sleepy .	the bowl paints really really really really really really really really really sleepy .
the boat is very very very very very very very very very excited .	the boat exercises very very very very very very very very very excited .
the shoe was really really really really really really really really really bored .	the shoe exercises really really really really really really really really really bored .
the candle is really really really really really really really really really wrong .	the candle sings really really really really really really really really really wrong .
the rocket is very very very very very very very very very curious .	the rocket cries very very very very very very very very very curious .
the bicycle is really really really really really really really really really lucky .	the bicycle exercises really really really really really really really really really lucky .
the book is very very very very very very very very very confused .	the book sings very very very very very very very very very confused .
the couch was really really really really really really really really really busy .	the couch cries really really really really really really really really really busy .
the button was very very very very very very very very very boring .	the button paints very very very very very very very very very boring .
the bicycle was really really really really really really really really really surprised .	the bicycle cries really really really really really really really really really surprised .
the spoon was really really really really really really really really really friendly .	the spoon paints really really really really really really really really really friendly .
the couch was very very very very very very very very very angry .	the couch reads very very very very very very very very very angry .
the ring is really really really really really really really really really bored .	the ring waves really really really really really really really really really bored .
the car is very very very very very very very very very tired .	the car talks very very very very very very very very very tired .
the toy is very very very very very very very very very tired .	the toy sings very very very very very very very very very tired .
the bag was really really really really really really really really really happy .	the bag exercises really really really really really really really really really happy .
the cup is really really really really really really really really really important .	the cup reads really really really really really really really really really important .
the ship was very very very very very very very very very young .	the ship talks very very very very very very very very very young .
the plate was really really really really really really really really really careful .	the plate waves really really really really really really really really really careful .
the plane is very very very very very very very very very confused .	the plane sings very very very very very very very very very confused .
the bed was very very very very very very very very very curious .	the bed exercises very very very very very very very very very curious .
the bicycle was very very very very very very very very very wrong .	the bicycle talks very very very very very very very very very wrong .
the book is very very very very very very very very very kind .	the book exercises very very very very very very very very very kind .
the bottle is really really really really really really really really really careful .	the bottle exercises really really really really really really really really really careful .
the boat was really really really really really really really really really healthy .	the boat paints really really really really really really really really really healthy .
the plate is really really really really really really really really really helpful .	the plate exercises really really really really really really really really really helpful .
the door is very very very very very very very very very curious .	the door cries very very very very very very very very very curious .
the couch was very very very very very very very very very clever .	the couch waves very very very very very very very very very clever .
the button is really really really really really really really really really friendly .	the button talks really really really really really really really really really friendly .
the boat is very very very very very very very very very sleepy .	the boat cries very very very very very very very very very sleepy .
the hat is really really really really really really really really really surprised .	the hat cries really really really really really really really really really surprised .
the doll is really really really really really really really really really tall .	the doll waves really really really really really really really really really tall .
the doll is very very very very very very very very very kind .	the doll talks very very very very very very very very very kind .
the shoe was really really really really really really really really really friendly .	the shoe exercises really really really really really really really really really friendly .
the book was very very very very very very very very very young .	the book talks very very very very very very very very very young .
the crayon is really really really really really really really really really nice .	the crayon paints really really really really really really really really really nice .
the hat is really really really really really really really really really happy .	the hat exercises really really really really really really really really really happy .
the car is very very very very very very very very very helpful .	the car sings very very very very very very very very very helpful .
the cup is really really really really really really really really really quiet .	the cup waves really really really really really really really really really quiet .
the shoe is really really really really really really really really really young .	the shoe reads really really really really really really really really really young .
the ring is really really really really really really really really really angry .	the ring exercises really really really really really really really really really angry .
the car was very very very very very very very very very careful .	the car talks very very very very very very very very very careful .
the car was very very very very very very very very very strong .	the car cries very very very very very very very very very strong .
the rocket is very very very very very very very very very strong .	the rocket cries very very very very very very very very very strong .
the car was really really really really really really really really really young .	the car reads really really really really really really really really really young .
the candle was really really really really really really really really really careful .	the candle exercises really really really really really really really really really careful .
the book is really really really really really really really really really tall .	the book exercises really really really really really really really really really tall .
the rocket is very very very very very very very very very happy .	the rocket cries very very very very very very very very very happy .
the spoon is very very very very very very very very very angry .	the spoon cries very very very very very very very very very angry .
the bag was very very very very very very very very very clever .	the bag paints very very very very very very very very very clever .
the book is really really really really really really really really really careful .	the book exercises really really really really really really really really really careful .
the candle was really really really really really really really really really upset .	the candle paints really really really really really really really really really upset .
the truck is very very very very very very very very very gentle .	the truck paints very very very very very very very very very gentle .
the fork was very very very very very very very very very sleepy .	the fork reads very very very very very very very very very sleepy .
the fork is really really really really really really really really really boring .	the fork paints really really really really really really really really really boring .
the glass was very very very very very very very very very curious .	the glass paints very very very very very very very very very curious .
the rug is very very very very very very very very very surprised .	the rug talks very very very very very very very very very surprised .
the dish was really really really really really really really really really boring .	the dish sings really really really really really really really really really boring .
the shirt is really really really really really really really really really clever .	the shirt paints really really really really really really really really really clever .
the window is very very very very very very very very very young .	the window reads very very very very very very very very very young .
the cup is very very very very very very very very very boring .	the cup talks very very very very very very very very very boring .
the boat was really really really really really really really really really kind .	the boat exercises really really really really really really really really really kind .
the bag was very very very very very very very very very busy .	the bag cries very very very very very very very very very busy .
the toy is really really really really really really really really really gentle .	the toy cries really really really really really really really really really gentle .
the doll is really really really really really really really really really upset .	the doll reads really really really really really really really really really upset .
the glass was really really really really really really really really really nice .	the glass talks really really really really really really really really really nice .
the bottle is really really really really really really really really really healthy .	the bottle sings really really really really really really really really really healthy .
the hat is very very very very very very very very very gentle .	the hat cries very very very very very very very very very gentle .
the bag is really really really really really really really really really clever .	the bag waves really really really really really really really really really clever .
the window was really really really really really really really really really surprised .	the window sings really really really really really really really really really surprised .
the couch was really really really really really really really really really young .	the couch sings really really really really really really really really really young .
the door was really really really really really really really really really boring .	the door sings really really really really really really really really really boring .
the book was very very very very very very very very very strong .	the book exercises very very very very very very very very very strong .
the ring was really really really really really really really really really bored .	the ring exercises really really really really really really really really really bored .
the door is really really really really really really really really really surprised .	the door waves really really really really really really really really really surprised .
the bowl is very very very very very very very very very sleepy .	the bowl reads very very very very very very very very very sleepy .
the box is really really really really really really really really really friendly .	the box paints really really really really really really really really really friendly .
the bag is really really really really really really really really really smart .	the bag cries really really really really really really really really really smart .
the car is very very very very very very very very very kind .	the car cries very very very very very very very very very kind .
the book is very very very very very very very very very gentle .	the book sings very very very very very very very very very gentle .
the doll is very very very very very very very very very bored .	the doll exercises very very very very very very very very very bored .
the cup is very very very very very very very very very surprised .	the cup talks very very very very very very very very very surprised .
the glass was really really really really really really really really really nice .	the glass waves really really really really really really really really really nice .
the toy is very very very very very very very very very bored .	the toy sings very very very very very very very very very bored .
the box is really really really really really really really really really busy .	the box reads really really really really really really really really really busy .
the picture was really really really really really really really really really important .	the picture waves really really really really really really really really really important .
the chair is very very very very very very very very very tired .	the chair exercises very very very very very very very very very tired .
the boat was very very very very very very very very very confused .	the boat paints very very very very very very very very very confused .
the ring is very very very very very very very very very confused .	the ring waves very very very very very very very very very confused .
the bicycle was really really really really really really really really really careful .	the bicycle paints really really really really really really really really really careful .
the glass is very very very very very very very very very angry .	the glass waves very very very very very very very very very angry .
the mirror is very very very very very very very very very busy .	the mirror paints very very very very very very very very very busy .
the chair is really really really really really really really really really quiet .	the chair sings really really really really really really really really really quiet .
the box is really really really really really really really really really bored .	the box exercises really really really really really really really really really bored .
the doll is really really really really really really really really really boring .	the doll sings really really really really really really really really really boring .
the bicycle was very very very very very very very very very quiet .	the bicycle cries very very very very very very very very very quiet .
the plate is really really really really really really really really really careful .	the plate waves really really really really really really really really really careful .
the box was really really really really really really really really really hungry .	the box exercises really really really really really really really really really hungry .
the bag is very very very very very very very very very bored .	the bag talks very very very very very very very very very bored .
the bowl is very very very very very very very very very confused .	the bowl exercises very very very very very very very very very confused .
the couch is really really really really really really really really really boring .	the couch talks really really really really really really really really really boring .
the crayon was very very very very very very very very very important .	the crayon talks very very very very very very very very very important .
the boat is really really really really really really really really really confused .	the boat sings really really really really really really really really really confused .
the rocket was very very very very very very very very very gentle .	the rocket sings very very very very very very very very very gentle .
the boat is very very very very very very very very very lucky .	the boat sings very very very very very very very very very lucky .
the picture was very very very very very very very very very friendly .	the picture paints very very very very very very very very very friendly .
the bicycle is really really really really really really really really really clever .	the bicycle exercises really really really really really really really really really clever .
the shoe is really really really really really really really really really lucky .	the shoe paints really really really really really really really really really lucky .
the box is very very very very very very very very very friendly .	the box paints very very very very very very very very very friendly .
the button is very very very very very very very very very gentle .	the button reads very very very very very very very very very gentle .
the rocket is very very very very very very very very very tired .	the rocket talks very very very very very very very very very tired .
the bag is really really really really really really really really really bored .	the bag paints really really really really really really really really really bored .
the truck was really really really really really really really really really young .	the truck sings really really really really really really really really really young .
the bicycle is very very very very very very very very very nice .	the bicycle exercises very very very very very very very very very nice .
the spoon is really really really really really really really really really kind .	the spoon cries really really really really really really really really really kind .
the car is really really really really really really really really really wrong .	the car waves really really really really really really really really really wrong .
the truck is really really really really really really really really really kind .	the truck sings really really really really really really really really really kind .
the box is really really really really really really really really really tall .	the box sings really really really really really really really really really tall .
the car was very very very very very very very very very wrong .	the car waves very very very very very very very very very wrong .
the car was very very very very very very very very very quiet .	the car exercises very very very very very very very very very quiet .
the hat is really really really really really really really really really clever .	the hat reads really really really really really really really really really clever .
the picture is very very very very very very very very very curious .	the picture paints very very very very very very very very very curious .
the bottle is really really really really really really really really really boring .	the bottle talks really really really really really really really really really boring .
the plane is really really really really really really really really really strong .	the plane sings really really really really really really really really really strong .
the bowl was very very very very very very very very very upset .	the bowl reads very very very very very very very very very upset .
the toy is really really really really really really really really really kind .	the toy paints really really really really really really really really really kind .
the bicycle was really really really really really really really really really upset .	the bicycle waves really really really really really really really really really upset .
the hat is very very very very very very very very very healthy .	the hat cries very very very very very very very very very healthy .
the glass was really really really really really really really really really clever .	the glass waves really really really really really really really really really clever .
the bowl was very very very very very very very very very tall .	the bowl paints very very very very very very very very very tall .
the fork was very very very very very very very very very clever .	the fork paints very very very very very very very very very clever .
the door is very very very very very very very very very surprised .	the door sings very very very very very very very very very surprised .
the car was very very very very very very very very very smart .	the car talks very very very very very very very very very smart .
the mirror is really really really really really really really really really smart .	the mirror waves really really really really really really really really really smart .
the door was really really really really really really really really really surprised .	the door cries really really really really really really really really really surprised .
the shirt is very very very very very very very very very gentle .	the shirt cries very very very very very very very very very gentle .
the chair is really really really really really really really really really tired .	the chair cries really really really really really really really really really tired .
the bottle was very very very very very very very very very strong .	the bottle talks very very very very very very very very very strong .
the dish was really really really really really really really really really tired .	the dish sings really really really really really really really really really tired .
the glass was really really really really really really really really really tired .	the glass reads really really really really really really really really really tired .
the picture was really really really really really really really really really curious .	the picture reads really really really really really really really really really curious .
the truck is really really really really really really really really really bored .	the truck cries really really really really really really really really really bored .
the ring was really really really really really really really really really hungry .	the ring talks really really really really really really really really really hungry .
the picture was really really really really really really really really really busy .	the picture sings really really really really really really really really really busy .
the dish was really really really really really really really really really hungry .	the dish paints really really really really really really really really really hungry .
the shirt is very very very very very very very very very sleepy .	the shirt reads very very very very very very very very very sleepy .
the plate is very very very very very very very very very tall .	the plate waves very very very very very very very very very tall .
the book was really really really really really really really really really quiet .	the book exercises really really really really really really really really really quiet .
the button is really really really really really really really really really wrong .	the button cries really really really really really really really really really wrong .
the ship is very very very very very very very very very confused .	the ship paints very very very very very very very very very confused .
the bed is really really really really really really really really really surprised .	the bed talks really really really really really really really really really surprised .
the door was really really really really really really really really really friendly .	the door cries really really really really really really really really really friendly .
the car was very very very very very very very very very angry .	the car sings very very very very very very very very very angry .
the plane was really really really really really really really really really surprised .	the plane paints really really really really really really really really really surprised .
the car was very very very very very very very very very careful .	the car paints very very very very very very very very very careful .
the button was really really really really really really really really really lucky .	the button talks really really really really really really really really really lucky .
the car is really really really really really really really really really tired .	the car cries really really really really really really really really really tired .
the boat is very very very very very very very very very healthy .	the boat waves very very very very very very very very very healthy .
the box was really really really really really really really really really angry .	the box cries really really really really really really really really really angry .
the car is very very very very very very very very very lucky .	the car talks very very very very very very very very very lucky .
the shirt is very very very very very very very very very helpful .	the shirt waves very very very very very very very very very helpful .
the candle is really really really really really really really really really kind .	the candle waves really really really really really really really really really kind .
the shoe was really really really really really really really really really bored .	the shoe talks really really really really really really really really really bored .
the mirror is really really really really really really really really really bored .	the mirror cries really really really really really really really really really bored .
the doll was really really really really really really really really really sleepy .	the doll cries really really really really really really really really really sleepy .
the picture is very very very very very very very very very gentle .	the picture exercises very very very very very very very very very gentle .
the fork was very very very very very very very very very quiet .	the fork cries very very very very very very very very very quiet .
the dish was really really really really really really really really really strong .	the dish reads really really really really really really really really really strong .
the rocket is really really really really really really really really really curious .	the rocket cries really really really really really really really really really curious .
the bottle is really really really really really really really really really quiet .	the bottle talks really really really really really really really really really quiet .
the door was really really really really really really really really really surprised .	the door talks really really really really really really really really really surprised .
the plane is really really really really really really really really really excited .	the plane exercises really really really really really really really really really excited .
the bag was very very very very very very very very very curious .	the bag sings very very very very very very very very very curious .
the box was really really really really really really really really really quiet .	the box talks really really really really really really really really really quiet .
the doll is really really really really really really really really really tall .	the doll cries really really really really really really really really really tall .
the book was very very very very very very very very very confused .	the book paints very very very very very very very very very confused .
the bicycle was really really really really really really really really really boring .	the bicycle waves really really really really really really really really really boring .
the door was really really really really really really really really really important .	the door exercises really really really really really really really really really important .
the fork is really really really really really really really really really quiet .	the fork exercises really really really really really really really really really quiet .
the cup is really really really really really really really really really helpful .	the cup cries really really really really really really really really really helpful .
the spoon was really really really really really really really really really clever .	the spoon reads really really really really really really really really really clever .
the truck is really really really really really really really really really lucky .	the truck waves really really really really really really really really really lucky .
the window is very very very very very very very very very friendly .	the window cries very very very very very very very very very friendly .
the glass is very very very very very very very very very nice .	the glass waves very very very very very very very very very nice .
the mirror was really really really really really really really really really smart .	the mirror waves really really really really really really really really really smart .
the picture is very very very very very very very very very tall .	the picture cries very very very very very very very very very tall .
the shoe is really really really really really really really really really gentle .	the shoe reads really really really really really really really really really gentle .
the book was really really really really really really really really really important .	the book waves really really really really really really really really really important .
the doll was really really really really really really really really really healthy .	the doll exercises really really really really really really really really really healthy .
the glass was very very very very very very very very very gentle .	the glass waves very very very very very very very very very gentle .
the bicycle is really really really really really really really really really smart .	the bicycle sings really really really really really really really really really smart .
the box is very very very very very very very very very bored .	the box paints very very very very very very very very very bored .
the crayon is very very very very very very very very very young .	the crayon paints very very very very very very very very very young .
the rug was very very very very very very very very very confused .	the rug exercises very very very very very very very very very confused .
the truck is really really really really really really really really really excited .	the truck sings really really really really really really really really really excited .
the book is really really really really really really really really really surprised .	the book paints really really really really really really really really really surprised .
the bowl was very very very very very very very very very smart .	the bowl reads very very very very very very very very very smart .
the bed is very very very very very very very very very happy .	the bed reads very very very very very very very very very happy .
the bed is really really really really really really really really really curious .	the bed waves really really really really really really really really really curious .
the book was very very very very very very very very very lucky .	the book sings very very very very very very very very very lucky .
the ring is very very very very very very very very very careful .	the ring reads very very very very very very very very very careful .
the chair was really really really really really really really really really tall .	the chair exercises really really really really really really really really really tall .
the rug was very very very very very very very very very sleepy .	the rug sings very very very very very very very very very sleepy .
the bowl was very very very very very very very very very boring .	the bowl sings very very very very very very very very very boring .
the shirt is really really really really really really really really really curious .	the shirt exercises really really really really really really really really really curious .
the box is very very very very very very very very very important .	the box sings very very very very very very very very very important .
the bicycle is very very very very very very very very very excited .	the bicycle reads very very very very very very very very very excited .
the truck is really really really really really really really really really clever .	the truck exercises really really really really really really really really really clever .
the book is really really really really really really really really really important .	the book exercises really really really really really really really really really important .
the book is really really really really really really really really really wrong .	the book reads really really really really really really really really really wrong .
the plane was really really really really really really really really really curious .	the plane cries really really really really really really really really really curious .
the shoe was very very very very very very very very very kind .	the shoe talks very very very very very very very very very kind .
the toy was really really really really really really really really really tired .	the toy paints really really really really really really really really really tired .
the crayon was really really really really really really really really really quiet .	the crayon paints really really really really really really really really really quiet .
the hat is very very very very very very very very very surprised .	the hat exercises very very very very very very very very very surprised .
the candle is very very very very very very very very very helpful .	the candle waves very very very very very very very very very helpful .
the car was very very very very very very very very very quiet .	the car sings very very very very very very very very very quiet .
the hat is very very very very very very very very very curious .	the hat talks very very very very very very very very very curious .
the crayon is really really really really really really really really really tired .	the crayon sings really really really really really really really really really tired .
the truck was really really really really really really really really really surprised .	the truck reads really really really really really really really really really surprised .
the boat was very very very very very very very very very busy .	the boat paints very very very very very very very very very busy .
the window is very very very very very very very very very hungry .	the window cries very very very very very very very very very hungry .
the rocket is really really really really really really really really really boring .	the rocket talks really really really really really really really really really boring .
the bed was really really really really really really really really really hungry .	the bed talks really really really really really really really really really hungry .
the spoon was very very very very very very very very very strong .	the spoon sings very very very very very very very very very strong .
the picture is really really really really really really really really really busy .	the picture paints really really really really really really really really really busy .
the bottle is very very very very very very very very very confused .	the bottle talks very very very very very very very very very confused .
the button is really really really really really really really really really careful .	the button paints really really really really really really really really really careful .
the bicycle was very very very very very very very very very sleepy .	the bicycle sings very very very very very very very very very sleepy .
the doll was really really really really really really really really really healthy .	the doll paints really really really really really really really really really healthy .
the bowl is very very very very very very very very very bored .	the bowl reads very very very very very very very very very bored .
the doll is really really really really really really really really really young .	the doll exercises really really really really really really really really really young .
the dish was really really really really really really really really really busy .	the dish paints really really really really really really really really really busy .
the ship is very very very very very very very very very kind .	the ship talks very very very very very very very very very kind .
the rug was really really really really really really really really really young .	the rug waves really really really really really really really really really young .
the mirror is very very very very very very very very very bored .	the mirror exercises very very very very very very very very very bored .
the shirt is really really really really really really really really really happy .	the shirt cries really really really really really really really really really happy .
the plane was really really really really really really really really really boring .	the plane waves really really really really really really really really really boring .
the chair was really really really really really really really really really busy .	the chair paints really really really really really really really really really busy .
the bicycle was really really really really really really really really really friendly .	the bicycle waves really really really really really really really really really friendly .
the bag was really really really really really really really really really upset .	the bag cries really really really really really really really really really upset .
the bicycle was very very very very very very very very very hungry .	the bicycle paints very very very very very very very very very hungry .
the bottle is really really really really really really really really really hungry .	the bottle paints really really really really really really really really really hungry .
the bed was very very very very very very very very very angry .	the bed reads very very very very very very very very very angry .
the rug is very very very very very very very very very helpful .	the rug cries very very very very very very very very very helpful .
the car is very very very very very very very very very happy .	the car cries very very very very very very very very very happy .
the box was very very very very very very very very very smart .	the box waves very very very very very very very very very smart .
the bag is very very very very very very very very very smart .	the bag exercises very very very very very very very very very smart .
the shirt was very very very very very very very very very healthy .	the shirt paints very very very very very very very very very healthy .
the shoe is really really really really really really really really really sleepy .	the shoe paints really really really really really really really really really sleepy .
the bed is really really really really really really really really really healthy .	the bed reads really really really really really really really really really healthy .
the ship is really really really really really really really really really confused .	the ship sings really really really really really really really really really confused .
the picture was very very very very very very very very very gentle .	the picture waves very very very very very very very very very gentle .
the button is very very very very very very very very very sleepy .	the button paints very very very very very very very very very sleepy .
the rocket is very very very very very very very very very sleepy .	the rocket waves very very very very very very very very very sleepy .
the ship was very very very very very very very very very nice .	the ship reads very very very very very very very very very nice .
the fork is very very very very very very very very very tired .	the fork cries very very very very very very very very very tired .
the glass was very very very very very very very very very smart .	the glass reads very very very very very very very very very smart .
the fork was very very very very very very very very very helpful .	the fork reads very very very very very very very very very helpful .
the doll is really really really really really really really really really young .	the doll paints really really really really really really really really really young .
the box was very very very very very very very very very gentle .	the box cries very very very very very very very very very gentle .
the bottle was really really really really really really really really really tall .	the bottle cries really really really really really really really really really tall .
the book is really really really really really really really really really strong .	the book paints really really really really really really really really really strong .
the rocket was very very very very very very very very very nice .	the rocket talks very very very very very very very very very nice .
the cup was very very very very very very very very very excited .	the cup exercises very very very very very very very very very excited .
the toy was very very very very very very very very very quiet .	the toy talks very very very very very very very very very quiet .
the plane was very very very very very very very very very curious .	the plane cries very very very very very very very very very curious .
the book is very very very very very very very very very young .	the book waves very very very very very very very very very young .
the box is really really really really really really really really really hungry .	the box reads really really really really really really really really really hungry .
the doll is really really really really really really really really really confused .	the doll exercises really really really really really really really really really confused .
the bed is really really really really really really really really really curious .	the bed talks really really really really really really really really really curious .
the rocket was very very very very very very very very very gentle .	the rocket waves very very very very very very very very very gentle .
the plate is really really really really really really really really really lucky .	the plate reads really really really really really really really really really lucky .
the door was really really really really really really really really really healthy .	the door talks really really really really really really really really really healthy .
the dish is very very very very very very very very very upset .	the dish reads very very very very very very very very very upset .
the door is very very very very very very very very very excited .	the door sings very very very very very very very very very excited .
the chair is really really really really really really really really really healthy .	the chair waves really really really really really really really really really healthy .
the candle was really really really really really really really really really careful .	the candle paints really really really really really really really really really careful .
the dish was very very very very very very very very very healthy .	the dish exercises very very very very very very very very very healthy .
the chair is really really really really really really really really really sleepy .	the chair paints really really really really really really really really really sleepy .
the bottle is really really really really really really really really really curious .	the bottle sings really really really really really really really really really curious .
the button was really really really really really really really really really healthy .	the button talks really really really really really really really really really healthy .
the candle was very very very very very very very very very sleepy .	the candle talks very very very very very very very very very sleepy .
the crayon is really really really really really really really really really nice .	the crayon waves really really really really really really really really really nice .
the bicycle is very very very very very very very very very busy .	the bicycle cries very very very very very very very very very busy .
the toy was really really really really really really really really really lucky .	the toy exercises really really really really really really really really really lucky .
the bed was really really really really really really really really really healthy .	the bed cries really really really really really really really really really healthy .
the picture is really really really really really really really really really kind .	the picture exercises really really really really really really really really really kind .
the plate is really really really really really really really really really happy .	the plate exercises really really really really really really really really really happy .
the book was very very very very very very very very very smart .	the book exercises very very very very very very very very very smart .
the hat is very very very very very very very very very angry .	the hat cries very very very very very very very very very angry .
the candle is really really really really really really really really really friendly .	the candle sings really really really really really really really really really friendly .
the doll was very very very very very very very very very upset .	the doll talks very very very very very very very very very upset .
the door is very very very very very very very very very tired .	the door paints very very very very very very very very very tired .
the rocket was very very very very very very very very very helpful .	the rocket paints very very very very very very very very very helpful .
the button was very very very very very very very very very happy .	the button cries very very very very very very very very very happy .
the plane is very very very very very very very very very happy .	the plane talks very very very very very very very very very happy .
the couch is really really really really really really really really really healthy .	the couch cries really really really really really really really really really healthy .
the fork is very very very very very very very very very upset .	the fork sings very very very very very very very very very upset .
the ship is very very very very very very very very very kind .	the ship exercises very very very very very very very very very kind .
the bicycle is very very very very very very very very very happy .	the bicycle paints very very very very very very very very very happy .
the glass is really really really really really really really really really confused .	the glass cries really really really really really really really really really confused .
the fork is really really really really really really really really really lucky .	the fork paints really really really really really really really really really lucky .
the book is really really really really really really really really really kind .	the book exercises really really really really really really really really really kind .
the window is really really really really really really really really really gentle .	the window talks really really really really really really really really really gentle .
the shoe was very very very very very very very very very busy .	the shoe reads very very very very very very very very very busy .
the truck was very very very very very very very very very smart .	the truck reads very very very very very very very very very smart .
the bag is very very very very very very very very very friendly .	the bag paints very very very very very very very very very friendly .
the window was really really really really really really really really really gentle .	the window cries really really really really really really really really really gentle .
the couch is really really really really really really really really really lucky .	the couch paints really really really really really really really really really lucky .
the cup is really really really really really really really really really happy .	the cup talks really really really really really really really really really happy .
the fork was really really really really really really really really really nice .	the fork waves really really really really really really really really really nice .
the ship is really really really really really really really really really nice .	the ship cries really really really really really really really really really nice .
the dish is really really really really really really really really really lucky .	the dish cries really really really really really really really really really lucky .
the plane is really really really really really really really really really sleepy .	the plane exercises really really really really really really really really really sleepy .
the doll is very very very very very very very very very angry .	the doll cries very very very very very very very very very angry .
the window is really really really really really really really really really important .	the window exercises really really really really really really really really really important .
the spoon is very very very very very very very very very kind .	the spoon cries very very very very very very very very very kind .
the bag was really really really really really really really really really busy .	the bag exercises really really really really really really really really really busy .
the doll is very very very very very very very very very hungry .	the doll sings very very very very very very very very very hungry .
the window was really really really really really really really really really upset .	the window waves really really really really really really really really really upset .
the dish was very very very very very very very very very lucky .	the dish paints very very very very very very very very very lucky .
the doll is really really really really really really really really really friendly .	the doll talks really really really really really really really really really friendly .
the fork was really really really really really really really really really lucky .	the fork cries really really really really really really really really really lucky .
the car was really really really really really really really really really angry .	the car paints really really really really really really really really really angry .
the button was very very very very very very very very very excited .	the button sings very very very very very very very very very excited .
the dish was very very very very very very very very very sleepy .	the dish reads very very very very very very very very very sleepy .
the cup was very very very very very very very very very kind .	the cup reads very very very very very very very very very kind .
the doll is very very very very very very very very very friendly .	the doll talks very very very very very very very very very friendly .
the boat was very very very very very very very very very excited .	the boat exercises very very very very very very very very very excited .
the mirror was really really really really really really really really really tall .	the mirror exercises really really really really really really really really really tall .
the chair was really really really really really really really really really nice .	the chair reads really really really really really really really really really nice .
the mirror was very very very very very very very very very tall .	the mirror waves very very very very very very very very very tall .
the candle is very very very very very very very very very angry .	the candle paints very very very very very very very very very angry .
the mirror was really really really really really really really really really upset .	the mirror talks really really really really really really really really really upset .
the car is really really really really really really really really really important .	the car waves really really really really really really really really really important .
the ship was very very very very very very very very very surprised .	the ship waves very very very very very very very very very surprised .
the car is very very very very very very very very very quiet .	the car waves very very very very very very very very very quiet .
the bed was really really really really really really really really really upset .	the bed paints really really really really really really really really really upset .
the ship was very very very very very very very very very tall .	the ship cries very very very very very very very very very tall .
the ship is really really really really really really really really really happy .	the ship exercises really really really really really really really really really happy .
the fork is really really really really really really really really really nice .	the fork sings really really really really really really really really really nice .
the chair was very very very very very very very very very curious .	the chair waves very very very very very very very very very curious .
the door was very very very very very very very very very excited .	the door waves very very very very very very very very very excited .
the book was really really really really really really really really really important .	the book cries really really really really really really really really really important .
the plate is really really really really really really really really really surprised .	the plate waves really really really really really really really really really surprised .
the chair is really really really really really really really really really young .	the chair reads really really really really really really really really really young .
the box is very very very very very very very very very kind .	the box cries very very very very very very very very very kind .
the bottle was very very very very very very very very very strong .	the bottle sings very very very very very very very very very strong .
the shirt was really really really really really really really really really young .	the shirt waves really really really really really really really really really young .
the button was very very very very very very very very very curious .	the button talks very very very very very very very very very curious .
the bowl was very very very very very very very very very gentle .	the bowl exercises very very very very very very very very very gentle .
the mirror was very very very very very very very very very healthy .	the mirror waves very very very very very very very very very healthy .
the dish was very very very very very very very very very wrong .	the dish cries very very very very very very very very very wrong .
the book was really really really really really really really really really important .	the book paints really really really really really really really really really important .
the book was really really really really really really really really really lucky .	the book exercises really really really really really really really really really lucky .
the shoe is very very very very very very very very very gentle .	the shoe waves very very very very very very very very very gentle .
the dish was very very very very very very very very very happy .	the dish talks very very very very very very very very very happy .
the mirror was really really really really really really really really really wrong .	the mirror sings really really really really really really really really really wrong .
the dish was very very very very very very very very very wrong .	the dish reads very very very very very very very very very wrong .
the boat is very very very very very very very very very tired .	the boat paints very very very very very very very very very tired .
the toy was really really really really really really really really really angry .	the toy paints really really really really really really really really really angry .
the box is very very very very very very very very very healthy .	the box waves very very very very very very very very very healthy .
the book is really really really really really really really really really busy .	the book talks really really really really really really really really really busy .
the ring was really really really really really really really really really lucky .	the ring sings really really really really really really really really really lucky .
the crayon is very very very very very very very very very important .	the crayon cries very very very very very very very very very important .
the plate was really really really really really really really really really confused .	the plate talks really really really really really really really really really confused .
the bowl is really really really really really really really really really quiet .	the bowl exercises really really really really really really really really really quiet .
the glass was really really really really really really really really really tall .	the glass waves really really really really really really really really really tall .
the fork was very very very very very very very very very quiet .	the fork reads very very very very very very very very very quiet .
the boat was very very very very very very very very very smart .	the boat sings very very very very very very very very very smart .
the doll was really really really really really really really really really lucky .	the doll waves really really really really really really really really really lucky .
the window is very very very very very very very very very tall .	the window exercises very very very very very very very very very tall .
the couch was really really really really really really really really really friendly .	the couch paints really really really really really really really really really friendly .
the crayon is very very very very very very very very very tall .	the crayon cries very very very very very very very very very tall .
the bicycle is really really really really really really really really really surprised .	the bicycle exercises really really really really really really really really really surprised .
the book is really really really really really really really really really confused .	the book talks really really really really really really really really really confused .
the box is really really really really really really really really really important .	the box talks really really really really really really really really really important .
the fork is very very very very very very very very very lucky .	the fork reads very very very very very very very very very lucky .
the couch was really really really really really really really really really curious .	the couch exercises really really really really really really really really really curious .
the button is very very very very very very very very very important .	the button paints very very very very very very very very very important .
the couch is really really really really really really really really really lucky .	the couch waves really really really really really really really really really lucky .
the spoon is really really really really really really really really really surprised .	the spoon cries really really really really really really really really really surprised .
the bottle was really really really really really really really really really gentle .	the bottle cries really really really really really really really really really gentle .
the chair was very very very very very very very very very excited .	the chair paints very very very very very very very very very excited .
the car was very very very very very very very very very careful .	the car waves very very very very very very very very very careful .
the mirror was very very very very very very very very very gentle .	the mirror sings very very very very very very very very very gentle .
the bowl is really really really really really really really really really healthy .	the bowl sings really really really really really really really really really healthy .
the cup was really really really really really really really really really angry .	the cup paints really really really really really really really really really angry .
the bicycle is very very very very very very very very very smart .	the bicycle cries very very very very very very very very very smart .
the bicycle is very very very very very very very very very tired .	the bicycle talks very very very very very very very very very tired .
the bowl is very very very very very very very very very quiet .	the bowl talks very very very very very very very very very quiet .
the rocket was really really really really really really really really really upset .	the rocket paints really really really really really really really really really upset .
the toy was really really really really really really really really really bored .	the toy talks really really really really really really really really really bored .
the ring is very very very very very very very very very strong .	the ring exercises very very very very very very very very very strong .
the button was very very very very very very very very very busy .	the button reads very very very very very very very very very busy .
the book was very very very very very very very very very smart .	the book talks very very very very very very very very very smart .
the doll was very very very very very very very very very young .	the doll exercises very very very very very very very very very young .
the door was really really really really really really really really really bored .	the door paints really really really really really really really really really bored .
the bottle is really really really really really really really really really kind .	the bottle exercises really really really really really really really really really kind .
the boat is very very very very very very very very very quiet .	the boat talks very very very very very very very very very quiet .
the book was very very very very very very very very very tall .	the book cries very very very very very very very very very tall .
the candle is very very very very very very very very very busy .	the candle exercises very very very very very very very very very busy .
the car was very very very very very very very very very young .	the car sings very very very very very very very very very young .
the fork is really really really really really really really really really important .	the fork waves really really really really really really really really really important .
the dish was really really really really really really really really really careful .	the dish sings really really really really really really really really really careful .
the couch was very very very very very very very very very curious .	the couch paints very very very very very very very very very curious .
the doll was very very very very very very very very very clever .	the doll reads very very very very very very very very very clever .
the shoe was very very very very very very very very very bored .	the shoe cries very very very very very very very very very bored .
the ship was really really really really really really really really really helpful .	the ship talks really really really really really really really really really helpful .
the hat is really really really really really really really really really friendly .	the hat cries really really really really really really really really really friendly .
the dish was really really really really really really really really really healthy .	the dish talks really really really really really really really really really healthy .
the book is very very very very very very very very very friendly .	the book sings very very very very very very very very very friendly .
the car is really really really really really really really really really lucky .	the car exercises really really really really really really really really really lucky .
the bottle is really really really really really really really really really busy .	the bottle exercises really really really really really really really really really busy .
the bottle is very very very very very very very very very wrong .	the bottle paints very very very very very very very very very wrong .
the couch was very very very very very very very very very important .	the couch cries very very very very very very very very very important .
the shoe is very very very very very very very very very helpful .	the shoe waves very very very very very very very very very helpful .
the bicycle was very very very very very very very very very nice .	the bicycle waves very very very very very very very very very nice .
the ring was very very very very very very very very very tall .	the ring cries very very very very very very very very very tall .
the candle is very very very very very very very very very important .	the candle paints very very very very very very very very very important .
the door is very very very very very very very very very bored .	the door talks very very very very very very very very very bored .
the glass was very very very very very very very very very sleepy .	the glass paints very very very very very very very very very sleepy .
the rocket is really really really really really really really really really careful .	the rocket cries really really really really really really really really really careful .
the chair was very very very very very very very very very upset .	the chair paints very very very very very very very very very upset .
the bag was really really really really really really really really really clever .	the bag cries really really really really really really really really really clever .
the bed is very very very very very very very very very surprised .	the bed sings very very very very very very very very very surprised .
the glass was very very very very very very very very very helpful .	the glass paints very very very very very very very very very helpful .
the shirt was really really really really really really really really really bored .	the shirt cries really really really really really really really really really bored .
the cup is really really really really really really really really really healthy .	the cup paints really really really really really really really really really healthy .
the window was really really really really really really really really really nice .	the window sings really really really really really really really really really nice .
the shoe is very very very very very very very very very tall .	the shoe reads very very very very very very very very very tall .
the doll was really really really really really really really really really clever .	the doll cries really really really really really really really really really clever .
the fork was really really really really really really really really really smart .	the fork paints really really really really really really really really really smart .
the bed was very very very very very very very very very nice .	the bed sings very very very very very very very very very nice .
the cup is very very very very very very very very very strong .	the cup waves very very very very very very very very very strong .
the bicycle is really really really really really really really really really clever .	the bicycle sings really really really really really really really really really clever .
the crayon is really really really really really really really really really hungry .	the crayon exercises really really really really really really really really really hungry .
the cup is really really really really really really really really really surprised .	the cup talks really really really really really really really really really surprised .
the rug was very very very very very very very very very curious .	the rug talks very very very very very very very very very curious .
the cup is very very very very very very very very very helpful .	the cup reads very very very very very very very very very helpful .
the book is really really really really really really really really really kind .	the book reads really really really really really really really really really kind .
the box was really really really really really really really really really smart .	the box exercises really really really really really really really really really smart .
the spoon was really really really really really really really really really nice .	the spoon waves really really really really really really really really really nice .
the bottle was really really really really really really really really really confused .	the bottle waves really really really really really really really really really confused .
the plane is really really really really really really really really really nice .	the plane paints really really really really really really really really really nice .
the spoon was really really really really really really really really really gentle .	the spoon reads really really really really really really really really really gentle .
the car is very very very very very very very very very important .	the car sings very very very very very very very very very important .
the bowl is very very very very very very very very very tall .	the bowl paints very very very very very very very very very tall .
the chair is really really really really really really really really really happy .	the chair talks really really really really really really really really really happy .
the book was very very very very very very very very very surprised .	the book cries very very very very very very very very very surprised .
the mirror is very very very very very very very very very tall .	the mirror talks very very very very very very very very very tall .
the plate is very very very very very very very very very hungry .	the plate waves very very very very very very very very very hungry .
the door was really really really really really really really really really important .	the door talks really really really really really really really really really important .
the ship is really really really really really really really really really happy .	the ship reads really really really really really really really really really happy .
the picture is really really really really really really really really really important .	the picture waves really really really really really really really really really important .
the cup was very very very very very very very very very happy .	the cup talks very very very very very very very very very happy .
the crayon was very very very very very very very very very nice .	the crayon paints very very very very very very very very very nice .
the fork is very very very very very very very very very gentle .	the fork waves very very very very very very very very very gentle .
the chair is really really really really really really really really really helpful .	the chair talks really really really really really really really really really helpful .
the rocket is very very very very very very very very very important .	the rocket sings very very very very very very very very very important .
the boat was very very very very very very very very very healthy .	the boat waves very very very very very very very very very healthy .
the hat was really really really really really really really really really excited .	the hat waves really really really really really really really really really excited .
the door was very very very very very very very very very smart .	the door sings very very very very very very very very very smart .
the rocket was very very very very very very very very very confused .	the rocket waves very very very very very very very very very confused .
the dish was really really really really really really really really really upset .	the dish reads really really really really really really really really really upset .
the bed was very very very very very very very very very surprised .	the bed talks very very very very very very very very very surprised .
the couch was very very very very very very very very very clever .	the couch exercises very very very very very very very very very clever .
the door was really really really really really really really really really hungry .	the door cries really really really really really really really really really hungry .
the picture is really really really really really really really really really curious .	the picture cries really really really really really really really really really curious .
the hat is really really really really really really really really really excited .	the hat paints really really really really really really really really really excited .
the hat is very very very very very very very very very confused .	the hat waves very very very very very very very very very confused .
the truck is very very very very very very very very very wrong .	the truck sings very very very very very very very very very wrong .
the truck was really really really really really really really really really upset .	the truck reads really really really really really really really really really upset .
the shoe was very very very very very very very very very gentle .	the shoe talks very very very very very very very very very gentle .
the bicycle was very very very very very very very very very busy .	the bicycle reads very very very very very very very very very busy .
the bag was really really really really really really really really really bored .	the bag reads really really really really really really really really really bored .
the fork was really really really really really really really really really friendly .	the fork paints really really really really really really really really really friendly .
the book was very very very very very very very very very boring .	the book talks very very very very very very very very very boring .
the doll is very very very very very very very very very gentle .	the doll paints very very very very very very very very very gentle .
the crayon was very very very very very very very very very excited .	the crayon paints very very very very very very very very very excited .
the picture is really really really really really really really really really bored .	the picture talks really really really really really really really really really bored .
the bicycle was very very very very very very very very very busy .	the bicycle talks very very very very very very very very very busy .
the car was very very very very very very very very very tall .	the car sings very very very very very very very very very tall .
the book is really really really really really really really really really confused .	the book paints really really really really really really really really really confused .
the glass is very very very very very very very very very kind .	the glass cries very very very very very very very very very kind .
the bicycle was very very very very very very very very very confused .	the bicycle reads very very very very very very very very very confused .
the car was very very very very very very very very very boring .	the car reads very very very very very very very very very boring .
the plate is really really really really really really really really really boring .	the plate talks really really really really really really really really really boring .
the window was really really really really really really really really really excited .	the window talks really really really really really really really really really excited .
the plate was very very very very very very very very very bored .	the plate paints very very very very very very very very very bored .
the bed was really really really really really really really really really friendly .	the bed paints really really really really really really really really really friendly .
the hat is really really really really really really really really really important .	the hat reads really really really really really really really really really important .
the rug was very very very very very very very very very lucky .	the rug paints very very very very very very very very very lucky .
the bowl was really really really really really really really really really kind .	the bowl cries really really really really really really really really really kind .
the shoe is very very very very very very very very very happy .	the shoe cries very very very very very very very very very happy .
the chair is very very very very very very very very very wrong .	the chair reads very very very very very very very very very wrong .
the bottle was very very very very very very very very very curious .	the bottle sings very very very very very very very very very curious .
the bottle was very very very very very very very very very kind .	the bottle waves very very very very very very very very very kind .
the ring is very very very very very very very very very bored .	the ring paints very very very very very very very very very bored .
the car was really really really really really really really really really hungry .	the car talks really really really really really really really really really hungry .
the bed is very very very very very very very very very tall .	the bed sings very very very very very very very very very tall .
the crayon is really really really really really really really really really careful .	the crayon reads really really really really really really really really really careful .
the cup is very very very very very very very very very confused .	the cup exercises very very very very very very very very very confused .
the bicycle is very very very very very very very very very curious .	the bicycle exercises very very very very very very very very very curious .
the bicycle is very very very very very very very very very confused .	the bicycle talks very very very very very very very very very confused .
the cup is really really really really really really really really really nice .	the cup exercises really really really really really really really really really nice .
the ship is really really really really really really really really really sleepy .	the ship sings really really really really really really really really really sleepy .
the car is very very very very very very very very very important .	the car exercises very very very very very very very very very important .
the doll is very very very very very very very very very friendly .	the doll reads very very very very very very very very very friendly .
the car is very very very very very very very very very quiet .	the car reads very very very very very very very very very quiet .
the ship was really really really really really really really really really young .	the ship waves really really really really really really really really really young .
the plane was really really really really really really really really really nice .	the plane cries really really really really really really really really really nice .
the couch is really really really really really really really really really boring .	the couch waves really really really really really really really really really boring .
the spoon was really really really really really really really really really curious .	the spoon sings really really really really really really really really really curious .
the dish was very very very very very very very very very clever .	the dish talks very very very very very very very very very clever .
the truck was very very very very very very very very very nice .	the truck reads very very very very very very very very very nice .
the window was really really really really really really really really really sleepy .	the window waves really really really really really really really really really sleepy .
the door is really really really really really really really really really confused .	the door reads really really really really really really really really really confused .
the cup was really really really really really really really really really happy .	the cup talks really really really really really really really really really happy .
the plane was really really really really really really really really really upset .	the plane cries really really really really really really really really really upset .
the shoe was really really really really really really really really really curious .	the shoe cries really really really really really really really really really curious .
the boat was very very very very very very very very very surprised .	the boat waves very very very very very very very very very surprised .
the cup was very very very very very very very very very hungry .	the cup talks very very very very very very very very very hungry .
the ship is really really really really really really really really really sleepy .	the ship talks really really really really really really really really really sleepy .
the ship was very very very very very very very very very happy .	the ship talks very very very very very very very very very happy .
the bowl is very very very very very very very very very angry .	the bowl paints very very very very very very very very very angry .
the shirt was very very very very very very very very very hungry .	the shirt reads very very very very very very very very very hungry .
the bag is very very very very very very very very very angry .	the bag sings very very very very very very very very very angry .
the book was very very very very very very very very very tall .	the book paints very very very very very very very very very tall .
the cup is very very very very very very very very very happy .	the cup reads very very very very very very very very very happy .
the ship is very very very very very very very very very happy .	the ship sings very very very very very very very very very happy .
the spoon was very very very very very very very very very nice .	the spoon cries very very very very very very very very very nice .
the rug was really really really really really really really really really kind .	the rug sings really really really really really really really really really kind .
the chair was really really really really really really really really really tired .	the chair sings really really really really really really really really really tired .
the ship was very very very very very very very very very friendly .	the ship sings very very very very very very very very very friendly .
the ship is very very very very very very very very very helpful .	the ship cries very very very very very very very very very helpful .
the couch is really really really really really really really really really happy .	the couch cries really really really really really really really really really happy .
the toy is really really really really really really really really really important .	the toy waves really really really really really really really really really important .
the crayon was very very very very very very very very very tired .	the crayon reads very very very very very very very very very tired .
the bag was really really really really really really really really really clever .	the bag exercises really really really really really really really really really clever .
the rocket is very very very very very very very very very excited .	the rocket cries very very very very very very very very very excited .
the plane is really really really really really really really really really friendly .	the plane talks really really really really really really really really really friendly .
the car was really really really really really really really really really hungry .	the car waves really really really really really really really really really hungry .
the bottle is really really really really really really really really really strong .	the bottle waves really really really really really really really really really strong .
the doll was very very very very very very very very very gentle .	the doll sings very very very very very very very very very gentle .
the ring was very very very very very very very very very curious .	the ring sings very very very very very very very very very curious .
the cup is very very very very very very very very very sleepy .	the cup talks very very very very very very very very very sleepy .
the bed is really really really really really really really really really upset .	the bed waves really really really really really really really really really upset .
the book is really really really really really really really really really strong .	the book cries really really really really really really really really really strong .
the candle is very very very very very very very very very strong .	the candle cries very very very very very very very very very strong .
the chair is really really really really really really really really really sleepy .	the chair reads really really really really really really really really really sleepy .
the car is really really really really really really really really really strong .	the car sings really really really really really really really really really strong .
the rocket was really really really really really really really really really nice .	the rocket paints really really really really really really really really really nice .
the glass was very very very very very very very very very nice .	the glass sings very very very very very very very very very nice .
the rocket was really really really really really really really really really careful .	the rocket sings really really really really really really really really really careful .
the hat is very very very very very very very very very excited .	the hat talks very very very very very very very very very excited .
the shoe is really really really really really really really really really tired .	the shoe cries really really really really really really really really really tired .
the book is really really really really really really really really really happy .	the book waves really really really really really really really really really happy .
the plate was very very very very very very very very very upset .	the plate reads very very very very very very very very very upset .
the book is really really really really really really really really really smart .	the book waves really really really really really really really really really smart .
the mirror is very very very very very very very very very happy .	the mirror sings very very very very very very very very very happy .
the bag was really really really really really really really really really angry .	the bag exercises really really really really really really really really really angry .
the box is very very very very very very very very very lucky .	the box talks very very very very very very very very very lucky .
the dish is really really really really really really really really really smart .	the dish exercises really really really really really really really really really smart .
the plate was really really really really really really really really really hungry .	the plate waves really really really really really really really really really hungry .
the door was very very very very very very very very very boring .	the door cries very very very very very very very very very boring .
the chair was really really really really really really really really really tall .	the chair waves really really really really really really really really really tall .
the spoon was really really really really really really really really really tall .	the spoon paints really really really really really really really really really tall .
the bowl was very very very very very very very very very excited .	the bowl talks very very very very very very very very very excited .
the toy was really really really really really really really really really healthy .	the toy reads really really really really really really really really really healthy .
the box was really really really really really really really really really important .	the box talks really really really really really really really really really important .
the bed is very very very very very very very very very healthy .	the bed exercises very very very very very very very very very healthy .
the doll was really really really really really really really really really curious .	the doll talks really really really really really really really really really curious .
the bottle was really really really really really really really really really kind .	the bottle cries really really really really really really really really really kind .
the truck is very very very very very very very very very gentle .	the truck reads very very very very very very very very very gentle .
the ring was very very very very very very very very very clever .	the ring talks very very very very very very very very very clever .
the rug is really really really really really really really really really lucky .	the rug waves really really really really really really really really really lucky .
the rocket is very very very very very very very very very excited .	the rocket sings very very very very very very very very very excited .
the dish was really really really really really really really really really excited .	the dish waves really really really really really really really really really excited .
the spoon was really really really really really really really really really strong .	the spoon cries really really really really really really really really really strong .
the toy is really really really really really really really really really busy .	the toy exercises really really really really really really really really really busy .
the window is very very very very very very very very very gentle .	the window exercises very very very very very very very very very gentle .
the box is very very very very very very very very very boring .	the box reads very very very very very very very very very boring .
the picture is very very very very very very very very very sleepy .	the picture waves very very very very very very very very very sleepy .
the car was very very very very very very very very very confused .	the car reads very very very very very very very very very confused .
the doll is very very very very very very very very very gentle .	the doll cries very very very very very very very very very gentle .
the rug was really really really really really really really really really sleepy .	the rug sings really really really really really really really really really sleepy .
the bag is very very very very very very very very very happy .	the bag exercises very very very very very very very very very happy .
the picture was very very very very very very very very very surprised .	the picture waves very very very very very very very very very surprised .
the crayon was really really really really really really really really really confused .	the crayon paints really really really really really really really really really confused .
the bowl was very very very very very very very very very important .	the bowl paints very very very very very very very very very important .
the fork was very very very very very very very very very healthy .	the fork reads very very very very very very very very very healthy .
the bed is very very very very very very very very very careful .	the bed waves very very very very very very very very very careful .
the mirror is really really really really really really really really really gentle .	the mirror waves really really really really really really really really really gentle .
the rocket is very very very very very very very very very surprised .	the rocket talks very very very very very very very very very surprised .
the door was very very very very very very very very very lucky .	the door paints very very very very very very very very very lucky .
the ring is really really really really really really really really really friendly .	the ring exercises really really really really really really really really really friendly .
the bottle was really really really really really really really really really kind .	the bottle reads really really really really really really really really really kind .
the spoon is really really really really really really really really really careful .	the spoon sings really really really really really really really really really careful .
the fork was really really really really really really really really really surprised .	the fork talks really really really really really really really really really surprised .
the candle is really really really really really really really really really busy .	the candle sings really really really really really really really really really busy .
the shoe is very very very very very very very very very friendly .	the shoe paints very very very very very very very very very friendly .
the boat was really really really really really really really really really healthy .	the boat waves really really really really really really really really really healthy .
the book is very very very very very very very very very wrong .	the book waves very very very very very very very very very wrong .
the fork was very very very very very very very very very angry .	the fork sings very very very very very very very very very angry .
the cup is very very very very very very very very very busy .	the cup waves very very very very very very very very very busy .
the hat is very very very very very very very very very strong .	the hat sings very very very very very very very very very strong .
the candle was very very very very very very very very very upset .	the candle paints very very very very very very very very very upset .
the crayon was very very very very very very very very very smart .	the crayon exercises very very very very very very very very very smart .
the book was very very very very very very very very very helpful .	the book paints very very very very very very very very very helpful .
the shirt was really really really really really really really really really boring .	the shirt waves really really really really really really really really really boring .
the plate is really really really really really really really really really confused .	the plate exercises really really really really really really really really really confused .
the crayon is really really really really really really really really really curious .	the crayon talks really really really really really really really really really curious .
the fork is very very very very very very very very very angry .	the fork waves very very very very very very very very very angry .
the book is really really really really really really really really really important .	the book waves really really really really really really really really really important .
the spoon was very very very very very very very very very confused .	the spoon sings very very very very very very very very very confused .
the book is very very very very very very very very very sleepy .	the book talks very very very very very very very very very sleepy .
the glass is very very very very very very very very very gentle .	the glass sings very very very very very very very very very gentle .
the book was really really really really really really really really really gentle .	the book sings really really really really really really really really really gentle .
the doll is really really really really really really really really really confused .	the doll talks really really really really really really really really really confused .
the fork was very very very very very very very very very surprised .	the fork cries very very very very very very very very very surprised .
the toy is very very very very very very very very very tall .	the toy sings very very very very very very very very very tall .
the crayon is really really really really really really really really really helpful .	the crayon reads really really really really really really really really really helpful .
the shoe was very very very very very very very very very upset .	the shoe reads very very very very very very very very very upset .
the plane was very very very very very very very very very gentle .	the plane exercises very very very very very very very very very gentle .
the box is really really really really really really really really really wrong .	the box reads really really really really really really really really really wrong .
the toy was very very very very very very very very very smart .	the toy paints very very very very very very very very very smart .
the bowl was really really really really really really really really really boring .	the bowl waves really really really really really really really really really boring .
the button is really really really really really really really really really tall .	the button waves really really really really really really really really really tall .
the bed was very very very very very very very very very important .	the bed talks very very very very very very very very very important .
the crayon is very very very very very very very very very friendly .	the crayon sings very very very very very very very very very friendly .
the window is really really really really really really really really really tall .	the window reads really really really really really really really really really tall .
the spoon is very very very very very very very very very smart .	the spoon reads very very very very very very very very very smart .
the bowl is very very very very very very very very very upset .	the bowl paints very very very very very very very very very upset .
the plate is really really really really really really really really really happy .	the plate reads really really really really really really really really really happy .
the door was very very very very very very very very very nice .	the door cries very very very very very very very very very nice .
the shirt was really really really really really really really really really kind .	the shirt talks really really really really really really really really really kind .
the fork was very very very very very very very very very confused .	the fork waves very very very very very very very very very confused .
the mirror is really really really really really really really really really upset .	the mirror sings really really really really really really really really really upset .
the bag was really really really really really really really really really busy .	the bag sings really really really really really really really really really busy .
the button was very very very very very very very very very young .	the button talks very very very very very very very very very young .
the bag is really really really really really really really really really excited .	the bag cries really really really really really really really really really excited .
the hat is very very very very very very very very very young .	the hat paints very very very very very very very very very young .
the bowl was really really really really really really really really really smart .	the bowl talks really really really really really really really really really smart .
the chair was really really really really really really really really really happy .	the chair sings really really really really really really really really really happy .
the window was really really really really really really really really really curious .	the window cries really really really really really really really really really curious .
the bowl was really really really really really really really really really tall .	the bowl cries really really really really really really really really really tall .
the toy is really really really really really really really really really tired .	the toy cries really really really really really really really really really tired .
the plane is very very very very very very very very very tall .	the plane reads very very very very very very very very very tall .
the shoe was really really really really really really really really really healthy .	the shoe talks really really really really really really really really really healthy .
the fork is really really really really really really really really really strong .	the fork paints really really really really really really really really really strong .
the hat was really really really really really really really really really nice .	the hat exercises really really really really really really really really really nice .
the hat was very very very very very very very very very lucky .	the hat waves very very very very very very very very very lucky .
the button is very very very very very very very very very excited .	the button cries very very very very very very very very very excited .
the chair is really really really really really really really really really friendly .	the chair talks really really really really really really really really really friendly .
the hat was very very very very very very very very very strong .	the hat cries very very very very very very very very very strong .
