the spoon knows that my friend 's daughter 's son 's friend 's grandmother 's grandmother 's rug is quiet .	the spoon works with my friend 's daughter 's son 's friend 's grandmother 's grandmother 's rug is quiet .
the ship thinks that your mom 's dad 's daughter 's dad 's friend 's friend 's boat is lucky .	the ship talks to your mom 's dad 's daughter 's dad 's friend 's friend 's boat is lucky .
the rug knows that your grandmother 's daughter 's sister 's husband 's cousin 's husband 's picture is healthy .	the rug works with your grandmother 's daughter 's sister 's husband 's cousin 's husband 's picture is healthy .
the rocket thinks that my grandmother 's grandmother 's mother 's boss 's dentist 's brother 's shirt is curious .	the rocket talks to my grandmother 's grandmother 's mother 's boss 's dentist 's brother 's shirt is curious .
the couch thinks that your boss 's friend 's wife 's boss 's mother 's husband 's doll is confused .	the couch scares your boss 's friend 's wife 's boss 's mother 's husband 's doll is confused .
the toy says that your dentist 's father 's husband 's grandmother 's mother 's mother 's doll is clever .	the toy works with your dentist 's father 's husband 's grandmother 's mother 's mother 's doll is clever .
the couch says that my friend 's doctor 's doctor 's grandmother 's boss 's husband 's truck is excited .	the couch works with my friend 's doctor 's doctor 's grandmother 's boss 's husband 's truck is excited .
the book knows that your teacher 's sister 's mom 's sister 's mother 's cousin 's crayon is wrong .	the book scares your teacher 's sister 's mom 's sister 's mother 's cousin 's crayon is wrong .
the ring says that my cousin 's mother 's cousin 's husband 's husband 's son 's car is surprised .	the ring scares my cousin 's mother 's cousin 's husband 's husband 's son 's car is surprised .
the fork thinks that your husband 's father 's cousin 's daughter 's doctor 's daughter 's doll is gentle .	the fork helps your husband 's father 's cousin 's daughter 's doctor 's daughter 's doll is gentle .
the shoe knows that your daughter 's father 's grandmother 's husband 's husband 's dad 's toy is hungry .	the shoe works with your daughter 's father 's grandmother 's husband 's husband 's dad 's toy is hungry .
the couch knows that your cousin 's wife 's son 's dentist 's cousin 's daughter 's car is gentle .	the couch scares your cousin 's wife 's son 's dentist 's cousin 's daughter 's car is gentle .
the book thinks that your mom 's son 's doctor 's boss 's cousin 's daughter 's crayon is angry .	the book helps your mom 's son 's doctor 's boss 's cousin 's daughter 's crayon is angry .
the rocket says that your son 's dad 's boss 's boss 's husband 's cousin 's mirror is clever .	the rocket talks to your son 's dad 's boss 's boss 's husband 's cousin 's mirror is clever .
the rocket knows that my doctor 's dentist 's daughter 's husband 's cousin 's mom 's book is boring .	the rocket helps my doctor 's dentist 's daughter 's husband 's cousin 's mom 's book is boring .
the dish knows that my friend 's cousin 's father 's teacher 's father 's son 's couch is tall .	the dish helps my friend 's cousin 's father 's teacher 's father 's son 's couch is tall .
the ring thinks that your cousin 's mother 's dad 's wife 's father 's sister 's rug is tired .	the ring scares your cousin 's mother 's dad 's wife 's father 's sister 's rug is tired .
the bowl says that my brother 's boss 's teacher 's dentist 's mother 's doctor 's car is young .	the bowl talks to my brother 's boss 's teacher 's dentist 's mother 's doctor 's car is young .
the picture knows that your wife 's son 's mother 's daughter 's wife 's husband 's box is young .	the picture talks to your wife 's son 's mother 's daughter 's wife 's husband 's box is young .
the book knows that my grandmother 's wife 's doctor 's husband 's sister 's daughter 's rocket is hungry .	the book scares my grandmother 's wife 's doctor 's husband 's sister 's daughter 's rocket is hungry .
the bicycle knows that your friend 's wife 's cousin 's father 's boss 's friend 's hat is clever .	the bicycle talks to your friend 's wife 's cousin 's father 's boss 's friend 's hat is clever .
the mirror knows that my doctor 's friend 's son 's teacher 's sister 's husband 's toy is helpful .	the mirror works with my doctor 's friend 's son 's teacher 's sister 's husband 's toy is helpful .
the plane knows that your sister 's wife 's doctor 's dad 's son 's brother 's car is important .	the plane works with your sister 's wife 's doctor 's dad 's son 's brother 's car is important .
the plane says that your brother 's wife 's dentist 's daughter 's son 's friend 's mirror is important .	the plane helps your brother 's wife 's dentist 's daughter 's son 's friend 's mirror is important .
the dish knows that your teacher 's husband 's boss 's teacher 's mom 's doctor 's spoon is strong .	the dish talks to your teacher 's husband 's boss 's teacher 's mom 's doctor 's spoon is strong .
the picture knows that your daughter 's father 's sister 's teacher 's son 's son 's crayon is hungry .	the picture talks to your daughter 's father 's sister 's teacher 's son 's son 's crayon is hungry .
the hat says that your father 's friend 's dad 's husband 's wife 's son 's book is excited .	the hat talks to your father 's friend 's dad 's husband 's wife 's son 's book is excited .
the fork says that my dentist 's cousin 's son 's mother 's grandmother 's sister 's ring is tired .	the fork works with my dentist 's cousin 's son 's mother 's grandmother 's sister 's ring is tired .
the book thinks that my brother 's mom 's teacher 's father 's friend 's dentist 's chair is lucky .	the book works with my brother 's mom 's teacher 's father 's friend 's dentist 's chair is lucky .
the car says that my son 's mom 's husband 's friend 's daughter 's dad 's bicycle is strong .	the car helps my son 's mom 's husband 's friend 's daughter 's dad 's bicycle is strong .
the fork knows that your father 's friend 's friend 's wife 's son 's mother 's bag is important .	the fork talks to your father 's friend 's friend 's wife 's son 's mother 's bag is important .
the shirt says that my brother 's doctor 's dad 's teacher 's doctor 's sister 's book is tired .	the shirt talks to my brother 's doctor 's dad 's teacher 's doctor 's sister 's book is tired .
the bed says that my dentist 's mom 's son 's brother 's dad 's brother 's hat is sleepy .	the bed scares my dentist 's mom 's son 's brother 's dad 's brother 's hat is sleepy .
the bed knows that my mom 's boss 's dad 's wife 's dad 's cousin 's box is confused .	the bed helps my mom 's boss 's dad 's wife 's dad 's cousin 's box is confused .
the couch knows that my dad 's father 's doctor 's grandmother 's grandmother 's teacher 's bowl is confused .	the couch talks to my dad 's father 's doctor 's grandmother 's grandmother 's teacher 's bowl is confused .
the picture knows that my dad 's daughter 's son 's dentist 's dad 's wife 's plate is tall .	the picture talks to my dad 's daughter 's son 's dentist 's dad 's wife 's plate is tall .
the car says that my mother 's brother 's friend 's grandmother 's cousin 's dentist 's cup is nice .	the car helps my mother 's brother 's friend 's grandmother 's cousin 's dentist 's cup is nice .
the crayon thinks that your wife 's husband 's cousin 's doctor 's dentist 's son 's couch is excited .	the crayon talks to your wife 's husband 's cousin 's doctor 's dentist 's son 's couch is excited .
the picture says that my dentist 's dentist 's mom 's father 's mom 's boss 's ship is smart .	the picture talks to my dentist 's dentist 's mom 's father 's mom 's boss 's ship is smart .
the rocket thinks that my mother 's son 's mom 's father 's brother 's wife 's fork is hungry .	the rocket works with my mother 's son 's mom 's father 's brother 's wife 's fork is hungry .
the door says that your brother 's teacher 's dentist 's grandmother 's dad 's friend 's rug is kind .	the door works with your brother 's teacher 's dentist 's grandmother 's dad 's friend 's rug is kind .
the rocket thinks that my teacher 's brother 's dad 's teacher 's sister 's teacher 's bag is kind .	the rocket talks to my teacher 's brother 's dad 's teacher 's sister 's teacher 's bag is kind .
the doll knows that my husband 's teacher 's grandmother 's grandmother 's wife 's dentist 's plane is kind .	the doll works with my husband 's teacher 's grandmother 's grandmother 's wife 's dentist 's plane is kind .
the candle knows that your friend 's son 's mother 's doctor 's daughter 's brother 's bag is hungry .	the candle talks to your friend 's son 's mother 's doctor 's daughter 's brother 's bag is hungry .
the window knows that your wife 's sister 's wife 's cousin 's son 's husband 's car is quiet .	the window helps your wife 's sister 's wife 's cousin 's son 's husband 's car is quiet .
the candle says that your father 's son 's boss 's husband 's grandmother 's daughter 's bag is healthy .	the candle helps your father 's son 's boss 's husband 's grandmother 's daughter 's bag is healthy .
the boat thinks that your son 's dentist 's grandmother 's daughter 's mother 's sister 's book is lucky .	the boat helps your son 's dentist 's grandmother 's daughter 's mother 's sister 's book is lucky .
the boat knows that my friend 's brother 's brother 's dad 's son 's dentist 's cup is important .	the boat scares my friend 's brother 's brother 's dad 's son 's dentist 's cup is important .
the door knows that my boss 's friend 's dad 's teacher 's boss 's friend 's rug is curious .	the door scares my boss 's friend 's dad 's teacher 's boss 's friend 's rug is curious .
the book says that your grandmother 's brother 's son 's dad 's mom 's daughter 's window is happy .	the book works with your grandmother 's brother 's son 's dad 's mom 's daughter 's window is happy .
the truck knows that my dad 's brother 's sister 's dad 's sister 's boss 's bag is angry .	the truck talks to my dad 's brother 's sister 's dad 's sister 's boss 's bag is angry .
the picture thinks that your mom 's dentist 's sister 's husband 's sister 's friend 's bed is angry .	the picture talks to your mom 's dentist 's sister 's husband 's sister 's friend 's bed is angry .
the toy thinks that your cousin 's son 's boss 's son 's sister 's wife 's plate is happy .	the toy scares your cousin 's son 's boss 's son 's sister 's wife 's plate is happy .
the dish thinks that your brother 's grandmother 's mother 's wife 's dentist 's boss 's glass is smart .	the dish works with your brother 's grandmother 's mother 's wife 's dentist 's boss 's glass is smart .
the box knows that your dad 's mom 's friend 's dad 's daughter 's father 's mirror is hungry .	the box talks to your dad 's mom 's friend 's dad 's daughter 's father 's mirror is hungry .
the dish knows that my mom 's boss 's friend 's husband 's son 's husband 's chair is happy .	the dish helps my mom 's boss 's friend 's husband 's son 's husband 's chair is happy .
the car knows that your friend 's sister 's daughter 's sister 's brother 's son 's rug is bored .	the car talks to your friend 's sister 's daughter 's sister 's brother 's son 's rug is bored .
the spoon knows that my doctor 's teacher 's husband 's mother 's cousin 's cousin 's ring is upset .	the spoon works with my doctor 's teacher 's husband 's mother 's cousin 's cousin 's ring is upset .
the boat thinks that your father 's brother 's cousin 's brother 's grandmother 's daughter 's crayon is busy .	the boat talks to your father 's brother 's cousin 's brother 's grandmother 's daughter 's crayon is busy .
the glass thinks that your teacher 's son 's daughter 's doctor 's mom 's wife 's book is wrong .	the glass works with your teacher 's son 's daughter 's doctor 's mom 's wife 's book is wrong .
the bed says that your dentist 's husband 's mother 's boss 's cousin 's grandmother 's car is sleepy .	the bed scares your dentist 's husband 's mother 's boss 's cousin 's grandmother 's car is sleepy .
the bag knows that my mom 's dad 's dentist 's wife 's cousin 's sister 's plate is tired .	the bag talks to my mom 's dad 's dentist 's wife 's cousin 's sister 's plate is tired .
the couch says that my brother 's grandmother 's wife 's husband 's cousin 's husband 's bed is lucky .	the couch works with my brother 's grandmother 's wife 's husband 's cousin 's husband 's bed is lucky .
the car knows that my boss 's husband 's grandmother 's wife 's cousin 's daughter 's window is young .	the car scares my boss 's husband 's grandmother 's wife 's cousin 's daughter 's window is young .
the car thinks that my boss 's grandmother 's husband 's son 's mother 's son 's bag is friendly .	the car scares my boss 's grandmother 's husband 's son 's mother 's son 's bag is friendly .
the plane thinks that my husband 's cousin 's wife 's boss 's doctor 's sister 's toy is helpful .	the plane helps my husband 's cousin 's wife 's boss 's doctor 's sister 's toy is helpful .
the car says that your brother 's cousin 's doctor 's dad 's dad 's boss 's picture is upset .	the car helps your brother 's cousin 's doctor 's dad 's dad 's boss 's picture is upset .
the ring says that your wife 's husband 's sister 's daughter 's doctor 's daughter 's bowl is angry .	the ring helps your wife 's husband 's sister 's daughter 's doctor 's daughter 's bowl is angry .
the shirt thinks that my daughter 's boss 's son 's father 's mom 's teacher 's mirror is nice .	the shirt helps my daughter 's boss 's son 's father 's mom 's teacher 's mirror is nice .
the shoe says that my mom 's father 's mom 's mom 's husband 's brother 's truck is helpful .	the shoe scares my mom 's father 's mom 's mom 's husband 's brother 's truck is helpful .
the bicycle says that your boss 's boss 's teacher 's daughter 's doctor 's friend 's plate is excited .	the bicycle works with your boss 's boss 's teacher 's daughter 's doctor 's friend 's plate is excited .
the door says that my dad 's dad 's wife 's father 's mom 's grandmother 's toy is quiet .	the door talks to my dad 's dad 's wife 's father 's mom 's grandmother 's toy is quiet .
the ship knows that your brother 's brother 's brother 's wife 's dad 's son 's bowl is boring .	the ship talks to your brother 's brother 's brother 's wife 's dad 's son 's bowl is boring .
the rug says that your friend 's husband 's cousin 's brother 's dad 's friend 's fork is kind .	the rug scares your friend 's husband 's cousin 's brother 's dad 's friend 's fork is kind .
the chair says that your friend 's dentist 's father 's brother 's father 's husband 's chair is excited .	the chair helps your friend 's dentist 's father 's brother 's father 's husband 's chair is excited .
the book says that my friend 's daughter 's cousin 's father 's teacher 's doctor 's plane is careful .	the book talks to my friend 's daughter 's cousin 's father 's teacher 's doctor 's plane is careful .
the glass says that your father 's brother 's mom 's son 's dad 's father 's bicycle is quiet .	the glass talks to your father 's brother 's mom 's son 's dad 's father 's bicycle is quiet .
the cup says that your husband 's son 's wife 's boss 's sister 's cousin 's boat is angry .	the cup talks to your husband 's son 's wife 's boss 's sister 's cousin 's boat is angry .
the cup says that your mother 's doctor 's mother 's grandmother 's boss 's dentist 's rocket is boring .	the cup scares your mother 's doctor 's mother 's grandmother 's boss 's dentist 's rocket is boring .
the bottle thinks that my brother 's daughter 's friend 's wife 's cousin 's mom 's candle is busy .	the bottle helps my brother 's daughter 's friend 's wife 's cousin 's mom 's candle is busy .
the bicycle says that your son 's teacher 's friend 's husband 's grandmother 's mother 's boat is tall .	the bicycle helps your son 's teacher 's friend 's husband 's grandmother 's mother 's boat is tall .
the mirror thinks that your grandmother 's son 's husband 's mother 's sister 's grandmother 's rocket is important .	the mirror helps your grandmother 's son 's husband 's mother 's sister 's grandmother 's rocket is important .
the window knows that my grandmother 's mother 's dentist 's mother 's dentist 's wife 's bed is quiet .	the window works with my grandmother 's mother 's dentist 's mother 's dentist 's wife 's bed is quiet .
the door thinks that your father 's sister 's teacher 's father 's friend 's father 's bag is confused .	the door works with your father 's sister 's teacher 's father 's friend 's father 's bag is confused .
the button says that my sister 's mom 's wife 's husband 's teacher 's boss 's toy is tall .	the button talks to my sister 's mom 's wife 's husband 's teacher 's boss 's toy is tall .
the plane knows that my dad 's sister 's daughter 's brother 's sister 's husband 's spoon is smart .	the plane helps my dad 's sister 's daughter 's brother 's sister 's husband 's spoon is smart .
the dish says that my dentist 's daughter 's husband 's husband 's dentist 's teacher 's book is angry .	the dish works with my dentist 's daughter 's husband 's husband 's dentist 's teacher 's book is angry .
the book says that my teacher 's daughter 's sister 's grandmother 's mom 's brother 's doll is tall .	the book works with my teacher 's daughter 's sister 's grandmother 's mom 's brother 's doll is tall .
the bicycle knows that your teacher 's grandmother 's boss 's doctor 's father 's dentist 's truck is sleepy .	the bicycle helps your teacher 's grandmother 's boss 's doctor 's father 's dentist 's truck is sleepy .
the doll thinks that my friend 's cousin 's sister 's dad 's son 's friend 's book is healthy .	the doll helps my friend 's cousin 's sister 's dad 's son 's friend 's book is healthy .
the bowl knows that your sister 's cousin 's boss 's mom 's daughter 's brother 's button is healthy .	the bowl talks to your sister 's cousin 's boss 's mom 's daughter 's brother 's button is healthy .
the dish thinks that my father 's husband 's friend 's son 's daughter 's mom 's spoon is curious .	the dish talks to my father 's husband 's friend 's son 's daughter 's mom 's spoon is curious .
the rocket says that your boss 's dentist 's mom 's son 's grandmother 's boss 's rocket is curious .	the rocket scares your boss 's dentist 's mom 's son 's grandmother 's boss 's rocket is curious .
the box says that my dad 's husband 's friend 's wife 's father 's dentist 's ring is wrong .	the box works with my dad 's husband 's friend 's wife 's father 's dentist 's ring is wrong .
the doll knows that your dentist 's wife 's son 's brother 's friend 's son 's mirror is hungry .	the doll talks to your dentist 's wife 's son 's brother 's friend 's son 's mirror is hungry .
the spoon says that your mom 's daughter 's sister 's dad 's husband 's father 's candle is wrong .	the spoon talks to your mom 's daughter 's sister 's dad 's husband 's father 's candle is wrong .
the couch thinks that my teacher 's cousin 's boss 's doctor 's husband 's grandmother 's window is tired .	the couch works with my teacher 's cousin 's boss 's doctor 's husband 's grandmother 's window is tired .
the bottle thinks that your cousin 's wife 's daughter 's cousin 's cousin 's friend 's bottle is surprised .	the bottle works with your cousin 's wife 's daughter 's cousin 's cousin 's friend 's bottle is surprised .
the window thinks that your son 's son 's dentist 's grandmother 's cousin 's friend 's bicycle is boring .	the window works with your son 's son 's dentist 's grandmother 's cousin 's friend 's bicycle is boring .
the plate says that my cousin 's brother 's mother 's brother 's brother 's doctor 's shoe is tired .	the plate helps my cousin 's brother 's mother 's brother 's brother 's doctor 's shoe is tired .
the chair knows that your daughter 's doctor 's son 's father 's doctor 's sister 's mirror is quiet .	the chair works with your daughter 's doctor 's son 's father 's doctor 's sister 's mirror is quiet .
the rocket knows that your doctor 's sister 's daughter 's dad 's sister 's dentist 's truck is helpful .	the rocket scares your doctor 's sister 's daughter 's dad 's sister 's dentist 's truck is helpful .
the mirror knows that your boss 's teacher 's brother 's brother 's dad 's friend 's toy is strong .	the mirror works with your boss 's teacher 's brother 's brother 's dad 's friend 's toy is strong .
the bed thinks that your dentist 's brother 's wife 's wife 's mother 's dentist 's doll is angry .	the bed scares your dentist 's brother 's wife 's wife 's mother 's dentist 's doll is angry .
the box thinks that your friend 's cousin 's mom 's brother 's mother 's teacher 's crayon is bored .	the box helps your friend 's cousin 's mom 's brother 's mother 's teacher 's crayon is bored .
the bed thinks that your husband 's wife 's boss 's father 's cousin 's cousin 's fork is curious .	the bed talks to your husband 's wife 's boss 's father 's cousin 's cousin 's fork is curious .
the bowl thinks that my friend 's boss 's daughter 's father 's wife 's father 's book is wrong .	the bowl helps my friend 's boss 's daughter 's father 's wife 's father 's book is wrong .
the rug says that my son 's mother 's sister 's teacher 's cousin 's mom 's chair is curious .	the rug talks to my son 's mother 's sister 's teacher 's cousin 's mom 's chair is curious .
the bicycle knows that my sister 's mom 's son 's daughter 's wife 's mother 's rug is tired .	the bicycle works with my sister 's mom 's son 's daughter 's wife 's mother 's rug is tired .
the plane knows that my grandmother 's teacher 's dentist 's grandmother 's father 's daughter 's picture is important .	the plane works with my grandmother 's teacher 's dentist 's grandmother 's father 's daughter 's picture is important .
the book says that your dad 's mother 's father 's doctor 's son 's mother 's fork is tall .	the book helps your dad 's mother 's father 's doctor 's son 's mother 's fork is tall .
the cup says that your son 's son 's grandmother 's dad 's husband 's son 's bottle is boring .	the cup scares your son 's son 's grandmother 's dad 's husband 's son 's bottle is boring .
the mirror thinks that my brother 's son 's mother 's doctor 's son 's friend 's toy is lucky .	the mirror helps my brother 's son 's mother 's doctor 's son 's friend 's toy is lucky .
the bag thinks that my brother 's brother 's daughter 's daughter 's father 's dad 's ship is nice .	the bag works with my brother 's brother 's daughter 's daughter 's father 's dad 's ship is nice .
the bowl thinks that my friend 's daughter 's husband 's son 's husband 's mom 's car is upset .	the bowl helps my friend 's daughter 's husband 's son 's husband 's mom 's car is upset .
the crayon thinks that my sister 's dentist 's daughter 's daughter 's cousin 's cousin 's truck is sleepy .	the crayon talks to my sister 's dentist 's daughter 's daughter 's cousin 's cousin 's truck is sleepy .
the picture thinks that your daughter 's wife 's teacher 's boss 's grandmother 's son 's bowl is hungry .	the picture works with your daughter 's wife 's teacher 's boss 's grandmother 's son 's bowl is hungry .
the rocket says that your grandmother 's mom 's sister 's sister 's son 's father 's car is nice .	the rocket talks to your grandmother 's mom 's sister 's sister 's son 's father 's car is nice .
the book thinks that my dentist 's dad 's teacher 's doctor 's dad 's dad 's mirror is healthy .	the book works with my dentist 's dad 's teacher 's doctor 's dad 's dad 's mirror is healthy .
the glass thinks that your cousin 's wife 's sister 's dentist 's brother 's daughter 's truck is lucky .	the glass helps your cousin 's wife 's sister 's dentist 's brother 's daughter 's truck is lucky .
the mirror knows that my father 's doctor 's dad 's dentist 's brother 's daughter 's ring is lucky .	the mirror scares my father 's doctor 's dad 's dentist 's brother 's daughter 's ring is lucky .
the button knows that your cousin 's doctor 's teacher 's mom 's wife 's friend 's car is gentle .	the button works with your cousin 's doctor 's teacher 's mom 's wife 's friend 's car is gentle .
the car thinks that your son 's friend 's doctor 's daughter 's teacher 's teacher 's truck is young .	the car scares your son 's friend 's doctor 's daughter 's teacher 's teacher 's truck is young .
the cup knows that my mom 's mom 's mom 's dad 's boss 's mom 's crayon is boring .	the cup talks to my mom 's mom 's mom 's dad 's boss 's mom 's crayon is boring .
the ring says that your father 's wife 's wife 's cousin 's sister 's dad 's hat is kind .	the ring helps your father 's wife 's wife 's cousin 's sister 's dad 's hat is kind .
the hat says that my doctor 's husband 's husband 's dentist 's father 's grandmother 's truck is smart .	the hat scares my doctor 's husband 's husband 's dentist 's father 's grandmother 's truck is smart .
the window thinks that my friend 's husband 's grandmother 's son 's mother 's mother 's car is kind .	the window scares my friend 's husband 's grandmother 's son 's mother 's mother 's car is kind .
the spoon thinks that your friend 's mom 's son 's dentist 's doctor 's son 's book is careful .	the spoon helps your friend 's mom 's son 's dentist 's doctor 's son 's book is careful .
the cup says that my brother 's grandmother 's son 's father 's friend 's doctor 's mirror is helpful .	the cup scares my brother 's grandmother 's son 's father 's friend 's doctor 's mirror is helpful .
the picture knows that my cousin 's teacher 's son 's husband 's sister 's dentist 's boat is strong .	the picture helps my cousin 's teacher 's son 's husband 's sister 's dentist 's boat is strong .
the mirror knows that my doctor 's dentist 's friend 's cousin 's mom 's brother 's shirt is helpful .	the mirror scares my doctor 's dentist 's friend 's cousin 's mom 's brother 's shirt is helpful .
the boat thinks that your doctor 's wife 's daughter 's grandmother 's wife 's wife 's bottle is excited .	the boat scares your doctor 's wife 's daughter 's grandmother 's wife 's wife 's bottle is excited .
the car knows that my son 's father 's boss 's mother 's boss 's grandmother 's rocket is busy .	the car talks to my son 's father 's boss 's mother 's boss 's grandmother 's rocket is busy .
the hat says that my grandmother 's father 's dad 's mother 's mother 's dentist 's car is gentle .	the hat works with my grandmother 's father 's dad 's mother 's mother 's dentist 's car is gentle .
the plate thinks that my mother 's brother 's husband 's cousin 's husband 's dad 's candle is bored .	the plate helps my mother 's brother 's husband 's cousin 's husband 's dad 's candle is bored .
the candle says that your brother 's doctor 's wife 's boss 's mother 's doctor 's button is excited .	the candle scares your brother 's doctor 's wife 's boss 's mother 's doctor 's button is excited .
the mirror says that my cousin 's daughter 's friend 's husband 's son 's husband 's bag is quiet .	the mirror helps my cousin 's daughter 's friend 's husband 's son 's husband 's bag is quiet .
the dish thinks that my father 's dentist 's mother 's daughter 's daughter 's boss 's dish is careful .	the dish works with my father 's dentist 's mother 's daughter 's daughter 's boss 's dish is careful .
the crayon thinks that my grandmother 's grandmother 's teacher 's friend 's sister 's son 's ring is tall .	the crayon scares my grandmother 's grandmother 's teacher 's friend 's sister 's son 's ring is tall .
the plane knows that my boss 's friend 's teacher 's doctor 's husband 's dad 's ring is sleepy .	the plane works with my boss 's friend 's teacher 's doctor 's husband 's dad 's ring is sleepy .
the book thinks that my mom 's doctor 's cousin 's wife 's brother 's mom 's plane is curious .	the book helps my mom 's doctor 's cousin 's wife 's brother 's mom 's plane is curious .
the plane knows that your mother 's daughter 's teacher 's son 's grandmother 's dad 's boat is wrong .	the plane helps your mother 's daughter 's teacher 's son 's grandmother 's dad 's boat is wrong .
the hat knows that my doctor 's mother 's husband 's wife 's brother 's mom 's boat is angry .	the hat works with my doctor 's mother 's husband 's wife 's brother 's mom 's boat is angry .
the shoe knows that your friend 's daughter 's son 's husband 's brother 's daughter 's chair is surprised .	the shoe talks to your friend 's daughter 's son 's husband 's brother 's daughter 's chair is surprised .
the mirror says that my mom 's sister 's husband 's brother 's son 's teacher 's glass is wrong .	the mirror works with my mom 's sister 's husband 's brother 's son 's teacher 's glass is wrong .
the dish knows that my dentist 's dentist 's father 's dentist 's friend 's brother 's door is important .	the dish scares my dentist 's dentist 's father 's dentist 's friend 's brother 's door is important .
the boat thinks that your husband 's doctor 's teacher 's cousin 's daughter 's mom 's shirt is nice .	the boat scares your husband 's doctor 's teacher 's cousin 's daughter 's mom 's shirt is nice .
the chair thinks that my mother 's grandmother 's mom 's daughter 's friend 's father 's glass is clever .	the chair talks to my mother 's grandmother 's mom 's daughter 's friend 's father 's glass is clever .
the shirt knows that my cousin 's doctor 's mother 's doctor 's grandmother 's mom 's shoe is upset .	the shirt talks to my cousin 's doctor 's mother 's doctor 's grandmother 's mom 's shoe is upset .
the candle thinks that your grandmother 's mother 's dad 's mother 's friend 's daughter 's bag is important .	the candle scares your grandmother 's mother 's dad 's mother 's friend 's daughter 's bag is important .
the shoe knows that my daughter 's husband 's brother 's boss 's mom 's sister 's bag is tired .	the shoe helps my daughter 's husband 's brother 's boss 's mom 's sister 's bag is tired .
the dish knows that your husband 's grandmother 's dentist 's doctor 's teacher 's sister 's book is excited .	the dish scares your husband 's grandmother 's dentist 's doctor 's teacher 's sister 's book is excited .
the truck says that your mom 's son 's dad 's son 's mother 's husband 's button is strong .	the truck helps your mom 's son 's dad 's son 's mother 's husband 's button is strong .
the ring knows that your sister 's mother 's father 's dad 's friend 's doctor 's rocket is smart .	the ring works with your sister 's mother 's father 's dad 's friend 's doctor 's rocket is smart .
the spoon knows that my mother 's boss 's mom 's brother 's grandmother 's friend 's glass is upset .	the spoon helps my mother 's boss 's mom 's brother 's grandmother 's friend 's glass is upset .
the picture says that my brother 's teacher 's boss 's sister 's sister 's grandmother 's book is sleepy .	the picture helps my brother 's teacher 's boss 's sister 's sister 's grandmother 's book is sleepy .
the book says that your teacher 's teacher 's father 's friend 's dad 's daughter 's boat is quiet .	the book helps your teacher 's teacher 's father 's friend 's dad 's daughter 's boat is quiet .
the cup thinks that my friend 's doctor 's mom 's mother 's husband 's boss 's plane is tall .	the cup works with my friend 's doctor 's mom 's mother 's husband 's boss 's plane is tall .
the picture thinks that my doctor 's dentist 's daughter 's dad 's son 's brother 's plane is healthy .	the picture works with my doctor 's dentist 's daughter 's dad 's son 's brother 's plane is healthy .
the button thinks that my cousin 's dad 's friend 's husband 's sister 's wife 's picture is upset .	the button talks to my cousin 's dad 's friend 's husband 's sister 's wife 's picture is upset .
the rocket knows that your dentist 's doctor 's friend 's cousin 's friend 's son 's shirt is important .	the rocket works with your dentist 's doctor 's friend 's cousin 's friend 's son 's shirt is important .
the ring knows that my dad 's sister 's mom 's dad 's mother 's teacher 's box is curious .	the ring scares my dad 's sister 's mom 's dad 's mother 's teacher 's box is curious .
the picture thinks that your daughter 's wife 's dad 's brother 's sister 's sister 's book is important .	the picture scares your daughter 's wife 's dad 's brother 's sister 's sister 's book is important .
the bowl says that your father 's dad 's wife 's dad 's daughter 's son 's book is important .	the bowl works with your father 's dad 's wife 's dad 's daughter 's son 's book is important .
the bowl says that your teacher 's husband 's dad 's boss 's grandmother 's doctor 's glass is gentle .	the bowl helps your teacher 's husband 's dad 's boss 's grandmother 's doctor 's glass is gentle .
the rug knows that your brother 's friend 's daughter 's mother 's husband 's daughter 's dish is upset .	the rug works with your brother 's friend 's daughter 's mother 's husband 's daughter 's dish is upset .
the boat thinks that my boss 's father 's cousin 's sister 's cousin 's dad 's dish is hungry .	the boat talks to my boss 's father 's cousin 's sister 's cousin 's dad 's dish is hungry .
the bicycle thinks that your teacher 's mother 's father 's father 's daughter 's sister 's rug is young .	the bicycle works with your teacher 's mother 's father 's father 's daughter 's sister 's rug is young .
the chair thinks that my brother 's cousin 's grandmother 's dad 's doctor 's cousin 's plane is angry .	the chair talks to my brother 's cousin 's grandmother 's dad 's doctor 's cousin 's plane is angry .
the car knows that my wife 's brother 's doctor 's mom 's sister 's son 's door is kind .	the car scares my wife 's brother 's doctor 's mom 's sister 's son 's door is kind .
the shoe thinks that my sister 's daughter 's wife 's friend 's boss 's mother 's spoon is kind .	the shoe works with my sister 's daughter 's wife 's friend 's boss 's mother 's spoon is kind .
the hat knows that your brother 's son 's boss 's husband 's grandmother 's mother 's shoe is kind .	the hat helps your brother 's son 's boss 's husband 's grandmother 's mother 's shoe is kind .
the button says that my grandmother 's son 's brother 's cousin 's mother 's sister 's truck is careful .	the button talks to my grandmother 's son 's brother 's cousin 's mother 's sister 's truck is careful .
the ship knows that my father 's sister 's mom 's grandmother 's father 's dad 's crayon is tall .	the ship scares my father 's sister 's mom 's grandmother 's father 's dad 's crayon is tall .
the mirror knows that your mom 's daughter 's dentist 's son 's mother 's cousin 's chair is careful .	the mirror scares your mom 's daughter 's dentist 's son 's mother 's cousin 's chair is careful .
the mirror says that your cousin 's grandmother 's grandmother 's husband 's cousin 's dentist 's chair is quiet .	the mirror talks to your cousin 's grandmother 's grandmother 's husband 's cousin 's dentist 's chair is quiet .
the door thinks that your mother 's mother 's friend 's son 's father 's husband 's glass is happy .	the door helps your mother 's mother 's friend 's son 's father 's husband 's glass is happy .
the button knows that your mother 's brother 's brother 's teacher 's husband 's boss 's shirt is busy .	the button talks to your mother 's brother 's brother 's teacher 's husband 's boss 's shirt is busy .
the window knows that my doctor 's daughter 's dad 's son 's sister 's teacher 's truck is excited .	the window scares my doctor 's daughter 's dad 's son 's sister 's teacher 's truck is excited .
the bed thinks that your cousin 's wife 's grandmother 's boss 's daughter 's boss 's picture is curious .	the bed scares your cousin 's wife 's grandmother 's boss 's daughter 's boss 's picture is curious .
the bowl says that my wife 's brother 's dad 's mom 's boss 's son 's plate is clever .	the bowl talks to my wife 's brother 's dad 's mom 's boss 's son 's plate is clever .
the bed thinks that your boss 's mother 's brother 's doctor 's father 's dentist 's bicycle is smart .	the bed scares your boss 's mother 's brother 's doctor 's father 's dentist 's bicycle is smart .
the hat thinks that my sister 's doctor 's father 's sister 's grandmother 's sister 's plate is young .	the hat scares my sister 's doctor 's father 's sister 's grandmother 's sister 's plate is young .
the bottle knows that your daughter 's father 's sister 's doctor 's father 's daughter 's ring is sleepy .	the bottle works with your daughter 's father 's sister 's doctor 's father 's daughter 's ring is sleepy .
the shirt knows that your sister 's boss 's doctor 's mother 's son 's son 's cup is sleepy .	the shirt talks to your sister 's boss 's doctor 's mother 's son 's son 's cup is sleepy .
the chair says that your mom 's grandmother 's brother 's sister 's teacher 's boss 's car is careful .	the chair works with your mom 's grandmother 's brother 's sister 's teacher 's boss 's car is careful .
the shoe thinks that my daughter 's friend 's wife 's grandmother 's teacher 's doctor 's rug is tired .	the shoe helps my daughter 's friend 's wife 's grandmother 's teacher 's doctor 's rug is tired .
the plane knows that my grandmother 's daughter 's father 's dentist 's dentist 's brother 's chair is careful .	the plane helps my grandmother 's daughter 's father 's dentist 's dentist 's brother 's chair is careful .
the fork says that my dentist 's husband 's friend 's father 's wife 's boss 's bicycle is young .	the fork helps my dentist 's husband 's friend 's father 's wife 's boss 's bicycle is young .
the ring knows that your grandmother 's husband 's daughter 's grandmother 's daughter 's husband 's rug is smart .	the ring works with your grandmother 's husband 's daughter 's grandmother 's daughter 's husband 's rug is smart .
the shirt thinks that your wife 's daughter 's sister 's teacher 's sister 's daughter 's car is clever .	the shirt helps your wife 's daughter 's sister 's teacher 's sister 's daughter 's car is clever .
the mirror says that your cousin 's doctor 's teacher 's dentist 's boss 's husband 's couch is young .	the mirror helps your cousin 's doctor 's teacher 's dentist 's boss 's husband 's couch is young .
the door knows that my mother 's teacher 's sister 's mother 's doctor 's son 's bottle is clever .	the door helps my mother 's teacher 's sister 's mother 's doctor 's son 's bottle is clever .
the crayon thinks that your son 's son 's brother 's boss 's daughter 's boss 's toy is happy .	the crayon helps your son 's son 's brother 's boss 's daughter 's boss 's toy is happy .
the boat says that my daughter 's wife 's cousin 's boss 's dentist 's sister 's spoon is surprised .	the boat scares my daughter 's wife 's cousin 's boss 's dentist 's sister 's spoon is surprised .
the crayon says that my wife 's father 's grandmother 's husband 's dentist 's cousin 's glass is young .	the crayon talks to my wife 's father 's grandmother 's husband 's dentist 's cousin 's glass is young .
the door thinks that your son 's teacher 's cousin 's wife 's father 's friend 's glass is careful .	the door helps your son 's teacher 's cousin 's wife 's father 's friend 's glass is careful .
the book knows that your mom 's husband 's daughter 's boss 's friend 's brother 's shoe is hungry .	the book scares your mom 's husband 's daughter 's boss 's friend 's brother 's shoe is hungry .
the shoe says that my wife 's doctor 's mother 's sister 's friend 's mother 's boat is hungry .	the shoe talks to my wife 's doctor 's mother 's sister 's friend 's mother 's boat is hungry .
the bed thinks that my mother 's mom 's sister 's teacher 's boss 's teacher 's doll is happy .	the bed talks to my mother 's mom 's sister 's teacher 's boss 's teacher 's doll is happy .
the plate knows that your sister 's teacher 's dentist 's boss 's grandmother 's son 's book is sleepy .	the plate talks to your sister 's teacher 's dentist 's boss 's grandmother 's son 's book is sleepy .
the candle knows that my mother 's father 's wife 's daughter 's husband 's wife 's picture is important .	the candle scares my mother 's father 's wife 's daughter 's husband 's wife 's picture is important .
the crayon knows that your wife 's daughter 's daughter 's brother 's son 's mom 's picture is boring .	the crayon talks to your wife 's daughter 's daughter 's brother 's son 's mom 's picture is boring .
the shirt knows that your grandmother 's cousin 's doctor 's friend 's dad 's brother 's plate is lucky .	the shirt works with your grandmother 's cousin 's doctor 's friend 's dad 's brother 's plate is lucky .
the ring thinks that my daughter 's doctor 's dad 's father 's cousin 's dentist 's rocket is bored .	the ring works with my daughter 's doctor 's dad 's father 's cousin 's dentist 's rocket is bored .
the plate knows that my friend 's dentist 's brother 's brother 's daughter 's mother 's chair is young .	the plate works with my friend 's dentist 's brother 's brother 's daughter 's mother 's chair is young .
the book knows that my dad 's mom 's sister 's friend 's grandmother 's dad 's rug is sleepy .	the book talks to my dad 's mom 's sister 's friend 's grandmother 's dad 's rug is sleepy .
the hat says that my mom 's mom 's friend 's grandmother 's mom 's daughter 's ship is tired .	the hat works with my mom 's mom 's friend 's grandmother 's mom 's daughter 's ship is tired .
the picture thinks that my father 's teacher 's cousin 's boss 's cousin 's boss 's book is angry .	the picture scares my father 's teacher 's cousin 's boss 's cousin 's boss 's book is angry .
the plane knows that your grandmother 's doctor 's mother 's dentist 's sister 's brother 's spoon is boring .	the plane talks to your grandmother 's doctor 's mother 's dentist 's sister 's brother 's spoon is boring .
the bag knows that my father 's dentist 's dad 's dentist 's boss 's son 's shoe is happy .	the bag talks to my father 's dentist 's dad 's dentist 's boss 's son 's shoe is happy .
the picture says that your father 's grandmother 's cousin 's husband 's mom 's dentist 's mirror is important .	the picture talks to your father 's grandmother 's cousin 's husband 's mom 's dentist 's mirror is important .
the chair says that your dad 's cousin 's mom 's mom 's friend 's friend 's book is happy .	the chair talks to your dad 's cousin 's mom 's mom 's friend 's friend 's book is happy .
the door thinks that my mother 's wife 's doctor 's doctor 's son 's boss 's plate is friendly .	the door scares my mother 's wife 's doctor 's doctor 's son 's boss 's plate is friendly .
the plate thinks that my husband 's grandmother 's dad 's dad 's dentist 's dad 's truck is bored .	the plate works with my husband 's grandmother 's dad 's dad 's dentist 's dad 's truck is bored .
the bowl says that my teacher 's doctor 's daughter 's wife 's boss 's cousin 's picture is surprised .	the bowl talks to my teacher 's doctor 's daughter 's wife 's boss 's cousin 's picture is surprised .
the book thinks that my daughter 's wife 's brother 's dentist 's friend 's teacher 's truck is tired .	the book talks to my daughter 's wife 's brother 's dentist 's friend 's teacher 's truck is tired .
the car says that your wife 's mother 's mom 's husband 's brother 's father 's book is kind .	the car works with your wife 's mother 's mom 's husband 's brother 's father 's book is kind .
the doll thinks that your sister 's sister 's doctor 's dentist 's mom 's husband 's candle is busy .	the doll scares your sister 's sister 's doctor 's dentist 's mom 's husband 's candle is busy .
the box knows that your teacher 's teacher 's mom 's son 's cousin 's mother 's hat is upset .	the box works with your teacher 's teacher 's mom 's son 's cousin 's mother 's hat is upset .
the boat says that your friend 's cousin 's husband 's boss 's boss 's dentist 's toy is tired .	the boat helps your friend 's cousin 's husband 's boss 's boss 's dentist 's toy is tired .
the shoe says that my mother 's grandmother 's daughter 's mom 's mother 's husband 's plate is upset .	the shoe scares my mother 's grandmother 's daughter 's mom 's mother 's husband 's plate is upset .
the toy knows that your brother 's wife 's mother 's dentist 's mother 's boss 's couch is confused .	the toy works with your brother 's wife 's mother 's dentist 's mother 's boss 's couch is confused .
the bowl says that my cousin 's grandmother 's brother 's doctor 's grandmother 's cousin 's door is surprised .	the bowl scares my cousin 's grandmother 's brother 's doctor 's grandmother 's cousin 's door is surprised .
the mirror knows that your husband 's brother 's husband 's daughter 's brother 's doctor 's cup is wrong .	the mirror helps your husband 's brother 's husband 's daughter 's brother 's doctor 's cup is wrong .
the hat says that my cousin 's husband 's wife 's daughter 's brother 's mom 's plate is angry .	the hat scares my cousin 's husband 's wife 's daughter 's brother 's mom 's plate is angry .
the fork thinks that your friend 's mom 's dentist 's dad 's dad 's husband 's plate is upset .	the fork works with your friend 's mom 's dentist 's dad 's dad 's husband 's plate is upset .
the rocket says that my dad 's father 's mom 's daughter 's father 's brother 's truck is boring .	the rocket works with my dad 's father 's mom 's daughter 's father 's brother 's truck is boring .
the window knows that your mom 's grandmother 's mother 's mother 's dad 's dad 's picture is confused .	the window talks to your mom 's grandmother 's mother 's mother 's dad 's dad 's picture is confused .
the bowl says that your cousin 's sister 's doctor 's son 's daughter 's friend 's ring is angry .	the bowl talks to your cousin 's sister 's doctor 's son 's daughter 's friend 's ring is angry .
the ship says that your grandmother 's wife 's wife 's mother 's boss 's father 's hat is clever .	the ship helps your grandmother 's wife 's wife 's mother 's boss 's father 's hat is clever .
the cup says that my daughter 's cousin 's husband 's brother 's mother 's son 's truck is angry .	the cup scares my daughter 's cousin 's husband 's brother 's mother 's son 's truck is angry .
the picture knows that your son 's cousin 's teacher 's dad 's cousin 's brother 's dish is kind .	the picture helps your son 's cousin 's teacher 's dad 's cousin 's brother 's dish is kind .
the window says that my cousin 's friend 's brother 's daughter 's dad 's grandmother 's ship is upset .	the window scares my cousin 's friend 's brother 's daughter 's dad 's grandmother 's ship is upset .
the cup knows that my brother 's wife 's brother 's dad 's grandmother 's dad 's bag is busy .	the cup works with my brother 's wife 's brother 's dad 's grandmother 's dad 's bag is busy .
the rug knows that my father 's brother 's son 's friend 's mom 's daughter 's rug is lucky .	the rug helps my father 's brother 's son 's friend 's mom 's daughter 's rug is lucky .
the rocket knows that my teacher 's cousin 's sister 's doctor 's doctor 's brother 's box is healthy .	the rocket helps my teacher 's cousin 's sister 's doctor 's doctor 's brother 's box is healthy .
the rocket says that your father 's son 's brother 's doctor 's husband 's cousin 's doll is friendly .	the rocket works with your father 's son 's brother 's doctor 's husband 's cousin 's doll is friendly .
the ring thinks that your mom 's brother 's daughter 's teacher 's brother 's father 's bag is quiet .	the ring talks to your mom 's brother 's daughter 's teacher 's brother 's father 's bag is quiet .
the doll says that your cousin 's daughter 's doctor 's husband 's friend 's sister 's window is lucky .	the doll scares your cousin 's daughter 's doctor 's husband 's friend 's sister 's window is lucky .
the box knows that your mother 's mother 's dentist 's grandmother 's grandmother 's boss 's book is important .	the box works with your mother 's mother 's dentist 's grandmother 's grandmother 's boss 's book is important .
the spoon thinks that my grandmother 's husband 's brother 's dad 's doctor 's boss 's rug is surprised .	the spoon works with my grandmother 's husband 's brother 's dad 's doctor 's boss 's rug is surprised .
the picture says that your boss 's father 's brother 's mother 's teacher 's teacher 's shoe is healthy .	the picture works with your boss 's father 's brother 's mother 's teacher 's teacher 's shoe is healthy .
the mirror knows that your teacher 's husband 's dentist 's mother 's son 's daughter 's bag is smart .	the mirror helps your teacher 's husband 's dentist 's mother 's son 's daughter 's bag is smart .
the couch thinks that your wife 's cousin 's dad 's dentist 's grandmother 's mother 's button is lucky .	the couch scares your wife 's cousin 's dad 's dentist 's grandmother 's mother 's button is lucky .
the button thinks that my husband 's teacher 's mom 's mother 's boss 's wife 's car is kind .	the button scares my husband 's teacher 's mom 's mother 's boss 's wife 's car is kind .
the book says that my cousin 's daughter 's boss 's grandmother 's dentist 's cousin 's truck is surprised .	the book talks to my cousin 's daughter 's boss 's grandmother 's dentist 's cousin 's truck is surprised .
the book says that your doctor 's brother 's sister 's mom 's teacher 's doctor 's shirt is confused .	the book talks to your doctor 's brother 's sister 's mom 's teacher 's doctor 's shirt is confused .
the fork says that your cousin 's cousin 's daughter 's mom 's teacher 's dentist 's car is friendly .	the fork talks to your cousin 's cousin 's daughter 's mom 's teacher 's dentist 's car is friendly .
the door says that my sister 's grandmother 's grandmother 's friend 's son 's son 's cup is busy .	the door helps my sister 's grandmother 's grandmother 's friend 's son 's son 's cup is busy .
the shirt says that your mom 's cousin 's mom 's cousin 's sister 's dad 's shirt is happy .	the shirt works with your mom 's cousin 's mom 's cousin 's sister 's dad 's shirt is happy .
the candle thinks that my daughter 's friend 's wife 's teacher 's dad 's cousin 's spoon is happy .	the candle scares my daughter 's friend 's wife 's teacher 's dad 's cousin 's spoon is happy .
the picture says that your wife 's cousin 's grandmother 's wife 's wife 's sister 's glass is lucky .	the picture scares your wife 's cousin 's grandmother 's wife 's wife 's sister 's glass is lucky .
the crayon knows that my cousin 's brother 's mother 's sister 's brother 's sister 's picture is careful .	the crayon talks to my cousin 's brother 's mother 's sister 's brother 's sister 's picture is careful .
the book knows that your dentist 's daughter 's son 's brother 's friend 's daughter 's glass is upset .	the book works with your dentist 's daughter 's son 's brother 's friend 's daughter 's glass is upset .
the plane knows that your father 's grandmother 's brother 's son 's sister 's doctor 's picture is tall .	the plane works with your father 's grandmother 's brother 's son 's sister 's doctor 's picture is tall .
the spoon knows that your grandmother 's mom 's dentist 's mother 's wife 's grandmother 's dish is confused .	the spoon talks to your grandmother 's mom 's dentist 's mother 's wife 's grandmother 's dish is confused .
the bicycle says that my daughter 's dad 's mom 's wife 's mother 's mother 's window is clever .	the bicycle scares my daughter 's dad 's mom 's wife 's mother 's mother 's window is clever .
the couch knows that your grandmother 's daughter 's teacher 's husband 's dad 's friend 's button is helpful .	the couch scares your grandmother 's daughter 's teacher 's husband 's dad 's friend 's button is helpful .
the fork knows that your sister 's wife 's father 's wife 's mother 's mom 's bag is confused .	the fork works with your sister 's wife 's father 's wife 's mother 's mom 's bag is confused .
the door says that your father 's friend 's daughter 's son 's boss 's dad 's couch is helpful .	the door scares your father 's friend 's daughter 's son 's boss 's dad 's couch is helpful .
the chair knows that my brother 's dentist 's cousin 's father 's dentist 's teacher 's picture is gentle .	the chair talks to my brother 's dentist 's cousin 's father 's dentist 's teacher 's picture is gentle .
the shirt knows that your sister 's wife 's doctor 's boss 's daughter 's father 's rocket is important .	the shirt helps your sister 's wife 's doctor 's boss 's daughter 's father 's rocket is important .
the bicycle says that your cousin 's husband 's friend 's father 's mother 's wife 's box is busy .	the bicycle talks to your cousin 's husband 's friend 's father 's mother 's wife 's box is busy .
the ring knows that my teacher 's daughter 's teacher 's dad 's teacher 's mom 's car is gentle .	the ring works with my teacher 's daughter 's teacher 's dad 's teacher 's mom 's car is gentle .
the mirror says that my husband 's mom 's grandmother 's mother 's doctor 's husband 's toy is excited .	the mirror scares my husband 's mom 's grandmother 's mother 's doctor 's husband 's toy is excited .
the mirror thinks that your boss 's cousin 's husband 's wife 's cousin 's boss 's couch is nice .	the mirror works with your boss 's cousin 's husband 's wife 's cousin 's boss 's couch is nice .
the picture says that your dad 's brother 's brother 's dad 's daughter 's mother 's ring is bored .	the picture scares your dad 's brother 's brother 's dad 's daughter 's mother 's ring is bored .
the car thinks that my dentist 's doctor 's friend 's mother 's boss 's friend 's bed is lucky .	the car helps my dentist 's doctor 's friend 's mother 's boss 's friend 's bed is lucky .
the crayon knows that my doctor 's grandmother 's grandmother 's cousin 's sister 's dad 's box is tired .	the crayon works with my doctor 's grandmother 's grandmother 's cousin 's sister 's dad 's box is tired .
the doll says that my grandmother 's husband 's son 's teacher 's boss 's boss 's candle is sleepy .	the doll works with my grandmother 's husband 's son 's teacher 's boss 's boss 's candle is sleepy .
the plate knows that your mom 's grandmother 's mother 's dentist 's mother 's sister 's shoe is busy .	the plate scares your mom 's grandmother 's mother 's dentist 's mother 's sister 's shoe is busy .
the truck knows that my doctor 's mother 's teacher 's dad 's husband 's father 's toy is boring .	the truck scares my doctor 's mother 's teacher 's dad 's husband 's father 's toy is boring .
the bicycle says that your daughter 's grandmother 's dad 's brother 's brother 's mother 's toy is young .	the bicycle scares your daughter 's grandmother 's dad 's brother 's brother 's mother 's toy is young .
the plane says that my sister 's husband 's son 's mother 's dad 's mother 's ship is tired .	the plane scares my sister 's husband 's son 's mother 's dad 's mother 's ship is tired .
the truck knows that your father 's dentist 's son 's boss 's dad 's boss 's mirror is excited .	the truck talks to your father 's dentist 's son 's boss 's dad 's boss 's mirror is excited .
the plane says that my grandmother 's dad 's mother 's doctor 's grandmother 's friend 's fork is careful .	the plane helps my grandmother 's dad 's mother 's doctor 's grandmother 's friend 's fork is careful .
the box thinks that your teacher 's daughter 's mom 's mother 's husband 's son 's dish is excited .	the box talks to your teacher 's daughter 's mom 's mother 's husband 's son 's dish is excited .
the plate says that my daughter 's husband 's husband 's cousin 's mother 's mom 's book is kind .	the plate scares my daughter 's husband 's husband 's cousin 's mother 's mom 's book is kind .
the boat says that your dentist 's cousin 's brother 's brother 's sister 's father 's mirror is gentle .	the boat talks to your dentist 's cousin 's brother 's brother 's sister 's father 's mirror is gentle .
the bicycle says that your boss 's teacher 's father 's daughter 's dad 's boss 's plate is boring .	the bicycle talks to your boss 's teacher 's father 's daughter 's dad 's boss 's plate is boring .
the candle says that your brother 's boss 's teacher 's husband 's grandmother 's boss 's ship is kind .	the candle helps your brother 's boss 's teacher 's husband 's grandmother 's boss 's ship is kind .
the ship knows that your boss 's friend 's son 's friend 's boss 's dentist 's picture is young .	the ship works with your boss 's friend 's son 's friend 's boss 's dentist 's picture is young .
the bottle says that my sister 's friend 's mother 's brother 's dad 's father 's boat is angry .	the bottle helps my sister 's friend 's mother 's brother 's dad 's father 's boat is angry .
the bed thinks that my dad 's daughter 's friend 's grandmother 's doctor 's brother 's couch is friendly .	the bed scares my dad 's daughter 's friend 's grandmother 's doctor 's brother 's couch is friendly .
the bag thinks that my mother 's father 's mom 's boss 's sister 's friend 's hat is kind .	the bag helps my mother 's father 's mom 's boss 's sister 's friend 's hat is kind .
the bicycle knows that your mom 's mother 's doctor 's mother 's daughter 's grandmother 's button is hungry .	the bicycle helps your mom 's mother 's doctor 's mother 's daughter 's grandmother 's button is hungry .
the window knows that my doctor 's mom 's dentist 's daughter 's boss 's wife 's crayon is quiet .	the window works with my doctor 's mom 's dentist 's daughter 's boss 's wife 's crayon is quiet .
the cup thinks that my teacher 's dentist 's friend 's doctor 's husband 's boss 's car is smart .	the cup scares my teacher 's dentist 's friend 's doctor 's husband 's boss 's car is smart .
the couch thinks that your cousin 's dad 's friend 's son 's son 's mother 's picture is helpful .	the couch talks to your cousin 's dad 's friend 's son 's son 's mother 's picture is helpful .
the mirror says that your doctor 's mom 's wife 's husband 's son 's doctor 's box is tired .	the mirror helps your doctor 's mom 's wife 's husband 's son 's doctor 's box is tired .
the crayon knows that my wife 's father 's brother 's wife 's sister 's daughter 's bottle is smart .	the crayon scares my wife 's father 's brother 's wife 's sister 's daughter 's bottle is smart .
the shirt thinks that your brother 's husband 's dad 's sister 's friend 's son 's rug is upset .	the shirt talks to your brother 's husband 's dad 's sister 's friend 's son 's rug is upset .
the picture says that my sister 's cousin 's sister 's mom 's grandmother 's father 's crayon is gentle .	the picture talks to my sister 's cousin 's sister 's mom 's grandmother 's father 's crayon is gentle .
the bottle says that your mom 's father 's wife 's father 's teacher 's father 's couch is surprised .	the bottle talks to your mom 's father 's wife 's father 's teacher 's father 's couch is surprised .
the bed says that my mother 's friend 's wife 's friend 's son 's boss 's box is wrong .	the bed helps my mother 's friend 's wife 's friend 's son 's boss 's box is wrong .
the dish says that your husband 's sister 's wife 's grandmother 's son 's brother 's crayon is helpful .	the dish works with your husband 's sister 's wife 's grandmother 's son 's brother 's crayon is helpful .
the plate says that your teacher 's grandmother 's doctor 's mom 's wife 's sister 's glass is surprised .	the plate scares your teacher 's grandmother 's doctor 's mom 's wife 's sister 's glass is surprised .
the box says that your cousin 's daughter 's friend 's boss 's mom 's mom 's candle is kind .	the box scares your cousin 's daughter 's friend 's boss 's mom 's mom 's candle is kind .
the shirt thinks that my brother 's daughter 's sister 's wife 's sister 's mom 's box is clever .	the shirt scares my brother 's daughter 's sister 's wife 's sister 's mom 's box is clever .
the window says that your dad 's brother 's son 's doctor 's mother 's mother 's bicycle is important .	the window talks to your dad 's brother 's son 's doctor 's mother 's mother 's bicycle is important .
the candle thinks that my friend 's dentist 's father 's husband 's dentist 's mom 's bottle is sleepy .	the candle helps my friend 's dentist 's father 's husband 's dentist 's mom 's bottle is sleepy .
the plate thinks that your husband 's friend 's son 's grandmother 's dad 's teacher 's fork is clever .	the plate scares your husband 's friend 's son 's grandmother 's dad 's teacher 's fork is clever .
the truck thinks that your husband 's father 's mom 's sister 's cousin 's daughter 's shirt is confused .	the truck works with your husband 's father 's mom 's sister 's cousin 's daughter 's shirt is confused .
the dish says that my teacher 's dentist 's sister 's grandmother 's husband 's daughter 's bicycle is happy .	the dish talks to my teacher 's dentist 's sister 's grandmother 's husband 's daughter 's bicycle is happy .
the book knows that your friend 's dentist 's husband 's husband 's teacher 's dad 's bag is kind .	the book works with your friend 's dentist 's husband 's husband 's teacher 's dad 's bag is kind .
the box says that my doctor 's brother 's daughter 's teacher 's dentist 's doctor 's mirror is angry .	the box helps my doctor 's brother 's daughter 's teacher 's dentist 's doctor 's mirror is angry .
the doll knows that my son 's boss 's teacher 's friend 's husband 's wife 's book is wrong .	the doll talks to my son 's boss 's teacher 's friend 's husband 's wife 's book is wrong .
the bag says that your brother 's grandmother 's teacher 's teacher 's mother 's mom 's button is surprised .	the bag scares your brother 's grandmother 's teacher 's teacher 's mother 's mom 's button is surprised .
the spoon knows that my dad 's dentist 's doctor 's husband 's son 's son 's ring is tall .	the spoon works with my dad 's dentist 's doctor 's husband 's son 's son 's ring is tall .
the truck thinks that your wife 's doctor 's sister 's doctor 's dentist 's brother 's chair is lucky .	the truck scares your wife 's doctor 's sister 's doctor 's dentist 's brother 's chair is lucky .
the fork says that your son 's daughter 's father 's daughter 's dad 's mom 's car is clever .	the fork works with your son 's daughter 's father 's daughter 's dad 's mom 's car is clever .
the window knows that your boss 's teacher 's doctor 's mom 's husband 's dentist 's rocket is kind .	the window talks to your boss 's teacher 's doctor 's mom 's husband 's dentist 's rocket is kind .
the boat knows that my son 's son 's boss 's boss 's father 's sister 's doll is curious .	the boat works with my son 's son 's boss 's boss 's father 's sister 's doll is curious .
the chair thinks that your mom 's wife 's father 's daughter 's dentist 's husband 's boat is young .	the chair talks to your mom 's wife 's father 's daughter 's dentist 's husband 's boat is young .
the bicycle knows that your husband 's doctor 's dad 's doctor 's daughter 's son 's shoe is lucky .	the bicycle talks to your husband 's doctor 's dad 's doctor 's daughter 's son 's shoe is lucky .
the dish thinks that your dad 's boss 's boss 's cousin 's husband 's boss 's crayon is angry .	the dish helps your dad 's boss 's boss 's cousin 's husband 's boss 's crayon is angry .
the bottle thinks that my father 's mom 's brother 's mom 's mother 's grandmother 's crayon is hungry .	the bottle helps my father 's mom 's brother 's mom 's mother 's grandmother 's crayon is hungry .
the couch knows that my wife 's father 's doctor 's sister 's sister 's mom 's bicycle is careful .	the couch works with my wife 's father 's doctor 's sister 's sister 's mom 's bicycle is careful .
the car thinks that your friend 's son 's grandmother 's daughter 's teacher 's brother 's boat is quiet .	the car works with your friend 's son 's grandmother 's daughter 's teacher 's brother 's boat is quiet .
the dish thinks that my dad 's teacher 's boss 's grandmother 's dentist 's brother 's car is gentle .	the dish talks to my dad 's teacher 's boss 's grandmother 's dentist 's brother 's car is gentle .
the truck thinks that your teacher 's daughter 's mom 's mom 's wife 's grandmother 's ring is tall .	the truck helps your teacher 's daughter 's mom 's mom 's wife 's grandmother 's ring is tall .
the button knows that my boss 's grandmother 's friend 's mom 's grandmother 's teacher 's crayon is hungry .	the button works with my boss 's grandmother 's friend 's mom 's grandmother 's teacher 's crayon is hungry .
the boat thinks that your friend 's son 's mother 's teacher 's father 's grandmother 's mirror is healthy .	the boat works with your friend 's son 's mother 's teacher 's father 's grandmother 's mirror is healthy .
the rug knows that your husband 's dad 's dad 's husband 's grandmother 's brother 's glass is gentle .	the rug scares your husband 's dad 's dad 's husband 's grandmother 's brother 's glass is gentle .
the ship says that your cousin 's dad 's father 's sister 's dad 's friend 's door is excited .	the ship scares your cousin 's dad 's father 's sister 's dad 's friend 's door is excited .
the window thinks that your sister 's cousin 's grandmother 's dad 's teacher 's dad 's rocket is helpful .	the window scares your sister 's cousin 's grandmother 's dad 's teacher 's dad 's rocket is helpful .
the bicycle says that your brother 's husband 's wife 's husband 's husband 's grandmother 's boat is upset .	the bicycle helps your brother 's husband 's wife 's husband 's husband 's grandmother 's boat is upset .
the truck says that my dentist 's dad 's dentist 's grandmother 's doctor 's teacher 's button is sleepy .	the truck scares my dentist 's dad 's dentist 's grandmother 's doctor 's teacher 's button is sleepy .
the shoe knows that your daughter 's friend 's wife 's wife 's husband 's wife 's glass is upset .	the shoe helps your daughter 's friend 's wife 's wife 's husband 's wife 's glass is upset .
the ring says that my mother 's daughter 's doctor 's mother 's mother 's brother 's glass is tired .	the ring talks to my mother 's daughter 's doctor 's mother 's mother 's brother 's glass is tired .
the plate says that my mother 's boss 's mom 's daughter 's mother 's mother 's doll is tall .	the plate helps my mother 's boss 's mom 's daughter 's mother 's mother 's doll is tall .
the doll thinks that my brother 's dentist 's cousin 's grandmother 's son 's grandmother 's plane is hungry .	the doll works with my brother 's dentist 's cousin 's grandmother 's son 's grandmother 's plane is hungry .
the doll says that my father 's mom 's sister 's mom 's boss 's teacher 's bed is bored .	the doll scares my father 's mom 's sister 's mom 's boss 's teacher 's bed is bored .
the car knows that my wife 's cousin 's teacher 's cousin 's husband 's teacher 's car is confused .	the car scares my wife 's cousin 's teacher 's cousin 's husband 's teacher 's car is confused .
the mirror thinks that my grandmother 's son 's daughter 's friend 's mom 's boss 's shoe is hungry .	the mirror helps my grandmother 's son 's daughter 's friend 's mom 's boss 's shoe is hungry .
the car knows that my boss 's dentist 's brother 's son 's cousin 's husband 's dish is helpful .	the car scares my boss 's dentist 's brother 's son 's cousin 's husband 's dish is helpful .
the window says that your mother 's grandmother 's sister 's daughter 's cousin 's doctor 's fork is friendly .	the window scares your mother 's grandmother 's sister 's daughter 's cousin 's doctor 's fork is friendly .
the shoe knows that your cousin 's mom 's teacher 's daughter 's sister 's dentist 's button is young .	the shoe helps your cousin 's mom 's teacher 's daughter 's sister 's dentist 's button is young .
the truck thinks that my dentist 's teacher 's brother 's husband 's wife 's boss 's car is sleepy .	the truck talks to my dentist 's teacher 's brother 's husband 's wife 's boss 's car is sleepy .
the plane thinks that your friend 's doctor 's friend 's mom 's mom 's boss 's ring is angry .	the plane works with your friend 's doctor 's friend 's mom 's mom 's boss 's ring is angry .
the crayon says that my mom 's cousin 's doctor 's mom 's grandmother 's grandmother 's bottle is careful .	the crayon works with my mom 's cousin 's doctor 's mom 's grandmother 's grandmother 's bottle is careful .
the bottle knows that my teacher 's mom 's friend 's daughter 's brother 's mother 's car is surprised .	the bottle helps my teacher 's mom 's friend 's daughter 's brother 's mother 's car is surprised .
the bag says that my father 's husband 's friend 's sister 's daughter 's friend 's bowl is nice .	the bag scares my father 's husband 's friend 's sister 's daughter 's friend 's bowl is nice .
the glass knows that my dad 's daughter 's son 's cousin 's cousin 's teacher 's rug is gentle .	the glass works with my dad 's daughter 's son 's cousin 's cousin 's teacher 's rug is gentle .
the window says that your cousin 's cousin 's dentist 's father 's cousin 's daughter 's window is gentle .	the window talks to your cousin 's cousin 's dentist 's father 's cousin 's daughter 's window is gentle .
the door thinks that your dentist 's sister 's dad 's doctor 's friend 's dentist 's doll is excited .	the door talks to your dentist 's sister 's dad 's doctor 's friend 's dentist 's doll is excited .
the fork knows that your friend 's dad 's dentist 's mother 's friend 's teacher 's window is surprised .	the fork talks to your friend 's dad 's dentist 's mother 's friend 's teacher 's window is surprised .
the toy says that my brother 's son 's boss 's daughter 's mom 's brother 's glass is upset .	the toy helps my brother 's son 's boss 's daughter 's mom 's brother 's glass is upset .
the doll says that my cousin 's friend 's dad 's sister 's cousin 's brother 's car is surprised .	the doll scares my cousin 's friend 's dad 's sister 's cousin 's brother 's car is surprised .
the button thinks that my friend 's teacher 's son 's son 's dad 's friend 's plane is wrong .	the button scares my friend 's teacher 's son 's son 's dad 's friend 's plane is wrong .
the shoe says that my wife 's daughter 's brother 's father 's cousin 's sister 's plate is curious .	the shoe talks to my wife 's daughter 's brother 's father 's cousin 's sister 's plate is curious .
the book knows that my sister 's teacher 's doctor 's wife 's teacher 's dad 's bed is boring .	the book works with my sister 's teacher 's doctor 's wife 's teacher 's dad 's bed is boring .
the window says that your husband 's dentist 's mom 's daughter 's friend 's teacher 's truck is angry .	the window helps your husband 's dentist 's mom 's daughter 's friend 's teacher 's truck is angry .
the button knows that my father 's friend 's daughter 's daughter 's dentist 's grandmother 's book is healthy .	the button helps my father 's friend 's daughter 's daughter 's dentist 's grandmother 's book is healthy .
the picture knows that your grandmother 's teacher 's sister 's cousin 's wife 's teacher 's dish is upset .	the picture talks to your grandmother 's teacher 's sister 's cousin 's wife 's teacher 's dish is upset .
the couch says that your teacher 's mom 's teacher 's boss 's teacher 's cousin 's fork is bored .	the couch scares your teacher 's mom 's teacher 's boss 's teacher 's cousin 's fork is bored .
the couch thinks that my brother 's friend 's teacher 's teacher 's son 's brother 's bowl is surprised .	the couch works with my brother 's friend 's teacher 's teacher 's son 's brother 's bowl is surprised .
the car says that my mother 's sister 's dentist 's dentist 's sister 's wife 's bowl is angry .	the car talks to my mother 's sister 's dentist 's dentist 's sister 's wife 's bowl is angry .
the toy thinks that your doctor 's mother 's cousin 's grandmother 's teacher 's husband 's box is curious .	the toy scares your doctor 's mother 's cousin 's grandmother 's teacher 's husband 's box is curious .
the box knows that your dad 's dentist 's wife 's dentist 's dad 's cousin 's truck is lucky .	the box helps your dad 's dentist 's wife 's dentist 's dad 's cousin 's truck is lucky .
the crayon says that your father 's wife 's boss 's grandmother 's dad 's grandmother 's car is bored .	the crayon works with your father 's wife 's boss 's grandmother 's dad 's grandmother 's car is bored .
the couch thinks that your sister 's son 's brother 's mom 's dad 's boss 's box is nice .	the couch scares your sister 's son 's brother 's mom 's dad 's boss 's box is nice .
the bed knows that your father 's dad 's dentist 's brother 's doctor 's wife 's plate is tall .	the bed scares your father 's dad 's dentist 's brother 's doctor 's wife 's plate is tall .
the dish says that my brother 's doctor 's wife 's father 's dentist 's teacher 's cup is clever .	the dish helps my brother 's doctor 's wife 's father 's dentist 's teacher 's cup is clever .
the chair knows that your father 's husband 's cousin 's sister 's doctor 's dad 's mirror is angry .	the chair scares your father 's husband 's cousin 's sister 's doctor 's dad 's mirror is angry .
the crayon thinks that your friend 's cousin 's cousin 's friend 's sister 's teacher 's bicycle is strong .	the crayon talks to your friend 's cousin 's cousin 's friend 's sister 's teacher 's bicycle is strong .
the candle knows that my dad 's daughter 's dentist 's daughter 's sister 's dentist 's shoe is kind .	the candle works with my dad 's daughter 's dentist 's daughter 's sister 's dentist 's shoe is kind .
the rug knows that my teacher 's brother 's father 's wife 's mother 's grandmother 's dish is confused .	the rug works with my teacher 's brother 's father 's wife 's mother 's grandmother 's dish is confused .
the candle knows that your wife 's wife 's sister 's father 's dentist 's wife 's book is friendly .	the candle works with your wife 's wife 's sister 's father 's dentist 's wife 's book is friendly .
the truck says that my cousin 's husband 's doctor 's daughter 's sister 's sister 's spoon is helpful .	the truck talks to my cousin 's husband 's doctor 's daughter 's sister 's sister 's spoon is helpful .
the ship thinks that my dentist 's grandmother 's wife 's dad 's boss 's son 's shirt is surprised .	the ship helps my dentist 's grandmother 's wife 's dad 's boss 's son 's shirt is surprised .
the book says that my cousin 's mom 's brother 's dad 's sister 's son 's rug is friendly .	the book talks to my cousin 's mom 's brother 's dad 's sister 's son 's rug is friendly .
the toy knows that my friend 's boss 's doctor 's son 's father 's mother 's car is tall .	the toy talks to my friend 's boss 's doctor 's son 's father 's mother 's car is tall .
the candle knows that your son 's wife 's grandmother 's sister 's friend 's mom 's doll is gentle .	the candle works with your son 's wife 's grandmother 's sister 's friend 's mom 's doll is gentle .
the glass thinks that my teacher 's wife 's boss 's husband 's mom 's boss 's ring is friendly .	the glass works with my teacher 's wife 's boss 's husband 's mom 's boss 's ring is friendly .
the mirror says that my cousin 's husband 's wife 's wife 's mom 's boss 's spoon is helpful .	the mirror helps my cousin 's husband 's wife 's wife 's mom 's boss 's spoon is helpful .
the fork says that my teacher 's teacher 's husband 's husband 's dentist 's dad 's shirt is sleepy .	the fork talks to my teacher 's teacher 's husband 's husband 's dentist 's dad 's shirt is sleepy .
the shirt knows that my wife 's dad 's brother 's son 's husband 's boss 's picture is boring .	the shirt scares my wife 's dad 's brother 's son 's husband 's boss 's picture is boring .
the bowl says that your husband 's dentist 's son 's sister 's sister 's friend 's box is lucky .	the bowl talks to your husband 's dentist 's son 's sister 's sister 's friend 's box is lucky .
the bed says that your daughter 's friend 's mom 's brother 's brother 's dentist 's fork is sleepy .	the bed talks to your daughter 's friend 's mom 's brother 's brother 's dentist 's fork is sleepy .
the car thinks that my wife 's husband 's daughter 's mom 's cousin 's brother 's bowl is young .	the car works with my wife 's husband 's daughter 's mom 's cousin 's brother 's bowl is young .
the glass thinks that my boss 's mother 's daughter 's father 's grandmother 's dad 's shoe is young .	the glass scares my boss 's mother 's daughter 's father 's grandmother 's dad 's shoe is young .
the shirt thinks that your boss 's brother 's friend 's dentist 's wife 's mom 's hat is important .	the shirt scares your boss 's brother 's friend 's dentist 's wife 's mom 's hat is important .
the ring says that my cousin 's dad 's mom 's cousin 's cousin 's dentist 's candle is smart .	the ring helps my cousin 's dad 's mom 's cousin 's cousin 's dentist 's candle is smart .
the picture thinks that my dentist 's friend 's husband 's son 's mom 's dentist 's book is strong .	the picture scares my dentist 's friend 's husband 's son 's mom 's dentist 's book is strong .
the boat thinks that your brother 's friend 's mom 's doctor 's friend 's teacher 's door is young .	the boat works with your brother 's friend 's mom 's doctor 's friend 's teacher 's door is young .
the bed thinks that my father 's dentist 's brother 's wife 's brother 's sister 's picture is clever .	the bed works with my father 's dentist 's brother 's wife 's brother 's sister 's picture is clever .
the crayon says that your doctor 's dentist 's wife 's cousin 's boss 's son 's toy is sleepy .	the crayon helps your doctor 's dentist 's wife 's cousin 's boss 's son 's toy is sleepy .
the bag says that my dad 's cousin 's grandmother 's brother 's teacher 's wife 's truck is busy .	the bag helps my dad 's cousin 's grandmother 's brother 's teacher 's wife 's truck is busy .
the rocket thinks that my grandmother 's boss 's doctor 's mother 's dad 's doctor 's couch is smart .	the rocket talks to my grandmother 's boss 's doctor 's mother 's dad 's doctor 's couch is smart .
the bowl says that your friend 's doctor 's son 's father 's grandmother 's grandmother 's plate is smart .	the bowl talks to your friend 's doctor 's son 's father 's grandmother 's grandmother 's plate is smart .
the fork says that your dad 's boss 's son 's wife 's boss 's cousin 's dish is smart .	the fork scares your dad 's boss 's son 's wife 's boss 's cousin 's dish is smart .
the mirror says that my friend 's wife 's mom 's brother 's father 's sister 's hat is quiet .	the mirror helps my friend 's wife 's mom 's brother 's father 's sister 's hat is quiet .
the bed knows that your boss 's dentist 's dentist 's brother 's mother 's mother 's hat is young .	the bed scares your boss 's dentist 's dentist 's brother 's mother 's mother 's hat is young .
the ring thinks that my friend 's wife 's mother 's son 's cousin 's teacher 's bicycle is careful .	the ring helps my friend 's wife 's mother 's son 's cousin 's teacher 's bicycle is careful .
the plane says that my dad 's son 's father 's sister 's dad 's wife 's candle is hungry .	the plane works with my dad 's son 's father 's sister 's dad 's wife 's candle is hungry .
the truck knows that my teacher 's sister 's brother 's husband 's husband 's brother 's doll is helpful .	the truck talks to my teacher 's sister 's brother 's husband 's husband 's brother 's doll is helpful .
the boat thinks that your boss 's friend 's doctor 's dad 's dentist 's son 's door is happy .	the boat scares your boss 's friend 's doctor 's dad 's dentist 's son 's door is happy .
the spoon thinks that your brother 's son 's brother 's father 's brother 's father 's bowl is excited .	the spoon helps your brother 's son 's brother 's father 's brother 's father 's bowl is excited .
the plate says that your father 's grandmother 's son 's brother 's son 's cousin 's doll is important .	the plate helps your father 's grandmother 's son 's brother 's son 's cousin 's doll is important .
the rocket knows that your mom 's dentist 's doctor 's dad 's grandmother 's friend 's bowl is curious .	the rocket works with your mom 's dentist 's doctor 's dad 's grandmother 's friend 's bowl is curious .
the boat knows that my teacher 's dad 's son 's sister 's doctor 's cousin 's button is busy .	the boat scares my teacher 's dad 's son 's sister 's doctor 's cousin 's button is busy .
the bottle says that my mom 's teacher 's brother 's teacher 's mother 's wife 's box is tall .	the bottle talks to my mom 's teacher 's brother 's teacher 's mother 's wife 's box is tall .
the book says that my mother 's doctor 's sister 's father 's brother 's brother 's candle is smart .	the book works with my mother 's doctor 's sister 's father 's brother 's brother 's candle is smart .
the glass says that my cousin 's boss 's dad 's friend 's dad 's mom 's shirt is clever .	the glass helps my cousin 's boss 's dad 's friend 's dad 's mom 's shirt is clever .
the toy says that your son 's dad 's dad 's brother 's friend 's husband 's plate is curious .	the toy helps your son 's dad 's dad 's brother 's friend 's husband 's plate is curious .
the fork knows that my dad 's father 's wife 's dentist 's husband 's grandmother 's ring is happy .	the fork helps my dad 's father 's wife 's dentist 's husband 's grandmother 's ring is happy .
the door knows that my dentist 's father 's daughter 's cousin 's dentist 's daughter 's crayon is young .	the door talks to my dentist 's father 's daughter 's cousin 's dentist 's daughter 's crayon is young .
the door says that my dentist 's boss 's dentist 's doctor 's teacher 's sister 's bottle is gentle .	the door helps my dentist 's boss 's dentist 's doctor 's teacher 's sister 's bottle is gentle .
the car knows that your boss 's mother 's brother 's friend 's dad 's son 's crayon is sleepy .	the car scares your boss 's mother 's brother 's friend 's dad 's son 's crayon is sleepy .
the picture knows that my mom 's teacher 's son 's dad 's father 's dad 's picture is healthy .	the picture talks to my mom 's teacher 's son 's dad 's father 's dad 's picture is healthy .
the spoon knows that your mother 's sister 's wife 's doctor 's sister 's dad 's car is lucky .	the spoon works with your mother 's sister 's wife 's doctor 's sister 's dad 's car is lucky .
the button thinks that your father 's son 's teacher 's sister 's mom 's boss 's candle is busy .	the button talks to your father 's son 's teacher 's sister 's mom 's boss 's candle is busy .
the candle thinks that your daughter 's grandmother 's son 's wife 's doctor 's grandmother 's ring is clever .	the candle works with your daughter 's grandmother 's son 's wife 's doctor 's grandmother 's ring is clever .
the car knows that your husband 's mom 's mother 's teacher 's son 's wife 's bottle is kind .	the car works with your husband 's mom 's mother 's teacher 's son 's wife 's bottle is kind .
the book thinks that my grandmother 's doctor 's father 's teacher 's doctor 's mom 's couch is careful .	the book works with my grandmother 's doctor 's father 's teacher 's doctor 's mom 's couch is careful .
the picture thinks that your cousin 's grandmother 's doctor 's grandmother 's grandmother 's husband 's picture is angry .	the picture talks to your cousin 's grandmother 's doctor 's grandmother 's grandmother 's husband 's picture is angry .
the hat thinks that my wife 's mom 's mother 's boss 's teacher 's friend 's plate is quiet .	the hat works with my wife 's mom 's mother 's boss 's teacher 's friend 's plate is quiet .
the rocket knows that your wife 's wife 's mother 's wife 's son 's brother 's rocket is bored .	the rocket works with your wife 's wife 's mother 's wife 's son 's brother 's rocket is bored .
the crayon says that my cousin 's boss 's husband 's son 's friend 's dentist 's window is careful .	the crayon works with my cousin 's boss 's husband 's son 's friend 's dentist 's window is careful .
the rocket knows that your friend 's mother 's son 's sister 's doctor 's husband 's ship is curious .	the rocket talks to your friend 's mother 's son 's sister 's doctor 's husband 's ship is curious .
the cup thinks that your doctor 's dad 's teacher 's husband 's mother 's dad 's ring is hungry .	the cup talks to your doctor 's dad 's teacher 's husband 's mother 's dad 's ring is hungry .
the doll thinks that your dentist 's wife 's dad 's mother 's boss 's boss 's rug is nice .	the doll works with your dentist 's wife 's dad 's mother 's boss 's boss 's rug is nice .
the crayon says that your husband 's dad 's cousin 's grandmother 's brother 's friend 's door is bored .	the crayon works with your husband 's dad 's cousin 's grandmother 's brother 's friend 's door is bored .
the bed thinks that your brother 's grandmother 's grandmother 's dad 's son 's cousin 's rocket is surprised .	the bed scares your brother 's grandmother 's grandmother 's dad 's son 's cousin 's rocket is surprised .
the rocket thinks that my mother 's doctor 's friend 's husband 's wife 's sister 's dish is clever .	the rocket works with my mother 's doctor 's friend 's husband 's wife 's sister 's dish is clever .
the ship thinks that your sister 's grandmother 's wife 's teacher 's brother 's dad 's candle is wrong .	the ship talks to your sister 's grandmother 's wife 's teacher 's brother 's dad 's candle is wrong .
the bag thinks that your mom 's friend 's father 's brother 's son 's mother 's rocket is friendly .	the bag scares your mom 's friend 's father 's brother 's son 's mother 's rocket is friendly .
the bottle thinks that your son 's sister 's dentist 's dentist 's son 's dentist 's bottle is careful .	the bottle talks to your son 's sister 's dentist 's dentist 's son 's dentist 's bottle is careful .
the bed thinks that my brother 's son 's boss 's grandmother 's father 's mom 's cup is friendly .	the bed works with my brother 's son 's boss 's grandmother 's father 's mom 's cup is friendly .
the plate says that my boss 's husband 's daughter 's teacher 's father 's friend 's car is healthy .	the plate talks to my boss 's husband 's daughter 's teacher 's father 's friend 's car is healthy .
the window knows that my doctor 's father 's wife 's mom 's son 's teacher 's bicycle is smart .	the window scares my doctor 's father 's wife 's mom 's son 's teacher 's bicycle is smart .
the car knows that your friend 's boss 's wife 's husband 's mom 's wife 's shoe is lucky .	the car works with your friend 's boss 's wife 's husband 's mom 's wife 's shoe is lucky .
the chair says that your brother 's father 's sister 's son 's wife 's doctor 's toy is important .	the chair works with your brother 's father 's sister 's son 's wife 's doctor 's toy is important .
the dish knows that my grandmother 's cousin 's father 's son 's wife 's daughter 's fork is nice .	the dish works with my grandmother 's cousin 's father 's son 's wife 's daughter 's fork is nice .
the shirt thinks that your mom 's boss 's dad 's grandmother 's cousin 's husband 's bottle is friendly .	the shirt works with your mom 's boss 's dad 's grandmother 's cousin 's husband 's bottle is friendly .
the couch says that your father 's son 's sister 's friend 's wife 's wife 's bottle is wrong .	the couch scares your father 's son 's sister 's friend 's wife 's wife 's bottle is wrong .
the rug knows that my mother 's friend 's son 's son 's daughter 's brother 's book is lucky .	the rug talks to my mother 's friend 's son 's son 's daughter 's brother 's book is lucky .
the bed thinks that your dentist 's mom 's sister 's doctor 's husband 's mom 's bed is confused .	the bed helps your dentist 's mom 's sister 's doctor 's husband 's mom 's bed is confused .
the spoon thinks that my dentist 's father 's wife 's dad 's cousin 's sister 's picture is angry .	the spoon works with my dentist 's father 's wife 's dad 's cousin 's sister 's picture is angry .
the dish says that my father 's dentist 's sister 's mom 's mom 's cousin 's shoe is tired .	the dish works with my father 's dentist 's sister 's mom 's mom 's cousin 's shoe is tired .
the bag says that my wife 's wife 's teacher 's brother 's dad 's son 's cup is quiet .	the bag scares my wife 's wife 's teacher 's brother 's dad 's son 's cup is quiet .
the mirror says that your mother 's mother 's mom 's brother 's husband 's wife 's plate is hungry .	the mirror scares your mother 's mother 's mom 's brother 's husband 's wife 's plate is hungry .
the dish says that your son 's friend 's daughter 's doctor 's wife 's cousin 's bowl is kind .	the dish works with your son 's friend 's daughter 's doctor 's wife 's cousin 's bowl is kind .
the glass knows that my teacher 's wife 's doctor 's teacher 's grandmother 's boss 's bicycle is tired .	the glass scares my teacher 's wife 's doctor 's teacher 's grandmother 's boss 's bicycle is tired .
the book says that your boss 's sister 's boss 's brother 's teacher 's mom 's candle is lucky .	the book scares your boss 's sister 's boss 's brother 's teacher 's mom 's candle is lucky .
the cup knows that my grandmother 's dentist 's dad 's mother 's mom 's cousin 's fork is wrong .	the cup scares my grandmother 's dentist 's dad 's mother 's mom 's cousin 's fork is wrong .
the spoon knows that my son 's mom 's father 's dad 's cousin 's boss 's window is boring .	the spoon talks to my son 's mom 's father 's dad 's cousin 's boss 's window is boring .
the truck says that your sister 's daughter 's mother 's cousin 's dentist 's wife 's plate is careful .	the truck helps your sister 's daughter 's mother 's cousin 's dentist 's wife 's plate is careful .
the ring thinks that your son 's daughter 's father 's father 's dad 's cousin 's truck is upset .	the ring helps your son 's daughter 's father 's father 's dad 's cousin 's truck is upset .
the rocket says that my mom 's boss 's friend 's doctor 's teacher 's daughter 's door is careful .	the rocket talks to my mom 's boss 's friend 's doctor 's teacher 's daughter 's door is careful .
the picture knows that my brother 's dad 's cousin 's husband 's teacher 's dentist 's ring is friendly .	the picture talks to my brother 's dad 's cousin 's husband 's teacher 's dentist 's ring is friendly .
the toy knows that my sister 's boss 's mom 's wife 's cousin 's daughter 's shoe is gentle .	the toy helps my sister 's boss 's mom 's wife 's cousin 's daughter 's shoe is gentle .
the spoon says that my teacher 's doctor 's brother 's wife 's son 's boss 's button is clever .	the spoon helps my teacher 's doctor 's brother 's wife 's son 's boss 's button is clever .
the bed knows that your daughter 's friend 's mom 's boss 's daughter 's doctor 's ship is quiet .	the bed helps your daughter 's friend 's mom 's boss 's daughter 's doctor 's ship is quiet .
the chair says that my mother 's father 's wife 's cousin 's sister 's brother 's truck is lucky .	the chair scares my mother 's father 's wife 's cousin 's sister 's brother 's truck is lucky .
the book thinks that your wife 's friend 's mother 's dad 's grandmother 's brother 's spoon is lucky .	the book works with your wife 's friend 's mother 's dad 's grandmother 's brother 's spoon is lucky .
the door knows that my brother 's wife 's son 's dentist 's mother 's brother 's spoon is sleepy .	the door helps my brother 's wife 's son 's dentist 's mother 's brother 's spoon is sleepy .
the couch knows that my cousin 's sister 's mom 's cousin 's brother 's friend 's boat is curious .	the couch helps my cousin 's sister 's mom 's cousin 's brother 's friend 's boat is curious .
the bottle says that my father 's wife 's cousin 's son 's father 's husband 's glass is excited .	the bottle helps my father 's wife 's cousin 's son 's father 's husband 's glass is excited .
the glass says that your boss 's mom 's friend 's wife 's grandmother 's husband 's door is bored .	the glass works with your boss 's mom 's friend 's wife 's grandmother 's husband 's door is bored .
the ring says that my brother 's doctor 's brother 's dad 's dentist 's son 's glass is boring .	the ring works with my brother 's doctor 's brother 's dad 's dentist 's son 's glass is boring .
the crayon says that your boss 's doctor 's husband 's mom 's father 's husband 's ring is gentle .	the crayon helps your boss 's doctor 's husband 's mom 's father 's husband 's ring is gentle .
the spoon says that my grandmother 's dentist 's father 's wife 's cousin 's cousin 's candle is happy .	the spoon scares my grandmother 's dentist 's father 's wife 's cousin 's cousin 's candle is happy .
the truck says that your dentist 's sister 's father 's dad 's brother 's doctor 's car is careful .	the truck works with your dentist 's sister 's father 's dad 's brother 's doctor 's car is careful .
the hat knows that my teacher 's wife 's boss 's friend 's teacher 's wife 's hat is hungry .	the hat works with my teacher 's wife 's boss 's friend 's teacher 's wife 's hat is hungry .
the bottle thinks that my dad 's daughter 's son 's father 's teacher 's brother 's picture is angry .	the bottle works with my dad 's daughter 's son 's father 's teacher 's brother 's picture is angry .
the mirror knows that my father 's doctor 's doctor 's dad 's sister 's son 's shirt is clever .	the mirror scares my father 's doctor 's doctor 's dad 's sister 's son 's shirt is clever .
the boat thinks that your mother 's cousin 's son 's boss 's grandmother 's friend 's rocket is sleepy .	the boat talks to your mother 's cousin 's son 's boss 's grandmother 's friend 's rocket is sleepy .
the bed thinks that your father 's daughter 's mom 's father 's teacher 's dentist 's toy is quiet .	the bed talks to your father 's daughter 's mom 's father 's teacher 's dentist 's toy is quiet .
the car knows that your son 's dad 's mom 's cousin 's sister 's doctor 's cup is confused .	the car talks to your son 's dad 's mom 's cousin 's sister 's doctor 's cup is confused .
the window thinks that your sister 's dad 's cousin 's father 's boss 's daughter 's bed is confused .	the window works with your sister 's dad 's cousin 's father 's boss 's daughter 's bed is confused .
the couch knows that your dentist 's daughter 's father 's teacher 's brother 's grandmother 's boat is angry .	the couch scares your dentist 's daughter 's father 's teacher 's brother 's grandmother 's boat is angry .
the box knows that my sister 's brother 's teacher 's wife 's sister 's father 's chair is friendly .	the box talks to my sister 's brother 's teacher 's wife 's sister 's father 's chair is friendly .
the mirror thinks that your husband 's wife 's husband 's boss 's wife 's friend 's bicycle is young .	the mirror talks to your husband 's wife 's husband 's boss 's wife 's friend 's bicycle is young .
the button says that my father 's dentist 's friend 's brother 's friend 's son 's car is bored .	the button helps my father 's dentist 's friend 's brother 's friend 's son 's car is bored .
the glass thinks that your brother 's boss 's teacher 's grandmother 's teacher 's grandmother 's mirror is sleepy .	the glass scares your brother 's boss 's teacher 's grandmother 's teacher 's grandmother 's mirror is sleepy .
the crayon says that my sister 's mother 's father 's mom 's sister 's grandmother 's bottle is nice .	the crayon works with my sister 's mother 's father 's mom 's sister 's grandmother 's bottle is nice .
the rocket says that your doctor 's doctor 's doctor 's wife 's mother 's husband 's couch is tired .	the rocket talks to your doctor 's doctor 's doctor 's wife 's mother 's husband 's couch is tired .
the spoon thinks that my mom 's cousin 's son 's daughter 's mom 's husband 's couch is busy .	the spoon talks to my mom 's cousin 's son 's daughter 's mom 's husband 's couch is busy .
the bowl says that your mom 's wife 's cousin 's wife 's boss 's father 's chair is lucky .	the bowl scares your mom 's wife 's cousin 's wife 's boss 's father 's chair is lucky .
the crayon knows that your daughter 's dad 's sister 's doctor 's brother 's dad 's box is excited .	the crayon scares your daughter 's dad 's sister 's doctor 's brother 's dad 's box is excited .
the picture thinks that my dentist 's sister 's sister 's mother 's teacher 's dentist 's ship is busy .	the picture helps my dentist 's sister 's sister 's mother 's teacher 's dentist 's ship is busy .
the shirt thinks that your doctor 's daughter 's teacher 's father 's daughter 's dentist 's bowl is tall .	the shirt scares your doctor 's daughter 's teacher 's father 's daughter 's dentist 's bowl is tall .
the book says that your boss 's friend 's brother 's boss 's brother 's doctor 's plane is gentle .	the book scares your boss 's friend 's brother 's boss 's brother 's doctor 's plane is gentle .
the book knows that your mom 's father 's boss 's dentist 's mom 's daughter 's rocket is busy .	the book scares your mom 's father 's boss 's dentist 's mom 's daughter 's rocket is busy .
the spoon says that your doctor 's mom 's teacher 's mom 's boss 's sister 's cup is healthy .	the spoon helps your doctor 's mom 's teacher 's mom 's boss 's sister 's cup is healthy .
the car thinks that your friend 's son 's doctor 's teacher 's teacher 's mother 's bottle is helpful .	the car scares your friend 's son 's doctor 's teacher 's teacher 's mother 's bottle is helpful .
the fork knows that my husband 's friend 's daughter 's daughter 's friend 's brother 's bicycle is upset .	the fork scares my husband 's friend 's daughter 's daughter 's friend 's brother 's bicycle is upset .
the book says that your grandmother 's friend 's father 's daughter 's mom 's sister 's candle is strong .	the book scares your grandmother 's friend 's father 's daughter 's mom 's sister 's candle is strong .
the plane thinks that my grandmother 's mom 's teacher 's grandmother 's father 's doctor 's dish is lucky .	the plane works with my grandmother 's mom 's teacher 's grandmother 's father 's doctor 's dish is lucky .
the bowl says that your friend 's grandmother 's father 's dad 's daughter 's wife 's fork is bored .	the bowl talks to your friend 's grandmother 's father 's dad 's daughter 's wife 's fork is bored .
the book thinks that your friend 's sister 's cousin 's dad 's cousin 's friend 's hat is smart .	the book works with your friend 's sister 's cousin 's dad 's cousin 's friend 's hat is smart .
the bottle says that my son 's brother 's boss 's mother 's doctor 's boss 's rug is wrong .	the bottle talks to my son 's brother 's boss 's mother 's doctor 's boss 's rug is wrong .
the boat says that my brother 's husband 's son 's dentist 's mom 's brother 's dish is wrong .	the boat works with my brother 's husband 's son 's dentist 's mom 's brother 's dish is wrong .
the picture says that my son 's friend 's mom 's dentist 's dad 's husband 's car is strong .	the picture helps my son 's friend 's mom 's dentist 's dad 's husband 's car is strong .
the plate thinks that my father 's teacher 's mom 's friend 's cousin 's cousin 's book is angry .	the plate scares my father 's teacher 's mom 's friend 's cousin 's cousin 's book is angry .
the hat says that your cousin 's friend 's friend 's teacher 's husband 's doctor 's plane is gentle .	the hat helps your cousin 's friend 's friend 's teacher 's husband 's doctor 's plane is gentle .
the plane thinks that your teacher 's wife 's friend 's mom 's dentist 's brother 's spoon is surprised .	the plane helps your teacher 's wife 's friend 's mom 's dentist 's brother 's spoon is surprised .
the box thinks that your cousin 's dad 's boss 's brother 's son 's teacher 's door is hungry .	the box works with your cousin 's dad 's boss 's brother 's son 's teacher 's door is hungry .
the chair thinks that my son 's friend 's friend 's doctor 's husband 's son 's spoon is excited .	the chair helps my son 's friend 's friend 's doctor 's husband 's son 's spoon is excited .
the fork says that your dentist 's husband 's grandmother 's husband 's grandmother 's son 's picture is tired .	the fork helps your dentist 's husband 's grandmother 's husband 's grandmother 's son 's picture is tired .
the box knows that my friend 's doctor 's mother 's wife 's cousin 's son 's shirt is boring .	the box scares my friend 's doctor 's mother 's wife 's cousin 's son 's shirt is boring .
the truck thinks that my dentist 's sister 's mother 's dad 's teacher 's dad 's bowl is young .	the truck works with my dentist 's sister 's mother 's dad 's teacher 's dad 's bowl is young .
the button knows that your cousin 's boss 's daughter 's doctor 's doctor 's doctor 's chair is young .	the button talks to your cousin 's boss 's daughter 's doctor 's doctor 's doctor 's chair is young .
the fork knows that your son 's friend 's father 's friend 's husband 's sister 's bed is busy .	the fork scares your son 's friend 's father 's friend 's husband 's sister 's bed is busy .
the shoe thinks that my dentist 's friend 's cousin 's doctor 's mom 's sister 's book is hungry .	the shoe talks to my dentist 's friend 's cousin 's doctor 's mom 's sister 's book is hungry .
the window says that your mother 's grandmother 's boss 's sister 's friend 's mom 's couch is friendly .	the window talks to your mother 's grandmother 's boss 's sister 's friend 's mom 's couch is friendly .
the cup knows that my teacher 's brother 's doctor 's daughter 's grandmother 's wife 's book is bored .	the cup talks to my teacher 's brother 's doctor 's daughter 's grandmother 's wife 's book is bored .
the bed says that my wife 's son 's mom 's husband 's teacher 's mom 's car is busy .	the bed helps my wife 's son 's mom 's husband 's teacher 's mom 's car is busy .
the rug says that your sister 's husband 's sister 's son 's brother 's mom 's car is boring .	the rug talks to your sister 's husband 's sister 's son 's brother 's mom 's car is boring .
the doll thinks that your mom 's doctor 's friend 's doctor 's dad 's dentist 's doll is smart .	the doll works with your mom 's doctor 's friend 's doctor 's dad 's dentist 's doll is smart .
the door says that your grandmother 's friend 's doctor 's teacher 's mother 's daughter 's rug is angry .	the door talks to your grandmother 's friend 's doctor 's teacher 's mother 's daughter 's rug is angry .
the candle says that your son 's doctor 's sister 's friend 's dentist 's mother 's ship is lucky .	the candle talks to your son 's doctor 's sister 's friend 's dentist 's mother 's ship is lucky .
the bicycle thinks that my grandmother 's son 's husband 's doctor 's doctor 's mother 's dish is curious .	the bicycle helps my grandmother 's son 's husband 's doctor 's doctor 's mother 's dish is curious .
the crayon thinks that my cousin 's mom 's boss 's doctor 's husband 's doctor 's toy is bored .	the crayon scares my cousin 's mom 's boss 's doctor 's husband 's doctor 's toy is bored .
the window thinks that my father 's daughter 's daughter 's cousin 's dentist 's father 's couch is smart .	the window scares my father 's daughter 's daughter 's cousin 's dentist 's father 's couch is smart .
the bicycle thinks that my son 's dentist 's teacher 's friend 's doctor 's husband 's bottle is important .	the bicycle helps my son 's dentist 's teacher 's friend 's doctor 's husband 's bottle is important .
the box thinks that your friend 's friend 's grandmother 's teacher 's mother 's father 's hat is strong .	the box scares your friend 's friend 's grandmother 's teacher 's mother 's father 's hat is strong .
the doll thinks that your mom 's wife 's boss 's friend 's grandmother 's father 's dish is gentle .	the doll scares your mom 's wife 's boss 's friend 's grandmother 's father 's dish is gentle .
the toy knows that your husband 's daughter 's husband 's friend 's sister 's grandmother 's door is young .	the toy helps your husband 's daughter 's husband 's friend 's sister 's grandmother 's door is young .
the shoe knows that your daughter 's wife 's son 's dad 's daughter 's daughter 's bowl is young .	the shoe talks to your daughter 's wife 's son 's dad 's daughter 's daughter 's bowl is young .
the car thinks that your daughter 's cousin 's husband 's wife 's husband 's dad 's cup is healthy .	the car talks to your daughter 's cousin 's husband 's wife 's husband 's dad 's cup is healthy .
the glass thinks that my dentist 's daughter 's mom 's wife 's dad 's doctor 's shoe is excited .	the glass scares my dentist 's daughter 's mom 's wife 's dad 's doctor 's shoe is excited .
the chair thinks that my father 's son 's daughter 's daughter 's wife 's dentist 's dish is hungry .	the chair scares my father 's son 's daughter 's daughter 's wife 's dentist 's dish is hungry .
the candle says that my grandmother 's cousin 's wife 's wife 's husband 's son 's truck is friendly .	the candle works with my grandmother 's cousin 's wife 's wife 's husband 's son 's truck is friendly .
the candle says that your mom 's friend 's cousin 's father 's daughter 's mother 's picture is tall .	the candle helps your mom 's friend 's cousin 's father 's daughter 's mother 's picture is tall .
the bed thinks that your brother 's husband 's daughter 's dentist 's dad 's teacher 's plate is confused .	the bed scares your brother 's husband 's daughter 's dentist 's dad 's teacher 's plate is confused .
the doll thinks that your sister 's mother 's cousin 's mom 's brother 's boss 's spoon is confused .	the doll talks to your sister 's mother 's cousin 's mom 's brother 's boss 's spoon is confused .
the truck says that your father 's sister 's son 's cousin 's brother 's dentist 's mirror is sleepy .	the truck works with your father 's sister 's son 's cousin 's brother 's dentist 's mirror is sleepy .
the mirror says that your son 's dentist 's friend 's friend 's brother 's boss 's box is surprised .	the mirror talks to your son 's dentist 's friend 's friend 's brother 's boss 's box is surprised .
the book says that my friend 's wife 's brother 's husband 's wife 's doctor 's chair is curious .	the book works with my friend 's wife 's brother 's husband 's wife 's doctor 's chair is curious .
the bed knows that my boss 's grandmother 's dentist 's dentist 's son 's friend 's bottle is curious .	the bed talks to my boss 's grandmother 's dentist 's dentist 's son 's friend 's bottle is curious .
the ring knows that my friend 's dad 's son 's wife 's wife 's daughter 's bag is excited .	the ring talks to my friend 's dad 's son 's wife 's wife 's daughter 's bag is excited .
the plate knows that your doctor 's teacher 's dad 's mom 's cousin 's mother 's doll is important .	the plate works with your doctor 's teacher 's dad 's mom 's cousin 's mother 's doll is important .
the bed says that my cousin 's boss 's wife 's wife 's mom 's mother 's bottle is quiet .	the bed helps my cousin 's boss 's wife 's wife 's mom 's mother 's bottle is quiet .
the candle knows that your dad 's father 's friend 's teacher 's husband 's mother 's dish is healthy .	the candle talks to your dad 's father 's friend 's teacher 's husband 's mother 's dish is healthy .
the car thinks that my grandmother 's grandmother 's cousin 's teacher 's grandmother 's cousin 's box is important .	the car talks to my grandmother 's grandmother 's cousin 's teacher 's grandmother 's cousin 's box is important .
the shirt knows that your wife 's daughter 's cousin 's cousin 's cousin 's wife 's cup is angry .	the shirt scares your wife 's daughter 's cousin 's cousin 's cousin 's wife 's cup is angry .
the candle says that my daughter 's teacher 's father 's son 's mother 's brother 's picture is boring .	the candle talks to my daughter 's teacher 's father 's son 's mother 's brother 's picture is boring .
the car says that your husband 's friend 's boss 's boss 's dad 's boss 's ship is angry .	the car works with your husband 's friend 's boss 's boss 's dad 's boss 's ship is angry .
the crayon says that my grandmother 's mother 's husband 's husband 's sister 's husband 's fork is strong .	the crayon scares my grandmother 's mother 's husband 's husband 's sister 's husband 's fork is strong .
the doll thinks that my doctor 's husband 's wife 's husband 's dentist 's cousin 's hat is surprised .	the doll helps my doctor 's husband 's wife 's husband 's dentist 's cousin 's hat is surprised .
the cup thinks that your mother 's son 's grandmother 's sister 's sister 's wife 's door is lucky .	the cup scares your mother 's son 's grandmother 's sister 's sister 's wife 's door is lucky .
the chair says that my son 's grandmother 's cousin 's dad 's mother 's daughter 's book is excited .	the chair works with my son 's grandmother 's cousin 's dad 's mother 's daughter 's book is excited .
the fork thinks that my husband 's boss 's dentist 's sister 's mom 's wife 's bowl is careful .	the fork talks to my husband 's boss 's dentist 's sister 's mom 's wife 's bowl is careful .
the box says that my brother 's dad 's wife 's grandmother 's dad 's boss 's rocket is clever .	the box talks to my brother 's dad 's wife 's grandmother 's dad 's boss 's rocket is clever .
the bowl thinks that my husband 's daughter 's mother 's daughter 's son 's son 's door is helpful .	the bowl helps my husband 's daughter 's mother 's daughter 's son 's son 's door is helpful .
the ship knows that my daughter 's boss 's brother 's dad 's doctor 's dad 's couch is tall .	the ship works with my daughter 's boss 's brother 's dad 's doctor 's dad 's couch is tall .
the car says that my wife 's teacher 's sister 's sister 's boss 's teacher 's box is helpful .	the car scares my wife 's teacher 's sister 's sister 's boss 's teacher 's box is helpful .
the button thinks that your boss 's brother 's brother 's doctor 's grandmother 's cousin 's chair is confused .	the button scares your boss 's brother 's brother 's doctor 's grandmother 's cousin 's chair is confused .
the doll thinks that your sister 's mom 's mom 's husband 's teacher 's dentist 's fork is confused .	the doll works with your sister 's mom 's mom 's husband 's teacher 's dentist 's fork is confused .
the boat says that my grandmother 's brother 's daughter 's dad 's mom 's father 's crayon is excited .	the boat talks to my grandmother 's brother 's daughter 's dad 's mom 's father 's crayon is excited .
the hat says that your father 's wife 's husband 's boss 's doctor 's cousin 's door is helpful .	the hat works with your father 's wife 's husband 's boss 's doctor 's cousin 's door is helpful .
the couch knows that my dentist 's son 's mother 's friend 's father 's father 's cup is healthy .	the couch works with my dentist 's son 's mother 's friend 's father 's father 's cup is healthy .
the dish says that my boss 's brother 's friend 's father 's cousin 's doctor 's button is gentle .	the dish helps my boss 's brother 's friend 's father 's cousin 's doctor 's button is gentle .
the couch thinks that your mother 's husband 's dentist 's daughter 's brother 's daughter 's plane is angry .	the couch talks to your mother 's husband 's dentist 's daughter 's brother 's daughter 's plane is angry .
the candle says that my husband 's mom 's doctor 's mom 's brother 's wife 's rug is important .	the candle scares my husband 's mom 's doctor 's mom 's brother 's wife 's rug is important .
the picture thinks that your dad 's dad 's boss 's mom 's teacher 's dad 's ring is wrong .	the picture works with your dad 's dad 's boss 's mom 's teacher 's dad 's ring is wrong .
the ring says that your grandmother 's mom 's cousin 's boss 's boss 's boss 's chair is healthy .	the ring scares your grandmother 's mom 's cousin 's boss 's boss 's boss 's chair is healthy .
the bottle says that my teacher 's grandmother 's teacher 's grandmother 's brother 's dentist 's spoon is healthy .	the bottle talks to my teacher 's grandmother 's teacher 's grandmother 's brother 's dentist 's spoon is healthy .
the car knows that my husband 's dad 's mom 's doctor 's sister 's son 's chair is happy .	the car works with my husband 's dad 's mom 's doctor 's sister 's son 's chair is happy .
the candle knows that your dad 's grandmother 's brother 's dentist 's grandmother 's cousin 's bag is tired .	the candle scares your dad 's grandmother 's brother 's dentist 's grandmother 's cousin 's bag is tired .
the rug knows that my cousin 's son 's grandmother 's dentist 's grandmother 's dentist 's shirt is smart .	the rug helps my cousin 's son 's grandmother 's dentist 's grandmother 's dentist 's shirt is smart .
the plate thinks that my dad 's dentist 's sister 's sister 's doctor 's friend 's book is young .	the plate scares my dad 's dentist 's sister 's sister 's doctor 's friend 's book is young .
the ship thinks that my wife 's friend 's dentist 's boss 's son 's dentist 's chair is angry .	the ship helps my wife 's friend 's dentist 's boss 's son 's dentist 's chair is angry .
the door says that your dentist 's dad 's son 's sister 's daughter 's son 's fork is curious .	the door scares your dentist 's dad 's son 's sister 's daughter 's son 's fork is curious .
the truck knows that my doctor 's brother 's dentist 's boss 's grandmother 's sister 's spoon is quiet .	the truck scares my doctor 's brother 's dentist 's boss 's grandmother 's sister 's spoon is quiet .
the mirror says that my boss 's doctor 's teacher 's dentist 's son 's sister 's ring is busy .	the mirror talks to my boss 's doctor 's teacher 's dentist 's son 's sister 's ring is busy .
the book thinks that my father 's mom 's brother 's boss 's sister 's mother 's spoon is important .	the book helps my father 's mom 's brother 's boss 's sister 's mother 's spoon is important .
the hat thinks that your grandmother 's dad 's dentist 's sister 's son 's boss 's ring is confused .	the hat helps your grandmother 's dad 's dentist 's sister 's son 's boss 's ring is confused .
the car knows that your teacher 's boss 's daughter 's wife 's sister 's wife 's button is busy .	the car talks to your teacher 's boss 's daughter 's wife 's sister 's wife 's button is busy .
the car knows that my sister 's boss 's brother 's husband 's daughter 's boss 's door is boring .	the car scares my sister 's boss 's brother 's husband 's daughter 's boss 's door is boring .
the mirror knows that my cousin 's wife 's friend 's teacher 's friend 's father 's hat is lucky .	the mirror works with my cousin 's wife 's friend 's teacher 's friend 's father 's hat is lucky .
the boat says that my grandmother 's brother 's wife 's mother 's dad 's son 's ship is happy .	the boat talks to my grandmother 's brother 's wife 's mother 's dad 's son 's ship is happy .
the bowl thinks that your son 's doctor 's dad 's wife 's doctor 's wife 's fork is hungry .	the bowl helps your son 's doctor 's dad 's wife 's doctor 's wife 's fork is hungry .
the door says that my grandmother 's teacher 's mother 's teacher 's doctor 's doctor 's plane is hungry .	the door scares my grandmother 's teacher 's mother 's teacher 's doctor 's doctor 's plane is hungry .
the cup says that your grandmother 's mom 's husband 's mother 's cousin 's dentist 's book is wrong .	the cup works with your grandmother 's mom 's husband 's mother 's cousin 's dentist 's book is wrong .
the bowl says that my brother 's son 's brother 's teacher 's cousin 's grandmother 's window is nice .	the bowl talks to my brother 's son 's brother 's teacher 's cousin 's grandmother 's window is nice .
the bed says that your mom 's husband 's teacher 's teacher 's sister 's wife 's bicycle is tall .	the bed scares your mom 's husband 's teacher 's teacher 's sister 's wife 's bicycle is tall .
the box knows that my mother 's dentist 's friend 's wife 's daughter 's grandmother 's car is quiet .	the box works with my mother 's dentist 's friend 's wife 's daughter 's grandmother 's car is quiet .
the book says that your daughter 's dad 's dentist 's sister 's mother 's dentist 's bag is excited .	the book works with your daughter 's dad 's dentist 's sister 's mother 's dentist 's bag is excited .
the bottle says that your brother 's cousin 's sister 's husband 's son 's dentist 's rug is busy .	the bottle helps your brother 's cousin 's sister 's husband 's son 's dentist 's rug is busy .
the bicycle says that your brother 's dad 's dentist 's grandmother 's doctor 's sister 's shirt is hungry .	the bicycle scares your brother 's dad 's dentist 's grandmother 's doctor 's sister 's shirt is hungry .
the fork knows that my friend 's grandmother 's brother 's grandmother 's doctor 's brother 's hat is nice .	the fork helps my friend 's grandmother 's brother 's grandmother 's doctor 's brother 's hat is nice .
the boat knows that your father 's wife 's doctor 's son 's dad 's daughter 's plane is boring .	the boat scares your father 's wife 's doctor 's son 's dad 's daughter 's plane is boring .
the button says that my dad 's brother 's sister 's dad 's dentist 's husband 's couch is excited .	the button works with my dad 's brother 's sister 's dad 's dentist 's husband 's couch is excited .
the ship thinks that your friend 's cousin 's dentist 's sister 's grandmother 's wife 's bottle is kind .	the ship talks to your friend 's cousin 's dentist 's sister 's grandmother 's wife 's bottle is kind .
the doll thinks that my teacher 's friend 's teacher 's son 's father 's father 's door is tired .	the doll helps my teacher 's friend 's teacher 's son 's father 's father 's door is tired .
the cup knows that your daughter 's dentist 's father 's friend 's grandmother 's wife 's truck is lucky .	the cup works with your daughter 's dentist 's father 's friend 's grandmother 's wife 's truck is lucky .
the glass knows that your teacher 's friend 's husband 's father 's brother 's grandmother 's bicycle is lucky .	the glass scares your teacher 's friend 's husband 's father 's brother 's grandmother 's bicycle is lucky .
the rocket knows that my grandmother 's teacher 's mom 's daughter 's cousin 's cousin 's plane is upset .	the rocket works with my grandmother 's teacher 's mom 's daughter 's cousin 's cousin 's plane is upset .
the door says that my doctor 's mother 's dentist 's dentist 's teacher 's teacher 's couch is quiet .	the door works with my doctor 's mother 's dentist 's dentist 's teacher 's teacher 's couch is quiet .
the plane knows that your daughter 's daughter 's dad 's mom 's mother 's friend 's candle is nice .	the plane helps your daughter 's daughter 's dad 's mom 's mother 's friend 's candle is nice .
the ring thinks that your grandmother 's cousin 's father 's doctor 's mother 's father 's plate is healthy .	the ring talks to your grandmother 's cousin 's father 's doctor 's mother 's father 's plate is healthy .
the box knows that my grandmother 's wife 's teacher 's friend 's sister 's wife 's crayon is sleepy .	the box helps my grandmother 's wife 's teacher 's friend 's sister 's wife 's crayon is sleepy .
the crayon knows that my doctor 's mom 's teacher 's cousin 's teacher 's grandmother 's book is wrong .	the crayon works with my doctor 's mom 's teacher 's cousin 's teacher 's grandmother 's book is wrong .
the bed thinks that your father 's brother 's boss 's father 's sister 's husband 's window is sleepy .	the bed talks to your father 's brother 's boss 's father 's sister 's husband 's window is sleepy .
the bag knows that your brother 's son 's father 's teacher 's father 's friend 's boat is strong .	the bag works with your brother 's son 's father 's teacher 's father 's friend 's boat is strong .
the plate thinks that my brother 's mom 's doctor 's husband 's teacher 's doctor 's plate is tired .	the plate scares my brother 's mom 's doctor 's husband 's teacher 's doctor 's plate is tired .
the rocket knows that your grandmother 's son 's sister 's teacher 's doctor 's dad 's ship is sleepy .	the rocket helps your grandmother 's son 's sister 's teacher 's doctor 's dad 's ship is sleepy .
the button knows that my brother 's brother 's boss 's mother 's husband 's boss 's picture is quiet .	the button helps my brother 's brother 's boss 's mother 's husband 's boss 's picture is quiet .
the bottle knows that your cousin 's teacher 's teacher 's boss 's grandmother 's dad 's boat is nice .	the bottle works with your cousin 's teacher 's teacher 's boss 's grandmother 's dad 's boat is nice .
the car says that your husband 's daughter 's mother 's daughter 's husband 's boss 's couch is kind .	the car talks to your husband 's daughter 's mother 's daughter 's husband 's boss 's couch is kind .
the window says that your teacher 's wife 's cousin 's doctor 's father 's teacher 's bottle is surprised .	the window works with your teacher 's wife 's cousin 's doctor 's father 's teacher 's bottle is surprised .
the picture says that your doctor 's teacher 's sister 's doctor 's dentist 's wife 's dish is wrong .	the picture scares your doctor 's teacher 's sister 's doctor 's dentist 's wife 's dish is wrong .
the mirror says that your mother 's father 's brother 's wife 's brother 's doctor 's box is lucky .	the mirror scares your mother 's father 's brother 's wife 's brother 's doctor 's box is lucky .
the shirt says that my mom 's brother 's dad 's wife 's dentist 's grandmother 's shoe is quiet .	the shirt talks to my mom 's brother 's dad 's wife 's dentist 's grandmother 's shoe is quiet .
the ring says that my friend 's mother 's husband 's dad 's dentist 's dad 's spoon is wrong .	the ring helps my friend 's mother 's husband 's dad 's dentist 's dad 's spoon is wrong .
the truck says that your dentist 's husband 's teacher 's sister 's sister 's dentist 's car is kind .	the truck talks to your dentist 's husband 's teacher 's sister 's sister 's dentist 's car is kind .
the book says that my doctor 's brother 's mom 's cousin 's boss 's dentist 's button is young .	the book helps my doctor 's brother 's mom 's cousin 's boss 's dentist 's button is young .
the fork thinks that your doctor 's dentist 's mom 's mother 's teacher 's cousin 's car is careful .	the fork works with your doctor 's dentist 's mom 's mother 's teacher 's cousin 's car is careful .
the bag thinks that your cousin 's mother 's friend 's brother 's dentist 's mother 's cup is friendly .	the bag helps your cousin 's mother 's friend 's brother 's dentist 's mother 's cup is friendly .
the bed knows that your sister 's son 's dad 's friend 's grandmother 's doctor 's box is sleepy .	the bed helps your sister 's son 's dad 's friend 's grandmother 's doctor 's box is sleepy .
the rug says that your wife 's son 's grandmother 's wife 's dad 's husband 's box is friendly .	the rug talks to your wife 's son 's grandmother 's wife 's dad 's husband 's box is friendly .
the bicycle knows that my wife 's mom 's father 's son 's mom 's dentist 's chair is confused .	the bicycle talks to my wife 's mom 's father 's son 's mom 's dentist 's chair is confused .
the box says that your friend 's boss 's grandmother 's dad 's teacher 's friend 's candle is excited .	the box helps your friend 's boss 's grandmother 's dad 's teacher 's friend 's candle is excited .
the doll knows that my cousin 's cousin 's father 's wife 's dad 's dad 's mirror is hungry .	the doll helps my cousin 's cousin 's father 's wife 's dad 's dad 's mirror is hungry .
the box knows that your friend 's dentist 's boss 's father 's sister 's son 's bed is helpful .	the box helps your friend 's dentist 's boss 's father 's sister 's son 's bed is helpful .
the ring says that your teacher 's son 's daughter 's dad 's son 's friend 's cup is gentle .	the ring helps your teacher 's son 's daughter 's dad 's son 's friend 's cup is gentle .
the boat knows that your daughter 's dad 's doctor 's husband 's boss 's mother 's spoon is excited .	the boat scares your daughter 's dad 's doctor 's husband 's boss 's mother 's spoon is excited .
the ring knows that my teacher 's friend 's dad 's mother 's husband 's cousin 's crayon is nice .	the ring scares my teacher 's friend 's dad 's mother 's husband 's cousin 's crayon is nice .
the ring says that your daughter 's doctor 's brother 's doctor 's husband 's cousin 's button is healthy .	the ring works with your daughter 's doctor 's brother 's doctor 's husband 's cousin 's button is healthy .
the ring thinks that my daughter 's wife 's daughter 's friend 's son 's brother 's car is kind .	the ring talks to my daughter 's wife 's daughter 's friend 's son 's brother 's car is kind .
the bicycle says that your teacher 's doctor 's wife 's boss 's doctor 's dad 's bicycle is smart .	the bicycle works with your teacher 's doctor 's wife 's boss 's doctor 's dad 's bicycle is smart .
the box says that your wife 's cousin 's sister 's son 's cousin 's husband 's mirror is clever .	the box talks to your wife 's cousin 's sister 's son 's cousin 's husband 's mirror is clever .
the button knows that your brother 's daughter 's doctor 's daughter 's mom 's mom 's bottle is important .	the button talks to your brother 's daughter 's doctor 's daughter 's mom 's mom 's bottle is important .
the picture says that my daughter 's father 's mom 's doctor 's grandmother 's dentist 's hat is curious .	the picture scares my daughter 's father 's mom 's doctor 's grandmother 's dentist 's hat is curious .
the doll knows that your boss 's father 's boss 's doctor 's teacher 's sister 's bottle is quiet .	the doll works with your boss 's father 's boss 's doctor 's teacher 's sister 's bottle is quiet .
the hat thinks that your mother 's dentist 's daughter 's father 's son 's doctor 's boat is busy .	the hat works with your mother 's dentist 's daughter 's father 's son 's doctor 's boat is busy .
the bag thinks that my brother 's doctor 's mom 's teacher 's cousin 's doctor 's book is lucky .	the bag helps my brother 's doctor 's mom 's teacher 's cousin 's doctor 's book is lucky .
the toy says that my friend 's husband 's wife 's mother 's mother 's friend 's bicycle is smart .	the toy works with my friend 's husband 's wife 's mother 's mother 's friend 's bicycle is smart .
the shirt thinks that my boss 's wife 's mother 's son 's father 's teacher 's window is surprised .	the shirt talks to my boss 's wife 's mother 's son 's father 's teacher 's window is surprised .
the rug knows that my sister 's cousin 's brother 's son 's grandmother 's friend 's crayon is confused .	the rug scares my sister 's cousin 's brother 's son 's grandmother 's friend 's crayon is confused .
the bottle thinks that my dentist 's brother 's cousin 's son 's mom 's cousin 's couch is boring .	the bottle helps my dentist 's brother 's cousin 's son 's mom 's cousin 's couch is boring .
the boat says that your brother 's sister 's dad 's son 's dad 's sister 's window is sleepy .	the boat works with your brother 's sister 's dad 's son 's dad 's sister 's window is sleepy .
the fork says that your mom 's mother 's brother 's cousin 's dentist 's cousin 's shirt is smart .	the fork scares your mom 's mother 's brother 's cousin 's dentist 's cousin 's shirt is smart .
the ship says that my friend 's brother 's dad 's husband 's friend 's cousin 's spoon is gentle .	the ship works with my friend 's brother 's dad 's husband 's friend 's cousin 's spoon is gentle .
the crayon knows that my son 's dentist 's friend 's wife 's dentist 's son 's candle is smart .	the crayon scares my son 's dentist 's friend 's wife 's dentist 's son 's candle is smart .
the ring knows that my mother 's wife 's dad 's friend 's mother 's mom 's fork is busy .	the ring scares my mother 's wife 's dad 's friend 's mother 's mom 's fork is busy .
the shoe says that your teacher 's boss 's son 's wife 's sister 's wife 's car is friendly .	the shoe works with your teacher 's boss 's son 's wife 's sister 's wife 's car is friendly .
the car knows that my mother 's cousin 's son 's cousin 's wife 's father 's couch is happy .	the car talks to my mother 's cousin 's son 's cousin 's wife 's father 's couch is happy .
the dish knows that your grandmother 's husband 's mom 's sister 's son 's grandmother 's button is strong .	the dish helps your grandmother 's husband 's mom 's sister 's son 's grandmother 's button is strong .
the bottle says that your son 's doctor 's husband 's doctor 's boss 's mother 's shoe is surprised .	the bottle helps your son 's doctor 's husband 's doctor 's boss 's mother 's shoe is surprised .
the door says that my husband 's dad 's father 's brother 's friend 's dad 's shoe is kind .	the door works with my husband 's dad 's father 's brother 's friend 's dad 's shoe is kind .
the window says that my husband 's teacher 's mother 's wife 's dad 's teacher 's picture is wrong .	the window helps my husband 's teacher 's mother 's wife 's dad 's teacher 's picture is wrong .
the book knows that your teacher 's doctor 's dentist 's mother 's son 's husband 's picture is surprised .	the book scares your teacher 's doctor 's dentist 's mother 's son 's husband 's picture is surprised .
the mirror says that my cousin 's son 's husband 's grandmother 's mom 's dad 's box is gentle .	the mirror helps my cousin 's son 's husband 's grandmother 's mom 's dad 's box is gentle .
the picture says that your grandmother 's cousin 's brother 's brother 's boss 's brother 's glass is young .	the picture helps your grandmother 's cousin 's brother 's brother 's boss 's brother 's glass is young .
the toy thinks that your cousin 's husband 's sister 's doctor 's daughter 's brother 's bowl is tall .	the toy helps your cousin 's husband 's sister 's doctor 's daughter 's brother 's bowl is tall .
the rocket knows that your husband 's friend 's grandmother 's brother 's dad 's cousin 's bag is healthy .	the rocket talks to your husband 's friend 's grandmother 's brother 's dad 's cousin 's bag is healthy .
the glass thinks that your brother 's dad 's friend 's sister 's brother 's doctor 's boat is kind .	the glass works with your brother 's dad 's friend 's sister 's brother 's doctor 's boat is kind .
the chair thinks that my cousin 's father 's teacher 's wife 's cousin 's cousin 's bicycle is confused .	the chair talks to my cousin 's father 's teacher 's wife 's cousin 's cousin 's bicycle is confused .
the door knows that my brother 's father 's husband 's doctor 's father 's cousin 's shirt is helpful .	the door helps my brother 's father 's husband 's doctor 's father 's cousin 's shirt is helpful .
the ring thinks that my cousin 's father 's teacher 's son 's daughter 's boss 's picture is young .	the ring talks to my cousin 's father 's teacher 's son 's daughter 's boss 's picture is young .
the book says that my friend 's wife 's mom 's friend 's wife 's boss 's rug is gentle .	the book scares my friend 's wife 's mom 's friend 's wife 's boss 's rug is gentle .
the window says that your dentist 's boss 's son 's daughter 's daughter 's father 's car is smart .	the window scares your dentist 's boss 's son 's daughter 's daughter 's father 's car is smart .
the mirror thinks that your dentist 's grandmother 's mother 's brother 's doctor 's mom 's picture is helpful .	the mirror works with your dentist 's grandmother 's mother 's brother 's doctor 's mom 's picture is helpful .
the door thinks that my boss 's husband 's doctor 's mom 's cousin 's father 's candle is curious .	the door helps my boss 's husband 's doctor 's mom 's cousin 's father 's candle is curious .
the car knows that your sister 's mom 's friend 's son 's brother 's father 's rug is quiet .	the car talks to your sister 's mom 's friend 's son 's brother 's father 's rug is quiet .
the bag says that your sister 's son 's friend 's mother 's wife 's wife 's bowl is curious .	the bag works with your sister 's son 's friend 's mother 's wife 's wife 's bowl is curious .
the door knows that your dentist 's grandmother 's doctor 's father 's father 's grandmother 's window is young .	the door talks to your dentist 's grandmother 's doctor 's father 's father 's grandmother 's window is young .
the book thinks that my wife 's teacher 's daughter 's doctor 's sister 's daughter 's window is healthy .	the book scares my wife 's teacher 's daughter 's doctor 's sister 's daughter 's window is healthy .
the shirt thinks that your dad 's grandmother 's doctor 's cousin 's brother 's brother 's bottle is healthy .	the shirt helps your dad 's grandmother 's doctor 's cousin 's brother 's brother 's bottle is healthy .
the window knows that my grandmother 's teacher 's cousin 's teacher 's father 's father 's cup is wrong .	the window talks to my grandmother 's teacher 's cousin 's teacher 's father 's father 's cup is wrong .
the bicycle knows that my brother 's daughter 's wife 's teacher 's wife 's cousin 's bag is important .	the bicycle works with my brother 's daughter 's wife 's teacher 's wife 's cousin 's bag is important .
the mirror knows that my teacher 's brother 's brother 's teacher 's grandmother 's cousin 's candle is hungry .	the mirror talks to my teacher 's brother 's brother 's teacher 's grandmother 's cousin 's candle is hungry .
the doll says that your teacher 's sister 's boss 's doctor 's wife 's mom 's rocket is kind .	the doll works with your teacher 's sister 's boss 's doctor 's wife 's mom 's rocket is kind .
the bottle knows that your father 's dentist 's mom 's boss 's doctor 's boss 's bowl is kind .	the bottle scares your father 's dentist 's mom 's boss 's doctor 's boss 's bowl is kind .
the bag knows that my boss 's mother 's dentist 's dad 's daughter 's friend 's cup is surprised .	the bag works with my boss 's mother 's dentist 's dad 's daughter 's friend 's cup is surprised .
the cup says that my dentist 's husband 's doctor 's son 's father 's mom 's hat is important .	the cup talks to my dentist 's husband 's doctor 's son 's father 's mom 's hat is important .
the cup knows that your doctor 's daughter 's mom 's daughter 's mom 's brother 's candle is gentle .	the cup scares your doctor 's daughter 's mom 's daughter 's mom 's brother 's candle is gentle .
the bag knows that my teacher 's friend 's daughter 's mom 's doctor 's dad 's ship is busy .	the bag scares my teacher 's friend 's daughter 's mom 's doctor 's dad 's ship is busy .
the bottle says that your wife 's father 's sister 's mom 's sister 's teacher 's bicycle is important .	the bottle works with your wife 's father 's sister 's mom 's sister 's teacher 's bicycle is important .
the fork thinks that your son 's dentist 's sister 's son 's doctor 's father 's spoon is helpful .	the fork talks to your son 's dentist 's sister 's son 's doctor 's father 's spoon is helpful .
the hat thinks that my grandmother 's grandmother 's friend 's dad 's son 's wife 's spoon is friendly .	the hat helps my grandmother 's grandmother 's friend 's dad 's son 's wife 's spoon is friendly .
the glass thinks that your teacher 's friend 's sister 's father 's friend 's mom 's shirt is gentle .	the glass talks to your teacher 's friend 's sister 's father 's friend 's mom 's shirt is gentle .
the ring says that your mom 's brother 's friend 's boss 's brother 's doctor 's picture is gentle .	the ring works with your mom 's brother 's friend 's boss 's brother 's doctor 's picture is gentle .
the ship knows that my cousin 's son 's son 's son 's mother 's husband 's couch is clever .	the ship helps my cousin 's son 's son 's son 's mother 's husband 's couch is clever .
the cup knows that my grandmother 's son 's father 's son 's doctor 's friend 's rocket is wrong .	the cup scares my grandmother 's son 's father 's son 's doctor 's friend 's rocket is wrong .
the car says that your dentist 's friend 's dad 's sister 's boss 's son 's couch is curious .	the car works with your dentist 's friend 's dad 's sister 's boss 's son 's couch is curious .
the shoe thinks that your teacher 's grandmother 's husband 's teacher 's boss 's sister 's boat is boring .	the shoe helps your teacher 's grandmother 's husband 's teacher 's boss 's sister 's boat is boring .
the doll says that your mom 's teacher 's mom 's mother 's brother 's brother 's crayon is tired .	the doll helps your mom 's teacher 's mom 's mother 's brother 's brother 's crayon is tired .
the shoe thinks that your doctor 's dad 's grandmother 's husband 's mom 's mother 's book is healthy .	the shoe talks to your doctor 's dad 's grandmother 's husband 's mom 's mother 's book is healthy .
the plate says that your mom 's mom 's daughter 's husband 's dad 's dentist 's chair is young .	the plate works with your mom 's mom 's daughter 's husband 's dad 's dentist 's chair is young .
the ship thinks that your wife 's grandmother 's sister 's grandmother 's mom 's brother 's cup is helpful .	the ship talks to your wife 's grandmother 's sister 's grandmother 's mom 's brother 's cup is helpful .
the button says that your father 's dentist 's father 's mother 's dentist 's father 's crayon is young .	the button scares your father 's dentist 's father 's mother 's dentist 's father 's crayon is young .
the plane knows that my teacher 's sister 's sister 's wife 's daughter 's sister 's cup is gentle .	the plane works with my teacher 's sister 's sister 's wife 's daughter 's sister 's cup is gentle .
the mirror thinks that your sister 's sister 's husband 's cousin 's boss 's father 's toy is young .	the mirror scares your sister 's sister 's husband 's cousin 's boss 's father 's toy is young .
the truck says that my brother 's mother 's mother 's husband 's dentist 's husband 's bag is smart .	the truck talks to my brother 's mother 's mother 's husband 's dentist 's husband 's bag is smart .
the door thinks that my brother 's brother 's teacher 's dad 's daughter 's teacher 's crayon is boring .	the door helps my brother 's brother 's teacher 's dad 's daughter 's teacher 's crayon is boring .
the cup knows that your cousin 's teacher 's husband 's brother 's cousin 's teacher 's bowl is nice .	the cup works with your cousin 's teacher 's husband 's brother 's cousin 's teacher 's bowl is nice .
the bag knows that your sister 's wife 's dad 's wife 's mother 's sister 's shirt is boring .	the bag helps your sister 's wife 's dad 's wife 's mother 's sister 's shirt is boring .
the shoe says that my daughter 's father 's son 's wife 's boss 's grandmother 's doll is sleepy .	the shoe talks to my daughter 's father 's son 's wife 's boss 's grandmother 's doll is sleepy .
the dish knows that my dad 's dentist 's husband 's doctor 's wife 's grandmother 's door is angry .	the dish helps my dad 's dentist 's husband 's doctor 's wife 's grandmother 's door is angry .
the doll says that your friend 's dentist 's brother 's grandmother 's dentist 's mom 's ship is quiet .	the doll talks to your friend 's dentist 's brother 's grandmother 's dentist 's mom 's ship is quiet .
the crayon knows that your brother 's daughter 's dentist 's dentist 's father 's husband 's cup is lucky .	the crayon talks to your brother 's daughter 's dentist 's dentist 's father 's husband 's cup is lucky .
the book thinks that your daughter 's son 's husband 's mom 's friend 's father 's bag is bored .	the book helps your daughter 's son 's husband 's mom 's friend 's father 's bag is bored .
the car knows that my mom 's mom 's friend 's doctor 's sister 's wife 's picture is confused .	the car helps my mom 's mom 's friend 's doctor 's sister 's wife 's picture is confused .
the glass knows that your brother 's wife 's brother 's teacher 's father 's doctor 's candle is boring .	the glass works with your brother 's wife 's brother 's teacher 's father 's doctor 's candle is boring .
the doll knows that my friend 's mom 's grandmother 's son 's daughter 's mother 's ship is smart .	the doll works with my friend 's mom 's grandmother 's son 's daughter 's mother 's ship is smart .
the dish knows that your son 's grandmother 's husband 's father 's mother 's sister 's shoe is gentle .	the dish scares your son 's grandmother 's husband 's father 's mother 's sister 's shoe is gentle .
the bowl knows that my grandmother 's wife 's wife 's cousin 's dentist 's daughter 's picture is wrong .	the bowl helps my grandmother 's wife 's wife 's cousin 's dentist 's daughter 's picture is wrong .
the bottle says that my dad 's wife 's son 's father 's husband 's sister 's cup is careful .	the bottle talks to my dad 's wife 's son 's father 's husband 's sister 's cup is careful .
the bowl thinks that your wife 's doctor 's father 's son 's father 's mom 's button is friendly .	the bowl works with your wife 's doctor 's father 's son 's father 's mom 's button is friendly .
the candle says that my brother 's doctor 's wife 's husband 's husband 's husband 's boat is gentle .	the candle helps my brother 's doctor 's wife 's husband 's husband 's husband 's boat is gentle .
the toy says that my doctor 's boss 's wife 's brother 's mom 's boss 's couch is tired .	the toy works with my doctor 's boss 's wife 's brother 's mom 's boss 's couch is tired .
the car thinks that my wife 's boss 's doctor 's sister 's dad 's teacher 's doll is smart .	the car works with my wife 's boss 's doctor 's sister 's dad 's teacher 's doll is smart .
the toy thinks that your friend 's father 's teacher 's cousin 's dad 's doctor 's truck is kind .	the toy talks to your friend 's father 's teacher 's cousin 's dad 's doctor 's truck is kind .
the car thinks that your boss 's daughter 's dad 's mother 's sister 's dad 's plate is hungry .	the car helps your boss 's daughter 's dad 's mother 's sister 's dad 's plate is hungry .
the book knows that your mother 's daughter 's cousin 's doctor 's cousin 's dad 's chair is young .	the book talks to your mother 's daughter 's cousin 's doctor 's cousin 's dad 's chair is young .
the hat says that my sister 's son 's grandmother 's mom 's mother 's teacher 's spoon is nice .	the hat talks to my sister 's son 's grandmother 's mom 's mother 's teacher 's spoon is nice .
the chair says that my mother 's daughter 's doctor 's wife 's mom 's mom 's button is excited .	the chair scares my mother 's daughter 's doctor 's wife 's mom 's mom 's button is excited .
the fork knows that your mom 's sister 's father 's teacher 's dentist 's father 's bag is sleepy .	the fork helps your mom 's sister 's father 's teacher 's dentist 's father 's bag is sleepy .
the candle knows that your father 's doctor 's husband 's father 's friend 's husband 's candle is healthy .	the candle works with your father 's doctor 's husband 's father 's friend 's husband 's candle is healthy .
the couch knows that my husband 's father 's grandmother 's boss 's daughter 's mom 's bottle is boring .	the couch talks to my husband 's father 's grandmother 's boss 's daughter 's mom 's bottle is boring .
the cup thinks that your friend 's brother 's dad 's doctor 's daughter 's sister 's toy is surprised .	the cup scares your friend 's brother 's dad 's doctor 's daughter 's sister 's toy is surprised .
the doll thinks that your cousin 's doctor 's dentist 's dentist 's daughter 's boss 's bed is tired .	the doll helps your cousin 's doctor 's dentist 's dentist 's daughter 's boss 's bed is tired .
the cup thinks that your cousin 's brother 's wife 's doctor 's daughter 's mother 's box is gentle .	the cup scares your cousin 's brother 's wife 's doctor 's daughter 's mother 's box is gentle .
the fork knows that my mother 's daughter 's friend 's dad 's son 's son 's toy is nice .	the fork talks to my mother 's daughter 's friend 's dad 's son 's son 's toy is nice .
the hat knows that your mom 's teacher 's cousin 's husband 's dentist 's father 's rug is busy .	the hat works with your mom 's teacher 's cousin 's husband 's dentist 's father 's rug is busy .
the rocket thinks that my cousin 's daughter 's friend 's father 's cousin 's doctor 's chair is excited .	the rocket works with my cousin 's daughter 's friend 's father 's cousin 's doctor 's chair is excited .
the ship thinks that your husband 's grandmother 's doctor 's husband 's grandmother 's teacher 's rocket is tall .	the ship talks to your husband 's grandmother 's doctor 's husband 's grandmother 's teacher 's rocket is tall .
the plane thinks that my grandmother 's husband 's husband 's dad 's teacher 's teacher 's candle is curious .	the plane works with my grandmother 's husband 's husband 's dad 's teacher 's teacher 's candle is curious .
the bed says that your doctor 's boss 's dad 's daughter 's sister 's dentist 's plane is hungry .	the bed scares your doctor 's boss 's dad 's daughter 's sister 's dentist 's plane is hungry .
the shirt thinks that my mom 's friend 's dentist 's boss 's mom 's grandmother 's hat is kind .	the shirt scares my mom 's friend 's dentist 's boss 's mom 's grandmother 's hat is kind .
the car thinks that your dad 's brother 's dad 's boss 's grandmother 's teacher 's plane is sleepy .	the car works with your dad 's brother 's dad 's boss 's grandmother 's teacher 's plane is sleepy .
the bowl says that my teacher 's wife 's doctor 's father 's mom 's boss 's doll is friendly .	the bowl helps my teacher 's wife 's doctor 's father 's mom 's boss 's doll is friendly .
the mirror knows that my son 's dentist 's doctor 's doctor 's son 's father 's button is strong .	the mirror scares my son 's dentist 's doctor 's doctor 's son 's father 's button is strong .
the crayon thinks that my sister 's grandmother 's dad 's boss 's cousin 's doctor 's bottle is important .	the crayon talks to my sister 's grandmother 's dad 's boss 's cousin 's doctor 's bottle is important .
the shoe thinks that your daughter 's dentist 's mom 's teacher 's brother 's wife 's rocket is gentle .	the shoe talks to your daughter 's dentist 's mom 's teacher 's brother 's wife 's rocket is gentle .
the button thinks that my dentist 's doctor 's brother 's dentist 's friend 's daughter 's bag is confused .	the button scares my dentist 's doctor 's brother 's dentist 's friend 's daughter 's bag is confused .
the picture thinks that your husband 's dentist 's dad 's grandmother 's brother 's boss 's couch is angry .	the picture works with your husband 's dentist 's dad 's grandmother 's brother 's boss 's couch is angry .
the box says that your husband 's doctor 's wife 's teacher 's doctor 's brother 's plane is tired .	the box helps your husband 's doctor 's wife 's teacher 's doctor 's brother 's plane is tired .
the bed knows that your father 's dad 's daughter 's daughter 's boss 's boss 's bag is lucky .	the bed helps your father 's dad 's daughter 's daughter 's boss 's boss 's bag is lucky .
the ring says that your father 's brother 's dentist 's father 's sister 's dentist 's car is surprised .	the ring helps your father 's brother 's dentist 's father 's sister 's dentist 's car is surprised .
the book says that my son 's doctor 's friend 's daughter 's teacher 's friend 's bag is happy .	the book talks to my son 's doctor 's friend 's daughter 's teacher 's friend 's bag is happy .
the box thinks that my teacher 's doctor 's son 's grandmother 's dentist 's boss 's chair is strong .	the box works with my teacher 's doctor 's son 's grandmother 's dentist 's boss 's chair is strong .
the shoe says that my husband 's son 's mom 's son 's mom 's teacher 's boat is quiet .	the shoe talks to my husband 's son 's mom 's son 's mom 's teacher 's boat is quiet .
the car knows that my friend 's sister 's dad 's dentist 's husband 's dentist 's book is kind .	the car helps my friend 's sister 's dad 's dentist 's husband 's dentist 's book is kind .
the candle thinks that my husband 's wife 's mother 's cousin 's daughter 's dad 's dish is important .	the candle talks to my husband 's wife 's mother 's cousin 's daughter 's dad 's dish is important .
the rug knows that my mom 's cousin 's grandmother 's father 's husband 's boss 's plane is confused .	the rug works with my mom 's cousin 's grandmother 's father 's husband 's boss 's plane is confused .
the car knows that your daughter 's boss 's dad 's grandmother 's friend 's mother 's doll is angry .	the car helps your daughter 's boss 's dad 's grandmother 's friend 's mother 's doll is angry .
the plate says that my boss 's wife 's brother 's son 's wife 's friend 's toy is healthy .	the plate scares my boss 's wife 's brother 's son 's wife 's friend 's toy is healthy .
the couch thinks that your doctor 's father 's grandmother 's husband 's dad 's mother 's ship is busy .	the couch works with your doctor 's father 's grandmother 's husband 's dad 's mother 's ship is busy .
the plate knows that your doctor 's daughter 's doctor 's boss 's daughter 's wife 's candle is bored .	the plate scares your doctor 's daughter 's doctor 's boss 's daughter 's wife 's candle is bored .
the glass says that my boss 's dad 's doctor 's husband 's wife 's father 's bicycle is curious .	the glass works with my boss 's dad 's doctor 's husband 's wife 's father 's bicycle is curious .
the ship thinks that your sister 's dentist 's doctor 's sister 's boss 's teacher 's shoe is healthy .	the ship works with your sister 's dentist 's doctor 's sister 's boss 's teacher 's shoe is healthy .
the window knows that your son 's friend 's friend 's dentist 's friend 's cousin 's book is healthy .	the window helps your son 's friend 's friend 's dentist 's friend 's cousin 's book is healthy .
the crayon thinks that my sister 's dentist 's mother 's boss 's mother 's father 's glass is young .	the crayon scares my sister 's dentist 's mother 's boss 's mother 's father 's glass is young .
the bicycle thinks that your teacher 's daughter 's doctor 's dentist 's husband 's teacher 's candle is important .	the bicycle works with your teacher 's daughter 's doctor 's dentist 's husband 's teacher 's candle is important .
the ring thinks that your mom 's wife 's doctor 's daughter 's daughter 's husband 's bag is smart .	the ring helps your mom 's wife 's doctor 's daughter 's daughter 's husband 's bag is smart .
the fork thinks that your doctor 's father 's dad 's father 's cousin 's cousin 's plane is hungry .	the fork works with your doctor 's father 's dad 's father 's cousin 's cousin 's plane is hungry .
the bowl knows that your mother 's son 's teacher 's dad 's mother 's wife 's box is wrong .	the bowl helps your mother 's son 's teacher 's dad 's mother 's wife 's box is wrong .
the bicycle says that my grandmother 's doctor 's mother 's cousin 's son 's grandmother 's rocket is kind .	the bicycle helps my grandmother 's doctor 's mother 's cousin 's son 's grandmother 's rocket is kind .
the bicycle thinks that my doctor 's daughter 's sister 's brother 's grandmother 's doctor 's fork is gentle .	the bicycle scares my doctor 's daughter 's sister 's brother 's grandmother 's doctor 's fork is gentle .
the crayon says that your dad 's dentist 's grandmother 's son 's husband 's doctor 's plate is wrong .	the crayon helps your dad 's dentist 's grandmother 's son 's husband 's doctor 's plate is wrong .
the shoe knows that your son 's husband 's sister 's grandmother 's cousin 's doctor 's bed is smart .	the shoe helps your son 's husband 's sister 's grandmother 's cousin 's doctor 's bed is smart .
the box knows that my doctor 's sister 's sister 's dad 's friend 's boss 's mirror is tired .	the box helps my doctor 's sister 's sister 's dad 's friend 's boss 's mirror is tired .
the chair says that my teacher 's friend 's doctor 's mother 's cousin 's grandmother 's ship is hungry .	the chair talks to my teacher 's friend 's doctor 's mother 's cousin 's grandmother 's ship is hungry .
the box knows that my mother 's boss 's husband 's daughter 's friend 's cousin 's glass is tall .	the box works with my mother 's boss 's husband 's daughter 's friend 's cousin 's glass is tall .
the toy says that your mother 's friend 's husband 's grandmother 's brother 's dad 's shoe is lucky .	the toy works with your mother 's friend 's husband 's grandmother 's brother 's dad 's shoe is lucky .
the ring thinks that my grandmother 's cousin 's teacher 's daughter 's son 's friend 's doll is young .	the ring scares my grandmother 's cousin 's teacher 's daughter 's son 's friend 's doll is young .
the ship thinks that your boss 's wife 's mother 's grandmother 's dad 's sister 's picture is busy .	the ship talks to your boss 's wife 's mother 's grandmother 's dad 's sister 's picture is busy .
the chair knows that my wife 's daughter 's teacher 's husband 's sister 's cousin 's fork is healthy .	the chair scares my wife 's daughter 's teacher 's husband 's sister 's cousin 's fork is healthy .
the cup knows that your father 's daughter 's doctor 's daughter 's mom 's daughter 's hat is upset .	the cup helps your father 's daughter 's doctor 's daughter 's mom 's daughter 's hat is upset .
the box thinks that my dentist 's mom 's mother 's grandmother 's boss 's husband 's spoon is friendly .	the box works with my dentist 's mom 's mother 's grandmother 's boss 's husband 's spoon is friendly .
the shirt says that your mother 's brother 's teacher 's cousin 's grandmother 's dentist 's button is healthy .	the shirt helps your mother 's brother 's teacher 's cousin 's grandmother 's dentist 's button is healthy .
the mirror thinks that your grandmother 's wife 's friend 's mom 's dad 's dad 's doll is young .	the mirror scares your grandmother 's wife 's friend 's mom 's dad 's dad 's doll is young .
the shoe says that your teacher 's sister 's grandmother 's boss 's dad 's boss 's doll is upset .	the shoe talks to your teacher 's sister 's grandmother 's boss 's dad 's boss 's doll is upset .
the spoon says that your son 's grandmother 's mother 's mom 's teacher 's husband 's bicycle is happy .	the spoon talks to your son 's grandmother 's mother 's mom 's teacher 's husband 's bicycle is happy .
the bed says that my doctor 's teacher 's wife 's wife 's sister 's cousin 's window is helpful .	the bed scares my doctor 's teacher 's wife 's wife 's sister 's cousin 's window is helpful .
the book says that your mom 's dad 's grandmother 's doctor 's son 's grandmother 's picture is sleepy .	the book helps your mom 's dad 's grandmother 's doctor 's son 's grandmother 's picture is sleepy .
the bag says that my son 's husband 's mother 's boss 's father 's sister 's doll is important .	the bag works with my son 's husband 's mother 's boss 's father 's sister 's doll is important .
the car knows that my wife 's doctor 's mother 's brother 's friend 's wife 's toy is lucky .	the car talks to my wife 's doctor 's mother 's brother 's friend 's wife 's toy is lucky .
the book says that your husband 's dad 's teacher 's dentist 's father 's friend 's bowl is young .	the book helps your husband 's dad 's teacher 's dentist 's father 's friend 's bowl is young .
the couch knows that my wife 's sister 's dad 's doctor 's friend 's mom 's crayon is kind .	the couch scares my wife 's sister 's dad 's doctor 's friend 's mom 's crayon is kind .
the bowl says that my sister 's mom 's dad 's teacher 's doctor 's teacher 's crayon is surprised .	the bowl helps my sister 's mom 's dad 's teacher 's doctor 's teacher 's crayon is surprised .
the picture knows that my friend 's doctor 's daughter 's cousin 's friend 's grandmother 's hat is smart .	the picture talks to my friend 's doctor 's daughter 's cousin 's friend 's grandmother 's hat is smart .
the button knows that your brother 's teacher 's doctor 's husband 's daughter 's mother 's boat is friendly .	the button talks to your brother 's teacher 's doctor 's husband 's daughter 's mother 's boat is friendly .
the mirror thinks that my dentist 's friend 's brother 's friend 's boss 's mom 's bed is careful .	the mirror scares my dentist 's friend 's brother 's friend 's boss 's mom 's bed is careful .
the bottle knows that your mother 's daughter 's doctor 's doctor 's mother 's father 's candle is nice .	the bottle scares your mother 's daughter 's doctor 's doctor 's mother 's father 's candle is nice .
the car says that my boss 's daughter 's sister 's husband 's son 's boss 's box is helpful .	the car works with my boss 's daughter 's sister 's husband 's son 's boss 's box is helpful .
the hat says that your father 's wife 's husband 's teacher 's father 's mom 's rocket is important .	the hat talks to your father 's wife 's husband 's teacher 's father 's mom 's rocket is important .
the door says that my doctor 's boss 's boss 's mom 's doctor 's brother 's crayon is bored .	the door helps my doctor 's boss 's boss 's mom 's doctor 's brother 's crayon is bored .
the glass says that your cousin 's mom 's sister 's cousin 's son 's father 's plane is gentle .	the glass helps your cousin 's mom 's sister 's cousin 's son 's father 's plane is gentle .
the cup thinks that my mom 's sister 's boss 's cousin 's husband 's brother 's bed is friendly .	the cup helps my mom 's sister 's boss 's cousin 's husband 's brother 's bed is friendly .
the bowl knows that my father 's grandmother 's cousin 's boss 's friend 's father 's mirror is upset .	the bowl scares my father 's grandmother 's cousin 's boss 's friend 's father 's mirror is upset .
the dish says that my father 's brother 's brother 's dad 's son 's teacher 's ring is quiet .	the dish works with my father 's brother 's brother 's dad 's son 's teacher 's ring is quiet .
the mirror says that your son 's dad 's daughter 's boss 's sister 's boss 's book is lucky .	the mirror works with your son 's dad 's daughter 's boss 's sister 's boss 's book is lucky .
the spoon knows that my teacher 's cousin 's sister 's dentist 's mother 's brother 's cup is wrong .	the spoon talks to my teacher 's cousin 's sister 's dentist 's mother 's brother 's cup is wrong .
the mirror knows that your cousin 's father 's daughter 's son 's dad 's teacher 's boat is nice .	the mirror works with your cousin 's father 's daughter 's son 's dad 's teacher 's boat is nice .
the chair knows that your cousin 's dentist 's doctor 's husband 's sister 's daughter 's shirt is helpful .	the chair works with your cousin 's dentist 's doctor 's husband 's sister 's daughter 's shirt is helpful .
the bag says that my mother 's husband 's friend 's mother 's dentist 's grandmother 's bottle is kind .	the bag helps my mother 's husband 's friend 's mother 's dentist 's grandmother 's bottle is kind .
the doll knows that my teacher 's teacher 's husband 's cousin 's cousin 's grandmother 's shirt is healthy .	the doll helps my teacher 's teacher 's husband 's cousin 's cousin 's grandmother 's shirt is healthy .
the shoe says that my husband 's dentist 's wife 's dad 's son 's mother 's truck is careful .	the shoe talks to my husband 's dentist 's wife 's dad 's son 's mother 's truck is careful .
the ship knows that my dentist 's son 's friend 's brother 's daughter 's wife 's rug is smart .	the ship works with my dentist 's son 's friend 's brother 's daughter 's wife 's rug is smart .
the book says that my boss 's dad 's dentist 's doctor 's mother 's husband 's spoon is boring .	the book works with my boss 's dad 's dentist 's doctor 's mother 's husband 's spoon is boring .
the cup knows that my husband 's teacher 's daughter 's dentist 's friend 's son 's fork is tall .	the cup talks to my husband 's teacher 's daughter 's dentist 's friend 's son 's fork is tall .
the dish says that my mother 's father 's cousin 's friend 's dentist 's mom 's ring is surprised .	the dish helps my mother 's father 's cousin 's friend 's dentist 's mom 's ring is surprised .
the mirror thinks that your mother 's son 's son 's boss 's teacher 's brother 's ship is happy .	the mirror helps your mother 's son 's son 's boss 's teacher 's brother 's ship is happy .
the box says that my boss 's wife 's boss 's sister 's husband 's father 's spoon is tall .	the box works with my boss 's wife 's boss 's sister 's husband 's father 's spoon is tall .
the bowl knows that your friend 's boss 's daughter 's boss 's wife 's dentist 's book is upset .	the bowl talks to your friend 's boss 's daughter 's boss 's wife 's dentist 's book is upset .
the truck knows that your friend 's friend 's teacher 's mother 's wife 's daughter 's fork is strong .	the truck works with your friend 's friend 's teacher 's mother 's wife 's daughter 's fork is strong .
the bottle knows that my brother 's sister 's son 's father 's cousin 's cousin 's car is curious .	the bottle helps my brother 's sister 's son 's father 's cousin 's cousin 's car is curious .
the bag says that your sister 's father 's cousin 's cousin 's brother 's grandmother 's chair is important .	the bag talks to your sister 's father 's cousin 's cousin 's brother 's grandmother 's chair is important .
the chair says that my dad 's friend 's brother 's father 's sister 's wife 's bag is healthy .	the chair talks to my dad 's friend 's brother 's father 's sister 's wife 's bag is healthy .
the car says that your father 's grandmother 's mom 's sister 's grandmother 's mother 's book is kind .	the car works with your father 's grandmother 's mom 's sister 's grandmother 's mother 's book is kind .
the hat thinks that your dad 's cousin 's father 's sister 's mom 's grandmother 's chair is gentle .	the hat scares your dad 's cousin 's father 's sister 's mom 's grandmother 's chair is gentle .
the hat knows that your friend 's grandmother 's mother 's father 's mother 's son 's picture is healthy .	the hat works with your friend 's grandmother 's mother 's father 's mother 's son 's picture is healthy .
the fork says that my teacher 's mom 's boss 's father 's dentist 's wife 's bag is lucky .	the fork talks to my teacher 's mom 's boss 's father 's dentist 's wife 's bag is lucky .
the ring knows that your wife 's mom 's doctor 's father 's teacher 's brother 's book is wrong .	the ring scares your wife 's mom 's doctor 's father 's teacher 's brother 's book is wrong .
the couch says that your son 's boss 's son 's father 's dad 's boss 's shoe is careful .	the couch scares your son 's boss 's son 's father 's dad 's boss 's shoe is careful .
the plate thinks that your husband 's mom 's mother 's daughter 's mother 's mom 's candle is healthy .	the plate scares your husband 's mom 's mother 's daughter 's mother 's mom 's candle is healthy .
the rug thinks that my son 's cousin 's dad 's mother 's dentist 's father 's bed is surprised .	the rug helps my son 's cousin 's dad 's mother 's dentist 's father 's bed is surprised .
the bowl says that my cousin 's grandmother 's dentist 's father 's brother 's husband 's book is confused .	the bowl helps my cousin 's grandmother 's dentist 's father 's brother 's husband 's book is confused .
the cup thinks that your husband 's doctor 's brother 's teacher 's father 's grandmother 's hat is healthy .	the cup helps your husband 's doctor 's brother 's teacher 's father 's grandmother 's hat is healthy .
the cup thinks that my brother 's husband 's doctor 's mom 's boss 's dad 's book is nice .	the cup helps my brother 's husband 's doctor 's mom 's boss 's dad 's book is nice .
the car thinks that your boss 's wife 's husband 's brother 's daughter 's teacher 's picture is gentle .	the car works with your boss 's wife 's husband 's brother 's daughter 's teacher 's picture is gentle .
the rocket thinks that your mom 's mom 's cousin 's dentist 's brother 's teacher 's car is young .	the rocket scares your mom 's mom 's cousin 's dentist 's brother 's teacher 's car is young .
the crayon knows that my daughter 's brother 's son 's dentist 's son 's father 's shirt is busy .	the crayon talks to my daughter 's brother 's son 's dentist 's son 's father 's shirt is busy .
the window knows that your mom 's doctor 's mother 's dentist 's dad 's wife 's window is busy .	the window helps your mom 's doctor 's mother 's dentist 's dad 's wife 's window is busy .
the mirror says that your daughter 's wife 's daughter 's boss 's son 's grandmother 's box is helpful .	the mirror works with your daughter 's wife 's daughter 's boss 's son 's grandmother 's box is helpful .
the fork says that my dad 's husband 's cousin 's mom 's sister 's daughter 's window is upset .	the fork helps my dad 's husband 's cousin 's mom 's sister 's daughter 's window is upset .
the truck says that your grandmother 's doctor 's dentist 's husband 's daughter 's brother 's plane is tired .	the truck works with your grandmother 's doctor 's dentist 's husband 's daughter 's brother 's plane is tired .
the hat knows that your friend 's mother 's teacher 's cousin 's cousin 's husband 's hat is busy .	the hat scares your friend 's mother 's teacher 's cousin 's cousin 's husband 's hat is busy .
the plane says that my daughter 's friend 's brother 's wife 's boss 's dentist 's bowl is curious .	the plane scares my daughter 's friend 's brother 's wife 's boss 's dentist 's bowl is curious .
the dish knows that your friend 's son 's mother 's son 's daughter 's dad 's picture is healthy .	the dish works with your friend 's son 's mother 's son 's daughter 's dad 's picture is healthy .
the hat thinks that your mom 's son 's husband 's grandmother 's mother 's doctor 's chair is quiet .	the hat scares your mom 's son 's husband 's grandmother 's mother 's doctor 's chair is quiet .
the ship thinks that your husband 's father 's brother 's friend 's mother 's father 's picture is smart .	the ship works with your husband 's father 's brother 's friend 's mother 's father 's picture is smart .
the bottle knows that my brother 's teacher 's daughter 's brother 's doctor 's dentist 's rug is confused .	the bottle works with my brother 's teacher 's daughter 's brother 's doctor 's dentist 's rug is confused .
the ring knows that my grandmother 's father 's wife 's cousin 's brother 's boss 's box is careful .	the ring works with my grandmother 's father 's wife 's cousin 's brother 's boss 's box is careful .
the dish thinks that your friend 's brother 's daughter 's wife 's teacher 's doctor 's car is friendly .	the dish helps your friend 's brother 's daughter 's wife 's teacher 's doctor 's car is friendly .
the rocket knows that my father 's sister 's cousin 's daughter 's dad 's friend 's picture is lucky .	the rocket works with my father 's sister 's cousin 's daughter 's dad 's friend 's picture is lucky .
the cup knows that your doctor 's dentist 's sister 's boss 's dentist 's brother 's bottle is lucky .	the cup talks to your doctor 's dentist 's sister 's boss 's dentist 's brother 's bottle is lucky .
the spoon knows that your cousin 's daughter 's friend 's grandmother 's father 's daughter 's spoon is sleepy .	the spoon talks to your cousin 's daughter 's friend 's grandmother 's father 's daughter 's spoon is sleepy .
the spoon says that my cousin 's dad 's mom 's mother 's mother 's dad 's hat is tired .	the spoon talks to my cousin 's dad 's mom 's mother 's mother 's dad 's hat is tired .
the rug thinks that my brother 's wife 's wife 's friend 's friend 's sister 's cup is kind .	the rug helps my brother 's wife 's wife 's friend 's friend 's sister 's cup is kind .
the crayon says that your boss 's husband 's mom 's teacher 's teacher 's sister 's candle is wrong .	the crayon works with your boss 's husband 's mom 's teacher 's teacher 's sister 's candle is wrong .
the boat thinks that your brother 's father 's son 's mom 's father 's wife 's couch is tall .	the boat helps your brother 's father 's son 's mom 's father 's wife 's couch is tall .
the ring knows that your son 's dentist 's sister 's dentist 's cousin 's sister 's fork is young .	the ring scares your son 's dentist 's sister 's dentist 's cousin 's sister 's fork is young .
the shoe thinks that your dad 's mom 's cousin 's brother 's husband 's father 's bed is smart .	the shoe talks to your dad 's mom 's cousin 's brother 's husband 's father 's bed is smart .
the boat knows that your mom 's sister 's boss 's wife 's boss 's mother 's fork is important .	the boat works with your mom 's sister 's boss 's wife 's boss 's mother 's fork is important .
the crayon knows that my doctor 's son 's son 's teacher 's dad 's son 's fork is curious .	the crayon helps my doctor 's son 's son 's teacher 's dad 's son 's fork is curious .
the truck says that my friend 's father 's daughter 's father 's son 's father 's hat is nice .	the truck scares my friend 's father 's daughter 's father 's son 's father 's hat is nice .
the plate thinks that your wife 's dad 's daughter 's cousin 's boss 's grandmother 's book is excited .	the plate talks to your wife 's dad 's daughter 's cousin 's boss 's grandmother 's book is excited .
the plane thinks that your brother 's dentist 's sister 's husband 's brother 's boss 's book is tall .	the plane helps your brother 's dentist 's sister 's husband 's brother 's boss 's book is tall .
the hat says that my grandmother 's teacher 's cousin 's dad 's sister 's teacher 's fork is important .	the hat talks to my grandmother 's teacher 's cousin 's dad 's sister 's teacher 's fork is important .
the toy thinks that your sister 's daughter 's sister 's friend 's son 's grandmother 's glass is clever .	the toy talks to your sister 's daughter 's sister 's friend 's son 's grandmother 's glass is clever .
the ring knows that my husband 's wife 's father 's wife 's dad 's sister 's doll is clever .	the ring works with my husband 's wife 's father 's wife 's dad 's sister 's doll is clever .
the cup knows that your father 's doctor 's teacher 's cousin 's daughter 's father 's ship is friendly .	the cup talks to your father 's doctor 's teacher 's cousin 's daughter 's father 's ship is friendly .
the truck thinks that my wife 's friend 's son 's grandmother 's boss 's husband 's door is tired .	the truck helps my wife 's friend 's son 's grandmother 's boss 's husband 's door is tired .
the bicycle knows that my doctor 's boss 's doctor 's doctor 's dad 's father 's plane is excited .	the bicycle talks to my doctor 's boss 's doctor 's doctor 's dad 's father 's plane is excited .
the crayon knows that your son 's cousin 's doctor 's dad 's dentist 's dad 's picture is smart .	the crayon scares your son 's cousin 's doctor 's dad 's dentist 's dad 's picture is smart .
the boat knows that your sister 's teacher 's brother 's father 's doctor 's son 's doll is kind .	the boat scares your sister 's teacher 's brother 's father 's doctor 's son 's doll is kind .
the mirror says that my father 's friend 's dad 's sister 's son 's dad 's couch is sleepy .	the mirror talks to my father 's friend 's dad 's sister 's son 's dad 's couch is sleepy .
the doll knows that your grandmother 's dentist 's friend 's doctor 's grandmother 's boss 's dish is kind .	the doll scares your grandmother 's dentist 's friend 's doctor 's grandmother 's boss 's dish is kind .
the glass knows that my grandmother 's son 's cousin 's friend 's son 's grandmother 's door is wrong .	the glass helps my grandmother 's son 's cousin 's friend 's son 's grandmother 's door is wrong .
the bicycle thinks that your friend 's father 's mother 's father 's teacher 's dad 's doll is busy .	the bicycle works with your friend 's father 's mother 's father 's teacher 's dad 's doll is busy .
the bottle knows that my doctor 's dentist 's mom 's brother 's brother 's cousin 's fork is tall .	the bottle scares my doctor 's dentist 's mom 's brother 's brother 's cousin 's fork is tall .
the bed says that your cousin 's husband 's brother 's father 's doctor 's teacher 's dish is curious .	the bed scares your cousin 's husband 's brother 's father 's doctor 's teacher 's dish is curious .
the bottle says that my husband 's sister 's sister 's doctor 's grandmother 's wife 's crayon is tall .	the bottle scares my husband 's sister 's sister 's doctor 's grandmother 's wife 's crayon is tall .
the mirror thinks that my son 's doctor 's doctor 's mother 's cousin 's sister 's bed is upset .	the mirror scares my son 's doctor 's doctor 's mother 's cousin 's sister 's bed is upset .
the toy says that my doctor 's doctor 's mom 's friend 's brother 's wife 's window is kind .	the toy talks to my doctor 's doctor 's mom 's friend 's brother 's wife 's window is kind .
the spoon thinks that my friend 's cousin 's wife 's sister 's dentist 's friend 's button is nice .	the spoon works with my friend 's cousin 's wife 's sister 's dentist 's friend 's button is nice .
the truck says that your friend 's father 's daughter 's dad 's son 's boss 's bed is boring .	the truck scares your friend 's father 's daughter 's dad 's son 's boss 's bed is boring .
the bed knows that your mom 's dad 's husband 's sister 's cousin 's brother 's mirror is boring .	the bed helps your mom 's dad 's husband 's sister 's cousin 's brother 's mirror is boring .
the book knows that your sister 's sister 's wife 's wife 's mom 's father 's plane is clever .	the book works with your sister 's sister 's wife 's wife 's mom 's father 's plane is clever .
the door says that my husband 's boss 's daughter 's husband 's dad 's teacher 's ring is nice .	the door helps my husband 's boss 's daughter 's husband 's dad 's teacher 's ring is nice .
the door knows that my teacher 's friend 's mom 's dad 's teacher 's dentist 's book is lucky .	the door helps my teacher 's friend 's mom 's dad 's teacher 's dentist 's book is lucky .
the cup knows that my teacher 's daughter 's mom 's mother 's mom 's daughter 's picture is hungry .	the cup talks to my teacher 's daughter 's mom 's mother 's mom 's daughter 's picture is hungry .
the ship knows that my doctor 's grandmother 's father 's mother 's friend 's grandmother 's box is young .	the ship helps my doctor 's grandmother 's father 's mother 's friend 's grandmother 's box is young .
the bottle thinks that my doctor 's husband 's brother 's cousin 's dentist 's grandmother 's shirt is hungry .	the bottle helps my doctor 's husband 's brother 's cousin 's dentist 's grandmother 's shirt is hungry .
the rug says that my grandmother 's dentist 's daughter 's brother 's sister 's cousin 's couch is friendly .	the rug helps my grandmother 's dentist 's daughter 's brother 's sister 's cousin 's couch is friendly .
the cup says that my dad 's boss 's friend 's father 's dentist 's doctor 's candle is surprised .	the cup works with my dad 's boss 's friend 's father 's dentist 's doctor 's candle is surprised .
the plane thinks that your brother 's father 's daughter 's husband 's husband 's sister 's chair is curious .	the plane talks to your brother 's father 's daughter 's husband 's husband 's sister 's chair is curious .
the couch says that my son 's doctor 's brother 's brother 's mother 's dentist 's car is strong .	the couch helps my son 's doctor 's brother 's brother 's mother 's dentist 's car is strong .
the bottle says that your son 's boss 's cousin 's daughter 's wife 's dentist 's door is young .	the bottle talks to your son 's boss 's cousin 's daughter 's wife 's dentist 's door is young .
the fork says that my father 's doctor 's sister 's friend 's mom 's daughter 's door is important .	the fork works with my father 's doctor 's sister 's friend 's mom 's daughter 's door is important .
the rug knows that my wife 's cousin 's brother 's mother 's boss 's grandmother 's truck is nice .	the rug works with my wife 's cousin 's brother 's mother 's boss 's grandmother 's truck is nice .
the window knows that my brother 's husband 's father 's doctor 's son 's cousin 's chair is smart .	the window works with my brother 's husband 's father 's doctor 's son 's cousin 's chair is smart .
the doll knows that my dentist 's husband 's friend 's cousin 's grandmother 's wife 's car is happy .	the doll scares my dentist 's husband 's friend 's cousin 's grandmother 's wife 's car is happy .
the ship says that my daughter 's doctor 's brother 's mother 's dad 's cousin 's ship is happy .	the ship scares my daughter 's doctor 's brother 's mother 's dad 's cousin 's ship is happy .
the crayon thinks that your dentist 's teacher 's mother 's cousin 's son 's grandmother 's box is gentle .	the crayon scares your dentist 's teacher 's mother 's cousin 's son 's grandmother 's box is gentle .
the shoe knows that your husband 's mom 's brother 's mother 's husband 's dentist 's bowl is careful .	the shoe helps your husband 's mom 's brother 's mother 's husband 's dentist 's bowl is careful .
the glass knows that my mother 's brother 's teacher 's brother 's mother 's friend 's book is helpful .	the glass works with my mother 's brother 's teacher 's brother 's mother 's friend 's book is helpful .
the button says that my teacher 's mom 's dentist 's mom 's father 's daughter 's bowl is sleepy .	the button scares my teacher 's mom 's dentist 's mom 's father 's daughter 's bowl is sleepy .
the rocket knows that your sister 's grandmother 's brother 's cousin 's boss 's cousin 's cup is sleepy .	the rocket works with your sister 's grandmother 's brother 's cousin 's boss 's cousin 's cup is sleepy .
the hat thinks that my wife 's son 's dentist 's mom 's sister 's dentist 's cup is curious .	the hat scares my wife 's son 's dentist 's mom 's sister 's dentist 's cup is curious .
the bicycle says that my grandmother 's mom 's son 's teacher 's doctor 's son 's spoon is lucky .	the bicycle helps my grandmother 's mom 's son 's teacher 's doctor 's son 's spoon is lucky .
the fork says that your father 's doctor 's mother 's husband 's brother 's cousin 's button is tired .	the fork talks to your father 's doctor 's mother 's husband 's brother 's cousin 's button is tired .
the book knows that your brother 's mom 's wife 's husband 's cousin 's cousin 's truck is tall .	the book helps your brother 's mom 's wife 's husband 's cousin 's cousin 's truck is tall .
the plane thinks that my mom 's dentist 's mom 's grandmother 's boss 's wife 's bicycle is smart .	the plane works with my mom 's dentist 's mom 's grandmother 's boss 's wife 's bicycle is smart .
the shoe says that my boss 's grandmother 's brother 's grandmother 's son 's father 's bed is happy .	the shoe works with my boss 's grandmother 's brother 's grandmother 's son 's father 's bed is happy .
the dish knows that your dad 's mother 's dentist 's wife 's grandmother 's friend 's door is friendly .	the dish scares your dad 's mother 's dentist 's wife 's grandmother 's friend 's door is friendly .
the mirror thinks that my daughter 's friend 's dentist 's mom 's mom 's boss 's car is healthy .	the mirror helps my daughter 's friend 's dentist 's mom 's mom 's boss 's car is healthy .
the shoe thinks that my doctor 's boss 's teacher 's father 's sister 's friend 's plate is nice .	the shoe talks to my doctor 's boss 's teacher 's father 's sister 's friend 's plate is nice .
the car thinks that your brother 's brother 's husband 's dentist 's father 's cousin 's picture is curious .	the car scares your brother 's brother 's husband 's dentist 's father 's cousin 's picture is curious .
the fork thinks that my mom 's sister 's sister 's mom 's grandmother 's dentist 's box is bored .	the fork works with my mom 's sister 's sister 's mom 's grandmother 's dentist 's box is bored .
the truck says that your daughter 's mother 's dad 's teacher 's dad 's mom 's crayon is tired .	the truck helps your daughter 's mother 's dad 's teacher 's dad 's mom 's crayon is tired .
the glass thinks that my sister 's daughter 's dentist 's brother 's wife 's father 's shoe is hungry .	the glass scares my sister 's daughter 's dentist 's brother 's wife 's father 's shoe is hungry .
the window says that your boss 's wife 's daughter 's wife 's teacher 's grandmother 's plate is happy .	the window helps your boss 's wife 's daughter 's wife 's teacher 's grandmother 's plate is happy .
the cup thinks that my dentist 's son 's doctor 's husband 's mom 's doctor 's bicycle is lucky .	the cup talks to my dentist 's son 's doctor 's husband 's mom 's doctor 's bicycle is lucky .
the picture says that my husband 's friend 's dad 's grandmother 's daughter 's dad 's ring is helpful .	the picture works with my husband 's friend 's dad 's grandmother 's daughter 's dad 's ring is helpful .
the ring knows that my boss 's mom 's grandmother 's daughter 's dad 's father 's bottle is clever .	the ring helps my boss 's mom 's grandmother 's daughter 's dad 's father 's bottle is clever .
the shirt knows that your son 's dad 's mother 's friend 's dad 's doctor 's glass is upset .	the shirt scares your son 's dad 's mother 's friend 's dad 's doctor 's glass is upset .
the boat thinks that my wife 's dad 's daughter 's teacher 's dentist 's friend 's couch is wrong .	the boat helps my wife 's dad 's daughter 's teacher 's dentist 's friend 's couch is wrong .
the rocket thinks that your dad 's sister 's cousin 's mother 's boss 's husband 's cup is important .	the rocket scares your dad 's sister 's cousin 's mother 's boss 's husband 's cup is important .
the hat says that your sister 's daughter 's father 's sister 's cousin 's father 's couch is clever .	the hat works with your sister 's daughter 's father 's sister 's cousin 's father 's couch is clever .
the bed says that your dentist 's mom 's brother 's mom 's boss 's wife 's shoe is quiet .	the bed works with your dentist 's mom 's brother 's mom 's boss 's wife 's shoe is quiet .
the boat knows that your son 's boss 's grandmother 's boss 's mother 's dad 's rocket is strong .	the boat talks to your son 's boss 's grandmother 's boss 's mother 's dad 's rocket is strong .
the spoon knows that my son 's grandmother 's husband 's grandmother 's son 's daughter 's door is curious .	the spoon works with my son 's grandmother 's husband 's grandmother 's son 's daughter 's door is curious .
the ship thinks that your mother 's dad 's dad 's brother 's son 's dentist 's spoon is confused .	the ship scares your mother 's dad 's dad 's brother 's son 's dentist 's spoon is confused .
the cup thinks that your son 's brother 's mom 's sister 's father 's dentist 's toy is bored .	the cup works with your son 's brother 's mom 's sister 's father 's dentist 's toy is bored .
the rug says that your teacher 's mother 's mom 's father 's grandmother 's dad 's rocket is excited .	the rug works with your teacher 's mother 's mom 's father 's grandmother 's dad 's rocket is excited .
the box says that your cousin 's daughter 's son 's boss 's grandmother 's dentist 's fork is upset .	the box talks to your cousin 's daughter 's son 's boss 's grandmother 's dentist 's fork is upset .
the window thinks that my sister 's doctor 's friend 's friend 's cousin 's teacher 's car is helpful .	the window scares my sister 's doctor 's friend 's friend 's cousin 's teacher 's car is helpful .
the couch says that my friend 's cousin 's cousin 's daughter 's wife 's sister 's spoon is sleepy .	the couch scares my friend 's cousin 's cousin 's daughter 's wife 's sister 's spoon is sleepy .
the plate knows that my wife 's boss 's friend 's teacher 's brother 's brother 's car is gentle .	the plate talks to my wife 's boss 's friend 's teacher 's brother 's brother 's car is gentle .
the plate knows that your mom 's husband 's mom 's dentist 's cousin 's brother 's picture is important .	the plate talks to your mom 's husband 's mom 's dentist 's cousin 's brother 's picture is important .
the cup says that my brother 's cousin 's daughter 's son 's father 's mother 's dish is sleepy .	the cup works with my brother 's cousin 's daughter 's son 's father 's mother 's dish is sleepy .
the bag thinks that my husband 's daughter 's dad 's dad 's grandmother 's doctor 's book is nice .	the bag works with my husband 's daughter 's dad 's dad 's grandmother 's doctor 's book is nice .
the toy knows that my friend 's dad 's wife 's father 's mom 's sister 's fork is curious .	the toy scares my friend 's dad 's wife 's father 's mom 's sister 's fork is curious .
the rocket says that your daughter 's friend 's dad 's son 's doctor 's mom 's bicycle is quiet .	the rocket helps your daughter 's friend 's dad 's son 's doctor 's mom 's bicycle is quiet .
the fork thinks that your dentist 's teacher 's wife 's sister 's grandmother 's grandmother 's bag is clever .	the fork scares your dentist 's teacher 's wife 's sister 's grandmother 's grandmother 's bag is clever .
the book thinks that your daughter 's husband 's doctor 's boss 's mom 's grandmother 's spoon is kind .	the book talks to your daughter 's husband 's doctor 's boss 's mom 's grandmother 's spoon is kind .
the shoe thinks that your father 's father 's dad 's sister 's teacher 's husband 's rocket is young .	the shoe talks to your father 's father 's dad 's sister 's teacher 's husband 's rocket is young .
the chair knows that your doctor 's dentist 's dentist 's cousin 's boss 's dentist 's plane is tired .	the chair works with your doctor 's dentist 's dentist 's cousin 's boss 's dentist 's plane is tired .
the shirt says that your brother 's sister 's daughter 's dad 's doctor 's son 's book is excited .	the shirt works with your brother 's sister 's daughter 's dad 's doctor 's son 's book is excited .
the plane knows that your dad 's mom 's boss 's father 's dad 's dad 's box is tall .	the plane works with your dad 's mom 's boss 's father 's dad 's dad 's box is tall .
the plane thinks that your boss 's sister 's husband 's husband 's dentist 's dentist 's shirt is smart .	the plane helps your boss 's sister 's husband 's husband 's dentist 's dentist 's shirt is smart .
the dish says that my father 's sister 's mom 's son 's sister 's doctor 's candle is kind .	the dish talks to my father 's sister 's mom 's son 's sister 's doctor 's candle is kind .
the car thinks that your boss 's wife 's daughter 's sister 's grandmother 's mother 's crayon is wrong .	the car scares your boss 's wife 's daughter 's sister 's grandmother 's mother 's crayon is wrong .
the rocket says that my husband 's mother 's dentist 's teacher 's husband 's brother 's shoe is curious .	the rocket works with my husband 's mother 's dentist 's teacher 's husband 's brother 's shoe is curious .
the spoon says that your dad 's dad 's friend 's husband 's husband 's dad 's bicycle is friendly .	the spoon talks to your dad 's dad 's friend 's husband 's husband 's dad 's bicycle is friendly .
the rocket says that your father 's husband 's mother 's sister 's husband 's doctor 's doll is busy .	the rocket talks to your father 's husband 's mother 's sister 's husband 's doctor 's doll is busy .
the fork says that my teacher 's doctor 's daughter 's teacher 's teacher 's teacher 's book is young .	the fork talks to my teacher 's doctor 's daughter 's teacher 's teacher 's teacher 's book is young .
the truck knows that your wife 's dad 's teacher 's grandmother 's dentist 's brother 's fork is friendly .	the truck works with your wife 's dad 's teacher 's grandmother 's dentist 's brother 's fork is friendly .
the bicycle thinks that your dad 's dad 's friend 's doctor 's mother 's mother 's button is hungry .	the bicycle scares your dad 's dad 's friend 's doctor 's mother 's mother 's button is hungry .
the bag knows that your mom 's dentist 's cousin 's dad 's husband 's sister 's bottle is healthy .	the bag works with your mom 's dentist 's cousin 's dad 's husband 's sister 's bottle is healthy .
the door says that your mother 's brother 's brother 's cousin 's dad 's dentist 's spoon is friendly .	the door works with your mother 's brother 's brother 's cousin 's dad 's dentist 's spoon is friendly .
the candle says that your wife 's mom 's friend 's teacher 's grandmother 's son 's mirror is confused .	the candle talks to your wife 's mom 's friend 's teacher 's grandmother 's son 's mirror is confused .
the doll thinks that my husband 's grandmother 's dentist 's husband 's teacher 's teacher 's door is happy .	the doll helps my husband 's grandmother 's dentist 's husband 's teacher 's teacher 's door is happy .
the truck says that your dad 's dad 's daughter 's wife 's husband 's doctor 's book is smart .	the truck works with your dad 's dad 's daughter 's wife 's husband 's doctor 's book is smart .
the crayon says that your doctor 's son 's brother 's dad 's mother 's cousin 's rug is healthy .	the crayon scares your doctor 's son 's brother 's dad 's mother 's cousin 's rug is healthy .
the bowl knows that your daughter 's teacher 's friend 's grandmother 's wife 's son 's glass is boring .	the bowl talks to your daughter 's teacher 's friend 's grandmother 's wife 's son 's glass is boring .
the hat knows that my brother 's mom 's father 's cousin 's sister 's wife 's window is clever .	the hat scares my brother 's mom 's father 's cousin 's sister 's wife 's window is clever .
the car says that your friend 's grandmother 's father 's father 's boss 's father 's ship is sleepy .	the car scares your friend 's grandmother 's father 's father 's boss 's father 's ship is sleepy .
the fork says that your son 's dad 's dad 's dad 's daughter 's mom 's shoe is quiet .	the fork scares your son 's dad 's dad 's dad 's daughter 's mom 's shoe is quiet .
the button thinks that your cousin 's cousin 's son 's mother 's teacher 's wife 's ship is boring .	the button scares your cousin 's cousin 's son 's mother 's teacher 's wife 's ship is boring .
the picture thinks that your cousin 's wife 's doctor 's daughter 's son 's son 's box is young .	the picture helps your cousin 's wife 's doctor 's daughter 's son 's son 's box is young .
the car knows that your mother 's mom 's mother 's grandmother 's father 's son 's bicycle is strong .	the car works with your mother 's mom 's mother 's grandmother 's father 's son 's bicycle is strong .
the book knows that my mother 's friend 's sister 's grandmother 's son 's sister 's shirt is lucky .	the book helps my mother 's friend 's sister 's grandmother 's son 's sister 's shirt is lucky .
the dish says that my friend 's mom 's grandmother 's dentist 's boss 's daughter 's shoe is helpful .	the dish scares my friend 's mom 's grandmother 's dentist 's boss 's daughter 's shoe is helpful .
the bag thinks that my mother 's friend 's sister 's dad 's husband 's mother 's boat is important .	the bag talks to my mother 's friend 's sister 's dad 's husband 's mother 's boat is important .
the couch says that your husband 's boss 's boss 's dad 's son 's grandmother 's bag is important .	the couch helps your husband 's boss 's boss 's dad 's son 's grandmother 's bag is important .
the plane knows that your sister 's grandmother 's grandmother 's mom 's father 's friend 's doll is friendly .	the plane works with your sister 's grandmother 's grandmother 's mom 's father 's friend 's doll is friendly .
the button knows that your father 's wife 's mom 's son 's brother 's brother 's glass is curious .	the button scares your father 's wife 's mom 's son 's brother 's brother 's glass is curious .
the hat thinks that your dentist 's dad 's dentist 's mother 's brother 's brother 's bottle is helpful .	the hat scares your dentist 's dad 's dentist 's mother 's brother 's brother 's bottle is helpful .
the spoon knows that your father 's husband 's son 's sister 's boss 's husband 's box is lucky .	the spoon helps your father 's husband 's son 's sister 's boss 's husband 's box is lucky .
the box knows that your son 's dentist 's father 's grandmother 's grandmother 's wife 's doll is gentle .	the box scares your son 's dentist 's father 's grandmother 's grandmother 's wife 's doll is gentle .
the button knows that your cousin 's boss 's grandmother 's friend 's daughter 's brother 's bowl is sleepy .	the button works with your cousin 's boss 's grandmother 's friend 's daughter 's brother 's bowl is sleepy .
the ship thinks that your daughter 's friend 's father 's daughter 's grandmother 's sister 's door is upset .	the ship works with your daughter 's friend 's father 's daughter 's grandmother 's sister 's door is upset .
the chair says that my doctor 's brother 's friend 's father 's dad 's brother 's fork is sleepy .	the chair helps my doctor 's brother 's friend 's father 's dad 's brother 's fork is sleepy .
the picture thinks that your father 's son 's father 's mother 's dad 's daughter 's hat is careful .	the picture works with your father 's son 's father 's mother 's dad 's daughter 's hat is careful .
the bed says that my daughter 's dad 's brother 's wife 's dentist 's daughter 's cup is clever .	the bed scares my daughter 's dad 's brother 's wife 's dentist 's daughter 's cup is clever .
the hat thinks that my grandmother 's sister 's cousin 's cousin 's mom 's brother 's door is quiet .	the hat helps my grandmother 's sister 's cousin 's cousin 's mom 's brother 's door is quiet .
the book knows that my teacher 's brother 's cousin 's sister 's father 's boss 's boat is curious .	the book helps my teacher 's brother 's cousin 's sister 's father 's boss 's boat is curious .
the door thinks that my teacher 's friend 's dentist 's dad 's daughter 's wife 's ring is friendly .	the door helps my teacher 's friend 's dentist 's dad 's daughter 's wife 's ring is friendly .
the book thinks that your friend 's mother 's grandmother 's doctor 's sister 's doctor 's button is busy .	the book helps your friend 's mother 's grandmother 's doctor 's sister 's doctor 's button is busy .
the plane says that my cousin 's mother 's dad 's cousin 's wife 's son 's fork is sleepy .	the plane talks to my cousin 's mother 's dad 's cousin 's wife 's son 's fork is sleepy .
the plate thinks that my father 's friend 's friend 's teacher 's doctor 's dad 's ring is sleepy .	the plate works with my father 's friend 's friend 's teacher 's doctor 's dad 's ring is sleepy .
the plane thinks that my teacher 's doctor 's mom 's doctor 's wife 's dentist 's picture is strong .	the plane works with my teacher 's doctor 's mom 's doctor 's wife 's dentist 's picture is strong .
the car says that my friend 's teacher 's grandmother 's mom 's grandmother 's dad 's plate is upset .	the car works with my friend 's teacher 's grandmother 's mom 's grandmother 's dad 's plate is upset .
the ring knows that your brother 's mother 's father 's boss 's father 's father 's car is bored .	the ring talks to your brother 's mother 's father 's boss 's father 's father 's car is bored .
the plane knows that your brother 's dad 's doctor 's wife 's brother 's friend 's car is bored .	the plane talks to your brother 's dad 's doctor 's wife 's brother 's friend 's car is bored .
the dish thinks that your mother 's mom 's brother 's mom 's brother 's wife 's spoon is quiet .	the dish talks to your mother 's mom 's brother 's mom 's brother 's wife 's spoon is quiet .
the car knows that your sister 's doctor 's teacher 's friend 's mother 's cousin 's car is tired .	the car helps your sister 's doctor 's teacher 's friend 's mother 's cousin 's car is tired .
the hat says that your father 's doctor 's teacher 's husband 's friend 's friend 's rug is happy .	the hat helps your father 's doctor 's teacher 's husband 's friend 's friend 's rug is happy .
the plate thinks that your sister 's son 's dad 's friend 's wife 's mother 's bag is important .	the plate works with your sister 's son 's dad 's friend 's wife 's mother 's bag is important .
the ship says that your teacher 's cousin 's sister 's grandmother 's dad 's father 's window is careful .	the ship works with your teacher 's cousin 's sister 's grandmother 's dad 's father 's window is careful .
the button thinks that my grandmother 's brother 's mother 's cousin 's mom 's friend 's bottle is gentle .	the button helps my grandmother 's brother 's mother 's cousin 's mom 's friend 's bottle is gentle .
the bag says that your doctor 's dentist 's mother 's boss 's brother 's sister 's ring is bored .	the bag talks to your doctor 's dentist 's mother 's boss 's brother 's sister 's ring is bored .
the chair knows that your dad 's boss 's dentist 's sister 's teacher 's wife 's plate is wrong .	the chair scares your dad 's boss 's dentist 's sister 's teacher 's wife 's plate is wrong .
the doll thinks that my sister 's friend 's mother 's mother 's cousin 's grandmother 's car is wrong .	the doll talks to my sister 's friend 's mother 's mother 's cousin 's grandmother 's car is wrong .
the picture knows that my dad 's boss 's sister 's dentist 's sister 's friend 's bag is friendly .	the picture works with my dad 's boss 's sister 's dentist 's sister 's friend 's bag is friendly .
the shirt knows that your mom 's boss 's cousin 's boss 's mother 's cousin 's doll is excited .	the shirt scares your mom 's boss 's cousin 's boss 's mother 's cousin 's doll is excited .
the bicycle says that my friend 's mother 's son 's dad 's boss 's daughter 's boat is sleepy .	the bicycle works with my friend 's mother 's son 's dad 's boss 's daughter 's boat is sleepy .
the doll knows that my dad 's husband 's teacher 's mother 's father 's dad 's plate is smart .	the doll helps my dad 's husband 's teacher 's mother 's father 's dad 's plate is smart .
the box says that my mother 's boss 's mom 's grandmother 's brother 's son 's book is excited .	the box scares my mother 's boss 's mom 's grandmother 's brother 's son 's book is excited .
the bicycle thinks that your teacher 's boss 's father 's dentist 's friend 's father 's glass is busy .	the bicycle talks to your teacher 's boss 's father 's dentist 's friend 's father 's glass is busy .
the cup says that my brother 's wife 's son 's friend 's teacher 's mom 's box is smart .	the cup scares my brother 's wife 's son 's friend 's teacher 's mom 's box is smart .
the doll says that your mom 's mom 's dentist 's dentist 's mother 's friend 's picture is happy .	the doll scares your mom 's mom 's dentist 's dentist 's mother 's friend 's picture is happy .
the book knows that my son 's boss 's boss 's boss 's son 's doctor 's doll is quiet .	the book helps my son 's boss 's boss 's boss 's son 's doctor 's doll is quiet .
the book thinks that my brother 's grandmother 's grandmother 's dentist 's husband 's mom 's toy is tall .	the book talks to my brother 's grandmother 's grandmother 's dentist 's husband 's mom 's toy is tall .
the doll knows that my dentist 's wife 's sister 's dad 's mother 's cousin 's spoon is wrong .	the doll talks to my dentist 's wife 's sister 's dad 's mother 's cousin 's spoon is wrong .
the crayon thinks that my boss 's friend 's father 's grandmother 's husband 's mom 's bottle is helpful .	the crayon scares my boss 's friend 's father 's grandmother 's husband 's mom 's bottle is helpful .
the bottle knows that your mother 's wife 's mother 's son 's wife 's father 's bed is hungry .	the bottle scares your mother 's wife 's mother 's son 's wife 's father 's bed is hungry .
the bed thinks that your daughter 's doctor 's sister 's wife 's son 's wife 's toy is upset .	the bed talks to your daughter 's doctor 's sister 's wife 's son 's wife 's toy is upset .
