the boat by the book on the table by the door in the school is bored .	the boat was by the book on the table by the door in the school is bored .
the dish on the bed in the school in the hospital by the fork is confused .	the dish was on the bed in the school in the hospital by the fork is confused .
the mirror by the button by the hat on the street on the bed is curious .	the mirror was by the button by the hat on the street on the bed is curious .
the rug by the door on the floor by the box on the street is clever .	the rug was by the door on the floor by the box on the street is clever .
the bowl in the bank by the rocket by the hat on the bed is confused .	the bowl was in the bank by the rocket by the hat on the bed is confused .
the window by the ship on the chair in the mall on the couch is happy .	the window was by the ship on the chair in the mall on the couch is happy .
the boat in the bank in the restaurant in the museum in the park is helpful .	the boat was in the bank in the restaurant in the museum in the park is helpful .
the car by the crayon by the crayon on the street in the restaurant is tall .	the car was by the crayon by the crayon on the street in the restaurant is tall .
the bicycle on the couch on the ground on the stool by the button is quiet .	the bicycle was on the couch on the ground on the stool by the button is quiet .
the plane on the street by the plate in the hospital by the rug is nice .	the plane was on the street by the plate in the hospital by the rug is nice .
the dish on the street on the couch in the bank by the bed was kind .	the dish is on the street on the couch in the bank by the bed was kind .
the bicycle in the bank on the table in the kitchen in the school was healthy .	the bicycle is in the bank on the table in the kitchen in the school was healthy .
the bottle by the book on the floor in the school on the stool is kind .	the bottle was by the book on the floor in the school on the stool is kind .
the toy in the mall on the chair on the floor in the restaurant was smart .	the toy is in the mall on the chair on the floor in the restaurant was smart .
the fork in the school in the school on the table in the hospital was young .	the fork is in the school in the school on the table in the hospital was young .
the mirror in the library in the kitchen by the rug on the street was happy .	the mirror is in the library in the kitchen by the rug on the street was happy .
the couch in the museum in the hospital by the ship on the floor is careful .	the couch was in the museum in the hospital by the ship on the floor is careful .
the mirror in the restaurant on the street in the school in the library is smart .	the mirror was in the restaurant on the street in the school in the library is smart .
the ship in the school on the ground on the street on the bed is surprised .	the ship was in the school on the ground on the street on the bed is surprised .
the chair in the restaurant on the floor on the chair by the bottle was excited .	the chair is in the restaurant on the floor on the chair by the bottle was excited .
the ship by the glass by the spoon by the car in the school is tall .	the ship was by the glass by the spoon by the car in the school is tall .
the bed by the shoe in the hospital by the bowl on the floor is surprised .	the bed was by the shoe in the hospital by the bowl on the floor is surprised .
the fork on the ground on the bed by the doll on the couch is healthy .	the fork was on the ground on the bed by the doll on the couch is healthy .
the toy in the museum in the room on the table on the table is curious .	the toy was in the museum in the room on the table on the table is curious .
the bowl in the kitchen by the cup on the bed on the bed was curious .	the bowl is in the kitchen by the cup on the bed on the bed was curious .
the couch on the floor in the bank in the school in the hospital was tall .	the couch is on the floor in the bank in the school in the hospital was tall .
the couch in the kitchen in the museum by the bowl by the fork was quiet .	the couch is in the kitchen in the museum by the bowl by the fork was quiet .
the ring by the hat on the stool by the car by the boat is clever .	the ring was by the hat on the stool by the car by the boat is clever .
the box by the rocket on the stool on the stool by the ring was young .	the box is by the rocket on the stool on the stool by the ring was young .
the ring by the boat on the stool by the book in the hospital was angry .	the ring is by the boat on the stool by the book in the hospital was angry .
the box in the bank on the stool on the floor on the ground was gentle .	the box is in the bank on the stool on the floor on the ground was gentle .
the candle in the hospital on the floor on the stool on the street was wrong .	the candle is in the hospital on the floor on the stool on the street was wrong .
the dish by the book by the shoe on the street by the couch is boring .	the dish was by the book by the shoe on the street by the couch is boring .
the doll on the street in the school by the shirt in the hospital was confused .	the doll is on the street in the school by the shirt in the hospital was confused .
the shirt by the cup in the museum in the mall on the couch is smart .	the shirt was by the cup in the museum in the mall on the couch is smart .
the glass in the kitchen in the restaurant on the stool by the rocket was tired .	the glass is in the kitchen in the restaurant on the stool by the rocket was tired .
the boat by the ship on the chair in the bank in the library was tall .	the boat is by the ship on the chair in the bank in the library was tall .
the ring on the couch by the spoon on the bed by the book is happy .	the ring was on the couch by the spoon on the bed by the book is happy .
the picture in the room in the school on the bed by the shoe was tall .	the picture is in the room in the school on the bed by the shoe was tall .
the plate by the picture by the shirt in the room by the hat is busy .	the plate was by the picture by the shirt in the room by the hat is busy .
the bed by the glass on the floor in the museum in the library was important .	the bed is by the glass on the floor in the museum in the library was important .
the doll on the couch in the room on the bed by the plane is bored .	the doll was on the couch in the room on the bed by the plane is bored .
the toy on the stool by the chair in the museum on the floor is hungry .	the toy was on the stool by the chair in the museum on the floor is hungry .
the crayon on the floor in the school in the school on the ground is strong .	the crayon was on the floor in the school in the school on the ground is strong .
the toy in the hospital by the shirt by the window by the bicycle is smart .	the toy was in the hospital by the shirt by the window by the bicycle is smart .
the cup in the room by the book in the school by the book is upset .	the cup was in the room by the book in the school by the book is upset .
the spoon on the couch by the couch on the bed in the school was surprised .	the spoon is on the couch by the couch on the bed in the school was surprised .
the button in the school by the plane on the bed by the car was wrong .	the button is in the school by the plane on the bed by the car was wrong .
the shoe in the park by the door in the room on the ground was curious .	the shoe is in the park by the door in the room on the ground was curious .
the shirt on the couch on the chair in the park in the mall was careful .	the shirt is on the couch on the chair in the park in the mall was careful .
the toy in the school on the table in the park on the table was upset .	the toy is in the school on the table in the park on the table was upset .
the bag on the floor on the bed by the door on the street was wrong .	the bag is on the floor on the bed by the door on the street was wrong .
the crayon in the school in the hospital by the bottle in the school is strong .	the crayon was in the school in the hospital by the bottle in the school is strong .
the shirt on the couch on the stool on the table on the table is angry .	the shirt was on the couch on the stool on the table on the table is angry .
the shirt on the table in the mall on the chair in the bank was kind .	the shirt is on the table in the mall on the chair in the bank was kind .
the plate in the kitchen in the library by the shirt in the school was kind .	the plate is in the kitchen in the library by the shirt in the school was kind .
the plane in the kitchen by the bottle on the chair in the school is upset .	the plane was in the kitchen by the bottle on the chair in the school is upset .
the window in the kitchen in the bank in the bank by the car was important .	the window is in the kitchen in the bank in the bank by the car was important .
the button in the mall on the floor in the museum by the rocket is sleepy .	the button was in the mall on the floor in the museum by the rocket is sleepy .
the car on the ground by the bowl on the table by the toy was strong .	the car is on the ground by the bowl on the table by the toy was strong .
the cup in the park by the candle by the truck in the restaurant was wrong .	the cup is in the park by the candle by the truck in the restaurant was wrong .
the plate on the chair in the kitchen in the mall by the shirt is gentle .	the plate was on the chair in the kitchen in the mall by the shirt is gentle .
the rocket by the chair in the restaurant on the bed on the bed was smart .	the rocket is by the chair in the restaurant on the bed on the bed was smart .
the chair in the bank on the floor by the book by the toy was quiet .	the chair is in the bank on the floor by the book by the toy was quiet .
the mirror in the mall by the box in the school on the floor was quiet .	the mirror is in the mall by the box in the school on the floor was quiet .
the dish on the bed in the library by the bag on the table was tall .	the dish is on the bed in the library by the bag on the table was tall .
the candle by the rocket on the table by the bed in the restaurant is healthy .	the candle was by the rocket on the table by the bed in the restaurant is healthy .
the plate on the ground in the hospital on the chair on the couch is quiet .	the plate was on the ground in the hospital on the chair on the couch is quiet .
the plane in the restaurant in the school by the plate on the chair is surprised .	the plane was in the restaurant in the school by the plate on the chair is surprised .
the cup in the library on the couch by the button by the bicycle was strong .	the cup is in the library on the couch by the button by the bicycle was strong .
the fork on the street by the bed on the stool in the school is busy .	the fork was on the street by the bed on the stool in the school is busy .
the shoe on the couch on the stool in the museum by the glass was bored .	the shoe is on the couch on the stool in the museum by the glass was bored .
the car on the street on the floor on the table in the school was clever .	the car is on the street on the floor on the table in the school was clever .
the bottle in the school on the floor by the door by the doll is sleepy .	the bottle was in the school on the floor by the door by the doll is sleepy .
the bowl by the rocket by the window on the table by the button is curious .	the bowl was by the rocket by the window on the table by the button is curious .
the chair by the dish in the park in the museum in the mall is sleepy .	the chair was by the dish in the park in the museum in the mall is sleepy .
the button by the window in the school in the room on the couch is happy .	the button was by the window in the school in the room on the couch is happy .
the rug by the spoon in the bank on the street in the hospital was kind .	the rug is by the spoon in the bank on the street in the hospital was kind .
the couch by the book in the museum by the rocket in the restaurant was confused .	the couch is by the book in the museum by the rocket in the restaurant was confused .
the shirt by the window on the floor on the chair by the chair was healthy .	the shirt is by the window on the floor on the chair by the chair was healthy .
the chair on the ground on the chair in the restaurant in the kitchen was strong .	the chair is on the ground on the chair in the restaurant in the kitchen was strong .
the chair in the bank on the floor on the ground on the bed was hungry .	the chair is in the bank on the floor on the ground on the bed was hungry .
the toy on the couch by the boat by the doll on the stool was young .	the toy is on the couch by the boat by the doll on the stool was young .
the rocket on the ground in the school on the table on the chair is strong .	the rocket was on the ground in the school on the table on the chair is strong .
the car by the chair on the table on the street in the room was gentle .	the car is by the chair on the table on the street in the room was gentle .
the book in the room by the dish by the bottle in the park is angry .	the book was in the room by the dish by the bottle in the park is angry .
the shoe by the car by the candle by the bed on the chair is tired .	the shoe was by the car by the candle by the bed on the chair is tired .
the fork by the bottle in the library by the truck by the glass was curious .	the fork is by the bottle in the library by the truck by the glass was curious .
the toy on the street on the stool in the restaurant by the shoe was tall .	the toy is on the street on the stool in the restaurant by the shoe was tall .
the ring on the floor by the book in the bank in the school was boring .	the ring is on the floor by the book in the bank in the school was boring .
the mirror by the picture on the ground in the library on the ground was helpful .	the mirror is by the picture on the ground in the library on the ground was helpful .
the truck by the hat by the rug on the stool in the mall was upset .	the truck is by the hat by the rug on the stool in the mall was upset .
the toy on the chair on the stool on the stool in the mall was lucky .	the toy is on the chair on the stool on the stool in the mall was lucky .
the bed by the rug in the museum in the school on the bed is clever .	the bed was by the rug in the museum in the school on the bed is clever .
the toy on the bed in the restaurant on the bed on the street was careful .	the toy is on the bed in the restaurant on the bed on the street was careful .
the candle on the ground on the stool on the floor on the table is sleepy .	the candle was on the ground on the stool on the floor on the table is sleepy .
the picture by the boat on the floor by the cup on the table was boring .	the picture is by the boat on the floor by the cup on the table was boring .
the chair by the door on the street in the kitchen in the museum was sleepy .	the chair is by the door on the street in the kitchen in the museum was sleepy .
the ring in the room on the floor by the shoe on the floor was gentle .	the ring is in the room on the floor by the shoe on the floor was gentle .
the fork by the truck on the floor on the floor on the street was excited .	the fork is by the truck on the floor on the floor on the street was excited .
the shirt in the restaurant on the couch by the bowl in the park is bored .	the shirt was in the restaurant on the couch by the bowl in the park is bored .
the plate on the bed in the room on the street by the button is bored .	the plate was on the bed in the room on the street by the button is bored .
the car by the car in the museum in the library in the kitchen was quiet .	the car is by the car in the museum in the library in the kitchen was quiet .
the glass in the school in the bank in the library in the park was quiet .	the glass is in the school in the bank in the library in the park was quiet .
the mirror in the library on the chair in the room on the couch was busy .	the mirror is in the library on the chair in the room on the couch was busy .
the spoon by the car on the ground on the chair in the hospital is hungry .	the spoon was by the car on the ground on the chair in the hospital is hungry .
the plate on the bed in the mall in the school by the candle is curious .	the plate was on the bed in the mall in the school by the candle is curious .
the toy on the chair in the kitchen by the bowl on the couch is confused .	the toy was on the chair in the kitchen by the bowl on the couch is confused .
the candle on the couch by the chair on the ground by the hat is healthy .	the candle was on the couch by the chair on the ground by the hat is healthy .
the bag on the chair on the couch by the picture on the couch was smart .	the bag is on the chair on the couch by the picture on the couch was smart .
the book by the doll on the table by the candle on the table was surprised .	the book is by the doll on the table by the candle on the table was surprised .
the ship in the library on the stool by the book by the spoon is nice .	the ship was in the library on the stool by the book by the spoon is nice .
the couch by the button on the street by the plate by the plane was lucky .	the couch is by the button on the street by the plate by the plane was lucky .
the book on the couch on the street in the bank by the bottle is tired .	the book was on the couch on the street in the bank by the bottle is tired .
the glass in the bank by the mirror on the ground by the mirror is tired .	the glass was in the bank by the mirror on the ground by the mirror is tired .
the bicycle in the library on the ground in the kitchen by the couch was strong .	the bicycle is in the library on the ground in the kitchen by the couch was strong .
the ring in the restaurant on the chair in the school on the floor is smart .	the ring was in the restaurant on the chair in the school on the floor is smart .
the glass on the bed on the table by the ship on the floor was clever .	the glass is on the bed on the table by the ship on the floor was clever .
the picture on the street on the floor by the candle by the dish was helpful .	the picture is on the street on the floor by the candle by the dish was helpful .
the bag in the kitchen by the bottle on the floor on the bed is curious .	the bag was in the kitchen by the bottle on the floor on the bed is curious .
the ship on the table on the ground on the floor on the table was healthy .	the ship is on the table on the ground on the floor on the table was healthy .
the shoe by the crayon on the bed in the school in the park is clever .	the shoe was by the crayon on the bed in the school in the park is clever .
the plate in the kitchen in the room on the street by the picture is hungry .	the plate was in the kitchen in the room on the street by the picture is hungry .
the button on the stool by the button in the mall in the park is friendly .	the button was on the stool by the button in the mall in the park is friendly .
the boat by the rug in the museum on the stool on the street is strong .	the boat was by the rug in the museum on the stool on the street is strong .
the toy on the chair in the park on the table on the couch was helpful .	the toy is on the chair in the park on the table on the couch was helpful .
the candle in the hospital in the park on the floor on the table is angry .	the candle was in the hospital in the park on the floor on the table is angry .
the button by the candle by the boat in the museum in the kitchen was sleepy .	the button is by the candle by the boat in the museum in the kitchen was sleepy .
the window on the table on the table on the bed by the glass was important .	the window is on the table on the table on the bed by the glass was important .
the crayon by the rug in the mall by the ring on the street is surprised .	the crayon was by the rug in the mall by the ring on the street is surprised .
the shoe on the table by the dish on the table by the bowl was helpful .	the shoe is on the table by the dish on the table by the bowl was helpful .
the plane by the crayon by the shirt in the kitchen in the mall was busy .	the plane is by the crayon by the shirt in the kitchen in the mall was busy .
the chair by the boat by the spoon by the bed in the library was friendly .	the chair is by the boat by the spoon by the bed in the library was friendly .
the doll on the bed on the bed in the library on the floor was friendly .	the doll is on the bed on the bed in the library on the floor was friendly .
the bed by the doll by the window on the couch on the chair is surprised .	the bed was by the doll by the window on the couch on the chair is surprised .
the picture on the table on the stool in the school by the plane was bored .	the picture is on the table on the stool in the school by the plane was bored .
the bottle by the box on the floor in the park by the picture is important .	the bottle was by the box on the floor in the park by the picture is important .
the spoon in the museum by the rug by the picture on the chair was quiet .	the spoon is in the museum by the rug by the picture on the chair was quiet .
the shirt in the mall by the shoe in the bank on the floor is boring .	the shirt was in the mall by the shoe in the bank on the floor is boring .
the doll by the plate by the car on the couch on the couch is important .	the doll was by the plate by the car on the couch on the couch is important .
the ring on the street in the mall by the toy by the button is excited .	the ring was on the street in the mall by the toy by the button is excited .
the cup on the ground by the car in the room by the shirt was bored .	the cup is on the ground by the car in the room by the shirt was bored .
the bag in the restaurant in the school by the bed on the ground is upset .	the bag was in the restaurant in the school by the bed on the ground is upset .
the truck on the floor by the box by the car in the mall is strong .	the truck was on the floor by the box by the car in the mall is strong .
the glass on the bed in the mall in the room on the table is curious .	the glass was on the bed in the mall in the room on the table is curious .
the button in the room in the bank on the ground on the table was young .	the button is in the room in the bank on the ground on the table was young .
the boat in the park on the chair by the chair in the kitchen was bored .	the boat is in the park on the chair by the chair in the kitchen was bored .
the chair by the bicycle on the stool in the park by the fork is nice .	the chair was by the bicycle on the stool in the park by the fork is nice .
the ship on the chair on the bed by the plate by the candle is young .	the ship was on the chair on the bed by the plate by the candle is young .
the car in the school by the box on the couch by the rug was healthy .	the car is in the school by the box on the couch by the rug was healthy .
the cup on the floor in the mall on the street by the plate was curious .	the cup is on the floor in the mall on the street by the plate was curious .
the fork in the kitchen in the park on the couch in the room is quiet .	the fork was in the kitchen in the park on the couch in the room is quiet .
the couch on the couch in the restaurant in the restaurant in the room is lucky .	the couch was on the couch in the restaurant in the restaurant in the room is lucky .
the book by the bottle on the floor on the bed in the room was busy .	the book is by the bottle on the floor on the bed in the room was busy .
the candle in the school in the park on the chair by the bag was hungry .	the candle is in the school in the park on the chair by the bag was hungry .
the couch by the bed on the chair on the street in the kitchen was healthy .	the couch is by the bed on the chair on the street in the kitchen was healthy .
the bed on the stool in the hospital on the couch in the museum is excited .	the bed was on the stool in the hospital on the couch in the museum is excited .
the fork by the book by the bicycle by the couch by the picture is upset .	the fork was by the book by the bicycle by the couch by the picture is upset .
the bag by the door on the street on the street on the street was lucky .	the bag is by the door on the street on the street on the street was lucky .
the box on the street on the street in the restaurant in the museum was sleepy .	the box is on the street on the street in the restaurant in the museum was sleepy .
the hat in the bank in the hospital by the crayon in the park is busy .	the hat was in the bank in the hospital by the crayon in the park is busy .
the ship on the couch by the doll in the school by the truck is bored .	the ship was on the couch by the doll in the school by the truck is bored .
the ship on the ground on the chair by the bottle in the hospital was nice .	the ship is on the ground on the chair by the bottle in the hospital was nice .
the book by the picture in the museum by the picture on the bed is strong .	the book was by the picture in the museum by the picture on the bed is strong .
the dish by the ship by the bed by the crayon by the bottle is gentle .	the dish was by the ship by the bed by the crayon by the bottle is gentle .
the book in the school in the park by the button in the bank is gentle .	the book was in the school in the park by the button in the bank is gentle .
the ring on the floor by the crayon in the restaurant on the bed is surprised .	the ring was on the floor by the crayon in the restaurant on the bed is surprised .
the bicycle by the couch by the plane in the school by the box is gentle .	the bicycle was by the couch by the plane in the school by the box is gentle .
the shirt by the doll on the couch in the school by the ring is careful .	the shirt was by the doll on the couch in the school by the ring is careful .
the candle on the bed by the mirror in the park on the chair was hungry .	the candle is on the bed by the mirror in the park on the chair was hungry .
the ring in the library on the table on the chair in the restaurant was hungry .	the ring is in the library on the table on the chair in the restaurant was hungry .
the fork in the room in the school by the rocket on the ground is tall .	the fork was in the room in the school by the rocket on the ground is tall .
the toy on the bed on the floor in the bank on the ground is quiet .	the toy was on the bed on the floor in the bank on the ground is quiet .
the picture in the hospital on the couch on the ground by the bicycle is quiet .	the picture was in the hospital on the couch on the ground by the bicycle is quiet .
the spoon by the spoon on the couch on the table by the chair is nice .	the spoon was by the spoon on the couch on the table by the chair is nice .
the mirror by the car on the street in the school in the school was clever .	the mirror is by the car on the street in the school in the school was clever .
the book by the mirror in the museum on the bed in the school was nice .	the book is by the mirror in the museum on the bed in the school was nice .
the mirror on the bed in the bank in the room on the floor was angry .	the mirror is on the bed in the bank in the room on the floor was angry .
the hat on the floor in the school by the picture by the box was bored .	the hat is on the floor in the school by the picture by the box was bored .
the candle by the truck on the stool on the floor by the box is tired .	the candle was by the truck on the stool on the floor by the box is tired .
the spoon in the school by the couch on the chair in the hospital is boring .	the spoon was in the school by the couch on the chair in the hospital is boring .
the crayon by the plane on the couch by the boat in the room was angry .	the crayon is by the plane on the couch by the boat in the room was angry .
the bed in the park on the ground in the school on the table is helpful .	the bed was in the park on the ground in the school on the table is helpful .
the crayon by the mirror on the street in the library by the ship was happy .	the crayon is by the mirror on the street in the library by the ship was happy .
the mirror on the ground on the chair on the floor on the street was clever .	the mirror is on the ground on the chair on the floor on the street was clever .
the mirror by the shirt on the couch by the crayon by the window is smart .	the mirror was by the shirt on the couch by the crayon by the window is smart .
the book on the floor in the mall by the box in the room was strong .	the book is on the floor in the mall by the box in the room was strong .
the cup by the picture by the spoon by the picture on the couch is lucky .	the cup was by the picture by the spoon by the picture on the couch is lucky .
the cup in the bank on the chair on the chair in the park was upset .	the cup is in the bank on the chair on the chair in the park was upset .
the bottle in the restaurant on the ground on the ground on the floor was strong .	the bottle is in the restaurant on the ground on the ground on the floor was strong .
the bag by the car in the school by the ring on the couch was angry .	the bag is by the car in the school by the ring on the couch was angry .
the door on the chair by the rug on the chair in the room is boring .	the door was on the chair by the rug on the chair in the room is boring .
the hat in the bank by the box on the chair in the mall was kind .	the hat is in the bank by the box on the chair in the mall was kind .
the book by the rug on the couch by the doll on the street was angry .	the book is by the rug on the couch by the doll on the street was angry .
the fork by the picture in the kitchen on the stool on the chair was surprised .	the fork is by the picture in the kitchen on the stool on the chair was surprised .
the picture on the ground on the chair in the hospital in the mall was healthy .	the picture is on the ground on the chair in the hospital in the mall was healthy .
the bed in the library in the library in the hospital on the couch is nice .	the bed was in the library in the library in the hospital on the couch is nice .
the chair in the kitchen in the school by the picture by the plane was young .	the chair is in the kitchen in the school by the picture by the plane was young .
the doll in the bank by the bottle on the couch by the chair is upset .	the doll was in the bank by the bottle on the couch by the chair is upset .
the picture by the chair on the floor by the shirt by the car is upset .	the picture was by the chair on the floor by the shirt by the car is upset .
the window in the mall on the chair on the stool in the museum was sleepy .	the window is in the mall on the chair on the stool in the museum was sleepy .
the glass by the bed on the floor on the couch in the restaurant was curious .	the glass is by the bed on the floor on the couch in the restaurant was curious .
the bottle in the school by the chair in the kitchen on the table is hungry .	the bottle was in the school by the chair in the kitchen on the table is hungry .
the glass on the stool on the chair on the table on the bed was hungry .	the glass is on the stool on the chair on the table on the bed was hungry .
the picture in the hospital on the bed by the dish by the bottle was excited .	the picture is in the hospital on the bed by the dish by the bottle was excited .
the book on the chair on the chair on the table on the table was curious .	the book is on the chair on the chair on the table on the table was curious .
the couch on the table by the doll by the boat in the library is smart .	the couch was on the table by the doll by the boat in the library is smart .
the fork by the car in the restaurant by the car by the glass is lucky .	the fork was by the car in the restaurant by the car by the glass is lucky .
the book on the bed on the ground by the plate on the street is boring .	the book was on the bed on the ground by the plate on the street is boring .
the car by the book on the table on the couch by the window was nice .	the car is by the book on the table on the couch by the window was nice .
the couch by the shirt by the dish on the bed on the stool was clever .	the couch is by the shirt by the dish on the bed on the stool was clever .
the car by the glass in the kitchen in the school in the mall is surprised .	the car was by the glass in the kitchen in the school in the mall is surprised .
the hat in the school by the plate on the stool on the couch is angry .	the hat was in the school by the plate on the stool on the couch is angry .
the truck in the restaurant by the ring on the chair by the bowl was clever .	the truck is in the restaurant by the ring on the chair by the bowl was clever .
the button in the kitchen by the bed on the couch in the park is important .	the button was in the kitchen by the bed on the couch in the park is important .
the dish by the bowl in the kitchen in the mall on the floor is tall .	the dish was by the bowl in the kitchen in the mall on the floor is tall .
the cup in the kitchen on the ground on the stool on the bed was important .	the cup is in the kitchen on the ground on the stool on the bed was important .
the chair by the door in the restaurant in the room on the bed was hungry .	the chair is by the door in the restaurant in the room on the bed was hungry .
the cup in the kitchen in the school on the stool on the table was gentle .	the cup is in the kitchen in the school on the stool on the table was gentle .
the car in the hospital by the shirt by the ship in the mall was important .	the car is in the hospital by the shirt by the ship in the mall was important .
the rug by the bicycle by the fork on the street in the room was surprised .	the rug is by the bicycle by the fork on the street in the room was surprised .
the plane by the chair by the crayon by the shirt by the door was excited .	the plane is by the chair by the crayon by the shirt by the door was excited .
the dish by the book by the car in the school in the park is strong .	the dish was by the book by the car in the school in the park is strong .
the couch in the kitchen by the bed by the box by the bowl was kind .	the couch is in the kitchen by the bed by the box by the bowl was kind .
the shirt in the school in the restaurant by the chair on the chair was friendly .	the shirt is in the school in the restaurant by the chair on the chair was friendly .
the truck by the cup on the ground by the shirt by the shirt was quiet .	the truck is by the cup on the ground by the shirt by the shirt was quiet .
the couch by the fork on the stool in the mall by the box was strong .	the couch is by the fork on the stool in the mall by the box was strong .
the car by the book on the street by the picture on the stool was tired .	the car is by the book on the street by the picture on the stool was tired .
the window on the floor in the park on the street in the museum is angry .	the window was on the floor in the park on the street in the museum is angry .
the chair in the library by the shirt by the button by the picture was hungry .	the chair is in the library by the shirt by the button by the picture was hungry .
the plate by the bicycle on the ground on the ground by the crayon is gentle .	the plate was by the bicycle on the ground on the ground by the crayon is gentle .
the ring in the library in the room by the car on the ground is lucky .	the ring was in the library in the room by the car on the ground is lucky .
the hat in the mall by the toy on the couch by the rug is excited .	the hat was in the mall by the toy on the couch by the rug is excited .
the toy on the street by the book by the boat by the book was busy .	the toy is on the street by the book by the boat by the book was busy .
the cup on the street on the table by the book in the mall was tall .	the cup is on the street on the table by the book in the mall was tall .
the rug in the restaurant by the rocket on the stool by the crayon was upset .	the rug is in the restaurant by the rocket on the stool by the crayon was upset .
the plane on the floor by the car on the table on the floor was excited .	the plane is on the floor by the car on the table on the floor was excited .
the bed on the ground by the book on the table on the couch is young .	the bed was on the ground by the book on the table on the couch is young .
the rug in the kitchen on the table by the box on the stool was clever .	the rug is in the kitchen on the table by the box on the stool was clever .
the door in the park in the restaurant by the plate on the couch is helpful .	the door was in the park in the restaurant by the plate on the couch is helpful .
the book by the fork by the rug in the school by the bowl was upset .	the book is by the fork by the rug in the school by the bowl was upset .
the truck on the chair on the bed in the bank on the bed was upset .	the truck is on the chair on the bed in the bank on the bed was upset .
the glass on the street in the bank by the cup by the hat was smart .	the glass is on the street in the bank by the cup by the hat was smart .
the car in the park in the bank in the bank in the hospital is young .	the car was in the park in the bank in the bank in the hospital is young .
the picture on the chair on the stool by the candle in the library is tall .	the picture was on the chair on the stool by the candle in the library is tall .
the cup on the bed on the table on the bed on the floor is busy .	the cup was on the bed on the table on the bed on the floor is busy .
the chair in the school in the kitchen by the bottle in the kitchen is bored .	the chair was in the school in the kitchen by the bottle in the kitchen is bored .
the shirt by the couch by the toy on the ground on the floor is lucky .	the shirt was by the couch by the toy on the ground on the floor is lucky .
the book on the table in the museum by the chair in the park is bored .	the book was on the table in the museum by the chair in the park is bored .
the spoon in the library by the spoon on the table on the chair was gentle .	the spoon is in the library by the spoon on the table on the chair was gentle .
the mirror in the park on the table in the park on the bed was quiet .	the mirror is in the park on the table in the park on the bed was quiet .
the window on the stool on the table on the street on the street was hungry .	the window is on the stool on the table on the street on the street was hungry .
the shoe on the table in the bank on the couch on the ground was wrong .	the shoe is on the table in the bank on the couch on the ground was wrong .
the book by the toy in the restaurant by the mirror in the park was gentle .	the book is by the toy in the restaurant by the mirror in the park was gentle .
the hat on the stool by the picture by the dish on the street is quiet .	the hat was on the stool by the picture by the dish on the street is quiet .
the plane in the mall on the table on the bed in the restaurant is quiet .	the plane was in the mall on the table on the bed in the restaurant is quiet .
the mirror on the ground by the car by the plane by the bicycle is important .	the mirror was on the ground by the car by the plane by the bicycle is important .
the mirror by the door by the ship by the shoe on the table was boring .	the mirror is by the door by the ship by the shoe on the table was boring .
the ship on the table in the school by the couch in the kitchen is happy .	the ship was on the table in the school by the couch in the kitchen is happy .
the bottle in the library by the bag in the school by the box was upset .	the bottle is in the library by the bag in the school by the box was upset .
the cup in the kitchen by the car on the stool on the ground was friendly .	the cup is in the kitchen by the car on the stool on the ground was friendly .
the dish in the library on the bed in the school in the library is quiet .	the dish was in the library on the bed in the school in the library is quiet .
the chair by the toy on the table by the plate in the library is healthy .	the chair was by the toy on the table by the plate in the library is healthy .
the couch in the mall on the couch on the couch in the school is important .	the couch was in the mall on the couch on the couch in the school is important .
the toy by the rug on the chair on the table on the ground is kind .	the toy was by the rug on the chair on the table on the ground is kind .
the shirt on the couch in the park in the restaurant by the hat is surprised .	the shirt was on the couch in the park in the restaurant by the hat is surprised .
the fork in the park by the candle on the table by the rug was hungry .	the fork is in the park by the candle on the table by the rug was hungry .
the plane in the library in the restaurant on the stool on the chair is clever .	the plane was in the library in the restaurant on the stool on the chair is clever .
the ship by the shoe in the school by the hat by the rocket was happy .	the ship is by the shoe in the school by the hat by the rocket was happy .
the chair in the school by the candle in the bank by the fork was kind .	the chair is in the school by the candle in the bank by the fork was kind .
the candle by the car on the chair on the stool on the chair is tall .	the candle was by the car on the chair on the stool on the chair is tall .
the car on the couch in the park by the boat by the boat was busy .	the car is on the couch in the park by the boat by the boat was busy .
the bottle on the table by the book on the floor by the hat is young .	the bottle was on the table by the book on the floor by the hat is young .
the plane in the school in the mall on the stool on the street was boring .	the plane is in the school in the mall on the stool on the street was boring .
the spoon by the truck on the table by the hat in the library was surprised .	the spoon is by the truck on the table by the hat in the library was surprised .
the shirt in the mall on the bed on the chair on the ground was young .	the shirt is in the mall on the bed on the chair on the ground was young .
the dish in the school by the crayon on the stool on the ground is surprised .	the dish was in the school by the crayon on the stool on the ground is surprised .
the shirt by the bed by the doll in the mall in the restaurant is healthy .	the shirt was by the bed by the doll in the mall in the restaurant is healthy .
the rocket on the floor by the toy on the table on the couch was clever .	the rocket is on the floor by the toy on the table on the couch was clever .
the book by the cup by the shoe by the mirror by the bag is wrong .	the book was by the cup by the shoe by the mirror by the bag is wrong .
the candle in the restaurant on the street on the street by the bag was lucky .	the candle is in the restaurant on the street on the street by the bag was lucky .
the picture on the table by the dish by the bed on the stool was strong .	the picture is on the table by the dish by the bed on the stool was strong .
the bed on the ground by the shoe by the book by the window was quiet .	the bed is on the ground by the shoe by the book by the window was quiet .
the car in the museum on the couch by the bed in the museum was excited .	the car is in the museum on the couch by the bed in the museum was excited .
the bicycle in the bank by the dish on the bed on the couch was important .	the bicycle is in the bank by the dish on the bed on the couch was important .
the bed on the street on the ground in the hospital by the ring is tall .	the bed was on the street on the ground in the hospital by the ring is tall .
the spoon in the museum in the mall on the table on the chair is angry .	the spoon was in the museum in the mall on the table on the chair is angry .
the crayon on the table in the restaurant by the box by the ship was healthy .	the crayon is on the table in the restaurant by the box by the ship was healthy .
the cup by the toy by the cup by the mirror by the plate was sleepy .	the cup is by the toy by the cup by the mirror by the plate was sleepy .
the chair on the couch by the bicycle on the floor on the stool was boring .	the chair is on the couch by the bicycle on the floor on the stool was boring .
the bicycle on the couch on the street in the museum on the chair is surprised .	the bicycle was on the couch on the street in the museum on the chair is surprised .
the ring by the toy by the car by the glass by the chair is boring .	the ring was by the toy by the car by the glass by the chair is boring .
the hat on the floor in the mall on the table by the cup is upset .	the hat was on the floor in the mall on the table by the cup is upset .
the bowl on the ground by the bowl on the stool in the kitchen was smart .	the bowl is on the ground by the bowl on the stool in the kitchen was smart .
the ring on the floor on the ground by the box on the floor is curious .	the ring was on the floor on the ground by the box on the floor is curious .
the cup on the ground by the spoon in the school by the truck is bored .	the cup was on the ground by the spoon in the school by the truck is bored .
the candle by the ship on the chair in the hospital by the chair was angry .	the candle is by the ship on the chair in the hospital by the chair was angry .
the box on the floor by the shoe by the shoe in the school is careful .	the box was on the floor by the shoe by the shoe in the school is careful .
the bottle in the school on the bed in the library on the table is angry .	the bottle was in the school on the bed in the library on the table is angry .
the bowl in the school by the shoe by the book by the ring is busy .	the bowl was in the school by the shoe by the book by the ring is busy .
the bed in the school in the mall by the spoon on the couch is happy .	the bed was in the school in the mall by the spoon on the couch is happy .
the toy by the book on the stool on the street on the couch was smart .	the toy is by the book on the stool on the street on the couch was smart .
the book by the picture by the book on the table in the mall was quiet .	the book is by the picture by the book on the table in the mall was quiet .
the book on the floor by the bag in the restaurant in the restaurant was boring .	the book is on the floor by the bag in the restaurant in the restaurant was boring .
the book by the picture in the hospital by the chair in the school was young .	the book is by the picture in the hospital by the chair in the school was young .
the truck in the mall in the bank in the kitchen by the bowl is helpful .	the truck was in the mall in the bank in the kitchen by the bowl is helpful .
the door by the ship on the table in the restaurant on the stool is boring .	the door was by the ship on the table in the restaurant on the stool is boring .
the cup on the street in the park on the floor by the fork is busy .	the cup was on the street in the park on the floor by the fork is busy .
the glass in the room by the plane by the ship in the hospital was gentle .	the glass is in the room by the plane by the ship in the hospital was gentle .
the shoe by the plane in the park in the mall in the school is healthy .	the shoe was by the plane in the park in the mall in the school is healthy .
the button in the bank in the room by the box in the hospital was surprised .	the button is in the bank in the room by the box in the hospital was surprised .
the book on the couch in the museum on the floor in the museum is lucky .	the book was on the couch in the museum on the floor in the museum is lucky .
the window by the car on the couch by the boat by the plate is careful .	the window was by the car on the couch by the boat by the plate is careful .
the car by the crayon in the mall in the library in the kitchen is smart .	the car was by the crayon in the mall in the library in the kitchen is smart .
the cup on the stool in the restaurant on the couch on the chair was hungry .	the cup is on the stool in the restaurant on the couch on the chair was hungry .
the door by the bowl by the ring in the park by the crayon was helpful .	the door is by the bowl by the ring in the park by the crayon was helpful .
the car by the bowl on the ground by the couch on the stool is healthy .	the car was by the bowl on the ground by the couch on the stool is healthy .
the box on the table on the table on the bed on the bed is bored .	the box was on the table on the table on the bed on the bed is bored .
the button by the dish on the stool in the museum on the couch was tall .	the button is by the dish on the stool in the museum on the couch was tall .
the crayon in the bank by the bowl on the bed in the mall was kind .	the crayon is in the bank by the bowl on the bed in the mall was kind .
the plane in the kitchen in the library in the school on the street is careful .	the plane was in the kitchen in the library in the school on the street is careful .
the bed in the room on the chair on the stool by the couch is friendly .	the bed was in the room on the chair on the stool by the couch is friendly .
the chair on the floor by the car by the book by the shirt was helpful .	the chair is on the floor by the car by the book by the shirt was helpful .
the mirror by the book in the school by the picture on the bed is boring .	the mirror was by the book in the school by the picture on the bed is boring .
the bottle on the table by the picture in the school by the rug is friendly .	the bottle was on the table by the picture in the school by the rug is friendly .
the dish on the stool on the ground by the button on the chair is nice .	the dish was on the stool on the ground by the button on the chair is nice .
the book on the chair by the rug on the floor by the plate was upset .	the book is on the chair by the rug on the floor by the plate was upset .
the candle by the shoe by the chair by the book in the kitchen was smart .	the candle is by the shoe by the chair by the book in the kitchen was smart .
the toy on the bed in the hospital in the school on the stool is boring .	the toy was on the bed in the hospital in the school on the stool is boring .
the mirror by the boat in the bank by the shoe by the couch is gentle .	the mirror was by the boat in the bank by the shoe by the couch is gentle .
the candle on the street on the couch in the park in the mall was lucky .	the candle is on the street on the couch in the park in the mall was lucky .
the fork on the floor on the chair by the toy in the school was careful .	the fork is on the floor on the chair by the toy in the school was careful .
the hat on the stool on the couch in the kitchen on the chair was careful .	the hat is on the stool on the couch in the kitchen on the chair was careful .
the book on the chair on the chair in the hospital by the car was excited .	the book is on the chair on the chair in the hospital by the car was excited .
the plane in the school on the couch by the picture on the chair was sleepy .	the plane is in the school on the couch by the picture on the chair was sleepy .
the cup by the ship in the mall by the car on the table was tall .	the cup is by the ship in the mall by the car on the table was tall .
the shirt on the ground in the school on the couch in the restaurant was confused .	the shirt is on the ground in the school on the couch in the restaurant was confused .
the candle by the doll on the ground on the stool by the toy is young .	the candle was by the doll on the ground on the stool by the toy is young .
the car in the school by the cup on the bed on the bed was gentle .	the car is in the school by the cup on the bed on the bed was gentle .
the mirror in the mall in the kitchen on the stool by the rocket was sleepy .	the mirror is in the mall in the kitchen on the stool by the rocket was sleepy .
the bicycle by the plate in the kitchen on the chair by the plane is sleepy .	the bicycle was by the plate in the kitchen on the chair by the plane is sleepy .
the shoe by the bowl in the kitchen by the bed in the park is excited .	the shoe was by the bowl in the kitchen by the bed in the park is excited .
the bicycle on the street in the library by the hat in the school was angry .	the bicycle is on the street in the library by the hat in the school was angry .
the candle by the spoon by the shoe by the glass on the chair was quiet .	the candle is by the spoon by the shoe by the glass on the chair was quiet .
the bicycle in the school in the school in the school on the table was young .	the bicycle is in the school in the school in the school on the table was young .
the shirt by the picture on the bed on the stool by the bag was wrong .	the shirt is by the picture on the bed on the stool by the bag was wrong .
the book by the car by the ship on the ground on the chair was busy .	the book is by the car by the ship on the ground on the chair was busy .
the fork by the spoon in the school on the ground by the book is boring .	the fork was by the spoon in the school on the ground by the book is boring .
the plane in the restaurant in the room in the restaurant on the street is young .	the plane was in the restaurant in the room in the restaurant on the street is young .
the picture by the bottle on the stool by the window by the dish was hungry .	the picture is by the bottle on the stool by the window by the dish was hungry .
the couch in the museum on the floor by the dish on the chair was quiet .	the couch is in the museum on the floor by the dish on the chair was quiet .
the bag in the school by the bottle on the floor on the chair was gentle .	the bag is in the school by the bottle on the floor on the chair was gentle .
the picture in the kitchen by the ring on the ground in the bank is boring .	the picture was in the kitchen by the ring on the ground in the bank is boring .
the plane in the museum in the restaurant on the ground on the ground was wrong .	the plane is in the museum in the restaurant on the ground on the ground was wrong .
the rocket by the bag by the car on the couch on the couch was upset .	the rocket is by the bag by the car on the couch on the couch was upset .
the glass on the stool in the room by the rocket by the hat was tired .	the glass is on the stool in the room by the rocket by the hat was tired .
the crayon by the book on the stool in the hospital by the ship was kind .	the crayon is by the book on the stool in the hospital by the ship was kind .
the shoe on the table by the car by the shirt on the floor is tall .	the shoe was on the table by the car by the shirt on the floor is tall .
the plane by the rug in the museum in the hospital on the stool is boring .	the plane was by the rug in the museum in the hospital on the stool is boring .
the picture by the shirt on the floor by the shoe by the book was surprised .	the picture is by the shirt on the floor by the shoe by the book was surprised .
the ring on the stool by the boat in the restaurant by the shoe was tall .	the ring is on the stool by the boat in the restaurant by the shoe was tall .
the bottle on the bed by the window in the room on the chair is friendly .	the bottle was on the bed by the window in the room on the chair is friendly .
the couch on the chair in the school by the bag on the chair was friendly .	the couch is on the chair in the school by the bag on the chair was friendly .
the bottle on the couch on the street by the dish on the stool is excited .	the bottle was on the couch on the street by the dish on the stool is excited .
the shoe by the hat on the street in the mall in the school is smart .	the shoe was by the hat on the street in the mall in the school is smart .
the car by the ring on the bed on the table on the table was sleepy .	the car is by the ring on the bed on the table on the table was sleepy .
the window on the couch by the book by the bag on the floor was careful .	the window is on the couch by the book by the bag on the floor was careful .
the shoe by the car in the park on the couch on the couch was excited .	the shoe is by the car in the park on the couch on the couch was excited .
the doll by the ship on the table in the school on the ground was busy .	the doll is by the ship on the table in the school on the ground was busy .
the hat on the floor in the museum in the park in the hospital was hungry .	the hat is on the floor in the museum in the park in the hospital was hungry .
the doll on the street in the bank in the school by the bed is boring .	the doll was on the street in the bank in the school by the bed is boring .
the shirt in the hospital on the bed in the kitchen on the table is sleepy .	the shirt was in the hospital on the bed in the kitchen on the table is sleepy .
the ship by the dish on the floor in the library on the floor was clever .	the ship is by the dish on the floor in the library on the floor was clever .
the couch by the ship on the ground on the couch in the school is tall .	the couch was by the ship on the ground on the couch in the school is tall .
the chair in the mall by the ship on the floor in the museum was kind .	the chair is in the mall by the ship on the floor in the museum was kind .
the rug by the rug by the crayon in the mall by the fork is gentle .	the rug was by the rug by the crayon in the mall by the fork is gentle .
the book in the mall on the chair on the chair by the bicycle was busy .	the book is in the mall on the chair on the chair by the bicycle was busy .
the dish by the shoe on the street in the mall by the spoon is nice .	the dish was by the shoe on the street in the mall by the spoon is nice .
the bowl on the table on the chair in the park on the chair is bored .	the bowl was on the table on the chair in the park on the chair is bored .
the spoon by the toy in the school by the car by the car is smart .	the spoon was by the toy in the school by the car by the car is smart .
the button by the bed in the hospital by the bowl by the cup was quiet .	the button is by the bed in the hospital by the bowl by the cup was quiet .
the toy in the park in the museum by the bag in the museum is tall .	the toy was in the park in the museum by the bag in the museum is tall .
the crayon in the school on the floor in the museum in the bank was quiet .	the crayon is in the school on the floor in the museum in the bank was quiet .
the hat in the restaurant in the restaurant on the ground on the chair was nice .	the hat is in the restaurant in the restaurant on the ground on the chair was nice .
the car on the stool on the ground in the school on the chair is strong .	the car was on the stool on the ground in the school on the chair is strong .
the cup by the car on the street on the street by the book is young .	the cup was by the car on the street on the street by the book is young .
the picture in the library in the school in the restaurant by the dish was sleepy .	the picture is in the library in the school in the restaurant by the dish was sleepy .
the ring by the book on the couch in the restaurant in the mall was helpful .	the ring is by the book on the couch in the restaurant in the mall was helpful .
the plane on the stool on the table by the shoe by the picture is careful .	the plane was on the stool on the table by the shoe by the picture is careful .
the book in the school on the street in the kitchen on the stool was clever .	the book is in the school on the street in the kitchen on the stool was clever .
the rug by the mirror in the kitchen by the button on the stool is curious .	the rug was by the mirror in the kitchen by the button on the stool is curious .
the mirror by the bowl by the door by the door by the candle was strong .	the mirror is by the bowl by the door by the door by the candle was strong .
the spoon by the bicycle on the table in the hospital by the book is hungry .	the spoon was by the bicycle on the table in the hospital by the book is hungry .
the couch on the bed in the mall in the mall on the floor was friendly .	the couch is on the bed in the mall in the mall on the floor was friendly .
the window by the shirt in the park in the mall on the table is curious .	the window was by the shirt in the park in the mall on the table is curious .
the plate in the restaurant by the spoon in the room in the room is strong .	the plate was in the restaurant by the spoon in the room in the room is strong .
the car by the doll in the park in the school by the shirt was happy .	the car is by the doll in the park in the school by the shirt was happy .
the bag in the library on the stool in the school on the stool is clever .	the bag was in the library on the stool in the school on the stool is clever .
the button by the ship on the table in the school in the park was helpful .	the button is by the ship on the table in the school in the park was helpful .
the button on the floor on the chair in the library in the restaurant is lucky .	the button was on the floor on the chair in the library in the restaurant is lucky .
the plane by the car by the glass in the mall in the school is healthy .	the plane was by the car by the glass in the mall in the school is healthy .
the bowl on the table by the bed on the bed in the school is clever .	the bowl was on the table by the bed on the bed in the school is clever .
the ship in the park in the bank on the table by the picture was gentle .	the ship is in the park in the bank on the table by the picture was gentle .
the book on the stool in the room by the car in the school was sleepy .	the book is on the stool in the room by the car in the school was sleepy .
the book on the bed by the window by the truck on the ground is happy .	the book was on the bed by the window by the truck on the ground is happy .
the boat by the car on the street on the ground on the bed is hungry .	the boat was by the car on the street on the ground on the bed is hungry .
the toy in the restaurant on the street in the restaurant on the stool was friendly .	the toy is in the restaurant on the street in the restaurant on the stool was friendly .
the car by the plane by the dish on the table by the bed is bored .	the car was by the plane by the dish on the table by the bed is bored .
the bowl by the bottle by the fork on the street in the school is smart .	the bowl was by the bottle by the fork on the street in the school is smart .
the bicycle on the stool in the kitchen by the cup on the couch is busy .	the bicycle was on the stool in the kitchen by the cup on the couch is busy .
the dish on the bed by the bicycle on the stool on the ground was strong .	the dish is on the bed by the bicycle on the stool on the ground was strong .
the shirt on the table on the floor by the dish in the hospital was happy .	the shirt is on the table on the floor by the dish in the hospital was happy .
the chair by the button by the toy by the door on the floor is young .	the chair was by the button by the toy by the door on the floor is young .
the book in the bank in the mall in the museum in the school is excited .	the book was in the bank in the mall in the museum in the school is excited .
the dish on the floor on the stool on the stool by the car was gentle .	the dish is on the floor on the stool on the stool by the car was gentle .
the bed by the cup on the floor by the boat by the glass is helpful .	the bed was by the cup on the floor by the boat by the glass is helpful .
the book by the shoe on the bed in the school on the bed was tall .	the book is by the shoe on the bed in the school on the bed was tall .
the ring by the window by the doll by the door by the book was quiet .	the ring is by the window by the doll by the door by the book was quiet .
the candle in the school by the bag by the plate on the stool is curious .	the candle was in the school by the bag by the plate on the stool is curious .
the boat on the stool by the button in the museum on the bed was healthy .	the boat is on the stool by the button in the museum on the bed was healthy .
the ship on the ground by the book by the bowl in the kitchen is curious .	the ship was on the ground by the book by the bowl in the kitchen is curious .
the window on the chair by the plate by the bicycle by the bottle was careful .	the window is on the chair by the plate by the bicycle by the bottle was careful .
the ring on the ground in the room in the kitchen on the stool is young .	the ring was on the ground in the room in the kitchen on the stool is young .
the spoon on the table by the book in the museum by the bicycle is careful .	the spoon was on the table by the book in the museum by the bicycle is careful .
the car on the chair by the plate on the floor in the room was careful .	the car is on the chair by the plate on the floor in the room was careful .
the bowl by the crayon in the hospital on the chair on the floor was bored .	the bowl is by the crayon in the hospital on the chair on the floor was bored .
the door on the floor on the ground on the floor on the street is upset .	the door was on the floor on the ground on the floor on the street is upset .
the bottle on the chair on the chair in the bank by the cup is wrong .	the bottle was on the chair on the chair in the bank by the cup is wrong .
the door on the stool in the hospital by the plane on the stool was strong .	the door is on the stool in the hospital by the plane on the stool was strong .
the plate in the park on the bed by the rocket on the ground is busy .	the plate was in the park on the bed by the rocket on the ground is busy .
the dish by the picture by the bed by the candle on the couch is boring .	the dish was by the picture by the bed by the candle on the couch is boring .
the bed on the street in the school in the school in the museum is friendly .	the bed was on the street in the school in the school in the museum is friendly .
the window by the book on the couch in the hospital on the couch is clever .	the window was by the book on the couch in the hospital on the couch is clever .
the chair on the ground on the stool in the restaurant on the bed is wrong .	the chair was on the ground on the stool in the restaurant on the bed is wrong .
the hat by the ship on the street in the restaurant by the bottle is happy .	the hat was by the ship on the street in the restaurant by the bottle is happy .
the ship on the bed on the bed by the bowl on the table is bored .	the ship was on the bed on the bed by the bowl on the table is bored .
the fork in the mall in the park on the ground by the bottle is quiet .	the fork was in the mall in the park on the ground by the bottle is quiet .
the toy by the ring by the truck by the door on the floor is strong .	the toy was by the ring by the truck by the door on the floor is strong .
the plane in the room by the crayon in the restaurant by the bag is sleepy .	the plane was in the room by the crayon in the restaurant by the bag is sleepy .
the ship on the floor in the library by the doll in the school is angry .	the ship was on the floor in the library by the doll in the school is angry .
the cup on the stool on the table by the spoon by the bag is strong .	the cup was on the stool on the table by the spoon by the bag is strong .
the bicycle on the street on the chair in the kitchen in the mall was excited .	the bicycle is on the street on the chair in the kitchen in the mall was excited .
the ship on the street on the chair on the table in the park is wrong .	the ship was on the street on the chair on the table in the park is wrong .
the shoe in the museum on the table by the truck on the chair is kind .	the shoe was in the museum on the table by the truck on the chair is kind .
the book in the hospital on the floor by the mirror on the bed was important .	the book is in the hospital on the floor by the mirror on the bed was important .
the book by the boat in the school in the room in the library was important .	the book is by the boat in the school in the room in the library was important .
the bowl in the museum on the table in the hospital by the book is happy .	the bowl was in the museum on the table in the hospital by the book is happy .
the rocket on the couch on the street in the school on the table was young .	the rocket is on the couch on the street in the school on the table was young .
the hat on the couch on the ground in the mall on the bed is boring .	the hat was on the couch on the ground in the mall on the bed is boring .
the hat in the school on the floor by the rug in the room was tall .	the hat is in the school on the floor by the rug in the room was tall .
the couch on the chair in the hospital on the stool on the street was smart .	the couch is on the chair in the hospital on the stool on the street was smart .
the bed on the bed on the bed on the bed in the school was busy .	the bed is on the bed on the bed on the bed in the school was busy .
the boat on the stool on the stool in the kitchen on the bed is gentle .	the boat was on the stool on the stool in the kitchen on the bed is gentle .
the cup by the crayon by the bed in the school by the bed was strong .	the cup is by the crayon by the bed in the school by the bed was strong .
the button by the bed on the stool on the couch on the stool is quiet .	the button was by the bed on the stool on the couch on the stool is quiet .
the shoe in the school in the school by the bottle by the dish is boring .	the shoe was in the school in the school by the bottle by the dish is boring .
the dish by the door by the dish by the couch in the mall is strong .	the dish was by the door by the dish by the couch in the mall is strong .
the picture by the chair by the rug on the stool on the ground is gentle .	the picture was by the chair by the rug on the stool on the ground is gentle .
the rug in the school by the dish by the dish on the bed was confused .	the rug is in the school by the dish by the dish on the bed was confused .
the toy in the hospital on the bed on the floor on the floor was angry .	the toy is in the hospital on the bed on the floor on the floor was angry .
the toy in the kitchen in the kitchen by the plate on the ground is gentle .	the toy was in the kitchen in the kitchen by the plate on the ground is gentle .
the ring in the museum on the floor in the museum in the park is bored .	the ring was in the museum on the floor in the museum in the park is bored .
the ship in the bank in the school on the floor on the bed was hungry .	the ship is in the bank in the school on the floor on the bed was hungry .
the bed in the park in the restaurant in the room on the ground is bored .	the bed was in the park in the restaurant in the room on the ground is bored .
the truck in the restaurant by the bicycle in the restaurant on the bed is strong .	the truck was in the restaurant by the bicycle in the restaurant on the bed is strong .
the candle on the couch in the hospital on the ground by the shoe is bored .	the candle was on the couch in the hospital on the ground by the shoe is bored .
the shirt by the bottle on the floor in the mall on the stool is curious .	the shirt was by the bottle on the floor in the mall on the stool is curious .
the rug by the ring in the hospital in the kitchen by the rug was bored .	the rug is by the ring in the hospital in the kitchen by the rug was bored .
the mirror on the floor by the box on the floor by the box was surprised .	the mirror is on the floor by the box on the floor by the box was surprised .
the mirror in the kitchen on the couch by the picture on the table was wrong .	the mirror is in the kitchen on the couch by the picture on the table was wrong .
the shoe in the school on the chair in the restaurant in the kitchen is quiet .	the shoe was in the school on the chair in the restaurant in the kitchen is quiet .
the ring on the chair on the street in the library by the glass was kind .	the ring is on the chair on the street in the library by the glass was kind .
the picture by the fork by the ring in the bank on the table is surprised .	the picture was by the fork by the ring in the bank on the table is surprised .
the chair on the chair by the fork by the plane by the crayon is upset .	the chair was on the chair by the fork by the plane by the crayon is upset .
the picture in the kitchen by the bed on the bed in the restaurant was nice .	the picture is in the kitchen by the bed on the bed in the restaurant was nice .
the truck on the couch on the street by the bed on the table was gentle .	the truck is on the couch on the street by the bed on the table was gentle .
the window in the kitchen on the stool on the table on the ground is curious .	the window was in the kitchen on the stool on the table on the ground is curious .
the glass by the rug in the bank in the library by the ring is gentle .	the glass was by the rug in the bank in the library by the ring is gentle .
the book in the kitchen on the couch in the school by the shoe was smart .	the book is in the kitchen on the couch in the school by the shoe was smart .
the boat in the museum in the room in the school on the street is boring .	the boat was in the museum in the room in the school on the street is boring .
the plane on the floor on the floor on the chair in the library is kind .	the plane was on the floor on the floor on the chair in the library is kind .
the doll on the chair on the bed on the ground on the floor was nice .	the doll is on the chair on the bed on the ground on the floor was nice .
the spoon by the bed by the car in the kitchen in the kitchen was tall .	the spoon is by the bed by the car in the kitchen in the kitchen was tall .
the plate on the table in the library on the bed by the crayon was upset .	the plate is on the table in the library on the bed by the crayon was upset .
the candle in the mall on the floor on the floor on the street is surprised .	the candle was in the mall on the floor on the floor on the street is surprised .
the door on the couch in the kitchen in the restaurant in the park was upset .	the door is on the couch in the kitchen in the restaurant in the park was upset .
the plane on the street on the couch in the library in the restaurant is curious .	the plane was on the street on the couch in the library in the restaurant is curious .
the shirt in the restaurant by the truck in the room on the street was friendly .	the shirt is in the restaurant by the truck in the room on the street was friendly .
the boat on the couch on the table by the cup on the floor is bored .	the boat was on the couch on the table by the cup on the floor is bored .
the toy by the couch on the street by the bed on the chair was happy .	the toy is by the couch on the street by the bed on the chair was happy .
the plane on the street by the chair in the hospital in the park was healthy .	the plane is on the street by the chair in the hospital in the park was healthy .
the spoon by the candle by the glass by the shoe by the bicycle is kind .	the spoon was by the candle by the glass by the shoe by the bicycle is kind .
the window in the kitchen in the school in the school by the car was tall .	the window is in the kitchen in the school in the school by the car was tall .
the hat on the bed in the school by the ring by the plate was gentle .	the hat is on the bed in the school by the ring by the plate was gentle .
the boat on the ground on the street in the hospital on the bed was nice .	the boat is on the ground on the street in the hospital on the bed was nice .
the glass by the bed on the floor in the museum by the rug was upset .	the glass is by the bed on the floor in the museum by the rug was upset .
the car on the bed in the school by the crayon on the street was quiet .	the car is on the bed in the school by the crayon on the street was quiet .
the dish in the school on the couch in the hospital on the bed is kind .	the dish was in the school on the couch in the hospital on the bed is kind .
the window by the book by the door by the truck in the kitchen was upset .	the window is by the book by the door by the truck in the kitchen was upset .
the shoe on the street on the street by the doll by the car was surprised .	the shoe is on the street on the street by the doll by the car was surprised .
the car in the mall in the bank by the couch on the floor is important .	the car was in the mall in the bank by the couch on the floor is important .
the dish by the hat by the bowl on the table in the room is nice .	the dish was by the hat by the bowl on the table in the room is nice .
the ring on the street on the bed in the kitchen on the bed is boring .	the ring was on the street on the bed in the kitchen on the bed is boring .
the bag in the school in the library on the table in the hospital is happy .	the bag was in the school in the library on the table in the hospital is happy .
the cup on the table in the kitchen on the chair on the street was bored .	the cup is on the table in the kitchen on the chair on the street was bored .
the hat in the school by the rug by the ring in the museum is boring .	the hat was in the school by the rug by the ring in the museum is boring .
the boat by the glass by the rocket by the bag by the couch was quiet .	the boat is by the glass by the rocket by the bag by the couch was quiet .
the rug in the library in the restaurant on the stool in the hospital is happy .	the rug was in the library in the restaurant on the stool in the hospital is happy .
the doll by the shirt in the kitchen on the bed in the bank was healthy .	the doll is by the shirt in the kitchen on the bed in the bank was healthy .
the fork on the street by the crayon on the chair by the dish is bored .	the fork was on the street by the crayon on the chair by the dish is bored .
the truck in the park on the table on the bed on the stool was upset .	the truck is in the park on the table on the bed on the stool was upset .
the boat by the dish by the bowl on the couch by the shirt is healthy .	the boat was by the dish by the bowl on the couch by the shirt is healthy .
the ship in the park in the park on the bed on the chair is young .	the ship was in the park in the park on the bed on the chair is young .
the book in the bank in the bank on the stool by the spoon was young .	the book is in the bank in the bank on the stool by the spoon was young .
the ring in the school by the ring in the school on the floor is tall .	the ring was in the school by the ring in the school on the floor is tall .
the plane on the floor in the kitchen on the street in the bank is boring .	the plane was on the floor in the kitchen on the street in the bank is boring .
the mirror on the table by the truck on the couch by the car was tall .	the mirror is on the table by the truck on the couch by the car was tall .
the book on the ground in the park on the ground in the museum was wrong .	the book is on the ground in the park on the ground in the museum was wrong .
the bottle on the floor by the dish on the couch on the couch is upset .	the bottle was on the floor by the dish on the couch on the couch is upset .
the crayon in the mall on the bed in the kitchen on the stool was sleepy .	the crayon is in the mall on the bed in the kitchen on the stool was sleepy .
the doll on the bed by the rug on the chair on the table is curious .	the doll was on the bed by the rug on the chair on the table is curious .
the shirt by the car by the bicycle by the picture by the button was wrong .	the shirt is by the car by the bicycle by the picture by the button was wrong .
the button on the floor in the library by the bicycle by the couch was excited .	the button is on the floor in the library by the bicycle by the couch was excited .
the shirt by the book by the cup on the bed on the floor is hungry .	the shirt was by the book by the cup on the bed on the floor is hungry .
the hat on the bed by the bottle in the kitchen by the book is busy .	the hat was on the bed by the bottle in the kitchen by the book is busy .
the crayon on the stool in the restaurant in the museum by the shirt was confused .	the crayon is on the stool in the restaurant in the museum by the shirt was confused .
the plate by the ring in the school in the room on the bed was strong .	the plate is by the ring in the school in the room on the bed was strong .
the toy on the street in the bank on the floor in the bank was surprised .	the toy is on the street in the bank on the floor in the bank was surprised .
the boat on the bed in the park in the restaurant in the room is upset .	the boat was on the bed in the park in the restaurant in the room is upset .
the button by the doll in the kitchen on the floor in the mall is friendly .	the button was by the doll in the kitchen on the floor in the mall is friendly .
the bag in the bank by the bowl in the park on the ground was hungry .	the bag is in the bank by the bowl in the park on the ground was hungry .
the toy on the floor on the street by the mirror on the ground is busy .	the toy was on the floor on the street by the mirror on the ground is busy .
the mirror in the hospital by the bowl on the floor on the ground was strong .	the mirror is in the hospital by the bowl on the floor on the ground was strong .
the button by the glass by the car in the school in the bank was gentle .	the button is by the glass by the car in the school in the bank was gentle .
the ship on the chair on the ground in the mall by the crayon is quiet .	the ship was on the chair on the ground in the mall by the crayon is quiet .
the ring in the school by the car by the shoe by the plane is confused .	the ring was in the school by the car by the shoe by the plane is confused .
the bed on the street in the library by the door in the museum was helpful .	the bed is on the street in the library by the door in the museum was helpful .
the bag by the bowl in the park by the crayon by the toy was sleepy .	the bag is by the bowl in the park by the crayon by the toy was sleepy .
the toy on the couch by the doll in the mall by the mirror is quiet .	the toy was on the couch by the doll in the mall by the mirror is quiet .
the dish by the plate in the school by the mirror by the window was curious .	the dish is by the plate in the school by the mirror by the window was curious .
the spoon on the table by the crayon in the bank by the toy is excited .	the spoon was on the table by the crayon in the bank by the toy is excited .
the shirt by the box on the chair by the bicycle in the mall was curious .	the shirt is by the box on the chair by the bicycle in the mall was curious .
the mirror on the stool by the picture in the mall in the school was surprised .	the mirror is on the stool by the picture in the mall in the school was surprised .
the bag in the bank by the car on the ground on the chair was gentle .	the bag is in the bank by the car on the ground on the chair was gentle .
the bag on the bed by the bicycle in the bank on the bed is healthy .	the bag was on the bed by the bicycle in the bank on the bed is healthy .
the chair by the window by the bicycle on the street on the street was helpful .	the chair is by the window by the bicycle on the street on the street was helpful .
the plate on the table by the glass in the mall on the street was happy .	the plate is on the table by the glass in the mall on the street was happy .
the cup by the couch by the toy in the park by the plane is helpful .	the cup was by the couch by the toy in the park by the plane is helpful .
the rocket by the rocket in the room in the mall in the library is important .	the rocket was by the rocket in the room in the mall in the library is important .
the truck by the spoon by the door on the street on the chair is excited .	the truck was by the spoon by the door on the street on the chair is excited .
the picture by the window by the box on the table on the stool is healthy .	the picture was by the window by the box on the table on the stool is healthy .
the book by the mirror on the street in the mall on the couch was happy .	the book is by the mirror on the street in the mall on the couch was happy .
the box on the ground on the bed in the school in the kitchen was nice .	the box is on the ground on the bed in the school in the kitchen was nice .
the button in the library by the picture by the shirt by the crayon was young .	the button is in the library by the picture by the shirt by the crayon was young .
the glass on the stool on the ground on the ground on the bed was tall .	the glass is on the stool on the ground on the ground on the bed was tall .
the plane by the doll by the bed by the book in the park is curious .	the plane was by the doll by the bed by the book in the park is curious .
the dish in the library by the rug by the hat by the chair is busy .	the dish was in the library by the rug by the hat by the chair is busy .
the couch on the chair on the chair on the street in the restaurant was strong .	the couch is on the chair on the chair on the street in the restaurant was strong .
the car by the picture by the book on the floor by the candle is young .	the car was by the picture by the book on the floor by the candle is young .
the glass by the box on the bed on the stool on the stool was hungry .	the glass is by the box on the bed on the stool on the stool was hungry .
the bag by the shoe by the book on the stool on the couch was upset .	the bag is by the shoe by the book on the stool on the couch was upset .
the crayon on the bed by the ring in the room on the couch was kind .	the crayon is on the bed by the ring in the room on the couch was kind .
the crayon by the toy on the floor on the bed on the ground is clever .	the crayon was by the toy on the floor on the bed on the ground is clever .
the plane on the floor in the mall on the stool on the street was friendly .	the plane is on the floor in the mall on the stool on the street was friendly .
the chair in the school in the museum on the ground on the table was clever .	the chair is in the school in the museum on the ground on the table was clever .
the ring on the chair by the shirt in the school by the bag is nice .	the ring was on the chair by the shirt in the school by the bag is nice .
the bicycle in the museum by the glass on the bed in the museum was strong .	the bicycle is in the museum by the glass on the bed in the museum was strong .
the truck on the chair by the rug in the bank by the bicycle is sleepy .	the truck was on the chair by the rug in the bank by the bicycle is sleepy .
the bed on the floor in the kitchen on the ground on the floor is young .	the bed was on the floor in the kitchen on the ground on the floor is young .
the ship on the ground on the stool on the stool by the car is helpful .	the ship was on the ground on the stool on the stool by the car is helpful .
the chair in the kitchen on the couch by the ship in the school was upset .	the chair is in the kitchen on the couch by the ship in the school was upset .
the glass by the book on the stool by the crayon in the bank is helpful .	the glass was by the book on the stool by the crayon in the bank is helpful .
the book by the hat on the ground in the hospital by the truck is wrong .	the book was by the hat on the ground in the hospital by the truck is wrong .
the book in the school by the ring on the ground by the car is wrong .	the book was in the school by the ring on the ground by the car is wrong .
the ring on the bed by the shirt in the bank in the kitchen was important .	the ring is on the bed by the shirt in the bank in the kitchen was important .
the bottle in the school by the couch by the ring on the couch is hungry .	the bottle was in the school by the couch by the ring on the couch is hungry .
the cup on the floor on the street on the floor in the school was clever .	the cup is on the floor on the street on the floor in the school was clever .
the couch by the bag in the mall by the door by the rug is hungry .	the couch was by the bag in the mall by the door by the rug is hungry .
the bicycle on the ground by the picture by the crayon on the floor was happy .	the bicycle is on the ground by the picture by the crayon on the floor was happy .
the car by the ship in the school in the bank on the table was upset .	the car is by the ship in the school in the bank on the table was upset .
the toy in the library by the door on the couch on the floor was upset .	the toy is in the library by the door on the couch on the floor was upset .
the cup in the school in the bank by the truck by the fork is bored .	the cup was in the school in the bank by the truck by the fork is bored .
the rocket in the restaurant on the floor by the glass by the button is important .	the rocket was in the restaurant on the floor by the glass by the button is important .
the fork on the bed by the dish on the table on the table is helpful .	the fork was on the bed by the dish on the table on the table is helpful .
the bowl on the table on the stool by the bag by the picture is strong .	the bowl was on the table on the stool by the bag by the picture is strong .
the bed on the chair by the fork on the floor on the ground is gentle .	the bed was on the chair by the fork on the floor on the ground is gentle .
the car by the bicycle in the museum in the mall in the restaurant was wrong .	the car is by the bicycle in the museum in the mall in the restaurant was wrong .
the box in the museum by the doll by the doll by the doll is young .	the box was in the museum by the doll by the doll by the doll is young .
the shirt on the floor on the table on the street on the street was clever .	the shirt is on the floor on the table on the street on the street was clever .
the fork in the kitchen in the school by the candle in the park was confused .	the fork is in the kitchen in the school by the candle in the park was confused .
the bag by the chair by the couch by the bag in the park was angry .	the bag is by the chair by the couch by the bag in the park was angry .
the window on the floor by the book by the doll on the stool is important .	the window was on the floor by the book by the doll on the stool is important .
the picture in the park on the table by the rug on the bed was friendly .	the picture is in the park on the table by the rug on the bed was friendly .
the mirror on the table in the mall on the chair by the spoon is careful .	the mirror was on the table in the mall on the chair by the spoon is careful .
the rocket in the school on the stool on the stool on the couch is smart .	the rocket was in the school on the stool on the stool on the couch is smart .
the window on the street in the school by the toy in the library was busy .	the window is on the street in the school by the toy in the library was busy .
the door in the school in the mall by the mirror in the restaurant was gentle .	the door is in the school in the mall by the mirror in the restaurant was gentle .
the ring on the stool by the book in the kitchen by the fork was tall .	the ring is on the stool by the book in the kitchen by the fork was tall .
the ring by the bowl in the kitchen by the hat in the mall was curious .	the ring is by the bowl in the kitchen by the hat in the mall was curious .
the button on the bed on the stool on the floor by the spoon was nice .	the button is on the bed on the stool on the floor by the spoon was nice .
the box by the bowl by the rocket by the plate by the hat is important .	the box was by the bowl by the rocket by the plate by the hat is important .
the box on the street by the picture on the couch on the ground is wrong .	the box was on the street by the picture on the couch on the ground is wrong .
the bowl on the street on the couch on the floor by the truck is hungry .	the bowl was on the street on the couch on the floor by the truck is hungry .
the dish in the museum in the school in the museum by the picture was friendly .	the dish is in the museum in the school in the museum by the picture was friendly .
the fork by the glass by the bag on the bed on the couch is healthy .	the fork was by the glass by the bag on the bed on the couch is healthy .
the spoon on the stool on the bed in the room by the window is hungry .	the spoon was on the stool on the bed in the room by the window is hungry .
the plane on the ground by the crayon on the bed on the street was helpful .	the plane is on the ground by the crayon on the bed on the street was helpful .
the boat by the picture in the school in the mall by the rug was sleepy .	the boat is by the picture in the school in the mall by the rug was sleepy .
the bottle by the bag in the museum by the truck in the museum was careful .	the bottle is by the bag in the museum by the truck in the museum was careful .
the bicycle on the ground in the school in the museum by the doll is wrong .	the bicycle was on the ground in the school in the museum by the doll is wrong .
the ring in the library on the street by the truck by the spoon is quiet .	the ring was in the library on the street by the truck by the spoon is quiet .
the rocket by the car by the shoe on the ground on the floor was helpful .	the rocket is by the car by the shoe on the ground on the floor was helpful .
the chair in the mall on the ground in the museum by the rocket was friendly .	the chair is in the mall on the ground in the museum by the rocket was friendly .
the plate on the floor by the rug on the couch by the window is healthy .	the plate was on the floor by the rug on the couch by the window is healthy .
the bowl in the library in the room on the street by the spoon was wrong .	the bowl is in the library in the room on the street by the spoon was wrong .
the shirt by the spoon by the glass on the bed on the street is careful .	the shirt was by the spoon by the glass on the bed on the street is careful .
the box in the school in the kitchen on the chair on the bed is smart .	the box was in the school in the kitchen on the chair on the bed is smart .
the dish by the couch in the park on the street by the bicycle was surprised .	the dish is by the couch in the park on the street by the bicycle was surprised .
the glass by the window by the hat by the fork on the street is sleepy .	the glass was by the window by the hat by the fork on the street is sleepy .
the rug on the chair on the table by the bottle by the book is important .	the rug was on the chair on the table by the bottle by the book is important .
the shoe in the school by the cup by the door on the chair is confused .	the shoe was in the school by the cup by the door on the chair is confused .
the plate on the stool in the hospital on the couch on the floor was important .	the plate is on the stool in the hospital on the couch on the floor was important .
the dish by the plate in the hospital in the mall in the restaurant is excited .	the dish was by the plate in the hospital in the mall in the restaurant is excited .
the bed in the kitchen by the shoe in the school by the fork is confused .	the bed was in the kitchen by the shoe in the school by the fork is confused .
the plane in the room in the restaurant in the room by the ship is happy .	the plane was in the room in the restaurant in the room by the ship is happy .
the candle in the school on the stool in the museum in the school is important .	the candle was in the school on the stool in the museum in the school is important .
the book on the bed in the school on the floor on the couch is quiet .	the book was on the bed in the school on the floor on the couch is quiet .
the candle by the toy by the doll in the room on the floor was kind .	the candle is by the toy by the doll in the room on the floor was kind .
the plate by the book in the hospital by the button by the glass was angry .	the plate is by the book in the hospital by the button by the glass was angry .
the car in the hospital by the dish by the box on the street was wrong .	the car is in the hospital by the dish by the box on the street was wrong .
the couch on the stool on the stool in the hospital in the school was surprised .	the couch is on the stool on the stool in the hospital in the school was surprised .
the bottle by the plate on the bed on the couch on the table was nice .	the bottle is by the plate on the bed on the couch on the table was nice .
the shirt on the couch by the cup by the plane in the hospital is happy .	the shirt was on the couch by the cup by the plane in the hospital is happy .
the book on the chair in the library by the car in the restaurant is bored .	the book was on the chair in the library by the car in the restaurant is bored .
the book by the book by the car by the bicycle on the chair is friendly .	the book was by the book by the car by the bicycle on the chair is friendly .
the rug by the chair on the floor by the ring by the car was tired .	the rug is by the chair on the floor by the ring by the car was tired .
the door in the room on the chair on the street on the couch is wrong .	the door was in the room on the chair on the street on the couch is wrong .
the button by the book by the couch by the boat by the toy is hungry .	the button was by the book by the couch by the boat by the toy is hungry .
the cup in the bank on the table in the room by the bowl was surprised .	the cup is in the bank on the table in the room by the bowl was surprised .
the glass in the mall by the glass by the fork in the school was curious .	the glass is in the mall by the glass by the fork in the school was curious .
the rug by the shirt on the couch on the couch on the street is tall .	the rug was by the shirt on the couch on the couch on the street is tall .
the button by the book in the kitchen by the rocket in the hospital was careful .	the button is by the book in the kitchen by the rocket in the hospital was careful .
the picture on the table by the bowl by the shoe on the couch is excited .	the picture was on the table by the bowl by the shoe on the couch is excited .
the mirror in the kitchen on the floor by the cup by the car is strong .	the mirror was in the kitchen on the floor by the cup by the car is strong .
the window in the hospital on the ground on the couch by the cup was careful .	the window is in the hospital on the ground on the couch by the cup was careful .
the spoon in the mall in the room by the chair by the boat was curious .	the spoon is in the mall in the room by the chair by the boat was curious .
the doll in the school in the mall by the ring on the couch is happy .	the doll was in the school in the mall by the ring on the couch is happy .
the box on the chair by the toy in the room on the ground is kind .	the box was on the chair by the toy in the room on the ground is kind .
the dish on the chair by the button in the room by the candle is gentle .	the dish was on the chair by the button in the room by the candle is gentle .
the glass on the bed in the museum by the couch in the mall is helpful .	the glass was on the bed in the museum by the couch in the mall is helpful .
the cup by the cup on the floor in the library on the couch is excited .	the cup was by the cup on the floor in the library on the couch is excited .
the ring by the toy by the door on the stool by the rug is smart .	the ring was by the toy by the door on the stool by the rug is smart .
the plate by the car by the crayon on the street on the couch was gentle .	the plate is by the car by the crayon on the street on the couch was gentle .
the fork by the book in the restaurant in the library on the table was upset .	the fork is by the book in the restaurant in the library on the table was upset .
the spoon on the street in the kitchen by the book in the school is young .	the spoon was on the street in the kitchen by the book in the school is young .
the toy by the toy in the kitchen in the restaurant on the table was upset .	the toy is by the toy in the kitchen in the restaurant on the table was upset .
the chair by the rocket on the ground on the street on the couch was smart .	the chair is by the rocket on the ground on the street on the couch was smart .
the car on the ground on the couch on the table on the stool was sleepy .	the car is on the ground on the couch on the table on the stool was sleepy .
the book on the ground in the school by the mirror in the restaurant was busy .	the book is on the ground in the school by the mirror in the restaurant was busy .
the ring by the shirt by the cup by the car by the rocket is smart .	the ring was by the shirt by the cup by the car by the rocket is smart .
the toy on the floor in the mall by the box on the street is careful .	the toy was on the floor in the mall by the box on the street is careful .
the picture by the box on the bed on the stool by the shirt was upset .	the picture is by the box on the bed on the stool by the shirt was upset .
the chair on the floor on the floor on the street by the rocket was careful .	the chair is on the floor on the floor on the street by the rocket was careful .
the ship by the doll on the ground on the floor by the bicycle is important .	the ship was by the doll on the ground on the floor by the bicycle is important .
the fork on the table on the couch in the room by the candle is angry .	the fork was on the table on the couch in the room by the candle is angry .
the truck by the car in the bank in the bank on the chair is important .	the truck was by the car in the bank in the bank on the chair is important .
the rug in the bank in the museum on the couch on the floor was nice .	the rug is in the bank in the museum on the couch on the floor was nice .
the rocket by the chair by the rocket on the street on the bed is lucky .	the rocket was by the chair by the rocket on the street on the bed is lucky .
the picture by the ship in the hospital on the chair by the cup is excited .	the picture was by the ship in the hospital on the chair by the cup is excited .
the mirror on the ground by the doll in the kitchen on the floor was quiet .	the mirror is on the ground by the doll in the kitchen on the floor was quiet .
the doll by the plane in the room on the table in the mall is nice .	the doll was by the plane in the room on the table in the mall is nice .
the ship on the street by the cup by the bed by the bed is quiet .	the ship was on the street by the cup by the bed by the bed is quiet .
the bicycle in the hospital on the street on the chair in the restaurant was bored .	the bicycle is in the hospital on the street on the chair in the restaurant was bored .
the window on the ground on the bed by the toy on the ground was careful .	the window is on the ground on the bed by the toy on the ground was careful .
the plate in the hospital on the couch in the kitchen by the ship is gentle .	the plate was in the hospital on the couch in the kitchen by the ship is gentle .
the bed on the stool by the doll by the bag on the bed was young .	the bed is on the stool by the doll by the bag on the bed was young .
the car by the rocket on the street on the chair on the couch is wrong .	the car was by the rocket on the street on the chair on the couch is wrong .
the mirror on the stool by the toy on the bed by the plate is lucky .	the mirror was on the stool by the toy on the bed by the plate is lucky .
the plane in the school in the bank by the chair in the room was helpful .	the plane is in the school in the bank by the chair in the room was helpful .
the book in the kitchen in the hospital on the chair by the door is nice .	the book was in the kitchen in the hospital on the chair by the door is nice .
the book on the table in the school in the school in the school is curious .	the book was on the table in the school in the school in the school is curious .
the window by the car in the mall on the table in the kitchen is boring .	the window was by the car in the mall on the table in the kitchen is boring .
the bicycle on the floor by the shoe on the table by the hat was friendly .	the bicycle is on the floor by the shoe on the table by the hat was friendly .
the candle on the couch by the bowl on the ground in the park is smart .	the candle was on the couch by the bowl on the ground in the park is smart .
the couch on the stool by the chair by the bottle by the truck is tired .	the couch was on the stool by the chair by the bottle by the truck is tired .
the window on the chair by the shoe in the mall in the hospital was nice .	the window is on the chair by the shoe in the mall in the hospital was nice .
the door in the museum in the room on the ground by the door was busy .	the door is in the museum in the room on the ground by the door was busy .
the book on the ground on the table on the table in the room was strong .	the book is on the ground on the table on the table in the room was strong .
the doll on the ground on the ground in the school in the school was curious .	the doll is on the ground on the ground in the school in the school was curious .
the ship in the hospital on the couch on the table on the couch was important .	the ship is in the hospital on the couch on the table on the couch was important .
the truck on the bed in the room on the bed in the restaurant is careful .	the truck was on the bed in the room on the bed in the restaurant is careful .
the toy in the hospital in the kitchen in the bank in the school was boring .	the toy is in the hospital in the kitchen in the bank in the school was boring .
the book in the room on the street by the bowl on the chair was excited .	the book is in the room on the street by the bowl on the chair was excited .
the window by the door in the park on the bed on the ground is upset .	the window was by the door in the park on the bed on the ground is upset .
the button in the museum by the spoon on the table on the couch was gentle .	the button is in the museum by the spoon on the table on the couch was gentle .
the plate on the chair in the kitchen in the kitchen in the museum was tall .	the plate is on the chair in the kitchen in the kitchen in the museum was tall .
the hat by the spoon on the ground by the cup on the couch is careful .	the hat was by the spoon on the ground by the cup on the couch is careful .
the hat by the plate on the street in the mall by the doll was excited .	the hat is by the plate on the street in the mall by the doll was excited .
the rug by the fork in the kitchen on the couch in the museum was hungry .	the rug is by the fork in the kitchen on the couch in the museum was hungry .
the cup on the stool on the couch in the room on the stool was tired .	the cup is on the stool on the couch in the room on the stool was tired .
the doll by the car on the ground on the ground on the floor was excited .	the doll is by the car on the ground on the ground on the floor was excited .
the bed in the library on the couch by the plane on the chair is sleepy .	the bed was in the library on the couch by the plane on the chair is sleepy .
the bicycle in the restaurant on the street by the mirror by the car was healthy .	the bicycle is in the restaurant on the street by the mirror by the car was healthy .
the chair on the floor by the rug by the shirt on the chair is upset .	the chair was on the floor by the rug by the shirt on the chair is upset .
the couch by the book on the floor on the chair in the library is curious .	the couch was by the book on the floor on the chair in the library is curious .
the car by the plane by the plane by the ring on the ground was sleepy .	the car is by the plane by the plane by the ring on the ground was sleepy .
the candle by the bowl in the school in the park in the museum was hungry .	the candle is by the bowl in the school in the park in the museum was hungry .
the door on the chair in the school by the glass on the bed was hungry .	the door is on the chair in the school by the glass on the bed was hungry .
the dish in the bank by the book on the street on the floor was friendly .	the dish is in the bank by the book on the street on the floor was friendly .
the fork in the kitchen in the library in the mall by the fork was nice .	the fork is in the kitchen in the library in the mall by the fork was nice .
the button in the hospital by the picture by the car on the bed is sleepy .	the button was in the hospital by the picture by the car on the bed is sleepy .
the button on the stool in the park by the chair in the school was friendly .	the button is on the stool in the park by the chair in the school was friendly .
the rocket by the plate on the stool on the bed by the picture is tired .	the rocket was by the plate on the stool on the bed by the picture is tired .
the glass by the button in the school by the book in the hospital is careful .	the glass was by the button in the school by the book in the hospital is careful .
the bowl on the bed on the stool on the couch on the street is healthy .	the bowl was on the bed on the stool on the couch on the street is healthy .
the plate by the ship by the picture by the button by the rocket is boring .	the plate was by the ship by the picture by the button by the rocket is boring .
the crayon on the floor on the table in the museum on the ground is young .	the crayon was on the floor on the table in the museum on the ground is young .
the chair by the book on the floor on the couch by the couch was upset .	the chair is by the book on the floor on the couch by the couch was upset .
the book in the school in the library on the floor by the truck is tall .	the book was in the school in the library on the floor by the truck is tall .
the bed by the fork by the cup on the bed in the restaurant was gentle .	the bed is by the fork by the cup on the bed in the restaurant was gentle .
the ring in the park on the stool in the room in the library is young .	the ring was in the park on the stool in the room in the library is young .
the boat on the bed in the school by the car in the kitchen was smart .	the boat is on the bed in the school by the car in the kitchen was smart .
the car by the doll by the bag by the door in the mall is confused .	the car was by the doll by the bag by the door in the mall is confused .
the picture by the doll by the rocket by the car by the bicycle is friendly .	the picture was by the doll by the rocket by the car by the bicycle is friendly .
the window on the chair in the school by the toy in the school is confused .	the window was on the chair in the school by the toy in the school is confused .
the glass in the park on the floor in the library by the shirt was nice .	the glass is in the park on the floor in the library by the shirt was nice .
the crayon by the truck on the chair on the couch in the room is tired .	the crayon was by the truck on the chair on the couch in the room is tired .
the glass by the couch in the school by the fork in the kitchen is wrong .	the glass was by the couch in the school by the fork in the kitchen is wrong .
the toy on the bed by the chair by the shirt by the chair is lucky .	the toy was on the bed by the chair by the shirt by the chair is lucky .
the plane by the window by the picture on the bed on the ground was tall .	the plane is by the window by the picture on the bed on the ground was tall .
the hat by the bicycle in the mall in the museum on the couch is boring .	the hat was by the bicycle in the mall in the museum on the couch is boring .
the button on the couch on the chair by the dish in the restaurant is clever .	the button was on the couch on the chair by the dish in the restaurant is clever .
the door in the room on the bed on the chair by the plane is surprised .	the door was in the room on the bed on the chair by the plane is surprised .
the toy in the kitchen in the park in the bank on the couch is careful .	the toy was in the kitchen in the park in the bank on the couch is careful .
the button on the floor by the dish on the floor by the mirror was quiet .	the button is on the floor by the dish on the floor by the mirror was quiet .
the crayon in the library in the room on the chair on the floor is friendly .	the crayon was in the library in the room on the chair on the floor is friendly .
the bicycle by the door on the chair by the rug on the floor was nice .	the bicycle is by the door on the chair by the rug on the floor was nice .
the shirt by the bottle by the plate on the bed by the car is confused .	the shirt was by the bottle by the plate on the bed by the car is confused .
the book on the bed on the table on the chair in the kitchen is friendly .	the book was on the bed on the table on the chair in the kitchen is friendly .
the bicycle by the shirt in the school in the mall in the school is tall .	the bicycle was by the shirt in the school in the mall in the school is tall .
the shirt by the shoe by the hat by the button on the bed was tired .	the shirt is by the shoe by the hat by the button on the bed was tired .
the picture by the plane on the floor by the cup by the cup is sleepy .	the picture was by the plane on the floor by the cup by the cup is sleepy .
the plane in the school on the couch in the room by the bed was young .	the plane is in the school on the couch in the room by the bed was young .
the plane in the museum in the restaurant by the car by the shirt is upset .	the plane was in the museum in the restaurant by the car by the shirt is upset .
the bag on the ground by the spoon in the hospital by the ring is healthy .	the bag was on the ground by the spoon in the hospital by the ring is healthy .
the fork on the couch on the chair by the plate by the boat is hungry .	the fork was on the couch on the chair by the plate by the boat is hungry .
the ring in the mall on the table on the stool in the room was angry .	the ring is in the mall on the table on the stool in the room was angry .
the door by the car in the kitchen on the stool by the book was sleepy .	the door is by the car in the kitchen on the stool by the book was sleepy .
the car by the shoe by the rug in the kitchen on the table is smart .	the car was by the shoe by the rug in the kitchen on the table is smart .
the boat on the ground on the couch in the museum in the bank is healthy .	the boat was on the ground on the couch in the museum in the bank is healthy .
the crayon in the school by the glass by the spoon in the school was upset .	the crayon is in the school by the glass by the spoon in the school was upset .
the bowl on the couch in the school by the bottle in the restaurant is tired .	the bowl was on the couch in the school by the bottle in the restaurant is tired .
the button by the crayon on the chair on the table by the doll is healthy .	the button was by the crayon on the chair on the table by the doll is healthy .
the truck on the chair in the mall by the rug on the street is busy .	the truck was on the chair in the mall by the rug on the street is busy .
the car on the couch in the school on the ground in the mall was gentle .	the car is on the couch in the school on the ground in the mall was gentle .
the candle on the couch by the boat by the glass in the mall was young .	the candle is on the couch by the boat by the glass in the mall was young .
the couch in the library in the school on the floor by the book was young .	the couch is in the library in the school on the floor by the book was young .
the picture by the toy in the school in the kitchen in the hospital is upset .	the picture was by the toy in the school in the kitchen in the hospital is upset .
the boat by the glass by the picture on the floor on the street is excited .	the boat was by the glass by the picture on the floor on the street is excited .
the rug in the school on the street in the park by the rug was curious .	the rug is in the school on the street in the park by the rug was curious .
the boat in the hospital by the boat on the couch by the spoon is healthy .	the boat was in the hospital by the boat on the couch by the spoon is healthy .
the fork by the boat in the museum by the glass by the toy was happy .	the fork is by the boat in the museum by the glass by the toy was happy .
the ring by the book in the school on the ground by the window is busy .	the ring was by the book in the school on the ground by the window is busy .
the toy in the restaurant in the room by the shoe on the chair was bored .	the toy is in the restaurant in the room by the shoe on the chair was bored .
the boat in the restaurant in the bank in the kitchen by the shoe was wrong .	the boat is in the restaurant in the bank in the kitchen by the shoe was wrong .
the car on the couch by the car by the shoe on the street was smart .	the car is on the couch by the car by the shoe on the street was smart .
the picture in the library in the museum on the table on the table is angry .	the picture was in the library in the museum on the table on the table is angry .
the crayon on the stool by the doll in the room in the museum was happy .	the crayon is on the stool by the doll in the room in the museum was happy .
the dish on the chair in the park on the ground by the book is upset .	the dish was on the chair in the park on the ground by the book is upset .
the cup in the hospital in the school on the stool in the school was confused .	the cup is in the hospital in the school on the stool in the school was confused .
the bag on the stool by the button in the library by the ship is important .	the bag was on the stool by the button in the library by the ship is important .
the rug by the shoe in the school in the room on the couch was healthy .	the rug is by the shoe in the school in the room on the couch was healthy .
the mirror in the park by the boat on the couch by the truck is surprised .	the mirror was in the park by the boat on the couch by the truck is surprised .
the fork by the box by the car by the rocket by the bowl was friendly .	the fork is by the box by the car by the rocket by the bowl was friendly .
the chair on the ground in the museum by the bag by the bed is smart .	the chair was on the ground in the museum by the bag by the bed is smart .
the bed by the doll by the rug on the couch on the couch was helpful .	the bed is by the doll by the rug on the couch on the couch was helpful .
the spoon in the school by the mirror by the crayon in the kitchen is angry .	the spoon was in the school by the mirror by the crayon in the kitchen is angry .
the fork on the table on the bed in the bank on the table is smart .	the fork was on the table on the bed in the bank on the table is smart .
the glass by the shirt in the bank on the chair in the bank was curious .	the glass is by the shirt in the bank on the chair in the bank was curious .
the candle by the door by the bag by the car in the restaurant was important .	the candle is by the door by the bag by the car in the restaurant was important .
the dish in the bank by the button in the room on the chair is hungry .	the dish was in the bank by the button in the room on the chair is hungry .
the mirror by the shirt on the street by the mirror by the plate is gentle .	the mirror was by the shirt on the street by the mirror by the plate is gentle .
the chair on the chair by the cup in the kitchen in the room is bored .	the chair was on the chair by the cup in the kitchen in the room is bored .
the book by the ring by the shoe on the stool by the bicycle was clever .	the book is by the ring by the shoe on the stool by the bicycle was clever .
the fork in the restaurant in the mall on the table by the book was strong .	the fork is in the restaurant in the mall on the table by the book was strong .
the car in the bank in the school by the door in the school was tall .	the car is in the bank in the school by the door in the school was tall .
the bicycle on the couch in the museum by the box on the street is sleepy .	the bicycle was on the couch in the museum by the box on the street is sleepy .
the box by the cup in the room by the shirt by the shirt is kind .	the box was by the cup in the room by the shirt by the shirt is kind .
the spoon in the library by the doll by the bowl by the book is tall .	the spoon was in the library by the doll by the bowl by the book is tall .
the truck in the restaurant in the library on the stool by the button was nice .	the truck is in the restaurant in the library on the stool by the button was nice .
the candle on the floor by the doll by the shirt in the room was surprised .	the candle is on the floor by the doll by the shirt in the room was surprised .
the button on the ground on the table by the shoe by the rug is busy .	the button was on the ground on the table by the shoe by the rug is busy .
the rug on the couch in the kitchen on the floor by the bowl was surprised .	the rug is on the couch in the kitchen on the floor by the bowl was surprised .
the bicycle on the chair on the bed in the bank in the bank is kind .	the bicycle was on the chair on the bed in the bank in the bank is kind .
the rocket by the rocket on the chair in the school by the plate was busy .	the rocket is by the rocket on the chair in the school by the plate was busy .
the dish by the car in the museum on the couch on the chair is excited .	the dish was by the car in the museum on the couch on the chair is excited .
the cup by the mirror in the library in the museum in the hospital is tired .	the cup was by the mirror in the library in the museum in the hospital is tired .
the truck in the room by the door on the couch in the hospital is excited .	the truck was in the room by the door on the couch in the hospital is excited .
the bag on the stool by the ring by the shirt by the plate is bored .	the bag was on the stool by the ring by the shirt by the plate is bored .
the shoe by the mirror by the crayon by the book in the school is kind .	the shoe was by the mirror by the crayon by the book in the school is kind .
the car by the fork on the stool in the school by the ship is friendly .	the car was by the fork on the stool in the school by the ship is friendly .
the window by the ring in the school by the toy on the table was boring .	the window is by the ring in the school by the toy on the table was boring .
the rocket on the stool in the restaurant by the candle in the room is tired .	the rocket was on the stool in the restaurant by the candle in the room is tired .
the door in the library on the chair on the couch on the chair was gentle .	the door is in the library on the chair on the couch on the chair was gentle .
the shirt by the ship on the chair in the room by the toy was confused .	the shirt is by the ship on the chair in the room by the toy was confused .
the fork by the book in the restaurant in the mall by the couch is smart .	the fork was by the book in the restaurant in the mall by the couch is smart .
the bicycle on the table in the hospital by the button on the stool was kind .	the bicycle is on the table in the hospital by the button on the stool was kind .
the ship on the bed in the mall by the chair in the mall was boring .	the ship is on the bed in the mall by the chair in the mall was boring .
the rug in the mall by the glass in the park in the room was nice .	the rug is in the mall by the glass in the park in the room was nice .
the window in the room by the plane on the stool in the hospital is helpful .	the window was in the room by the plane on the stool in the hospital is helpful .
the rug by the doll in the bank by the crayon by the shirt is lucky .	the rug was by the doll in the bank by the crayon by the shirt is lucky .
the plate in the bank on the chair on the ground on the street is surprised .	the plate was in the bank on the chair on the ground on the street is surprised .
the shoe by the dish in the mall by the plane by the rug was lucky .	the shoe is by the dish in the mall by the plane by the rug was lucky .
the plane on the bed on the table on the ground by the truck was hungry .	the plane is on the bed on the table on the ground by the truck was hungry .
the ship by the fork in the school by the rocket by the boat is busy .	the ship was by the fork in the school by the rocket by the boat is busy .
the ring on the floor by the picture in the restaurant by the bowl was busy .	the ring is on the floor by the picture in the restaurant by the bowl was busy .
the rocket by the plate on the street by the shoe by the button is surprised .	the rocket was by the plate on the street by the shoe by the button is surprised .
the dish by the dish in the bank on the table in the mall is hungry .	the dish was by the dish in the bank on the table in the mall is hungry .
the ring in the library by the shoe on the ground in the library was confused .	the ring is in the library by the shoe on the ground in the library was confused .
the hat on the stool on the table on the ground on the chair was strong .	the hat is on the stool on the table on the ground on the chair was strong .
the candle on the street in the restaurant in the restaurant on the chair was kind .	the candle is on the street in the restaurant in the restaurant on the chair was kind .
the book on the table by the couch by the ring on the stool is healthy .	the book was on the table by the couch by the ring on the stool is healthy .
the picture in the mall by the chair by the book in the bank was excited .	the picture is in the mall by the chair by the book in the bank was excited .
the chair in the school in the park by the car on the floor is young .	the chair was in the school in the park by the car on the floor is young .
the cup on the table on the stool in the school in the restaurant is strong .	the cup was on the table on the stool in the school in the restaurant is strong .
the bed by the door by the plane by the bicycle by the chair was boring .	the bed is by the door by the plane by the bicycle by the chair was boring .
the button in the room by the glass by the cup by the boat was gentle .	the button is in the room by the glass by the cup by the boat was gentle .
the car on the ground by the toy on the street by the truck was sleepy .	the car is on the ground by the toy on the street by the truck was sleepy .
the dish on the couch on the table by the doll by the bottle was tired .	the dish is on the couch on the table by the doll by the bottle was tired .
the dish by the couch by the fork by the button by the mirror is curious .	the dish was by the couch by the fork by the button by the mirror is curious .
the ring in the room by the doll on the floor on the chair is kind .	the ring was in the room by the doll on the floor on the chair is kind .
the bowl on the floor by the rocket in the park by the box was hungry .	the bowl is on the floor by the rocket in the park by the box was hungry .
the plane by the ship on the chair by the mirror in the restaurant was nice .	the plane is by the ship on the chair by the mirror in the restaurant was nice .
the doll on the bed on the stool by the bottle by the box is clever .	the doll was on the bed on the stool by the bottle by the box is clever .
the truck in the kitchen by the crayon on the ground by the truck was sleepy .	the truck is in the kitchen by the crayon on the ground by the truck was sleepy .
the dish on the stool on the bed by the shirt on the ground is nice .	the dish was on the stool on the bed by the shirt on the ground is nice .
the cup in the museum in the kitchen by the button by the candle is tired .	the cup was in the museum in the kitchen by the button by the candle is tired .
the book on the ground on the floor on the floor on the couch is friendly .	the book was on the ground on the floor on the floor on the couch is friendly .
the box on the chair in the room by the candle in the room is wrong .	the box was on the chair in the room by the candle in the room is wrong .
the cup on the floor on the bed on the table on the table is confused .	the cup was on the floor on the bed on the table on the table is confused .
the bowl in the school on the couch in the restaurant on the floor is gentle .	the bowl was in the school on the couch in the restaurant on the floor is gentle .
the car in the park in the school on the bed in the school is young .	the car was in the park in the school on the bed in the school is young .
the shoe on the chair on the bed on the stool on the floor is young .	the shoe was on the chair on the bed on the stool on the floor is young .
the plate on the couch by the spoon on the stool by the ring is careful .	the plate was on the couch by the spoon on the stool by the ring is careful .
the spoon by the car in the room in the bank by the couch is quiet .	the spoon was by the car in the room in the bank by the couch is quiet .
the glass by the box in the bank in the mall by the candle was important .	the glass is by the box in the bank in the mall by the candle was important .
the picture by the window in the museum on the couch on the stool was lucky .	the picture is by the window in the museum on the couch on the stool was lucky .
the crayon by the dish on the stool on the street in the school was confused .	the crayon is by the dish on the stool on the street in the school was confused .
the window by the window by the spoon in the room by the rug was happy .	the window is by the window by the spoon in the room by the rug was happy .
the ring by the crayon in the hospital in the mall in the restaurant is angry .	the ring was by the crayon in the hospital in the mall in the restaurant is angry .
the rug in the kitchen in the room by the glass in the museum was surprised .	the rug is in the kitchen in the room by the glass in the museum was surprised .
the bottle by the ring in the restaurant on the street on the ground was sleepy .	the bottle is by the ring in the restaurant on the street on the ground was sleepy .
the chair by the door by the box in the school by the shoe is strong .	the chair was by the door by the box in the school by the shoe is strong .
the box in the restaurant on the chair in the bank by the plane is confused .	the box was in the restaurant on the chair in the bank by the plane is confused .
the truck on the floor in the library on the stool on the couch is smart .	the truck was on the floor in the library on the stool on the couch is smart .
the bed on the street on the chair on the couch in the park was upset .	the bed is on the street on the chair on the couch in the park was upset .
the book on the street by the car by the boat by the bag was tired .	the book is on the street by the car by the boat by the bag was tired .
the car in the library in the hospital in the museum on the table is sleepy .	the car was in the library in the hospital in the museum on the table is sleepy .
the cup in the school on the street on the table by the button was smart .	the cup is in the school on the street on the table by the button was smart .
the shirt on the chair on the street in the room by the picture was lucky .	the shirt is on the chair on the street in the room by the picture was lucky .
the car by the doll on the bed by the candle in the library was angry .	the car is by the doll on the bed by the candle in the library was angry .
the crayon by the plane on the ground in the restaurant in the library was healthy .	the crayon is by the plane on the ground in the restaurant in the library was healthy .
the ring in the room on the street in the mall on the table was busy .	the ring is in the room on the street in the mall on the table was busy .
the fork on the chair on the table in the park by the shoe was surprised .	the fork is on the chair on the table in the park by the shoe was surprised .
the cup by the shirt by the bag by the car by the car is healthy .	the cup was by the shirt by the bag by the car by the car is healthy .
the spoon in the museum in the room by the shoe in the library is confused .	the spoon was in the museum in the room by the shoe in the library is confused .
the door on the couch by the boat by the fork on the couch was boring .	the door is on the couch by the boat by the fork on the couch was boring .
the mirror on the ground in the school by the dish in the hospital was boring .	the mirror is on the ground in the school by the dish in the hospital was boring .
the rug in the mall in the park by the bicycle in the school is happy .	the rug was in the mall in the park by the bicycle in the school is happy .
the ship by the plate on the street in the museum in the bank is excited .	the ship was by the plate on the street in the museum in the bank is excited .
the plate in the hospital on the bed on the floor by the bed was quiet .	the plate is in the hospital on the bed on the floor by the bed was quiet .
the truck in the library in the room by the shirt on the bed was tall .	the truck is in the library in the room by the shirt on the bed was tall .
the bed in the school on the couch on the bed in the bank is friendly .	the bed was in the school on the couch on the bed in the bank is friendly .
the shoe on the stool by the shirt in the hospital by the toy is lucky .	the shoe was on the stool by the shirt in the hospital by the toy is lucky .
the couch in the mall on the couch by the cup on the floor was confused .	the couch is in the mall on the couch by the cup on the floor was confused .
the chair on the street in the mall by the door on the chair is young .	the chair was on the street in the mall by the door on the chair is young .
the box by the crayon in the room by the window on the bed was gentle .	the box is by the crayon in the room by the window on the bed was gentle .
the door on the chair on the bed in the room on the street was strong .	the door is on the chair on the bed in the room on the street was strong .
the shirt by the picture in the room on the table by the bowl is hungry .	the shirt was by the picture in the room on the table by the bowl is hungry .
the bowl in the bank by the picture on the table by the bed was upset .	the bowl is in the bank by the picture on the table by the bed was upset .
the couch by the truck in the school in the park on the couch is young .	the couch was by the truck in the school in the park on the couch is young .
the bag in the park on the bed on the chair by the fork was wrong .	the bag is in the park on the bed on the chair by the fork was wrong .
the bag on the couch in the school in the room in the school is happy .	the bag was on the couch in the school in the room in the school is happy .
the bed by the chair in the mall by the shoe on the table was gentle .	the bed is by the chair in the mall by the shoe on the table was gentle .
the dish on the floor in the library in the library on the ground is kind .	the dish was on the floor in the library in the library on the ground is kind .
the couch on the stool in the school in the kitchen in the museum is clever .	the couch was on the stool in the school in the kitchen in the museum is clever .
the box by the ring on the ground by the shirt in the park was angry .	the box is by the ring on the ground by the shirt in the park was angry .
the shoe on the street by the doll in the kitchen on the floor is sleepy .	the shoe was on the street by the doll in the kitchen on the floor is sleepy .
the spoon on the couch in the room on the bed in the restaurant is excited .	the spoon was on the couch in the room on the bed in the restaurant is excited .
the cup by the bottle on the couch on the street in the room is gentle .	the cup was by the bottle on the couch on the street in the room is gentle .
the bicycle on the chair by the car on the floor on the table is wrong .	the bicycle was on the chair by the car on the floor on the table is wrong .
the plane in the kitchen in the kitchen on the ground by the fork was hungry .	the plane is in the kitchen in the kitchen on the ground by the fork was hungry .
the glass in the restaurant by the chair in the kitchen by the ship is angry .	the glass was in the restaurant by the chair in the kitchen by the ship is angry .
the plane on the couch on the stool in the room in the hospital is nice .	the plane was on the couch on the stool in the room in the hospital is nice .
the bottle on the chair by the plate on the chair by the truck is curious .	the bottle was on the chair by the plate on the chair by the truck is curious .
the toy in the kitchen on the ground by the box on the bed was confused .	the toy is in the kitchen on the ground by the box on the bed was confused .
the door on the table in the mall in the room by the doll was kind .	the door is on the table in the mall in the room by the doll was kind .
the box in the hospital in the library in the library by the boat was boring .	the box is in the hospital in the library in the library by the boat was boring .
the rocket on the table on the couch by the shirt by the rocket was boring .	the rocket is on the table on the couch by the shirt by the rocket was boring .
the book on the ground on the floor on the bed in the mall is kind .	the book was on the ground on the floor on the bed in the mall is kind .
the cup by the toy on the chair on the street by the bed is smart .	the cup was by the toy on the chair on the street by the bed is smart .
the chair in the hospital by the window by the door by the shoe is happy .	the chair was in the hospital by the window by the door by the shoe is happy .
the bowl in the museum by the rocket in the restaurant in the room is excited .	the bowl was in the museum by the rocket in the restaurant in the room is excited .
the cup in the park by the book in the room on the bed is happy .	the cup was in the park by the book in the room on the bed is happy .
the bottle on the bed by the rocket by the truck by the ring was boring .	the bottle is on the bed by the rocket by the truck by the ring was boring .
the ship by the bowl on the floor in the restaurant in the school is boring .	the ship was by the bowl on the floor in the restaurant in the school is boring .
the ship on the table in the museum by the plate in the school was careful .	the ship is on the table in the museum by the plate in the school was careful .
the ring in the bank in the restaurant on the chair in the hospital was hungry .	the ring is in the bank in the restaurant on the chair in the hospital was hungry .
the shirt in the school in the room on the ground on the chair is tired .	the shirt was in the school in the room on the ground on the chair is tired .
the candle on the table on the stool by the shirt in the library was healthy .	the candle is on the table on the stool by the shirt in the library was healthy .
the rug on the floor in the park by the bicycle on the stool is friendly .	the rug was on the floor in the park by the bicycle on the stool is friendly .
the doll by the book by the chair in the hospital by the window was busy .	the doll is by the book by the chair in the hospital by the window was busy .
the cup on the stool in the hospital by the rug by the couch is careful .	the cup was on the stool in the hospital by the rug by the couch is careful .
the rocket in the school in the hospital on the floor in the park was smart .	the rocket is in the school in the hospital on the floor in the park was smart .
the bottle on the ground on the ground by the bicycle on the stool is tall .	the bottle was on the ground on the ground by the bicycle on the stool is tall .
the boat by the rug on the ground on the stool on the chair was clever .	the boat is by the rug on the ground on the stool on the chair was clever .
the boat on the street on the ground on the bed on the street was nice .	the boat is on the street on the ground on the bed on the street was nice .
the doll by the toy on the bed in the bank on the chair is friendly .	the doll was by the toy on the bed in the bank on the chair is friendly .
the candle by the car on the street by the toy by the boat is kind .	the candle was by the car on the street by the toy by the boat is kind .
the mirror by the car on the table in the kitchen on the ground is busy .	the mirror was by the car on the table in the kitchen on the ground is busy .
the book on the stool on the floor in the library on the table is strong .	the book was on the stool on the floor in the library on the table is strong .
the plate on the ground by the shirt by the button by the glass is happy .	the plate was on the ground by the shirt by the button by the glass is happy .
the chair by the fork in the bank in the school by the fork was careful .	the chair is by the fork in the bank in the school by the fork was careful .
the spoon in the kitchen by the plate by the truck in the restaurant was kind .	the spoon is in the kitchen by the plate by the truck in the restaurant was kind .
the book in the bank in the school by the car on the chair was quiet .	the book is in the bank in the school by the car on the chair was quiet .
the picture in the park in the school in the school in the bank is wrong .	the picture was in the park in the school in the school in the bank is wrong .
the bed in the kitchen on the chair by the bed in the mall was happy .	the bed is in the kitchen on the chair by the bed in the mall was happy .
the box on the chair by the rocket by the plate in the room was clever .	the box is on the chair by the rocket by the plate in the room was clever .
the boat by the bag on the couch on the ground on the table was angry .	the boat is by the bag on the couch on the ground on the table was angry .
the spoon in the school in the kitchen in the library by the button is excited .	the spoon was in the school in the kitchen in the library by the button is excited .
the doll by the glass on the stool on the couch on the street was young .	the doll is by the glass on the stool on the couch on the street was young .
the crayon in the mall by the fork by the bottle in the restaurant is upset .	the crayon was in the mall by the fork by the bottle in the restaurant is upset .
the box on the street in the school on the chair by the button is excited .	the box was on the street in the school on the chair by the button is excited .
the toy by the fork by the book on the table on the street was happy .	the toy is by the fork by the book on the table on the street was happy .
the window by the spoon by the car on the stool on the floor was quiet .	the window is by the spoon by the car on the stool on the floor was quiet .
the crayon in the hospital on the street on the bed in the restaurant was wrong .	the crayon is in the hospital on the street on the bed in the restaurant was wrong .
the button in the kitchen in the school by the hat in the room was happy .	the button is in the kitchen in the school by the hat in the room was happy .
the mirror in the hospital in the school by the bicycle in the kitchen is friendly .	the mirror was in the hospital in the school by the bicycle in the kitchen is friendly .
the car on the couch by the boat by the bicycle in the room was tall .	the car is on the couch by the boat by the bicycle in the room was tall .
the ring in the mall by the book on the table on the couch is happy .	the ring was in the mall by the book on the table on the couch is happy .
the fork on the bed in the museum on the chair on the table was boring .	the fork is on the bed in the museum on the chair on the table was boring .
the plate in the library in the mall in the school on the chair was angry .	the plate is in the library in the mall in the school on the chair was angry .
the hat by the truck in the restaurant by the ship on the table was friendly .	the hat is by the truck in the restaurant by the ship on the table was friendly .
the book by the candle on the floor by the car on the floor was curious .	the book is by the candle on the floor by the car on the floor was curious .
the shoe on the chair on the couch by the shoe on the table was happy .	the shoe is on the chair on the couch by the shoe on the table was happy .
the plate by the car in the restaurant by the plate by the bed is smart .	the plate was by the car in the restaurant by the plate by the bed is smart .
the ship on the bed by the plate in the kitchen by the ring was angry .	the ship is on the bed by the plate in the kitchen by the ring was angry .
the car by the plane by the car by the book in the hospital was boring .	the car is by the plane by the car by the book in the hospital was boring .
the button by the spoon on the street on the chair by the bag is helpful .	the button was by the spoon on the street on the chair by the bag is helpful .
the rocket in the school in the mall by the crayon in the school is happy .	the rocket was in the school in the mall by the crayon in the school is happy .
the window in the room by the bowl in the school on the street was smart .	the window is in the room by the bowl in the school on the street was smart .
the shoe on the floor on the floor on the street by the bed is young .	the shoe was on the floor on the floor on the street by the bed is young .
the picture by the box on the ground on the floor on the couch was happy .	the picture is by the box on the ground on the floor on the couch was happy .
the mirror by the mirror by the rug by the rocket in the park was kind .	the mirror is by the mirror by the rug by the rocket in the park was kind .
the mirror by the plane in the mall on the street in the museum is clever .	the mirror was by the plane in the mall on the street in the museum is clever .
the ship on the stool on the couch on the street on the couch was excited .	the ship is on the stool on the couch on the street on the couch was excited .
the button by the plate in the mall on the couch on the stool was angry .	the button is by the plate in the mall on the couch on the stool was angry .
the rug on the couch on the couch in the room on the table is boring .	the rug was on the couch on the couch in the room on the table is boring .
the ring by the shirt on the street by the glass by the hat was helpful .	the ring is by the shirt on the street by the glass by the hat was helpful .
the chair on the ground on the stool on the couch on the bed was clever .	the chair is on the ground on the stool on the couch on the bed was clever .
the chair by the shoe by the bed by the glass by the box was upset .	the chair is by the shoe by the bed by the glass by the box was upset .
the plate in the kitchen by the dish in the restaurant on the floor was quiet .	the plate is in the kitchen by the dish in the restaurant on the floor was quiet .
the box by the book in the park in the mall in the library was young .	the box is by the book in the park in the mall in the library was young .
the plate in the museum on the floor by the book on the street is quiet .	the plate was in the museum on the floor by the book on the street is quiet .
the ship by the bag in the room on the chair by the plate was healthy .	the ship is by the bag in the room on the chair by the plate was healthy .
the book in the room on the floor on the table in the hospital is sleepy .	the book was in the room on the floor on the table in the hospital is sleepy .
the mirror by the fork by the fork on the floor in the restaurant is clever .	the mirror was by the fork by the fork on the floor in the restaurant is clever .
the chair on the ground by the plane by the box in the room is hungry .	the chair was on the ground by the plane by the box in the room is hungry .
the crayon on the couch by the car by the boat on the ground was tired .	the crayon is on the couch by the car by the boat on the ground was tired .
the window on the ground on the bed in the school on the couch is gentle .	the window was on the ground on the bed in the school on the couch is gentle .
the cup on the stool in the room by the shirt on the chair is quiet .	the cup was on the stool in the room by the shirt on the chair is quiet .
the bowl in the kitchen in the library by the ring on the chair was smart .	the bowl is in the kitchen in the library by the ring on the chair was smart .
the plate by the book on the couch in the hospital by the couch was wrong .	the plate is by the book on the couch in the hospital by the couch was wrong .
the couch by the picture in the restaurant by the car in the school is healthy .	the couch was by the picture in the restaurant by the car in the school is healthy .
the spoon by the cup by the book on the bed in the mall was boring .	the spoon is by the cup by the book on the bed in the mall was boring .
the button by the plate on the chair on the street on the stool was wrong .	the button is by the plate on the chair on the street on the stool was wrong .
the mirror on the ground by the ring by the doll on the floor was healthy .	the mirror is on the ground by the ring by the doll on the floor was healthy .
the bottle on the bed by the dish on the floor on the chair was smart .	the bottle is on the bed by the dish on the floor on the chair was smart .
the bowl on the ground in the school on the stool by the car was tall .	the bowl is on the ground in the school on the stool by the car was tall .
the hat by the picture by the shoe by the shirt on the stool is hungry .	the hat was by the picture by the shoe by the shirt on the stool is hungry .
the couch on the chair in the mall in the mall in the park is excited .	the couch was on the chair in the mall in the mall in the park is excited .
the toy on the table by the fork in the school in the park was clever .	the toy is on the table by the fork in the school in the park was clever .
the plate on the table in the hospital by the shirt in the mall is busy .	the plate was on the table in the hospital by the shirt in the mall is busy .
the door in the kitchen on the chair on the chair on the couch was gentle .	the door is in the kitchen on the chair on the chair on the couch was gentle .
the bicycle in the room on the couch by the ring in the hospital is clever .	the bicycle was in the room on the couch by the ring in the hospital is clever .
the bag in the restaurant on the ground in the room on the bed was tall .	the bag is in the restaurant on the ground in the room on the bed was tall .
the doll by the rocket by the door by the spoon on the ground was healthy .	the doll is by the rocket by the door by the spoon on the ground was healthy .
the car by the ring in the kitchen on the bed by the rug is sleepy .	the car was by the ring in the kitchen on the bed by the rug is sleepy .
the book by the truck in the mall in the restaurant in the park is sleepy .	the book was by the truck in the mall in the restaurant in the park is sleepy .
the shoe by the ship by the glass on the floor on the couch is important .	the shoe was by the ship by the glass on the floor on the couch is important .
the bed on the chair in the hospital by the cup by the bag is helpful .	the bed was on the chair in the hospital by the cup by the bag is helpful .
the bowl by the crayon in the room in the park on the stool was smart .	the bowl is by the crayon in the room in the park on the stool was smart .
the doll on the bed by the door by the fork by the car was smart .	the doll is on the bed by the door by the fork by the car was smart .
the car on the stool by the box in the hospital on the bed is surprised .	the car was on the stool by the box in the hospital on the bed is surprised .
the bed on the ground by the button by the cup in the restaurant is careful .	the bed was on the ground by the button by the cup in the restaurant is careful .
the book on the bed by the book by the rocket by the hat is healthy .	the book was on the bed by the book by the rocket by the hat is healthy .
the car by the bag on the ground in the school in the room is curious .	the car was by the bag on the ground in the school in the room is curious .
the fork on the ground by the button on the ground on the street was curious .	the fork is on the ground by the button on the ground on the street was curious .
the bag by the shoe on the couch in the restaurant on the table is young .	the bag was by the shoe on the couch in the restaurant on the table is young .
the car on the ground on the stool by the picture by the rug is bored .	the car was on the ground on the stool by the picture by the rug is bored .
