the cup sings very very very quickly .	the cup was very very very quickly .
the plate sings very very very slowly .	the plate was very very very slowly .
the boat waves really really really perfectly .	the boat is really really really perfectly .
the plate paints really really really carefully .	the plate is really really really carefully .
the plane talks very very very slowly .	the plane was very very very slowly .
the plate exercises really really really perfectly .	the plate was really really really perfectly .
the chair reads really really really carefully .	the chair is really really really carefully .
the shirt waves really really really perfectly .	the shirt was really really really perfectly .
the ring sings very very very carefully .	the ring was very very very carefully .
the ring exercises very very very quickly .	the ring is very very very quickly .
the cup reads very very very quietly .	the cup is very very very quietly .
the bag exercises very very very carefully .	the bag is very very very carefully .
the mirror talks very very very carefully .	the mirror is very very very carefully .
the glass cries really really really slowly .	the glass was really really really slowly .
the box waves really really really perfectly .	the box is really really really perfectly .
the bed waves very very very slowly .	the bed is very very very slowly .
the couch cries very very very quickly .	the couch is very very very quickly .
the car exercises really really really perfectly .	the car was really really really perfectly .
the crayon paints really really really quickly .	the crayon was really really really quickly .
the window paints very very very quickly .	the window is very very very quickly .
the box paints very very very perfectly .	the box is very very very perfectly .
the ring cries really really really quietly .	the ring was really really really quietly .
the door sings very very very slowly .	the door was very very very slowly .
the picture cries really really really quickly .	the picture is really really really quickly .
the couch paints really really really perfectly .	the couch is really really really perfectly .
the button exercises very very very carefully .	the button was very very very carefully .
the toy waves very very very quickly .	the toy is very very very quickly .
the shirt cries very very very carefully .	the shirt is very very very carefully .
the car waves very very very perfectly .	the car was very very very perfectly .
the ship waves really really really carefully .	the ship is really really really carefully .
the mirror paints very very very slowly .	the mirror is very very very slowly .
the car sings very very very slowly .	the car is very very very slowly .
the glass waves really really really quietly .	the glass was really really really quietly .
the crayon cries really really really quickly .	the crayon is really really really quickly .
the bed paints really really really perfectly .	the bed is really really really perfectly .
the plate waves really really really perfectly .	the plate is really really really perfectly .
the cup reads really really really carefully .	the cup is really really really carefully .
the car sings really really really perfectly .	the car was really really really perfectly .
the shirt reads really really really slowly .	the shirt is really really really slowly .
the plane reads very very very slowly .	the plane is very very very slowly .
the book talks very very very quickly .	the book was very very very quickly .
the couch sings really really really carefully .	the couch was really really really carefully .
the fork reads very very very carefully .	the fork is very very very carefully .
the doll cries very very very quietly .	the doll was very very very quietly .
the cup reads really really really carefully .	the cup was really really really carefully .
the candle cries very very very carefully .	the candle was very very very carefully .
the hat waves really really really carefully .	the hat is really really really carefully .
the cup waves very very very perfectly .	the cup is very very very perfectly .
the book exercises really really really carefully .	the book was really really really carefully .
the chair exercises very very very perfectly .	the chair is very very very perfectly .
the glass talks really really really quietly .	the glass is really really really quietly .
the boat cries really really really slowly .	the boat was really really really slowly .
the box exercises very very very quietly .	the box is very very very quietly .
the window talks really really really quickly .	the window was really really really quickly .
the boat sings really really really carefully .	the boat was really really really carefully .
the plane paints really really really perfectly .	the plane was really really really perfectly .
the cup cries very very very carefully .	the cup is very very very carefully .
the bag talks really really really quickly .	the bag was really really really quickly .
the rug reads really really really slowly .	the rug is really really really slowly .
the bed paints really really really quietly .	the bed was really really really quietly .
the rocket sings really really really perfectly .	the rocket was really really really perfectly .
the mirror paints really really really perfectly .	the mirror is really really really perfectly .
the button waves very very very quietly .	the button was very very very quietly .
the doll cries really really really quickly .	the doll is really really really quickly .
the window reads really really really perfectly .	the window was really really really perfectly .
the car exercises very very very perfectly .	the car was very very very perfectly .
the car waves very very very quickly .	the car is very very very quickly .
the chair talks really really really slowly .	the chair is really really really slowly .
the ship reads really really really carefully .	the ship was really really really carefully .
the boat waves very very very carefully .	the boat was very very very carefully .
the box exercises very very very carefully .	the box was very very very carefully .
the bottle paints very very very quietly .	the bottle was very very very quietly .
the book cries really really really perfectly .	the book is really really really perfectly .
the book exercises really really really perfectly .	the book is really really really perfectly .
the door reads very very very carefully .	the door is very very very carefully .
the toy reads very very very quickly .	the toy was very very very quickly .
the toy reads very very very quietly .	the toy is very very very quietly .
the car cries really really really quietly .	the car is really really really quietly .
the shoe reads really really really perfectly .	the shoe is really really really perfectly .
the chair talks really really really perfectly .	the chair is really really really perfectly .
the shoe reads really really really slowly .	the shoe is really really really slowly .
the picture waves really really really quickly .	the picture is really really really quickly .
the bowl cries very very very carefully .	the bowl was very very very carefully .
the chair waves really really really perfectly .	the chair is really really really perfectly .
the couch exercises very very very carefully .	the couch was very very very carefully .
the ring reads very very very carefully .	the ring was very very very carefully .
the bicycle cries very very very quickly .	the bicycle was very very very quickly .
the spoon exercises really really really quietly .	the spoon was really really really quietly .
the ship cries very very very quickly .	the ship is very very very quickly .
the rocket waves really really really slowly .	the rocket was really really really slowly .
the bicycle waves very very very quietly .	the bicycle was very very very quietly .
the hat sings really really really quietly .	the hat is really really really quietly .
the shoe paints very very very slowly .	the shoe was very very very slowly .
the button talks really really really quietly .	the button was really really really quietly .
the rocket waves very very very perfectly .	the rocket was very very very perfectly .
the candle sings very very very quickly .	the candle is very very very quickly .
the bag exercises really really really perfectly .	the bag was really really really perfectly .
the boat paints really really really quickly .	the boat was really really really quickly .
the truck sings very very very quickly .	the truck is very very very quickly .
the bicycle paints very very very slowly .	the bicycle was very very very slowly .
the bicycle exercises really really really slowly .	the bicycle is really really really slowly .
the hat exercises very very very carefully .	the hat was very very very carefully .
the bowl talks really really really carefully .	the bowl was really really really carefully .
the cup cries really really really quietly .	the cup was really really really quietly .
the cup exercises really really really carefully .	the cup is really really really carefully .
the rug cries very very very quietly .	the rug was very very very quietly .
the hat sings very very very quickly .	the hat is very very very quickly .
the ship cries really really really carefully .	the ship is really really really carefully .
the candle waves very very very quietly .	the candle was very very very quietly .
the mirror waves really really really carefully .	the mirror is really really really carefully .
the button cries very very very quietly .	the button was very very very quietly .
the couch cries very very very carefully .	the couch was very very very carefully .
the mirror waves really really really perfectly .	the mirror is really really really perfectly .
the bicycle cries really really really perfectly .	the bicycle was really really really perfectly .
the car talks really really really slowly .	the car is really really really slowly .
the mirror reads really really really quietly .	the mirror is really really really quietly .
the bag exercises very very very quietly .	the bag is very very very quietly .
the car waves very very very quietly .	the car is very very very quietly .
the chair paints very very very slowly .	the chair was very very very slowly .
the rocket talks really really really quickly .	the rocket was really really really quickly .
the bowl talks really really really perfectly .	the bowl was really really really perfectly .
the book reads very very very quickly .	the book was very very very quickly .
the hat paints very very very perfectly .	the hat is very very very perfectly .
the ship sings really really really carefully .	the ship was really really really carefully .
the doll exercises really really really perfectly .	the doll was really really really perfectly .
the cup paints very very very quickly .	the cup is very very very quickly .
the glass talks really really really slowly .	the glass was really really really slowly .
the plane sings very very very quietly .	the plane was very very very quietly .
the box reads very very very quickly .	the box was very very very quickly .
the ship reads really really really quickly .	the ship is really really really quickly .
the crayon cries really really really quietly .	the crayon was really really really quietly .
the shirt talks really really really slowly .	the shirt was really really really slowly .
the shirt sings really really really quietly .	the shirt was really really really quietly .
the glass waves really really really carefully .	the glass was really really really carefully .
the bed exercises really really really perfectly .	the bed is really really really perfectly .
the book sings very very very perfectly .	the book was very very very perfectly .
the plane exercises really really really slowly .	the plane was really really really slowly .
the rocket sings really really really quickly .	the rocket is really really really quickly .
the mirror paints really really really carefully .	the mirror was really really really carefully .
the car sings very very very quickly .	the car was very very very quickly .
the crayon reads really really really quickly .	the crayon is really really really quickly .
the glass talks very very very slowly .	the glass was very very very slowly .
the button reads very very very quietly .	the button was very very very quietly .
the shoe sings really really really slowly .	the shoe is really really really slowly .
the mirror reads very very very carefully .	the mirror was very very very carefully .
the book exercises really really really perfectly .	the book was really really really perfectly .
the dish cries really really really quietly .	the dish was really really really quietly .
the mirror waves really really really slowly .	the mirror was really really really slowly .
the bed sings very very very carefully .	the bed is very very very carefully .
the candle reads very very very quietly .	the candle was very very very quietly .
the ring exercises really really really carefully .	the ring is really really really carefully .
the couch talks really really really quietly .	the couch is really really really quietly .
the bottle exercises really really really slowly .	the bottle is really really really slowly .
the spoon exercises really really really perfectly .	the spoon was really really really perfectly .
the dish reads really really really quietly .	the dish was really really really quietly .
the bicycle sings very very very quietly .	the bicycle is very very very quietly .
the ship paints very very very quietly .	the ship was very very very quietly .
the bottle sings really really really carefully .	the bottle was really really really carefully .
the plane reads really really really carefully .	the plane is really really really carefully .
the chair sings very very very slowly .	the chair was very very very slowly .
the door exercises really really really quickly .	the door is really really really quickly .
the cup talks really really really perfectly .	the cup was really really really perfectly .
the shirt exercises really really really quietly .	the shirt is really really really quietly .
the chair talks really really really carefully .	the chair is really really really carefully .
the book cries really really really perfectly .	the book was really really really perfectly .
the candle sings really really really slowly .	the candle was really really really slowly .
the book cries very very very slowly .	the book was very very very slowly .
the rug exercises very very very carefully .	the rug is very very very carefully .
the book sings very very very quietly .	the book is very very very quietly .
the rocket paints very very very perfectly .	the rocket is very very very perfectly .
the door talks really really really quickly .	the door is really really really quickly .
the bicycle reads really really really carefully .	the bicycle is really really really carefully .
the car paints very very very slowly .	the car is very very very slowly .
the bowl exercises very very very slowly .	the bowl was very very very slowly .
the mirror paints really really really slowly .	the mirror is really really really slowly .
the dish talks really really really slowly .	the dish is really really really slowly .
the ship cries really really really perfectly .	the ship was really really really perfectly .
the truck cries really really really slowly .	the truck was really really really slowly .
the glass paints really really really slowly .	the glass is really really really slowly .
the boat cries really really really slowly .	the boat is really really really slowly .
the picture waves really really really quietly .	the picture was really really really quietly .
the box cries really really really slowly .	the box is really really really slowly .
the box reads really really really quickly .	the box is really really really quickly .
the bicycle cries really really really carefully .	the bicycle was really really really carefully .
the bowl reads really really really quietly .	the bowl was really really really quietly .
the bed waves very very very quietly .	the bed was very very very quietly .
the picture paints very very very slowly .	the picture is very very very slowly .
the car paints really really really carefully .	the car is really really really carefully .
the rocket reads really really really slowly .	the rocket is really really really slowly .
the chair reads really really really carefully .	the chair was really really really carefully .
the toy cries really really really perfectly .	the toy is really really really perfectly .
the picture talks really really really quickly .	the picture is really really really quickly .
the bottle reads very very very perfectly .	the bottle was very very very perfectly .
the car sings really really really quickly .	the car is really really really quickly .
the plate reads really really really quietly .	the plate is really really really quietly .
the boat waves very very very perfectly .	the boat is very very very perfectly .
the candle paints very very very quietly .	the candle was very very very quietly .
the bed paints really really really quietly .	the bed is really really really quietly .
the mirror exercises very very very slowly .	the mirror was very very very slowly .
the mirror talks really really really perfectly .	the mirror is really really really perfectly .
the shirt waves really really really slowly .	the shirt is really really really slowly .
the truck cries very very very quickly .	the truck was very very very quickly .
the bowl waves really really really carefully .	the bowl is really really really carefully .
the candle talks very very very quietly .	the candle was very very very quietly .
the crayon waves very very very perfectly .	the crayon was very very very perfectly .
the dish talks really really really quickly .	the dish is really really really quickly .
the window waves really really really slowly .	the window was really really really slowly .
the book cries really really really carefully .	the book was really really really carefully .
the candle sings really really really quickly .	the candle was really really really quickly .
the candle waves really really really carefully .	the candle was really really really carefully .
the boat sings very very very quietly .	the boat is very very very quietly .
the fork reads very very very quickly .	the fork was very very very quickly .
the dish waves very very very slowly .	the dish was very very very slowly .
the toy cries really really really carefully .	the toy is really really really carefully .
the rocket sings really really really perfectly .	the rocket is really really really perfectly .
the candle paints really really really slowly .	the candle was really really really slowly .
the rug cries really really really carefully .	the rug was really really really carefully .
the door paints really really really quickly .	the door was really really really quickly .
the fork paints really really really quickly .	the fork was really really really quickly .
the button waves very very very perfectly .	the button is very very very perfectly .
the plate waves very very very quickly .	the plate was very very very quickly .
the book exercises very very very perfectly .	the book was very very very perfectly .
the ring talks very very very slowly .	the ring is very very very slowly .
the button cries very very very carefully .	the button is very very very carefully .
the rug cries very very very quickly .	the rug was very very very quickly .
the bowl paints very very very perfectly .	the bowl was very very very perfectly .
the plate paints really really really quietly .	the plate is really really really quietly .
the door waves really really really carefully .	the door is really really really carefully .
the spoon talks really really really quietly .	the spoon is really really really quietly .
the couch reads very very very slowly .	the couch is very very very slowly .
the bottle sings very very very quickly .	the bottle is very very very quickly .
the bottle sings very very very perfectly .	the bottle was very very very perfectly .
the bag reads very very very slowly .	the bag was very very very slowly .
the picture waves very very very carefully .	the picture is very very very carefully .
the button sings really really really quietly .	the button was really really really quietly .
the bottle sings really really really carefully .	the bottle is really really really carefully .
the toy exercises very very very quietly .	the toy is very very very quietly .
the boat talks very very very perfectly .	the boat is very very very perfectly .
the button waves really really really perfectly .	the button is really really really perfectly .
the doll reads really really really carefully .	the doll was really really really carefully .
the shirt waves very very very slowly .	the shirt is very very very slowly .
the crayon exercises really really really slowly .	the crayon is really really really slowly .
the picture exercises very very very perfectly .	the picture is very very very perfectly .
the plane exercises really really really quickly .	the plane is really really really quickly .
the bicycle reads very very very perfectly .	the bicycle was very very very perfectly .
the shoe cries really really really carefully .	the shoe was really really really carefully .
the hat exercises really really really carefully .	the hat was really really really carefully .
the dish exercises really really really quietly .	the dish is really really really quietly .
the bicycle exercises really really really carefully .	the bicycle is really really really carefully .
the bag reads very very very perfectly .	the bag is very very very perfectly .
the truck sings really really really quietly .	the truck is really really really quietly .
the toy talks really really really quietly .	the toy was really really really quietly .
the car sings very very very slowly .	the car was very very very slowly .
the bed reads really really really slowly .	the bed is really really really slowly .
the glass paints very very very quietly .	the glass is very very very quietly .
the fork sings really really really quietly .	the fork was really really really quietly .
the car exercises really really really quickly .	the car is really really really quickly .
the shoe exercises really really really carefully .	the shoe is really really really carefully .
the boat sings really really really quickly .	the boat was really really really quickly .
the bowl talks very very very quietly .	the bowl is very very very quietly .
the doll paints really really really slowly .	the doll is really really really slowly .
the mirror exercises very very very quickly .	the mirror was very very very quickly .
the candle waves very very very perfectly .	the candle was very very very perfectly .
the doll sings really really really carefully .	the doll was really really really carefully .
the boat cries really really really carefully .	the boat is really really really carefully .
the book paints very very very perfectly .	the book is very very very perfectly .
the spoon sings very very very quietly .	the spoon is very very very quietly .
the ring cries really really really carefully .	the ring is really really really carefully .
the candle sings really really really slowly .	the candle is really really really slowly .
the cup exercises really really really quietly .	the cup was really really really quietly .
the hat sings very very very quietly .	the hat is very very very quietly .
the shoe sings very very very slowly .	the shoe is very very very slowly .
the cup paints really really really perfectly .	the cup was really really really perfectly .
the book reads really really really carefully .	the book is really really really carefully .
the shoe reads really really really quietly .	the shoe is really really really quietly .
the button exercises very very very slowly .	the button was very very very slowly .
the toy talks really really really slowly .	the toy is really really really slowly .
the chair talks very very very carefully .	the chair is very very very carefully .
the boat reads really really really quickly .	the boat is really really really quickly .
the bowl waves really really really carefully .	the bowl was really really really carefully .
the car talks really really really carefully .	the car was really really really carefully .
the bottle talks very very very quietly .	the bottle was very very very quietly .
the plate paints very very very perfectly .	the plate was very very very perfectly .
the bag reads really really really perfectly .	the bag is really really really perfectly .
the cup waves really really really quietly .	the cup was really really really quietly .
the book reads very very very slowly .	the book was very very very slowly .
the bottle waves very very very perfectly .	the bottle was very very very perfectly .
the spoon reads really really really quickly .	the spoon is really really really quickly .
the couch paints very very very carefully .	the couch is very very very carefully .
the plane cries really really really quickly .	the plane is really really really quickly .
the boat waves very very very slowly .	the boat was very very very slowly .
the car sings really really really quietly .	the car was really really really quietly .
the shoe paints very very very quickly .	the shoe was very very very quickly .
the doll paints very very very slowly .	the doll is very very very slowly .
the shirt exercises very very very quietly .	the shirt is very very very quietly .
the hat cries very very very quickly .	the hat is very very very quickly .
the book waves really really really carefully .	the book was really really really carefully .
the box reads really really really quickly .	the box was really really really quickly .
the glass reads really really really quietly .	the glass is really really really quietly .
the button waves really really really quickly .	the button is really really really quickly .
the bag talks very very very perfectly .	the bag is very very very perfectly .
the car waves really really really quickly .	the car was really really really quickly .
the window cries really really really quickly .	the window was really really really quickly .
the bag reads really really really perfectly .	the bag was really really really perfectly .
the candle waves really really really slowly .	the candle is really really really slowly .
the bicycle exercises really really really quietly .	the bicycle is really really really quietly .
the chair talks very very very perfectly .	the chair was very very very perfectly .
the book talks very very very perfectly .	the book is very very very perfectly .
the dish waves very very very quickly .	the dish is very very very quickly .
the bed paints very very very quietly .	the bed is very very very quietly .
the chair paints really really really quietly .	the chair is really really really quietly .
the button reads very very very quickly .	the button was very very very quickly .
the couch exercises really really really quickly .	the couch was really really really quickly .
the shirt talks really really really perfectly .	the shirt is really really really perfectly .
the hat paints very very very slowly .	the hat was very very very slowly .
the ring waves very very very carefully .	the ring was very very very carefully .
the couch exercises very very very slowly .	the couch is very very very slowly .
the car waves very very very slowly .	the car was very very very slowly .
the book sings really really really quietly .	the book is really really really quietly .
the boat exercises very very very perfectly .	the boat is very very very perfectly .
the bottle exercises very very very quietly .	the bottle was very very very quietly .
the ring cries really really really perfectly .	the ring is really really really perfectly .
the couch paints really really really quickly .	the couch is really really really quickly .
the shirt cries very very very quietly .	the shirt is very very very quietly .
the rocket reads really really really quickly .	the rocket is really really really quickly .
the rug talks really really really quietly .	the rug was really really really quietly .
the truck talks really really really quickly .	the truck was really really really quickly .
the boat cries very very very slowly .	the boat is very very very slowly .
the doll talks very very very perfectly .	the doll was very very very perfectly .
the shirt talks very very very carefully .	the shirt is very very very carefully .
the doll cries really really really perfectly .	the doll was really really really perfectly .
the fork talks very very very perfectly .	the fork is very very very perfectly .
the cup cries really really really quickly .	the cup is really really really quickly .
the book sings very very very quietly .	the book was very very very quietly .
the box sings very very very slowly .	the box is very very very slowly .
the truck cries very very very carefully .	the truck was very very very carefully .
the bowl talks really really really quietly .	the bowl was really really really quietly .
the bag talks really really really slowly .	the bag was really really really slowly .
the bag sings really really really carefully .	the bag is really really really carefully .
the box paints really really really carefully .	the box is really really really carefully .
the cup reads really really really perfectly .	the cup is really really really perfectly .
the dish exercises really really really quickly .	the dish was really really really quickly .
the bag paints very very very perfectly .	the bag was very very very perfectly .
the car paints very very very quickly .	the car was very very very quickly .
the bed cries very very very quickly .	the bed is very very very quickly .
the box cries very very very slowly .	the box is very very very slowly .
the ring sings very very very quietly .	the ring was very very very quietly .
the chair reads very very very carefully .	the chair is very very very carefully .
the crayon reads very very very carefully .	the crayon was very very very carefully .
the car paints very very very quietly .	the car is very very very quietly .
the ring talks really really really carefully .	the ring is really really really carefully .
the plate exercises very very very perfectly .	the plate is very very very perfectly .
the ship sings really really really quietly .	the ship was really really really quietly .
the shirt paints very very very slowly .	the shirt is very very very slowly .
the door exercises very very very quietly .	the door was very very very quietly .
the bowl talks really really really quickly .	the bowl was really really really quickly .
the ship reads really really really quickly .	the ship was really really really quickly .
the mirror waves very very very perfectly .	the mirror was very very very perfectly .
the chair sings very very very quietly .	the chair is very very very quietly .
the ring waves very very very slowly .	the ring was very very very slowly .
the spoon exercises really really really quickly .	the spoon is really really really quickly .
the cup waves very very very perfectly .	the cup was very very very perfectly .
the candle paints really really really quietly .	the candle was really really really quietly .
the glass reads really really really slowly .	the glass is really really really slowly .
the spoon exercises very very very carefully .	the spoon is very very very carefully .
the toy paints really really really carefully .	the toy is really really really carefully .
the mirror cries very very very quickly .	the mirror is very very very quickly .
the car reads very very very quickly .	the car was very very very quickly .
the box reads very very very slowly .	the box is very very very slowly .
the hat paints very very very carefully .	the hat is very very very carefully .
the book talks really really really quietly .	the book is really really really quietly .
the doll sings really really really carefully .	the doll is really really really carefully .
the hat exercises really really really carefully .	the hat is really really really carefully .
the chair cries really really really carefully .	the chair was really really really carefully .
the rug cries very very very carefully .	the rug was very very very carefully .
the bag exercises very very very slowly .	the bag is very very very slowly .
the spoon cries really really really carefully .	the spoon is really really really carefully .
the spoon sings really really really carefully .	the spoon was really really really carefully .
the bottle cries really really really slowly .	the bottle is really really really slowly .
the picture waves very very very quietly .	the picture is very very very quietly .
the spoon cries very very very quietly .	the spoon is very very very quietly .
the ship paints really really really slowly .	the ship is really really really slowly .
the door waves really really really slowly .	the door is really really really slowly .
the boat sings very very very perfectly .	the boat is very very very perfectly .
the car reads really really really quickly .	the car was really really really quickly .
the mirror exercises very very very carefully .	the mirror is very very very carefully .
the door waves very very very quietly .	the door was very very very quietly .
the doll sings very very very quietly .	the doll is very very very quietly .
the toy sings really really really slowly .	the toy is really really really slowly .
the rocket paints really really really carefully .	the rocket was really really really carefully .
the mirror talks really really really quickly .	the mirror was really really really quickly .
the mirror exercises really really really quietly .	the mirror was really really really quietly .
the hat sings very very very quickly .	the hat was very very very quickly .
the boat sings really really really perfectly .	the boat is really really really perfectly .
the button cries really really really carefully .	the button was really really really carefully .
the box exercises very very very quickly .	the box is very very very quickly .
the bed talks really really really quickly .	the bed was really really really quickly .
the doll exercises very very very carefully .	the doll is very very very carefully .
the boat paints very very very perfectly .	the boat is very very very perfectly .
the plane reads very very very carefully .	the plane was very very very carefully .
the car waves very very very quickly .	the car was very very very quickly .
the mirror talks very very very perfectly .	the mirror is very very very perfectly .
the mirror exercises very very very quietly .	the mirror was very very very quietly .
the bowl talks very very very quietly .	the bowl was very very very quietly .
the book exercises very very very quickly .	the book was very very very quickly .
the window waves very very very perfectly .	the window was very very very perfectly .
the ring cries very very very quietly .	the ring is very very very quietly .
the door reads very very very quietly .	the door was very very very quietly .
the bicycle exercises very very very quickly .	the bicycle was very very very quickly .
the car talks really really really quickly .	the car is really really really quickly .
the couch exercises really really really perfectly .	the couch was really really really perfectly .
the doll reads really really really slowly .	the doll was really really really slowly .
the button reads really really really slowly .	the button is really really really slowly .
the spoon talks really really really perfectly .	the spoon is really really really perfectly .
the button reads really really really quickly .	the button was really really really quickly .
the book sings very very very quickly .	the book was very very very quickly .
the hat reads really really really perfectly .	the hat was really really really perfectly .
the rug talks really really really carefully .	the rug was really really really carefully .
the book talks really really really quickly .	the book was really really really quickly .
the picture waves really really really slowly .	the picture was really really really slowly .
the hat reads really really really quickly .	the hat was really really really quickly .
the truck exercises really really really slowly .	the truck was really really really slowly .
the spoon sings really really really carefully .	the spoon is really really really carefully .
the shirt waves very very very quietly .	the shirt is very very very quietly .
the fork sings very very very perfectly .	the fork was very very very perfectly .
the boat talks very very very perfectly .	the boat was very very very perfectly .
the mirror paints really really really perfectly .	the mirror was really really really perfectly .
the bed sings really really really perfectly .	the bed was really really really perfectly .
the doll talks really really really slowly .	the doll was really really really slowly .
the mirror exercises really really really carefully .	the mirror is really really really carefully .
the bowl exercises really really really perfectly .	the bowl is really really really perfectly .
the window talks really really really slowly .	the window was really really really slowly .
the shirt paints very very very carefully .	the shirt was very very very carefully .
the couch exercises very very very quietly .	the couch was very very very quietly .
the chair talks very very very perfectly .	the chair is very very very perfectly .
the dish sings really really really quietly .	the dish was really really really quietly .
the bottle sings really really really slowly .	the bottle was really really really slowly .
the ring cries really really really perfectly .	the ring was really really really perfectly .
the rocket reads really really really quietly .	the rocket is really really really quietly .
the toy reads very very very quickly .	the toy is very very very quickly .
the plate exercises very very very slowly .	the plate is very very very slowly .
the rug paints really really really quickly .	the rug is really really really quickly .
the door talks very very very quietly .	the door is very very very quietly .
the dish exercises very very very carefully .	the dish was very very very carefully .
the mirror talks very very very quietly .	the mirror is very very very quietly .
the button exercises very very very carefully .	the button is very very very carefully .
the ring cries really really really carefully .	the ring was really really really carefully .
the button reads really really really quietly .	the button was really really really quietly .
the box sings really really really perfectly .	the box was really really really perfectly .
the mirror sings really really really carefully .	the mirror is really really really carefully .
the chair talks very very very quietly .	the chair is very very very quietly .
the bicycle cries very very very slowly .	the bicycle was very very very slowly .
the car reads very very very carefully .	the car was very very very carefully .
the doll reads really really really quietly .	the doll was really really really quietly .
the rug exercises very very very perfectly .	the rug is very very very perfectly .
the button reads really really really perfectly .	the button was really really really perfectly .
the box cries really really really carefully .	the box was really really really carefully .
the book sings very very very carefully .	the book was very very very carefully .
the bed paints very very very perfectly .	the bed is very very very perfectly .
the hat waves very very very carefully .	the hat is very very very carefully .
the ship waves really really really carefully .	the ship was really really really carefully .
the bag waves really really really slowly .	the bag is really really really slowly .
the couch paints very very very quickly .	the couch is very very very quickly .
the toy reads very very very quietly .	the toy was very very very quietly .
the cup talks really really really perfectly .	the cup is really really really perfectly .
the doll paints really really really slowly .	the doll was really really really slowly .
the car reads very very very quickly .	the car is very very very quickly .
the spoon cries really really really quickly .	the spoon is really really really quickly .
the ship cries really really really quickly .	the ship is really really really quickly .
the bed exercises really really really slowly .	the bed is really really really slowly .
the crayon paints very very very slowly .	the crayon was very very very slowly .
the candle reads very very very carefully .	the candle is very very very carefully .
the hat paints really really really quietly .	the hat is really really really quietly .
the bed talks really really really perfectly .	the bed is really really really perfectly .
the hat sings really really really carefully .	the hat was really really really carefully .
the box paints very very very carefully .	the box was very very very carefully .
the doll cries really really really quietly .	the doll is really really really quietly .
the bowl exercises really really really slowly .	the bowl is really really really slowly .
the button waves very very very quickly .	the button was very very very quickly .
the shoe sings really really really perfectly .	the shoe was really really really perfectly .
the picture exercises really really really perfectly .	the picture is really really really perfectly .
the mirror cries very very very quietly .	the mirror is very very very quietly .
the car waves really really really carefully .	the car is really really really carefully .
the mirror exercises really really really carefully .	the mirror was really really really carefully .
the book paints really really really quietly .	the book was really really really quietly .
the picture cries very very very slowly .	the picture is very very very slowly .
the shoe sings very very very carefully .	the shoe is very very very carefully .
the door sings really really really quickly .	the door was really really really quickly .
the chair reads very very very perfectly .	the chair was very very very perfectly .
the shoe talks really really really perfectly .	the shoe was really really really perfectly .
the cup reads really really really quickly .	the cup was really really really quickly .
the bed sings very very very slowly .	the bed is very very very slowly .
the mirror sings really really really quietly .	the mirror is really really really quietly .
the plane sings really really really perfectly .	the plane is really really really perfectly .
the bowl reads very very very perfectly .	the bowl is very very very perfectly .
the car sings very very very quickly .	the car is very very very quickly .
the spoon talks very very very perfectly .	the spoon was very very very perfectly .
the crayon exercises really really really quietly .	the crayon was really really really quietly .
the rocket exercises very very very perfectly .	the rocket is very very very perfectly .
the truck cries really really really carefully .	the truck was really really really carefully .
the candle exercises very very very slowly .	the candle is very very very slowly .
the glass talks very very very slowly .	the glass is very very very slowly .
the boat sings very very very slowly .	the boat was very very very slowly .
the bed waves really really really carefully .	the bed is really really really carefully .
the ring sings very very very slowly .	the ring was very very very slowly .
the ship waves very very very quietly .	the ship was very very very quietly .
the truck waves really really really slowly .	the truck was really really really slowly .
the bottle exercises very very very carefully .	the bottle was very very very carefully .
the glass sings really really really carefully .	the glass was really really really carefully .
the box reads very very very quickly .	the box is very very very quickly .
the cup reads very very very quickly .	the cup was very very very quickly .
the crayon cries really really really slowly .	the crayon is really really really slowly .
the ship paints really really really quietly .	the ship is really really really quietly .
the book waves very very very perfectly .	the book is very very very perfectly .
the crayon reads really really really carefully .	the crayon was really really really carefully .
the couch waves really really really quietly .	the couch was really really really quietly .
the fork cries really really really quietly .	the fork was really really really quietly .
the boat exercises really really really quietly .	the boat was really really really quietly .
the rocket cries very very very carefully .	the rocket was very very very carefully .
the picture sings very very very slowly .	the picture is very very very slowly .
the button talks really really really quickly .	the button was really really really quickly .
the toy cries very very very perfectly .	the toy was very very very perfectly .
the couch waves very very very slowly .	the couch was very very very slowly .
the chair cries very very very perfectly .	the chair is very very very perfectly .
the box paints really really really perfectly .	the box was really really really perfectly .
the bed exercises very very very quietly .	the bed is very very very quietly .
the glass sings very very very perfectly .	the glass is very very very perfectly .
the doll cries really really really quickly .	the doll was really really really quickly .
the mirror exercises really really really slowly .	the mirror is really really really slowly .
the glass waves very very very quietly .	the glass is very very very quietly .
the candle talks really really really perfectly .	the candle is really really really perfectly .
the rug paints very very very carefully .	the rug was very very very carefully .
the fork sings very very very quietly .	the fork is very very very quietly .
the bag cries very very very carefully .	the bag is very very very carefully .
the ring waves very very very perfectly .	the ring is very very very perfectly .
the cup sings very very very quietly .	the cup was very very very quietly .
the boat talks very very very quietly .	the boat was very very very quietly .
the window cries very very very quickly .	the window is very very very quickly .
the car exercises very very very perfectly .	the car is very very very perfectly .
the bottle cries very very very quietly .	the bottle was very very very quietly .
the car talks very very very perfectly .	the car was very very very perfectly .
the bag reads really really really quietly .	the bag is really really really quietly .
the rug sings really really really carefully .	the rug is really really really carefully .
the bicycle paints really really really perfectly .	the bicycle is really really really perfectly .
the plate talks really really really quickly .	the plate is really really really quickly .
the fork exercises very very very slowly .	the fork is very very very slowly .
the spoon reads really really really quietly .	the spoon was really really really quietly .
the dish reads really really really quietly .	the dish is really really really quietly .
the bowl cries really really really carefully .	the bowl was really really really carefully .
the rocket waves really really really quickly .	the rocket was really really really quickly .
the box sings very very very quietly .	the box was very very very quietly .
the boat reads very very very slowly .	the boat is very very very slowly .
the book reads very very very quietly .	the book is very very very quietly .
the car sings really really really carefully .	the car was really really really carefully .
the bowl sings very very very slowly .	the bowl is very very very slowly .
the button cries really really really quietly .	the button was really really really quietly .
the picture paints very very very quietly .	the picture is very very very quietly .
the book cries really really really carefully .	the book is really really really carefully .
the door reads really really really quickly .	the door was really really really quickly .
the ring reads really really really carefully .	the ring is really really really carefully .
the bottle sings really really really quietly .	the bottle was really really really quietly .
the plate reads very very very perfectly .	the plate was very very very perfectly .
the book paints very very very perfectly .	the book was very very very perfectly .
the chair cries very very very quietly .	the chair is very very very quietly .
the bed cries very very very quietly .	the bed is very very very quietly .
the bicycle sings very very very carefully .	the bicycle is very very very carefully .
the book waves very very very carefully .	the book is very very very carefully .
the box sings really really really quietly .	the box is really really really quietly .
the doll reads really really really carefully .	the doll is really really really carefully .
the toy cries really really really quietly .	the toy is really really really quietly .
the ring paints very very very quickly .	the ring is very very very quickly .
the bottle cries very very very slowly .	the bottle was very very very slowly .
the bag waves very very very carefully .	the bag is very very very carefully .
the window cries really really really quietly .	the window is really really really quietly .
the couch cries really really really quietly .	the couch was really really really quietly .
the ship cries really really really carefully .	the ship was really really really carefully .
the crayon waves very very very carefully .	the crayon was very very very carefully .
the fork reads very very very carefully .	the fork was very very very carefully .
the spoon cries very very very slowly .	the spoon was very very very slowly .
the doll waves really really really slowly .	the doll was really really really slowly .
the cup sings really really really carefully .	the cup is really really really carefully .
the fork exercises really really really carefully .	the fork is really really really carefully .
the bottle sings really really really quickly .	the bottle is really really really quickly .
the bag exercises very very very quietly .	the bag was very very very quietly .
the car waves really really really perfectly .	the car is really really really perfectly .
the rocket sings very very very quietly .	the rocket is very very very quietly .
the mirror reads really really really slowly .	the mirror was really really really slowly .
the car cries really really really quietly .	the car was really really really quietly .
the bowl waves really really really perfectly .	the bowl is really really really perfectly .
the shirt sings really really really carefully .	the shirt was really really really carefully .
the couch paints really really really slowly .	the couch is really really really slowly .
the couch reads very very very perfectly .	the couch is very very very perfectly .
the plane exercises very very very slowly .	the plane is very very very slowly .
the car reads really really really quickly .	the car is really really really quickly .
the spoon paints really really really quickly .	the spoon is really really really quickly .
the door waves really really really perfectly .	the door is really really really perfectly .
the door waves really really really slowly .	the door was really really really slowly .
the cup exercises very very very perfectly .	the cup was very very very perfectly .
the truck reads very very very carefully .	the truck is very very very carefully .
the toy paints really really really slowly .	the toy is really really really slowly .
the hat sings really really really slowly .	the hat is really really really slowly .
the spoon paints really really really quietly .	the spoon is really really really quietly .
the shoe sings really really really quietly .	the shoe is really really really quietly .
the toy sings very very very carefully .	the toy is very very very carefully .
the bed talks very very very quietly .	the bed was very very very quietly .
the bowl talks really really really quickly .	the bowl is really really really quickly .
the shirt cries really really really carefully .	the shirt was really really really carefully .
the dish cries very very very quickly .	the dish is very very very quickly .
the book talks very very very perfectly .	the book was very very very perfectly .
the ring cries really really really slowly .	the ring is really really really slowly .
the cup exercises very very very quietly .	the cup is very very very quietly .
the plate paints really really really carefully .	the plate was really really really carefully .
the box cries very very very quietly .	the box was very very very quietly .
the bed reads really really really quietly .	the bed was really really really quietly .
the dish waves really really really quickly .	the dish was really really really quickly .
the fork reads really really really slowly .	the fork was really really really slowly .
the bowl paints very very very slowly .	the bowl was very very very slowly .
the window paints very very very perfectly .	the window was very very very perfectly .
the bed sings very very very quickly .	the bed was very very very quickly .
the toy exercises really really really perfectly .	the toy is really really really perfectly .
the book exercises very very very perfectly .	the book is very very very perfectly .
the rocket reads very very very quietly .	the rocket is very very very quietly .
the fork waves very very very quietly .	the fork is very very very quietly .
the bed reads really really really perfectly .	the bed was really really really perfectly .
the cup talks very very very perfectly .	the cup was very very very perfectly .
the car exercises really really really slowly .	the car is really really really slowly .
the shoe paints very very very slowly .	the shoe is very very very slowly .
the chair exercises very very very quietly .	the chair is very very very quietly .
the rocket exercises really really really perfectly .	the rocket was really really really perfectly .
the plate reads really really really slowly .	the plate is really really really slowly .
the bottle paints very very very carefully .	the bottle is very very very carefully .
the book waves really really really slowly .	the book was really really really slowly .
the bag sings very very very perfectly .	the bag was very very very perfectly .
the bowl cries very very very slowly .	the bowl is very very very slowly .
the button reads very very very perfectly .	the button is very very very perfectly .
the rug reads very very very quietly .	the rug is very very very quietly .
the bicycle cries very very very quietly .	the bicycle is very very very quietly .
the bed talks really really really slowly .	the bed is really really really slowly .
the cup cries really really really perfectly .	the cup was really really really perfectly .
the toy paints very very very slowly .	the toy is very very very slowly .
the car paints very very very perfectly .	the car was very very very perfectly .
the book sings really really really carefully .	the book is really really really carefully .
the chair reads really really really quietly .	the chair is really really really quietly .
the glass reads really really really perfectly .	the glass is really really really perfectly .
the hat sings really really really quickly .	the hat was really really really quickly .
the candle exercises very very very slowly .	the candle was very very very slowly .
the spoon talks very very very carefully .	the spoon is very very very carefully .
the cup waves very very very carefully .	the cup was very very very carefully .
the box paints very very very quickly .	the box was very very very quickly .
the mirror waves very very very quietly .	the mirror is very very very quietly .
the book reads really really really carefully .	the book was really really really carefully .
the door waves very very very perfectly .	the door is very very very perfectly .
the bottle exercises very very very carefully .	the bottle is very very very carefully .
the cup talks really really really quietly .	the cup was really really really quietly .
the door exercises really really really quietly .	the door was really really really quietly .
the bed exercises really really really quietly .	the bed is really really really quietly .
the shirt paints very very very quietly .	the shirt is very very very quietly .
the plane talks really really really quickly .	the plane was really really really quickly .
the boat paints really really really perfectly .	the boat is really really really perfectly .
the bicycle talks very very very quietly .	the bicycle is very very very quietly .
the ring cries very very very carefully .	the ring was very very very carefully .
the plane paints very very very carefully .	the plane was very very very carefully .
the plate talks really really really perfectly .	the plate was really really really perfectly .
the car paints really really really slowly .	the car was really really really slowly .
the shoe talks very very very perfectly .	the shoe was very very very perfectly .
the plane cries really really really perfectly .	the plane was really really really perfectly .
the bag reads very very very carefully .	the bag was very very very carefully .
the truck paints very very very quietly .	the truck is very very very quietly .
the shirt paints very very very quickly .	the shirt was very very very quickly .
the candle exercises very very very quietly .	the candle is very very very quietly .
the spoon talks really really really carefully .	the spoon is really really really carefully .
the box paints really really really carefully .	the box was really really really carefully .
the shoe talks really really really quickly .	the shoe is really really really quickly .
the truck cries really really really perfectly .	the truck is really really really perfectly .
the button cries really really really perfectly .	the button is really really really perfectly .
the car talks really really really perfectly .	the car is really really really perfectly .
the window talks very very very quickly .	the window is very very very quickly .
the couch paints really really really quietly .	the couch was really really really quietly .
the rug waves really really really quietly .	the rug was really really really quietly .
the plane paints really really really carefully .	the plane was really really really carefully .
the ring paints very very very slowly .	the ring was very very very slowly .
the bowl talks very very very carefully .	the bowl is very very very carefully .
the dish paints really really really slowly .	the dish is really really really slowly .
the bicycle exercises really really really quickly .	the bicycle was really really really quickly .
the bicycle waves really really really perfectly .	the bicycle is really really really perfectly .
the bowl talks very very very perfectly .	the bowl was very very very perfectly .
the boat waves really really really quickly .	the boat was really really really quickly .
the dish talks really really really perfectly .	the dish is really really really perfectly .
the book sings very very very slowly .	the book was very very very slowly .
the picture reads very very very slowly .	the picture is very very very slowly .
the button paints really really really quietly .	the button was really really really quietly .
the fork waves really really really slowly .	the fork is really really really slowly .
the couch sings really really really perfectly .	the couch is really really really perfectly .
the shoe exercises very very very slowly .	the shoe is very very very slowly .
the toy exercises really really really quickly .	the toy is really really really quickly .
the bottle paints really really really quietly .	the bottle was really really really quietly .
the book reads really really really slowly .	the book was really really really slowly .
the ring sings really really really quickly .	the ring was really really really quickly .
the shirt sings really really really perfectly .	the shirt was really really really perfectly .
the picture paints really really really perfectly .	the picture is really really really perfectly .
the ship reads very very very quietly .	the ship was very very very quietly .
the car paints really really really quickly .	the car was really really really quickly .
the chair exercises really really really slowly .	the chair is really really really slowly .
the dish cries very very very quietly .	the dish is very very very quietly .
the glass waves very very very quickly .	the glass is very very very quickly .
the doll waves very very very quietly .	the doll was very very very quietly .
the plane waves really really really quickly .	the plane was really really really quickly .
the bottle waves really really really slowly .	the bottle was really really really slowly .
the toy sings very very very quietly .	the toy was very very very quietly .
the candle reads really really really quickly .	the candle was really really really quickly .
the bicycle sings really really really perfectly .	the bicycle is really really really perfectly .
the glass cries really really really perfectly .	the glass is really really really perfectly .
the toy exercises really really really slowly .	the toy is really really really slowly .
the box sings really really really perfectly .	the box is really really really perfectly .
the car talks really really really quietly .	the car was really really really quietly .
the rocket cries very very very slowly .	the rocket was very very very slowly .
the door talks really really really quietly .	the door is really really really quietly .
the crayon talks really really really perfectly .	the crayon is really really really perfectly .
the candle reads really really really slowly .	the candle was really really really slowly .
the bottle cries really really really perfectly .	the bottle is really really really perfectly .
the rug reads very very very quickly .	the rug was very very very quickly .
the rug cries really really really quickly .	the rug is really really really quickly .
the couch cries very very very perfectly .	the couch was very very very perfectly .
the couch talks very very very quickly .	the couch is very very very quickly .
the shoe exercises very very very carefully .	the shoe is very very very carefully .
the book cries very very very slowly .	the book is very very very slowly .
the fork sings very very very carefully .	the fork is very very very carefully .
the button exercises really really really slowly .	the button was really really really slowly .
the toy reads really really really carefully .	the toy was really really really carefully .
the book waves really really really quickly .	the book is really really really quickly .
the crayon exercises very very very carefully .	the crayon is very very very carefully .
the boat reads very very very quickly .	the boat was very very very quickly .
the ship sings really really really slowly .	the ship was really really really slowly .
the plate cries very very very slowly .	the plate was very very very slowly .
the candle sings really really really perfectly .	the candle is really really really perfectly .
the spoon talks very very very slowly .	the spoon was very very very slowly .
the bag sings very very very carefully .	the bag is very very very carefully .
the boat exercises very very very carefully .	the boat was very very very carefully .
the ship reads really really really slowly .	the ship was really really really slowly .
the bottle paints really really really perfectly .	the bottle was really really really perfectly .
the rug exercises very very very quietly .	the rug was very very very quietly .
the toy talks very very very carefully .	the toy is very very very carefully .
the boat talks very very very quickly .	the boat is very very very quickly .
the picture exercises really really really carefully .	the picture was really really really carefully .
the spoon reads very very very quietly .	the spoon is very very very quietly .
the window waves really really really perfectly .	the window was really really really perfectly .
the doll cries very very very slowly .	the doll was very very very slowly .
the candle reads really really really quickly .	the candle is really really really quickly .
the spoon waves very very very carefully .	the spoon is very very very carefully .
the rug talks very very very quickly .	the rug is very very very quickly .
the chair sings really really really perfectly .	the chair was really really really perfectly .
the rug waves really really really slowly .	the rug was really really really slowly .
the car talks very very very quickly .	the car is very very very quickly .
the book talks really really really quickly .	the book is really really really quickly .
the plate waves very very very perfectly .	the plate is very very very perfectly .
the plate paints very very very quietly .	the plate was very very very quietly .
the couch sings very very very carefully .	the couch was very very very carefully .
the bowl reads really really really perfectly .	the bowl was really really really perfectly .
the couch paints very very very perfectly .	the couch was very very very perfectly .
the dish cries very very very quietly .	the dish was very very very quietly .
the rug cries very very very slowly .	the rug was very very very slowly .
the button waves very very very perfectly .	the button was very very very perfectly .
the dish talks very very very quickly .	the dish was very very very quickly .
the toy waves really really really slowly .	the toy was really really really slowly .
the button waves really really really slowly .	the button is really really really slowly .
the bag talks very very very slowly .	the bag was very very very slowly .
the dish paints very very very perfectly .	the dish is very very very perfectly .
the truck cries very very very perfectly .	the truck was very very very perfectly .
the cup paints very very very quietly .	the cup was very very very quietly .
the crayon exercises very very very slowly .	the crayon was very very very slowly .
the bicycle cries really really really carefully .	the bicycle is really really really carefully .
the mirror talks really really really slowly .	the mirror is really really really slowly .
the picture talks very very very carefully .	the picture was very very very carefully .
the plane waves really really really slowly .	the plane is really really really slowly .
the rug reads very very very perfectly .	the rug is very very very perfectly .
the ship paints really really really slowly .	the ship was really really really slowly .
the spoon waves very very very perfectly .	the spoon is very very very perfectly .
the ring exercises really really really quietly .	the ring is really really really quietly .
the dish sings really really really quickly .	the dish is really really really quickly .
the plate waves very very very slowly .	the plate is very very very slowly .
the plane cries very very very carefully .	the plane is very very very carefully .
the cup exercises really really really quietly .	the cup is really really really quietly .
the bag cries really really really carefully .	the bag is really really really carefully .
the plane sings very very very quickly .	the plane was very very very quickly .
the book paints very very very slowly .	the book is very very very slowly .
the window cries very very very carefully .	the window was very very very carefully .
the hat talks really really really perfectly .	the hat was really really really perfectly .
the rug talks very very very quickly .	the rug was very very very quickly .
the car cries very very very perfectly .	the car is very very very perfectly .
the car waves very very very quietly .	the car was very very very quietly .
the fork exercises very very very quietly .	the fork is very very very quietly .
the picture cries very very very slowly .	the picture was very very very slowly .
the rug sings very very very carefully .	the rug was very very very carefully .
the box cries very very very carefully .	the box is very very very carefully .
the bed reads really really really perfectly .	the bed is really really really perfectly .
the shoe sings very very very perfectly .	the shoe is very very very perfectly .
the boat reads very very very quietly .	the boat is very very very quietly .
the plate waves really really really quietly .	the plate was really really really quietly .
the bottle talks really really really carefully .	the bottle is really really really carefully .
the bowl sings really really really quickly .	the bowl was really really really quickly .
the shoe paints really really really quietly .	the shoe is really really really quietly .
the car cries really really really quickly .	the car was really really really quickly .
the button sings really really really slowly .	the button is really really really slowly .
the couch talks very very very slowly .	the couch was very very very slowly .
the shirt waves very very very perfectly .	the shirt was very very very perfectly .
the mirror waves really really really slowly .	the mirror is really really really slowly .
the candle exercises really really really carefully .	the candle is really really really carefully .
the couch sings really really really slowly .	the couch is really really really slowly .
the hat cries very very very carefully .	the hat is very very very carefully .
the door waves really really really carefully .	the door was really really really carefully .
the car reads very very very slowly .	the car is very very very slowly .
the bed sings really really really slowly .	the bed was really really really slowly .
the bowl talks really really really slowly .	the bowl was really really really slowly .
the rocket cries very very very quietly .	the rocket was very very very quietly .
the spoon sings very very very perfectly .	the spoon is very very very perfectly .
the shirt waves very very very quietly .	the shirt was very very very quietly .
the toy paints very very very quickly .	the toy was very very very quickly .
the toy reads really really really slowly .	the toy is really really really slowly .
the glass sings really really really quickly .	the glass is really really really quickly .
the glass reads really really really quickly .	the glass was really really really quickly .
the ring reads really really really quietly .	the ring is really really really quietly .
the ship cries very very very slowly .	the ship is very very very slowly .
the book sings very very very quickly .	the book is very very very quickly .
the cup reads really really really perfectly .	the cup was really really really perfectly .
the toy reads really really really perfectly .	the toy is really really really perfectly .
the button waves really really really slowly .	the button was really really really slowly .
the bowl waves very very very carefully .	the bowl was very very very carefully .
the bottle sings very very very quietly .	the bottle is very very very quietly .
the rocket sings really really really slowly .	the rocket is really really really slowly .
the car talks really really really slowly .	the car was really really really slowly .
the bed talks really really really perfectly .	the bed was really really really perfectly .
the dish waves really really really quickly .	the dish is really really really quickly .
the fork talks really really really slowly .	the fork was really really really slowly .
the shirt reads very very very quietly .	the shirt was very very very quietly .
the doll exercises really really really carefully .	the doll was really really really carefully .
the truck paints very very very carefully .	the truck was very very very carefully .
the button paints really really really perfectly .	the button was really really really perfectly .
the book paints really really really quickly .	the book was really really really quickly .
the book reads really really really slowly .	the book is really really really slowly .
the shirt cries very very very quickly .	the shirt is very very very quickly .
the cup exercises very very very quickly .	the cup was very very very quickly .
the ship paints really really really quickly .	the ship was really really really quickly .
the boat cries really really really quickly .	the boat was really really really quickly .
the spoon exercises really really really quietly .	the spoon is really really really quietly .
the door talks very very very quickly .	the door was very very very quickly .
the crayon talks very very very quietly .	the crayon is very very very quietly .
the crayon cries really really really quickly .	the crayon was really really really quickly .
the spoon waves really really really quietly .	the spoon was really really really quietly .
the bottle cries really really really quickly .	the bottle is really really really quickly .
the door waves very very very perfectly .	the door was very very very perfectly .
the box waves very very very perfectly .	the box is very very very perfectly .
the button cries really really really perfectly .	the button was really really really perfectly .
the box cries very very very perfectly .	the box is very very very perfectly .
the dish sings really really really quickly .	the dish was really really really quickly .
the car cries very very very carefully .	the car is very very very carefully .
the box cries very very very quickly .	the box is very very very quickly .
the plane paints very very very perfectly .	the plane was very very very perfectly .
the boat exercises really really really perfectly .	the boat was really really really perfectly .
the mirror paints really really really carefully .	the mirror is really really really carefully .
the dish cries very very very quickly .	the dish was very very very quickly .
the toy talks very very very slowly .	the toy is very very very slowly .
the cup sings really really really quickly .	the cup is really really really quickly .
the bed cries really really really perfectly .	the bed is really really really perfectly .
the candle reads really really really carefully .	the candle is really really really carefully .
the chair sings really really really slowly .	the chair is really really really slowly .
the box talks really really really slowly .	the box was really really really slowly .
the glass waves very very very carefully .	the glass is very very very carefully .
the bed cries very very very carefully .	the bed is very very very carefully .
the button sings very very very quietly .	the button was very very very quietly .
the car cries really really really slowly .	the car is really really really slowly .
the boat cries very very very quickly .	the boat was very very very quickly .
the ring exercises really really really slowly .	the ring was really really really slowly .
the shirt exercises really really really slowly .	the shirt was really really really slowly .
the chair sings really really really perfectly .	the chair is really really really perfectly .
the glass sings really really really perfectly .	the glass is really really really perfectly .
the rocket waves really really really quietly .	the rocket was really really really quietly .
the bottle talks really really really quietly .	the bottle was really really really quietly .
the window paints really really really perfectly .	the window was really really really perfectly .
the boat waves really really really quickly .	the boat is really really really quickly .
the candle exercises really really really quickly .	the candle was really really really quickly .
the window waves really really really carefully .	the window is really really really carefully .
the book cries really really really quietly .	the book is really really really quietly .
the rocket exercises really really really quickly .	the rocket was really really really quickly .
the rocket exercises really really really carefully .	the rocket is really really really carefully .
the dish waves really really really carefully .	the dish was really really really carefully .
the chair paints really really really slowly .	the chair is really really really slowly .
the plane exercises very very very perfectly .	the plane is very very very perfectly .
the truck exercises really really really slowly .	the truck is really really really slowly .
the ship talks really really really slowly .	the ship was really really really slowly .
the shoe waves very very very quietly .	the shoe was very very very quietly .
the glass cries very very very carefully .	the glass is very very very carefully .
the cup talks really really really slowly .	the cup is really really really slowly .
the crayon waves very very very quietly .	the crayon is very very very quietly .
the rocket paints very very very slowly .	the rocket was very very very slowly .
the fork paints really really really carefully .	the fork is really really really carefully .
the mirror cries really really really carefully .	the mirror was really really really carefully .
the rocket talks very very very carefully .	the rocket is very very very carefully .
the dish paints really really really quickly .	the dish is really really really quickly .
the book exercises really really really quickly .	the book is really really really quickly .
the toy waves very very very carefully .	the toy is very very very carefully .
the doll exercises really really really slowly .	the doll is really really really slowly .
the bed paints really really really slowly .	the bed is really really really slowly .
the plane paints very very very slowly .	the plane is very very very slowly .
the picture sings really really really quickly .	the picture was really really really quickly .
the door paints really really really slowly .	the door was really really really slowly .
the book sings very very very slowly .	the book is very very very slowly .
the mirror cries really really really slowly .	the mirror was really really really slowly .
the fork sings really really really perfectly .	the fork is really really really perfectly .
the rocket waves very very very carefully .	the rocket is very very very carefully .
the rug reads very very very slowly .	the rug was very very very slowly .
the mirror sings really really really perfectly .	the mirror is really really really perfectly .
the bag exercises very very very perfectly .	the bag is very very very perfectly .
the spoon exercises very very very slowly .	the spoon is very very very slowly .
the glass cries really really really quietly .	the glass was really really really quietly .
the plane exercises really really really quietly .	the plane is really really really quietly .
the hat waves very very very quietly .	the hat was very very very quietly .
the couch reads really really really quickly .	the couch is really really really quickly .
the plate exercises really really really slowly .	the plate was really really really slowly .
the book waves really really really quietly .	the book is really really really quietly .
the hat reads very very very quickly .	the hat was very very very quickly .
the truck paints really really really quickly .	the truck was really really really quickly .
the picture cries very very very perfectly .	the picture was very very very perfectly .
the shoe sings really really really perfectly .	the shoe is really really really perfectly .
the rocket talks really really really carefully .	the rocket was really really really carefully .
the mirror waves really really really quietly .	the mirror was really really really quietly .
the rocket talks very very very quietly .	the rocket is very very very quietly .
the picture talks very very very slowly .	the picture is very very very slowly .
the book talks really really really carefully .	the book is really really really carefully .
the box paints very very very slowly .	the box was very very very slowly .
the shoe exercises very very very perfectly .	the shoe is very very very perfectly .
the glass paints very very very slowly .	the glass was very very very slowly .
the door sings very very very perfectly .	the door is very very very perfectly .
the boat cries very very very carefully .	the boat is very very very carefully .
the couch paints really really really quietly .	the couch is really really really quietly .
the bicycle talks really really really quickly .	the bicycle is really really really quickly .
the glass cries really really really quickly .	the glass was really really really quickly .
the door cries really really really quickly .	the door was really really really quickly .
the doll exercises very very very slowly .	the doll is very very very slowly .
the doll paints really really really quietly .	the doll was really really really quietly .
the ring cries very very very perfectly .	the ring was very very very perfectly .
the bottle sings really really really slowly .	the bottle is really really really slowly .
the bowl waves really really really slowly .	the bowl is really really really slowly .
the bag paints very very very carefully .	the bag is very very very carefully .
the plane paints very very very carefully .	the plane is very very very carefully .
the cup waves really really really quickly .	the cup was really really really quickly .
the hat waves really really really perfectly .	the hat is really really really perfectly .
the chair cries really really really perfectly .	the chair is really really really perfectly .
the toy talks very very very slowly .	the toy was very very very slowly .
the boat reads really really really carefully .	the boat was really really really carefully .
the shirt exercises very very very carefully .	the shirt was very very very carefully .
the truck cries very very very quietly .	the truck is very very very quietly .
the bed talks very very very perfectly .	the bed was very very very perfectly .
the couch reads very very very perfectly .	the couch was very very very perfectly .
the bowl waves very very very slowly .	the bowl was very very very slowly .
the crayon paints very very very carefully .	the crayon was very very very carefully .
the bowl sings really really really quietly .	the bowl was really really really quietly .
the spoon paints very very very quietly .	the spoon is very very very quietly .
the boat talks really really really perfectly .	the boat is really really really perfectly .
the plane cries really really really quietly .	the plane was really really really quietly .
the plate waves very very very perfectly .	the plate was very very very perfectly .
the hat exercises really really really quietly .	the hat is really really really quietly .
the bicycle paints very very very quickly .	the bicycle is very very very quickly .
the hat waves very very very slowly .	the hat was very very very slowly .
the box waves really really really slowly .	the box is really really really slowly .
the toy waves really really really quickly .	the toy was really really really quickly .
the chair exercises really really really carefully .	the chair is really really really carefully .
the shirt reads really really really carefully .	the shirt is really really really carefully .
the rocket reads really really really quickly .	the rocket was really really really quickly .
the spoon exercises really really really slowly .	the spoon is really really really slowly .
the box paints really really really quickly .	the box is really really really quickly .
the spoon paints really really really perfectly .	the spoon was really really really perfectly .
the mirror cries really really really quietly .	the mirror is really really really quietly .
the bowl cries really really really perfectly .	the bowl was really really really perfectly .
the door reads very very very perfectly .	the door was very very very perfectly .
the car exercises really really really quietly .	the car is really really really quietly .
the shirt cries really really really perfectly .	the shirt was really really really perfectly .
the mirror sings really really really perfectly .	the mirror was really really really perfectly .
the shoe reads really really really perfectly .	the shoe was really really really perfectly .
the bottle reads really really really slowly .	the bottle was really really really slowly .
the doll exercises really really really quickly .	the doll is really really really quickly .
the chair reads very very very carefully .	the chair was very very very carefully .
the door paints really really really carefully .	the door is really really really carefully .
the rug exercises really really really carefully .	the rug was really really really carefully .
the spoon talks very very very quickly .	the spoon is very very very quickly .
the bowl talks really really really slowly .	the bowl is really really really slowly .
the bowl reads very very very perfectly .	the bowl was very very very perfectly .
the car paints really really really perfectly .	the car is really really really perfectly .
the button reads very very very slowly .	the button is very very very slowly .
the mirror exercises really really really perfectly .	the mirror is really really really perfectly .
the cup exercises very very very carefully .	the cup is very very very carefully .
the couch paints very very very perfectly .	the couch is very very very perfectly .
the crayon sings very very very carefully .	the crayon was very very very carefully .
the bottle exercises very very very perfectly .	the bottle was very very very perfectly .
the shoe reads really really really carefully .	the shoe was really really really carefully .
the cup exercises very very very slowly .	the cup is very very very slowly .
the bottle cries very very very quietly .	the bottle is very very very quietly .
the box talks really really really slowly .	the box is really really really slowly .
the dish exercises really really really carefully .	the dish was really really really carefully .
the bowl paints really really really quickly .	the bowl was really really really quickly .
the ring waves really really really slowly .	the ring is really really really slowly .
