Deborah bought my sister 's daughter 's doctor 's husband the ring .	Deborah lost my sister 's daughter 's doctor 's husband the ring .
my friend bought my boss 's sister 's dad 's teacher the button .	my friend moved my boss 's sister 's dad 's teacher the button .
my boss sent your son 's mom 's cousin 's mother the candle .	my boss shook your son 's mom 's cousin 's mother the candle .
the patient sent my sister 's dad 's dad 's son the ring .	the patient cleaned my sister 's dad 's dad 's son the ring .
my doctor gave your friend 's dentist 's mom 's father the ship .	my doctor moved your friend 's dentist 's mom 's father the ship .
the dentist bought my brother 's wife 's dentist 's teacher the candle .	the dentist dropped my brother 's wife 's dentist 's teacher the candle .
your doctor showed your friend 's daughter 's doctor 's friend the car .	your doctor held your friend 's daughter 's doctor 's friend the car .
the patient showed my mom 's teacher 's husband 's boss the picture .	the patient cleaned my mom 's teacher 's husband 's boss the picture .
the teacher showed your dentist 's mom 's grandmother 's dad the rocket .	the teacher lost your dentist 's mom 's grandmother 's dad the rocket .
my teacher sent your teacher 's grandmother 's son 's father the dish .	my teacher dropped your teacher 's grandmother 's son 's father the dish .
your boss bought your father 's sister 's doctor 's sister the ring .	your boss dropped your father 's sister 's doctor 's sister the ring .
Jill bought my father 's wife 's daughter 's dentist the cup .	Jill held my father 's wife 's daughter 's dentist the cup .
my doctor sent your friend 's cousin 's father 's friend the hat .	my doctor moved your friend 's cousin 's father 's friend the hat .
your cousin bought your mother 's father 's husband 's dad the book .	your cousin cleaned your mother 's father 's husband 's dad the book .
your cousin sent my doctor 's son 's friend 's wife the glass .	your cousin lost my doctor 's son 's friend 's wife the glass .
your boss bought your wife 's dentist 's daughter 's boss the cup .	your boss cleaned your wife 's dentist 's daughter 's boss the cup .
my teacher sent my son 's mom 's doctor 's friend the plate .	my teacher kept my son 's mom 's doctor 's friend the plate .
the customer showed my cousin 's wife 's mother 's cousin the rocket .	the customer kept my cousin 's wife 's mother 's cousin the rocket .
Brett sent your sister 's friend 's mom 's mom the boat .	Brett dropped your sister 's friend 's mom 's mom the boat .
my friend gave my cousin 's daughter 's boss 's dad the boat .	my friend cleaned my cousin 's daughter 's boss 's dad the boat .
the adult sent my mom 's friend 's boss 's cousin the bicycle .	the adult kept my mom 's friend 's boss 's cousin the bicycle .
Nancy gave my dentist 's brother 's sister 's dentist the bowl .	Nancy kept my dentist 's brother 's sister 's dentist the bowl .
the doctor sent your grandmother 's daughter 's father 's cousin the bicycle .	the doctor cleaned your grandmother 's daughter 's father 's cousin the bicycle .
Nicole bought my daughter 's cousin 's daughter 's wife the boat .	Nicole lost my daughter 's cousin 's daughter 's wife the boat .
the child gave your teacher 's son 's son 's daughter the picture .	the child shook your teacher 's son 's son 's daughter the picture .
Barbara gave your friend 's daughter 's mom 's dentist the button .	Barbara dropped your friend 's daughter 's mom 's dentist the button .
the adult bought my boss 's cousin 's husband 's grandmother the fork .	the adult moved my boss 's cousin 's husband 's grandmother the fork .
your teacher sent my dad 's dentist 's friend 's mother the bottle .	your teacher kept my dad 's dentist 's friend 's mother the bottle .
your cousin showed my friend 's sister 's daughter 's mother the box .	your cousin dropped my friend 's sister 's daughter 's mother the box .
my doctor bought your teacher 's wife 's boss 's teacher the mirror .	my doctor moved your teacher 's wife 's boss 's teacher the mirror .
my teacher gave my father 's daughter 's friend 's dad the window .	my teacher shook my father 's daughter 's friend 's dad the window .
Gregory bought my teacher 's teacher 's cousin 's wife the doll .	Gregory held my teacher 's teacher 's cousin 's wife the doll .
my boss bought my son 's boss 's doctor 's boss the chair .	my boss dropped my son 's boss 's doctor 's boss the chair .
the child showed my grandmother 's husband 's dentist 's son the button .	the child moved my grandmother 's husband 's dentist 's son the button .
Daniel gave your cousin 's mom 's dentist 's son the book .	Daniel cleaned your cousin 's mom 's dentist 's son the book .
the dancer showed your doctor 's cousin 's daughter 's daughter the boat .	the dancer kept your doctor 's cousin 's daughter 's daughter the boat .
my doctor sent my daughter 's teacher 's cousin 's cousin the cup .	my doctor moved my daughter 's teacher 's cousin 's cousin the cup .
Anne showed your dad 's sister 's brother 's mother the shirt .	Anne lost your dad 's sister 's brother 's mother the shirt .
the driver sent your son 's sister 's daughter 's brother the picture .	the driver lost your son 's sister 's daughter 's brother the picture .
Thomas bought my boss 's son 's mom 's boss the crayon .	Thomas kept my boss 's son 's mom 's boss the crayon .
the customer showed my dentist 's brother 's cousin 's mom the bag .	the customer lost my dentist 's brother 's cousin 's mom the bag .
Sandra sent my doctor 's grandmother 's wife 's teacher the rug .	Sandra shook my doctor 's grandmother 's wife 's teacher the rug .
my dentist sent my mom 's teacher 's boss 's husband the fork .	my dentist kept my mom 's teacher 's boss 's husband the fork .
my doctor bought your son 's husband 's friend 's cousin the book .	my doctor kept your son 's husband 's friend 's cousin the book .
my teacher sent my sister 's wife 's cousin 's friend the couch .	my teacher held my sister 's wife 's cousin 's friend the couch .
the dentist showed my brother 's son 's husband 's grandmother the boat .	the dentist kept my brother 's son 's husband 's grandmother the boat .
Gregory sent my friend 's father 's husband 's mother the ring .	Gregory kept my friend 's father 's husband 's mother the ring .
my cousin sent my sister 's mom 's cousin 's dad the book .	my cousin shook my sister 's mom 's cousin 's dad the book .
Kayla sent my grandmother 's sister 's friend 's mother the book .	Kayla dropped my grandmother 's sister 's friend 's mother the book .
the child sent my boss 's husband 's father 's son the bicycle .	the child moved my boss 's husband 's father 's son the bicycle .
the teacher showed my daughter 's dentist 's teacher 's son the bag .	the teacher held my daughter 's dentist 's teacher 's son the bag .
the teacher gave my daughter 's dad 's wife 's friend the ring .	the teacher held my daughter 's dad 's wife 's friend the ring .
the child gave your dentist 's husband 's grandmother 's doctor the ship .	the child dropped your dentist 's husband 's grandmother 's doctor the ship .
the person showed my wife 's doctor 's sister 's dentist the toy .	the person moved my wife 's doctor 's sister 's dentist the toy .
the doctor bought your dad 's husband 's mom 's cousin the plane .	the doctor kept your dad 's husband 's mom 's cousin the plane .
your teacher gave your friend 's mother 's friend 's friend the shirt .	your teacher cleaned your friend 's mother 's friend 's friend the shirt .
Becky bought my mother 's brother 's husband 's sister the chair .	Becky cleaned my mother 's brother 's husband 's sister the chair .
the teacher showed my son 's dad 's dad 's cousin the shirt .	the teacher lost my son 's dad 's dad 's cousin the shirt .
Carl gave my grandmother 's cousin 's dad 's mom the bowl .	Carl shook my grandmother 's cousin 's dad 's mom the bowl .
my boss gave my teacher 's husband 's husband 's dentist the bottle .	my boss cleaned my teacher 's husband 's husband 's dentist the bottle .
Judy gave your teacher 's dentist 's grandmother 's daughter the fork .	Judy moved your teacher 's dentist 's grandmother 's daughter the fork .
my friend bought your daughter 's teacher 's sister 's daughter the book .	my friend lost your daughter 's teacher 's sister 's daughter the book .
your teacher showed your father 's cousin 's dentist 's doctor the bag .	your teacher dropped your father 's cousin 's dentist 's doctor the bag .
your friend showed your boss 's brother 's mother 's cousin the chair .	your friend cleaned your boss 's brother 's mother 's cousin the chair .
the person sent my wife 's son 's son 's sister the bowl .	the person lost my wife 's son 's son 's sister the bowl .
my doctor sent my husband 's sister 's dad 's mother the book .	my doctor held my husband 's sister 's dad 's mother the book .
Carl sent your dentist 's daughter 's grandmother 's dentist the dish .	Carl held your dentist 's daughter 's grandmother 's dentist the dish .
your friend gave my boss 's father 's friend 's sister the candle .	your friend dropped my boss 's father 's friend 's sister the candle .
Anna sent my husband 's boss 's sister 's cousin the chair .	Anna moved my husband 's boss 's sister 's cousin the chair .
the child bought my cousin 's grandmother 's cousin 's daughter the ship .	the child cleaned my cousin 's grandmother 's cousin 's daughter the ship .
the customer gave your daughter 's mom 's father 's daughter the car .	the customer kept your daughter 's mom 's father 's daughter the car .
Jerry showed my wife 's teacher 's teacher 's friend the shoe .	Jerry dropped my wife 's teacher 's teacher 's friend the shoe .
the child gave your son 's dentist 's dentist 's husband the fork .	the child lost your son 's dentist 's dentist 's husband the fork .
the person gave my daughter 's wife 's boss 's friend the car .	the person cleaned my daughter 's wife 's boss 's friend the car .
Liam bought your son 's grandmother 's wife 's sister the bag .	Liam cleaned your son 's grandmother 's wife 's sister the bag .
your boss bought your grandmother 's dentist 's cousin 's father the bag .	your boss lost your grandmother 's dentist 's cousin 's father the bag .
Melissa sent my cousin 's sister 's daughter 's husband the ring .	Melissa cleaned my cousin 's sister 's daughter 's husband the ring .
the teacher bought your dad 's husband 's daughter 's dentist the rocket .	the teacher shook your dad 's husband 's daughter 's dentist the rocket .
the teacher showed your sister 's daughter 's daughter 's dentist the candle .	the teacher kept your sister 's daughter 's daughter 's dentist the candle .
your dentist sent your mother 's doctor 's son 's dentist the fork .	your dentist dropped your mother 's doctor 's son 's dentist the fork .
your cousin gave my dentist 's husband 's boss 's teacher the door .	your cousin dropped my dentist 's husband 's boss 's teacher the door .
my dentist gave your dentist 's son 's dad 's daughter the plate .	my dentist dropped your dentist 's son 's dad 's daughter the plate .
my dentist showed your mom 's boss 's mother 's grandmother the plane .	my dentist lost your mom 's boss 's mother 's grandmother the plane .
the teacher gave my husband 's father 's mom 's teacher the chair .	the teacher held my husband 's father 's mom 's teacher the chair .
David showed your mom 's wife 's dad 's mom the book .	David held your mom 's wife 's dad 's mom the book .
Gregory showed your dad 's boss 's brother 's doctor the door .	Gregory moved your dad 's boss 's brother 's doctor the door .
the customer showed my brother 's brother 's sister 's boss the shirt .	the customer moved my brother 's brother 's sister 's boss the shirt .
the person gave my dad 's mom 's mom 's father the dish .	the person moved my dad 's mom 's mom 's father the dish .
my boss sent your teacher 's wife 's sister 's daughter the boat .	my boss lost your teacher 's wife 's sister 's daughter the boat .
Liam bought my sister 's brother 's teacher 's dad the car .	Liam lost my sister 's brother 's teacher 's dad the car .
the adult gave my mother 's husband 's dentist 's grandmother the plate .	the adult held my mother 's husband 's dentist 's grandmother the plate .
Nancy showed my friend 's dad 's dentist 's cousin the rocket .	Nancy moved my friend 's dad 's dentist 's cousin the rocket .
the person showed your dad 's boss 's boss 's daughter the door .	the person lost your dad 's boss 's boss 's daughter the door .
your dentist sent your friend 's grandmother 's sister 's brother the plane .	your dentist held your friend 's grandmother 's sister 's brother the plane .
George gave my wife 's father 's grandmother 's daughter the bowl .	George cleaned my wife 's father 's grandmother 's daughter the bowl .
the doctor sent my daughter 's brother 's friend 's father the plate .	the doctor moved my daughter 's brother 's friend 's father the plate .
the person gave my father 's dad 's dad 's mother the book .	the person moved my father 's dad 's dad 's mother the book .
William sent your son 's cousin 's dad 's son the toy .	William shook your son 's cousin 's dad 's son the toy .
your teacher showed my son 's father 's sister 's cousin the hat .	your teacher shook my son 's father 's sister 's cousin the hat .
my teacher sent your dentist 's dad 's husband 's doctor the cup .	my teacher moved your dentist 's dad 's husband 's doctor the cup .
the teacher showed my daughter 's wife 's mom 's wife the truck .	the teacher shook my daughter 's wife 's mom 's wife the truck .
my boss gave your doctor 's dentist 's boss 's wife the button .	my boss dropped your doctor 's dentist 's boss 's wife the button .
James bought your friend 's mother 's doctor 's brother the shoe .	James lost your friend 's mother 's doctor 's brother the shoe .
my dentist showed my mother 's dad 's grandmother 's sister the book .	my dentist held my mother 's dad 's grandmother 's sister the book .
Cindy gave your sister 's grandmother 's cousin 's teacher the book .	Cindy lost your sister 's grandmother 's cousin 's teacher the book .
my cousin sent your friend 's mom 's teacher 's father the bag .	my cousin lost your friend 's mom 's teacher 's father the bag .
the driver gave my grandmother 's son 's mother 's cousin the chair .	the driver moved my grandmother 's son 's mother 's cousin the chair .
my teacher gave your dad 's cousin 's husband 's daughter the boat .	my teacher dropped your dad 's cousin 's husband 's daughter the boat .
the person bought my cousin 's mom 's grandmother 's wife the shirt .	the person dropped my cousin 's mom 's grandmother 's wife the shirt .
my teacher sent my sister 's son 's dentist 's brother the door .	my teacher lost my sister 's son 's dentist 's brother the door .
my dentist bought your husband 's daughter 's dad 's mother the button .	my dentist cleaned your husband 's daughter 's dad 's mother the button .
the patient gave your mom 's mom 's sister 's teacher the bed .	the patient shook your mom 's mom 's sister 's teacher the bed .
Denise gave my wife 's brother 's friend 's wife the crayon .	Denise kept my wife 's brother 's friend 's wife the crayon .
the child gave your son 's dentist 's boss 's boss the couch .	the child held your son 's dentist 's boss 's boss the couch .
the dancer bought your grandmother 's cousin 's dentist 's son the ship .	the dancer shook your grandmother 's cousin 's dentist 's son the ship .
the patient gave your mother 's friend 's teacher 's teacher the fork .	the patient held your mother 's friend 's teacher 's teacher the fork .
the child sent your doctor 's doctor 's cousin 's son the ship .	the child lost your doctor 's doctor 's cousin 's son the ship .
my teacher gave my son 's grandmother 's mom 's doctor the bag .	my teacher lost my son 's grandmother 's mom 's doctor the bag .
the child gave your doctor 's father 's dentist 's brother the rocket .	the child shook your doctor 's father 's dentist 's brother the rocket .
Brett bought my dad 's doctor 's sister 's sister the plate .	Brett dropped my dad 's doctor 's sister 's sister the plate .
Allison sent your sister 's dad 's dad 's dad the book .	Allison lost your sister 's dad 's dad 's dad the book .
the child showed your mother 's dentist 's son 's grandmother the car .	the child held your mother 's dentist 's son 's grandmother the car .
the child showed my dad 's mom 's sister 's grandmother the mirror .	the child lost my dad 's mom 's sister 's grandmother the mirror .
the person showed your grandmother 's husband 's sister 's cousin the picture .	the person shook your grandmother 's husband 's sister 's cousin the picture .
Christopher bought your boss 's brother 's mother 's cousin the rocket .	Christopher moved your boss 's brother 's mother 's cousin the rocket .
the dentist showed your boss 's cousin 's son 's father the button .	the dentist moved your boss 's cousin 's son 's father the button .
John bought my cousin 's dentist 's father 's cousin the couch .	John moved my cousin 's dentist 's father 's cousin the couch .
James gave your boss 's father 's boss 's brother the toy .	James lost your boss 's father 's boss 's brother the toy .
Judy sent my father 's wife 's mom 's dad the plane .	Judy cleaned my father 's wife 's mom 's dad the plane .
the teacher sent my boss 's dentist 's father 's son the couch .	the teacher dropped my boss 's dentist 's father 's son the couch .
Stephanie sent my friend 's son 's grandmother 's grandmother the doll .	Stephanie shook my friend 's son 's grandmother 's grandmother the doll .
Stephanie bought my wife 's grandmother 's dad 's grandmother the book .	Stephanie cleaned my wife 's grandmother 's dad 's grandmother the book .
my friend bought your sister 's brother 's son 's cousin the glass .	my friend dropped your sister 's brother 's son 's cousin the glass .
the adult gave my friend 's dentist 's dad 's wife the shoe .	the adult moved my friend 's dentist 's dad 's wife the shoe .
the customer bought my husband 's teacher 's wife 's father the boat .	the customer dropped my husband 's teacher 's wife 's father the boat .
Jill showed your doctor 's friend 's doctor 's boss the dish .	Jill kept your doctor 's friend 's doctor 's boss the dish .
Jessica bought your brother 's boss 's cousin 's father the bowl .	Jessica shook your brother 's boss 's cousin 's father the bowl .
the teacher sent my grandmother 's friend 's grandmother 's doctor the plane .	the teacher cleaned my grandmother 's friend 's grandmother 's doctor the plane .
April bought your mom 's doctor 's cousin 's husband the rug .	April shook your mom 's doctor 's cousin 's husband the rug .
the dentist showed your mother 's friend 's wife 's teacher the plane .	the dentist moved your mother 's friend 's wife 's teacher the plane .
Noah bought your cousin 's brother 's sister 's friend the chair .	Noah cleaned your cousin 's brother 's sister 's friend the chair .
the dentist sent my husband 's doctor 's doctor 's mother the shirt .	the dentist lost my husband 's doctor 's doctor 's mother the shirt .
your boss bought my friend 's mother 's dentist 's dentist the cup .	your boss held my friend 's mother 's dentist 's dentist the cup .
the teacher gave my grandmother 's mother 's doctor 's father the glass .	the teacher shook my grandmother 's mother 's doctor 's father the glass .
the patient showed my mom 's doctor 's husband 's son the couch .	the patient kept my mom 's doctor 's husband 's son the couch .
Jane gave my husband 's son 's daughter 's cousin the shoe .	Jane shook my husband 's son 's daughter 's cousin the shoe .
Karen sent my doctor 's dad 's husband 's husband the rocket .	Karen held my doctor 's dad 's husband 's husband the rocket .
your dentist bought your friend 's father 's father 's friend the picture .	your dentist shook your friend 's father 's father 's friend the picture .
your teacher sent my doctor 's mother 's wife 's cousin the hat .	your teacher cleaned my doctor 's mother 's wife 's cousin the hat .
your teacher bought your father 's boss 's teacher 's son the rocket .	your teacher shook your father 's boss 's teacher 's son the rocket .
your cousin bought my friend 's friend 's teacher 's daughter the fork .	your cousin moved my friend 's friend 's teacher 's daughter the fork .
my friend sent your sister 's son 's grandmother 's daughter the cup .	my friend kept your sister 's son 's grandmother 's daughter the cup .
your teacher gave my dentist 's cousin 's mother 's friend the bag .	your teacher held my dentist 's cousin 's mother 's friend the bag .
my teacher bought your boss 's wife 's son 's mom the plane .	my teacher kept your boss 's wife 's son 's mom the plane .
the adult gave your wife 's sister 's son 's sister the picture .	the adult shook your wife 's sister 's son 's sister the picture .
your boss showed my daughter 's son 's doctor 's father the mirror .	your boss cleaned my daughter 's son 's doctor 's father the mirror .
Amy gave my grandmother 's brother 's sister 's mom the fork .	Amy held my grandmother 's brother 's sister 's mom the fork .
your doctor bought my sister 's dentist 's daughter 's dentist the box .	your doctor moved my sister 's dentist 's daughter 's dentist the box .
Richard sent your mother 's doctor 's wife 's husband the glass .	Richard kept your mother 's doctor 's wife 's husband the glass .
my dentist gave my father 's mother 's father 's mom the picture .	my dentist cleaned my father 's mother 's father 's mom the picture .
Alice sent your teacher 's cousin 's father 's friend the mirror .	Alice lost your teacher 's cousin 's father 's friend the mirror .
the teacher gave your doctor 's teacher 's cousin 's father the fork .	the teacher moved your doctor 's teacher 's cousin 's father the fork .
your teacher gave your husband 's wife 's teacher 's mother the crayon .	your teacher cleaned your husband 's wife 's teacher 's mother the crayon .
my cousin bought your sister 's doctor 's grandmother 's wife the glass .	my cousin shook your sister 's doctor 's grandmother 's wife the glass .
my dentist gave my cousin 's mother 's friend 's daughter the truck .	my dentist dropped my cousin 's mother 's friend 's daughter the truck .
your doctor sent your mom 's father 's boss 's doctor the bottle .	your doctor cleaned your mom 's father 's boss 's doctor the bottle .
the person sent your dentist 's cousin 's daughter 's daughter the bed .	the person lost your dentist 's cousin 's daughter 's daughter the bed .
the customer showed your doctor 's husband 's dentist 's doctor the bag .	the customer lost your doctor 's husband 's dentist 's doctor the bag .
Donna sent my daughter 's teacher 's doctor 's husband the car .	Donna held my daughter 's teacher 's doctor 's husband the car .
my friend bought your cousin 's dad 's grandmother 's daughter the dish .	my friend cleaned your cousin 's dad 's grandmother 's daughter the dish .
my boss gave your son 's father 's cousin 's husband the plane .	my boss dropped your son 's father 's cousin 's husband the plane .
the customer gave my grandmother 's doctor 's daughter 's teacher the plate .	the customer cleaned my grandmother 's doctor 's daughter 's teacher the plate .
the dentist bought my mother 's dentist 's husband 's sister the cup .	the dentist lost my mother 's dentist 's husband 's sister the cup .
the teacher sent your brother 's wife 's friend 's dad the picture .	the teacher cleaned your brother 's wife 's friend 's dad the picture .
Julia sent my doctor 's sister 's husband 's friend the plane .	Julia shook my doctor 's sister 's husband 's friend the plane .
Janet bought your boss 's father 's boss 's friend the shoe .	Janet held your boss 's father 's boss 's friend the shoe .
Anna gave your wife 's teacher 's wife 's doctor the fork .	Anna shook your wife 's teacher 's wife 's doctor the fork .
your cousin showed your friend 's husband 's grandmother 's doctor the couch .	your cousin held your friend 's husband 's grandmother 's doctor the couch .
the teacher showed your dad 's boss 's brother 's son the shirt .	the teacher held your dad 's boss 's brother 's son the shirt .
your cousin showed your mother 's sister 's mother 's boss the chair .	your cousin kept your mother 's sister 's mother 's boss the chair .
Laurie gave your father 's son 's sister 's cousin the glass .	Laurie cleaned your father 's son 's sister 's cousin the glass .
the dentist bought my boss 's son 's cousin 's father the bag .	the dentist cleaned my boss 's son 's cousin 's father the bag .
Tracy gave your doctor 's brother 's father 's friend the bed .	Tracy kept your doctor 's brother 's father 's friend the bed .
Alice gave my doctor 's brother 's cousin 's husband the plane .	Alice lost my doctor 's brother 's cousin 's husband the plane .
David bought my mom 's husband 's sister 's wife the cup .	David cleaned my mom 's husband 's sister 's wife the cup .
Sara showed my husband 's cousin 's mother 's mother the bowl .	Sara lost my husband 's cousin 's mother 's mother the bowl .
the person showed your friend 's dad 's brother 's brother the bowl .	the person held your friend 's dad 's brother 's brother the bowl .
James bought my mother 's grandmother 's mother 's boss the cup .	James kept my mother 's grandmother 's mother 's boss the cup .
my doctor gave your sister 's dad 's mother 's doctor the window .	my doctor held your sister 's dad 's mother 's doctor the window .
Mary showed my mom 's wife 's mom 's boss the spoon .	Mary kept my mom 's wife 's mom 's boss the spoon .
your friend sent my dad 's sister 's boss 's daughter the door .	your friend dropped my dad 's sister 's boss 's daughter the door .
my boss sent your dentist 's husband 's mother 's daughter the rocket .	my boss held your dentist 's husband 's mother 's daughter the rocket .
my doctor sent your doctor 's husband 's mom 's doctor the shoe .	my doctor cleaned your doctor 's husband 's mom 's doctor the shoe .
Andrew sent your dad 's grandmother 's boss 's friend the spoon .	Andrew shook your dad 's grandmother 's boss 's friend the spoon .
the dancer showed your son 's sister 's brother 's father the ring .	the dancer held your son 's sister 's brother 's father the ring .
the child sent your father 's husband 's dentist 's boss the book .	the child shook your father 's husband 's dentist 's boss the book .
the patient gave my dad 's doctor 's mom 's boss the cup .	the patient shook my dad 's doctor 's mom 's boss the cup .
my cousin bought my father 's husband 's brother 's father the window .	my cousin lost my father 's husband 's brother 's father the window .
the person sent my teacher 's mother 's grandmother 's grandmother the dish .	the person cleaned my teacher 's mother 's grandmother 's grandmother the dish .
Anne gave my sister 's wife 's grandmother 's boss the rug .	Anne moved my sister 's wife 's grandmother 's boss the rug .
the patient showed my daughter 's mom 's brother 's brother the shoe .	the patient moved my daughter 's mom 's brother 's brother the shoe .
the adult sent your mom 's mother 's son 's dad the dish .	the adult moved your mom 's mother 's son 's dad the dish .
Martin bought your dad 's sister 's doctor 's wife the bag .	Martin kept your dad 's sister 's doctor 's wife the bag .
your teacher showed your doctor 's grandmother 's dad 's friend the dish .	your teacher held your doctor 's grandmother 's dad 's friend the dish .
Alexander bought my dentist 's dad 's husband 's husband the rug .	Alexander shook my dentist 's dad 's husband 's husband the rug .
Kevin gave my father 's daughter 's father 's wife the box .	Kevin held my father 's daughter 's father 's wife the box .
my teacher gave my friend 's teacher 's cousin 's grandmother the candle .	my teacher lost my friend 's teacher 's cousin 's grandmother the candle .
your cousin sent your brother 's father 's grandmother 's grandmother the spoon .	your cousin cleaned your brother 's father 's grandmother 's grandmother the spoon .
the doctor sent my father 's wife 's friend 's doctor the window .	the doctor dropped my father 's wife 's friend 's doctor the window .
my dentist sent my sister 's daughter 's daughter 's mother the mirror .	my dentist shook my sister 's daughter 's daughter 's mother the mirror .
Eric gave my husband 's brother 's dad 's cousin the candle .	Eric dropped my husband 's brother 's dad 's cousin the candle .
Karen gave your grandmother 's wife 's boss 's son the rug .	Karen shook your grandmother 's wife 's boss 's son the rug .
the dancer showed my friend 's mother 's boss 's daughter the ship .	the dancer dropped my friend 's mother 's boss 's daughter the ship .
the teacher sent my friend 's wife 's husband 's doctor the plane .	the teacher kept my friend 's wife 's husband 's doctor the plane .
the child bought your daughter 's husband 's son 's dentist the chair .	the child held your daughter 's husband 's son 's dentist the chair .
Kristen bought your teacher 's son 's dad 's mother the bowl .	Kristen dropped your teacher 's son 's dad 's mother the bowl .
the patient sent my dad 's boss 's dentist 's mom the crayon .	the patient kept my dad 's boss 's dentist 's mom the crayon .
the adult bought your friend 's boss 's father 's dad the shoe .	the adult shook your friend 's boss 's father 's dad the shoe .
your teacher gave your sister 's grandmother 's mother 's doctor the shirt .	your teacher lost your sister 's grandmother 's mother 's doctor the shirt .
your dentist showed your father 's grandmother 's sister 's boss the toy .	your dentist moved your father 's grandmother 's sister 's boss the toy .
your boss sent your sister 's dentist 's dad 's dad the button .	your boss dropped your sister 's dentist 's dad 's dad the button .
the person bought your friend 's mother 's cousin 's doctor the glass .	the person held your friend 's mother 's cousin 's doctor the glass .
my dentist showed your cousin 's doctor 's friend 's mother the spoon .	my dentist kept your cousin 's doctor 's friend 's mother the spoon .
Susan gave your father 's grandmother 's boss 's dad the rug .	Susan kept your father 's grandmother 's boss 's dad the rug .
Susan sent your mom 's daughter 's son 's daughter the glass .	Susan shook your mom 's daughter 's son 's daughter the glass .
Amelia gave your boss 's cousin 's friend 's sister the cup .	Amelia cleaned your boss 's cousin 's friend 's sister the cup .
Sarah showed your friend 's wife 's father 's cousin the spoon .	Sarah dropped your friend 's wife 's father 's cousin the spoon .
my dentist sent your brother 's grandmother 's sister 's husband the button .	my dentist cleaned your brother 's grandmother 's sister 's husband the button .
the doctor gave my dentist 's daughter 's cousin 's teacher the shirt .	the doctor lost my dentist 's daughter 's cousin 's teacher the shirt .
Mark sent your teacher 's friend 's son 's mother the bag .	Mark kept your teacher 's friend 's son 's mother the bag .
the driver sent your brother 's dentist 's dad 's brother the car .	the driver held your brother 's dentist 's dad 's brother the car .
the dancer showed my mom 's father 's wife 's dentist the doll .	the dancer kept my mom 's father 's wife 's dentist the doll .
the customer sent your sister 's mother 's sister 's grandmother the couch .	the customer kept your sister 's mother 's sister 's grandmother the couch .
my friend gave your teacher 's brother 's grandmother 's cousin the door .	my friend dropped your teacher 's brother 's grandmother 's cousin the door .
the teacher sent my dad 's sister 's friend 's dentist the car .	the teacher kept my dad 's sister 's friend 's dentist the car .
Joseph gave your friend 's husband 's doctor 's mother the plate .	Joseph cleaned your friend 's husband 's doctor 's mother the plate .
my doctor sent your husband 's doctor 's wife 's husband the car .	my doctor dropped your husband 's doctor 's wife 's husband the car .
Samantha gave your brother 's grandmother 's mother 's teacher the bed .	Samantha lost your brother 's grandmother 's mother 's teacher the bed .
my friend bought my boss 's dentist 's doctor 's son the rug .	my friend held my boss 's dentist 's doctor 's son the rug .
the doctor bought your brother 's daughter 's sister 's father the cup .	the doctor moved your brother 's daughter 's sister 's father the cup .
Lisa showed my husband 's boss 's dad 's grandmother the crayon .	Lisa shook my husband 's boss 's dad 's grandmother the crayon .
the driver showed your boss 's wife 's father 's boss the mirror .	the driver dropped your boss 's wife 's father 's boss the mirror .
Sandra sent my brother 's cousin 's friend 's daughter the car .	Sandra cleaned my brother 's cousin 's friend 's daughter the car .
the adult sent my dad 's dentist 's dad 's teacher the glass .	the adult kept my dad 's dentist 's dad 's teacher the glass .
the customer sent my dad 's cousin 's son 's mother the crayon .	the customer lost my dad 's cousin 's son 's mother the crayon .
Jill sent my dentist 's friend 's doctor 's grandmother the mirror .	Jill held my dentist 's friend 's doctor 's grandmother the mirror .
Rachel sent my mom 's doctor 's grandmother 's husband the hat .	Rachel dropped my mom 's doctor 's grandmother 's husband the hat .
the doctor gave my daughter 's doctor 's dentist 's cousin the couch .	the doctor dropped my daughter 's doctor 's dentist 's cousin the couch .
your friend gave my sister 's cousin 's father 's doctor the shirt .	your friend kept my sister 's cousin 's father 's doctor the shirt .
the child showed my mom 's dentist 's grandmother 's brother the dish .	the child dropped my mom 's dentist 's grandmother 's brother the dish .
the teacher gave my dentist 's teacher 's father 's husband the picture .	the teacher dropped my dentist 's teacher 's father 's husband the picture .
the patient showed your doctor 's grandmother 's mom 's brother the car .	the patient shook your doctor 's grandmother 's mom 's brother the car .
your cousin bought your brother 's daughter 's son 's brother the candle .	your cousin dropped your brother 's daughter 's son 's brother the candle .
the child showed my doctor 's boss 's husband 's dad the rocket .	the child moved my doctor 's boss 's husband 's dad the rocket .
my doctor showed your mom 's father 's boss 's brother the chair .	my doctor lost your mom 's father 's boss 's brother the chair .
Kevin bought my mother 's dentist 's dad 's mom the bicycle .	Kevin held my mother 's dentist 's dad 's mom the bicycle .
Christopher bought my son 's cousin 's brother 's doctor the glass .	Christopher kept my son 's cousin 's brother 's doctor the glass .
my teacher sent your dad 's boss 's sister 's cousin the door .	my teacher held your dad 's boss 's sister 's cousin the door .
your doctor bought your boss 's doctor 's dentist 's husband the dish .	your doctor cleaned your boss 's doctor 's dentist 's husband the dish .
Samantha showed your mom 's brother 's sister 's son the rocket .	Samantha shook your mom 's brother 's sister 's son the rocket .
Laurie sent your husband 's daughter 's doctor 's cousin the picture .	Laurie kept your husband 's daughter 's doctor 's cousin the picture .
Anna sent your brother 's boss 's boss 's son the glass .	Anna lost your brother 's boss 's boss 's son the glass .
Carol bought your teacher 's son 's mother 's brother the dish .	Carol dropped your teacher 's son 's mother 's brother the dish .
the dancer showed my wife 's son 's son 's boss the glass .	the dancer moved my wife 's son 's son 's boss the glass .
my doctor showed my daughter 's mother 's father 's teacher the door .	my doctor dropped my daughter 's mother 's father 's teacher the door .
Tracy sent your grandmother 's teacher 's father 's doctor the ring .	Tracy lost your grandmother 's teacher 's father 's doctor the ring .
the person showed your mom 's father 's daughter 's wife the bowl .	the person held your mom 's father 's daughter 's wife the bowl .
your cousin sent your cousin 's daughter 's mother 's son the car .	your cousin shook your cousin 's daughter 's mother 's son the car .
your boss showed my brother 's grandmother 's grandmother 's sister the cup .	your boss held my brother 's grandmother 's grandmother 's sister the cup .
the driver bought my teacher 's grandmother 's daughter 's dad the couch .	the driver kept my teacher 's grandmother 's daughter 's dad the couch .
the doctor showed my father 's mother 's husband 's brother the crayon .	the doctor moved my father 's mother 's husband 's brother the crayon .
the dancer showed my teacher 's brother 's father 's son the dish .	the dancer cleaned my teacher 's brother 's father 's son the dish .
Scott showed my cousin 's son 's mom 's doctor the car .	Scott cleaned my cousin 's son 's mom 's doctor the car .
the dentist sent your friend 's brother 's boss 's boss the book .	the dentist cleaned your friend 's brother 's boss 's boss the book .
Martin bought your brother 's dad 's wife 's cousin the bag .	Martin shook your brother 's dad 's wife 's cousin the bag .
Vanessa sent your daughter 's father 's mom 's mother the book .	Vanessa moved your daughter 's father 's mom 's mother the book .
my doctor gave your cousin 's mother 's brother 's father the spoon .	my doctor held your cousin 's mother 's brother 's father the spoon .
my cousin gave my husband 's son 's husband 's cousin the book .	my cousin dropped my husband 's son 's husband 's cousin the book .
the patient showed my husband 's husband 's husband 's boss the fork .	the patient dropped my husband 's husband 's husband 's boss the fork .
the patient sent your mom 's mother 's daughter 's boss the bowl .	the patient kept your mom 's mother 's daughter 's boss the bowl .
the customer showed my teacher 's wife 's cousin 's teacher the rocket .	the customer held my teacher 's wife 's cousin 's teacher the rocket .
my dentist sent my brother 's wife 's teacher 's friend the cup .	my dentist kept my brother 's wife 's teacher 's friend the cup .
the person bought your mother 's sister 's daughter 's mom the plane .	the person kept your mother 's sister 's daughter 's mom the plane .
the teacher bought my teacher 's mom 's doctor 's sister the doll .	the teacher lost my teacher 's mom 's doctor 's sister the doll .
Barbara bought your grandmother 's friend 's friend 's doctor the ring .	Barbara cleaned your grandmother 's friend 's friend 's doctor the ring .
Karen sent my cousin 's friend 's sister 's brother the door .	Karen shook my cousin 's friend 's sister 's brother the door .
Becky showed my mom 's mom 's husband 's daughter the cup .	Becky shook my mom 's mom 's husband 's daughter the cup .
the doctor gave your brother 's grandmother 's mother 's dad the rug .	the doctor dropped your brother 's grandmother 's mother 's dad the rug .
the driver sent my dentist 's teacher 's daughter 's dad the box .	the driver lost my dentist 's teacher 's daughter 's dad the box .
the person showed your mom 's cousin 's grandmother 's dad the doll .	the person dropped your mom 's cousin 's grandmother 's dad the doll .
the teacher sent your boss 's teacher 's doctor 's dentist the boat .	the teacher shook your boss 's teacher 's doctor 's dentist the boat .
the dentist showed your dad 's brother 's friend 's husband the spoon .	the dentist moved your dad 's brother 's friend 's husband the spoon .
the adult gave my cousin 's friend 's cousin 's grandmother the crayon .	the adult lost my cousin 's friend 's cousin 's grandmother the crayon .
my cousin bought my teacher 's friend 's daughter 's daughter the doll .	my cousin moved my teacher 's friend 's daughter 's daughter the doll .
the teacher gave your dad 's daughter 's dad 's grandmother the car .	the teacher kept your dad 's daughter 's dad 's grandmother the car .
Jennifer showed my brother 's brother 's dentist 's sister the bicycle .	Jennifer lost my brother 's brother 's dentist 's sister the bicycle .
the dancer sent my brother 's dad 's doctor 's mother the plane .	the dancer cleaned my brother 's dad 's doctor 's mother the plane .
Samantha gave your mom 's mother 's daughter 's doctor the bed .	Samantha kept your mom 's mother 's daughter 's doctor the bed .
your teacher gave your mother 's husband 's daughter 's friend the plane .	your teacher lost your mother 's husband 's daughter 's friend the plane .
the person sent your mother 's grandmother 's doctor 's mother the box .	the person shook your mother 's grandmother 's doctor 's mother the box .
Julie gave your dad 's dad 's grandmother 's grandmother the dish .	Julie held your dad 's dad 's grandmother 's grandmother the dish .
the child sent my teacher 's son 's grandmother 's father the doll .	the child shook my teacher 's son 's grandmother 's father the doll .
the dancer showed my brother 's dentist 's friend 's doctor the chair .	the dancer dropped my brother 's dentist 's friend 's doctor the chair .
Robert gave your mother 's dentist 's boss 's boss the picture .	Robert shook your mother 's dentist 's boss 's boss the picture .
Anna bought my sister 's sister 's boss 's mom the couch .	Anna shook my sister 's sister 's boss 's mom the couch .
my boss bought your teacher 's husband 's brother 's friend the boat .	my boss moved your teacher 's husband 's brother 's friend the boat .
Denise bought my grandmother 's daughter 's friend 's teacher the bed .	Denise cleaned my grandmother 's daughter 's friend 's teacher the bed .
my boss bought my dentist 's brother 's son 's dad the window .	my boss shook my dentist 's brother 's son 's dad the window .
the dancer showed my daughter 's friend 's wife 's grandmother the toy .	the dancer held my daughter 's friend 's wife 's grandmother the toy .
the person gave your grandmother 's brother 's son 's mom the shoe .	the person kept your grandmother 's brother 's son 's mom the shoe .
my teacher bought my brother 's son 's mother 's dad the window .	my teacher kept my brother 's son 's mother 's dad the window .
the person bought your dentist 's sister 's husband 's sister the dish .	the person shook your dentist 's sister 's husband 's sister the dish .
my teacher gave my brother 's doctor 's wife 's brother the toy .	my teacher lost my brother 's doctor 's wife 's brother the toy .
your teacher gave your sister 's wife 's boss 's boss the rug .	your teacher held your sister 's wife 's boss 's boss the rug .
Peter sent your son 's grandmother 's father 's boss the picture .	Peter held your son 's grandmother 's father 's boss the picture .
Jane sent your dad 's dad 's father 's dentist the rug .	Jane shook your dad 's dad 's father 's dentist the rug .
your cousin sent your father 's mother 's sister 's wife the couch .	your cousin dropped your father 's mother 's sister 's wife the couch .
George gave my sister 's doctor 's sister 's wife the bottle .	George moved my sister 's doctor 's sister 's wife the bottle .
the person sent your son 's cousin 's daughter 's dentist the chair .	the person held your son 's cousin 's daughter 's dentist the chair .
the driver gave my friend 's doctor 's doctor 's daughter the dish .	the driver lost my friend 's doctor 's doctor 's daughter the dish .
Adam bought my friend 's dad 's teacher 's friend the cup .	Adam cleaned my friend 's dad 's teacher 's friend the cup .
Ronald gave your friend 's boss 's dad 's mom the shoe .	Ronald cleaned your friend 's boss 's dad 's mom the shoe .
Richard showed my daughter 's brother 's daughter 's wife the toy .	Richard shook my daughter 's brother 's daughter 's wife the toy .
my cousin bought my doctor 's father 's doctor 's daughter the chair .	my cousin dropped my doctor 's father 's doctor 's daughter the chair .
James showed your wife 's daughter 's dentist 's cousin the hat .	James cleaned your wife 's daughter 's dentist 's cousin the hat .
the person showed your cousin 's sister 's sister 's boss the toy .	the person dropped your cousin 's sister 's sister 's boss the toy .
George gave your brother 's friend 's friend 's dad the door .	George lost your brother 's friend 's friend 's dad the door .
my boss showed my dad 's sister 's mom 's friend the fork .	my boss dropped my dad 's sister 's mom 's friend the fork .
the adult sent my brother 's boss 's brother 's sister the car .	the adult moved my brother 's boss 's brother 's sister the car .
my cousin gave your friend 's mother 's brother 's cousin the shoe .	my cousin moved your friend 's mother 's brother 's cousin the shoe .
Alice showed my doctor 's mother 's sister 's dentist the ring .	Alice cleaned my doctor 's mother 's sister 's dentist the ring .
Aaron sent my boss 's boss 's dentist 's son the book .	Aaron shook my boss 's boss 's dentist 's son the book .
the teacher gave my boss 's grandmother 's father 's sister the bag .	the teacher lost my boss 's grandmother 's father 's sister the bag .
your doctor gave your mother 's dad 's son 's cousin the box .	your doctor cleaned your mother 's dad 's son 's cousin the box .
Nicole bought my grandmother 's father 's mother 's husband the picture .	Nicole kept my grandmother 's father 's mother 's husband the picture .
your friend gave my friend 's mother 's son 's friend the car .	your friend cleaned my friend 's mother 's son 's friend the car .
my friend bought my friend 's friend 's husband 's doctor the shoe .	my friend moved my friend 's friend 's husband 's doctor the shoe .
your teacher gave your dad 's dentist 's teacher 's father the spoon .	your teacher kept your dad 's dentist 's teacher 's father the spoon .
the dancer gave your father 's grandmother 's friend 's sister the glass .	the dancer held your father 's grandmother 's friend 's sister the glass .
the dentist showed your son 's dentist 's father 's teacher the car .	the dentist shook your son 's dentist 's father 's teacher the car .
the dentist gave your dad 's boss 's cousin 's wife the plane .	the dentist shook your dad 's boss 's cousin 's wife the plane .
your friend sent my son 's wife 's mom 's wife the bowl .	your friend lost my son 's wife 's mom 's wife the bowl .
your doctor sent your friend 's brother 's grandmother 's mother the candle .	your doctor held your friend 's brother 's grandmother 's mother the candle .
Michael sent your father 's sister 's grandmother 's son the hat .	Michael cleaned your father 's sister 's grandmother 's son the hat .
Sarah showed my mom 's husband 's friend 's cousin the bottle .	Sarah dropped my mom 's husband 's friend 's cousin the bottle .
my friend sent my mom 's brother 's boss 's grandmother the plate .	my friend kept my mom 's brother 's boss 's grandmother the plate .
the driver showed your brother 's husband 's teacher 's mother the car .	the driver moved your brother 's husband 's teacher 's mother the car .
the driver bought your son 's father 's dad 's cousin the box .	the driver shook your son 's father 's dad 's cousin the box .
the adult gave my dad 's brother 's husband 's father the rocket .	the adult moved my dad 's brother 's husband 's father the rocket .
your dentist sent my daughter 's mother 's son 's mom the doll .	your dentist lost my daughter 's mother 's son 's mom the doll .
your dentist bought your teacher 's mother 's wife 's son the toy .	your dentist shook your teacher 's mother 's wife 's son the toy .
the dancer gave your son 's son 's mom 's son the button .	the dancer moved your son 's son 's mom 's son the button .
my teacher showed my sister 's mother 's dad 's teacher the door .	my teacher shook my sister 's mother 's dad 's teacher the door .
my dentist bought my boss 's friend 's dad 's brother the bag .	my dentist cleaned my boss 's friend 's dad 's brother the bag .
the customer sent my doctor 's cousin 's boss 's dad the picture .	the customer moved my doctor 's cousin 's boss 's dad the picture .
Vanessa gave your grandmother 's teacher 's boss 's doctor the ship .	Vanessa lost your grandmother 's teacher 's boss 's doctor the ship .
the driver bought my teacher 's friend 's brother 's wife the shirt .	the driver shook my teacher 's friend 's brother 's wife the shirt .
Richard gave my son 's friend 's husband 's teacher the doll .	Richard lost my son 's friend 's husband 's teacher the doll .
my cousin bought my grandmother 's dad 's husband 's grandmother the ship .	my cousin shook my grandmother 's dad 's husband 's grandmother the ship .
your cousin showed your husband 's boss 's son 's husband the fork .	your cousin cleaned your husband 's boss 's son 's husband the fork .
the teacher sent your dentist 's boss 's cousin 's friend the cup .	the teacher kept your dentist 's boss 's cousin 's friend the cup .
Martin gave your dentist 's friend 's mom 's dentist the bag .	Martin moved your dentist 's friend 's mom 's dentist the bag .
the doctor showed your daughter 's wife 's cousin 's brother the dish .	the doctor cleaned your daughter 's wife 's cousin 's brother the dish .
Todd sent my dentist 's mom 's brother 's doctor the box .	Todd cleaned my dentist 's mom 's brother 's doctor the box .
the doctor gave your dentist 's son 's cousin 's friend the candle .	the doctor shook your dentist 's son 's cousin 's friend the candle .
your friend bought my mother 's sister 's cousin 's cousin the chair .	your friend shook my mother 's sister 's cousin 's cousin the chair .
my doctor bought my wife 's doctor 's teacher 's grandmother the rocket .	my doctor lost my wife 's doctor 's teacher 's grandmother the rocket .
the driver showed my dentist 's husband 's sister 's wife the bed .	the driver dropped my dentist 's husband 's sister 's wife the bed .
the child sent my husband 's sister 's father 's friend the rug .	the child dropped my husband 's sister 's father 's friend the rug .
my friend showed your boss 's cousin 's husband 's boss the window .	my friend dropped your boss 's cousin 's husband 's boss the window .
your boss showed my cousin 's grandmother 's mom 's daughter the ring .	your boss moved my cousin 's grandmother 's mom 's daughter the ring .
my doctor gave your sister 's brother 's brother 's sister the button .	my doctor held your sister 's brother 's brother 's sister the button .
Vanessa gave my sister 's teacher 's cousin 's son the book .	Vanessa moved my sister 's teacher 's cousin 's son the book .
my doctor bought my sister 's dad 's teacher 's doctor the crayon .	my doctor moved my sister 's dad 's teacher 's doctor the crayon .
the person bought your dentist 's sister 's boss 's grandmother the bicycle .	the person held your dentist 's sister 's boss 's grandmother the bicycle .
Stephanie sent my friend 's cousin 's sister 's brother the crayon .	Stephanie cleaned my friend 's cousin 's sister 's brother the crayon .
your boss bought your boss 's friend 's husband 's teacher the couch .	your boss dropped your boss 's friend 's husband 's teacher the couch .
the person showed my cousin 's teacher 's dentist 's husband the fork .	the person held my cousin 's teacher 's dentist 's husband the fork .
Brett showed my sister 's dad 's grandmother 's daughter the book .	Brett lost my sister 's dad 's grandmother 's daughter the book .
Patrick gave your daughter 's husband 's friend 's doctor the fork .	Patrick moved your daughter 's husband 's friend 's doctor the fork .
April bought your mother 's son 's daughter 's dentist the ring .	April cleaned your mother 's son 's daughter 's dentist the ring .
your doctor bought my dentist 's wife 's son 's husband the book .	your doctor cleaned my dentist 's wife 's son 's husband the book .
the dancer showed your cousin 's dad 's dentist 's sister the candle .	the dancer shook your cousin 's dad 's dentist 's sister the candle .
Liam showed my teacher 's son 's dentist 's sister the car .	Liam held my teacher 's son 's dentist 's sister the car .
Robert gave your sister 's friend 's dad 's boss the boat .	Robert moved your sister 's friend 's dad 's boss the boat .
the dentist bought your daughter 's wife 's cousin 's boss the shirt .	the dentist held your daughter 's wife 's cousin 's boss the shirt .
Allison bought your dad 's husband 's teacher 's mother the fork .	Allison held your dad 's husband 's teacher 's mother the fork .
the customer showed your dentist 's mother 's doctor 's grandmother the glass .	the customer held your dentist 's mother 's doctor 's grandmother the glass .
my boss sent my father 's daughter 's husband 's son the truck .	my boss moved my father 's daughter 's husband 's son the truck .
the patient sent my doctor 's doctor 's brother 's grandmother the cup .	the patient lost my doctor 's doctor 's brother 's grandmother the cup .
your doctor bought your dad 's daughter 's mother 's sister the rocket .	your doctor shook your dad 's daughter 's mother 's sister the rocket .
your friend bought my dentist 's father 's son 's mom the mirror .	your friend cleaned my dentist 's father 's son 's mom the mirror .
the child gave my grandmother 's sister 's husband 's dentist the mirror .	the child moved my grandmother 's sister 's husband 's dentist the mirror .
the patient sent your husband 's husband 's mother 's father the bottle .	the patient held your husband 's husband 's mother 's father the bottle .
your dentist gave your dentist 's dad 's brother 's boss the doll .	your dentist lost your dentist 's dad 's brother 's boss the doll .
Laurie gave my sister 's daughter 's father 's mom the shoe .	Laurie shook my sister 's daughter 's father 's mom the shoe .
Joseph sent my wife 's teacher 's wife 's doctor the window .	Joseph shook my wife 's teacher 's wife 's doctor the window .
the teacher sent your sister 's doctor 's boss 's teacher the fork .	the teacher moved your sister 's doctor 's boss 's teacher the fork .
my teacher gave your boss 's daughter 's teacher 's mom the bowl .	my teacher shook your boss 's daughter 's teacher 's mom the bowl .
Andrew gave my daughter 's boss 's brother 's daughter the picture .	Andrew held my daughter 's boss 's brother 's daughter the picture .
my dentist gave your friend 's grandmother 's wife 's doctor the rug .	my dentist kept your friend 's grandmother 's wife 's doctor the rug .
your teacher gave your dad 's father 's cousin 's dad the crayon .	your teacher shook your dad 's father 's cousin 's dad the crayon .
Tracy gave your wife 's mother 's mom 's cousin the ship .	Tracy lost your wife 's mother 's mom 's cousin the ship .
the adult bought your son 's brother 's doctor 's husband the bed .	the adult kept your son 's brother 's doctor 's husband the bed .
my boss sent my mother 's doctor 's boss 's husband the rug .	my boss lost my mother 's doctor 's boss 's husband the rug .
the adult sent my teacher 's grandmother 's mother 's cousin the rocket .	the adult moved my teacher 's grandmother 's mother 's cousin the rocket .
Liam bought my grandmother 's sister 's friend 's wife the plane .	Liam shook my grandmother 's sister 's friend 's wife the plane .
my cousin sent my dentist 's father 's dad 's friend the ship .	my cousin shook my dentist 's father 's dad 's friend the ship .
the dancer showed your son 's teacher 's dentist 's dad the fork .	the dancer lost your son 's teacher 's dentist 's dad the fork .
your teacher sent your husband 's teacher 's mother 's doctor the chair .	your teacher lost your husband 's teacher 's mother 's doctor the chair .
the doctor showed your doctor 's cousin 's daughter 's husband the toy .	the doctor moved your doctor 's cousin 's daughter 's husband the toy .
my dentist gave my brother 's sister 's doctor 's cousin the toy .	my dentist moved my brother 's sister 's doctor 's cousin the toy .
the doctor bought my dentist 's mom 's boss 's mom the bicycle .	the doctor cleaned my dentist 's mom 's boss 's mom the bicycle .
your cousin bought my dad 's grandmother 's mom 's husband the bowl .	your cousin kept my dad 's grandmother 's mom 's husband the bowl .
Michelle gave my husband 's dentist 's son 's daughter the bed .	Michelle held my husband 's dentist 's son 's daughter the bed .
the adult sent my mother 's daughter 's wife 's doctor the mirror .	the adult shook my mother 's daughter 's wife 's doctor the mirror .
Martin bought my friend 's daughter 's daughter 's daughter the bowl .	Martin dropped my friend 's daughter 's daughter 's daughter the bowl .
Julie showed your husband 's sister 's mom 's dentist the box .	Julie lost your husband 's sister 's mom 's dentist the box .
Scott bought my daughter 's teacher 's mother 's brother the bowl .	Scott kept my daughter 's teacher 's mother 's brother the bowl .
the driver bought your doctor 's wife 's sister 's doctor the box .	the driver kept your doctor 's wife 's sister 's doctor the box .
my boss showed my mom 's friend 's son 's sister the cup .	my boss kept my mom 's friend 's son 's sister the cup .
my doctor showed your brother 's doctor 's brother 's dentist the candle .	my doctor kept your brother 's doctor 's brother 's dentist the candle .
Linda bought my daughter 's dentist 's sister 's boss the window .	Linda moved my daughter 's dentist 's sister 's boss the window .
Linda sent your friend 's mother 's dad 's cousin the ring .	Linda shook your friend 's mother 's dad 's cousin the ring .
Eric sent my doctor 's grandmother 's friend 's boss the spoon .	Eric held my doctor 's grandmother 's friend 's boss the spoon .
Nina sent your mother 's grandmother 's sister 's friend the book .	Nina cleaned your mother 's grandmother 's sister 's friend the book .
Joseph bought my grandmother 's father 's husband 's wife the couch .	Joseph shook my grandmother 's father 's husband 's wife the couch .
your friend sent your friend 's father 's cousin 's brother the plate .	your friend shook your friend 's father 's cousin 's brother the plate .
Laurie sent my father 's father 's boss 's sister the book .	Laurie kept my father 's father 's boss 's sister the book .
my teacher gave my friend 's sister 's cousin 's daughter the fork .	my teacher shook my friend 's sister 's cousin 's daughter the fork .
my friend showed my mom 's daughter 's grandmother 's dentist the chair .	my friend held my mom 's daughter 's grandmother 's dentist the chair .
Wendy sent my mother 's mother 's dad 's brother the bed .	Wendy held my mother 's mother 's dad 's brother the bed .
the dentist showed my husband 's grandmother 's cousin 's doctor the cup .	the dentist held my husband 's grandmother 's cousin 's doctor the cup .
Guy showed your dentist 's son 's teacher 's dentist the shoe .	Guy shook your dentist 's son 's teacher 's dentist the shoe .
my dentist gave your sister 's son 's brother 's father the dish .	my dentist held your sister 's son 's brother 's father the dish .
Guy sent my daughter 's wife 's son 's doctor the mirror .	Guy moved my daughter 's wife 's son 's doctor the mirror .
your teacher sent my brother 's daughter 's daughter 's doctor the car .	your teacher moved my brother 's daughter 's daughter 's doctor the car .
the person sent your mom 's cousin 's mom 's brother the fork .	the person shook your mom 's cousin 's mom 's brother the fork .
your cousin bought my brother 's boss 's boss 's husband the truck .	your cousin lost my brother 's boss 's boss 's husband the truck .
my cousin bought your friend 's mother 's son 's son the shirt .	my cousin held your friend 's mother 's son 's son the shirt .
Sally showed your brother 's dentist 's friend 's brother the car .	Sally cleaned your brother 's dentist 's friend 's brother the car .
my friend showed your friend 's grandmother 's friend 's grandmother the bag .	my friend cleaned your friend 's grandmother 's friend 's grandmother the bag .
your boss showed my teacher 's cousin 's wife 's dad the toy .	your boss lost my teacher 's cousin 's wife 's dad the toy .
your dentist showed my grandmother 's mother 's doctor 's boss the picture .	your dentist moved my grandmother 's mother 's doctor 's boss the picture .
Allison gave my dad 's husband 's father 's cousin the chair .	Allison cleaned my dad 's husband 's father 's cousin the chair .
Kevin gave my brother 's teacher 's dentist 's dentist the boat .	Kevin shook my brother 's teacher 's dentist 's dentist the boat .
my dentist sent your teacher 's mother 's boss 's son the bag .	my dentist moved your teacher 's mother 's boss 's son the bag .
your friend gave your doctor 's mom 's doctor 's wife the box .	your friend held your doctor 's mom 's doctor 's wife the box .
your teacher bought your husband 's grandmother 's daughter 's brother the mirror .	your teacher cleaned your husband 's grandmother 's daughter 's brother the mirror .
my cousin showed your son 's mom 's dentist 's mom the window .	my cousin held your son 's mom 's dentist 's mom the window .
Jane gave your grandmother 's sister 's friend 's grandmother the shoe .	Jane lost your grandmother 's sister 's friend 's grandmother the shoe .
the driver gave my sister 's boss 's dentist 's sister the bowl .	the driver moved my sister 's boss 's dentist 's sister the bowl .
the dancer showed my mother 's friend 's cousin 's daughter the ring .	the dancer held my mother 's friend 's cousin 's daughter the ring .
James bought my boss 's mom 's cousin 's friend the window .	James lost my boss 's mom 's cousin 's friend the window .
Mary bought your husband 's brother 's daughter 's cousin the mirror .	Mary lost your husband 's brother 's daughter 's cousin the mirror .
your boss sent your doctor 's son 's mother 's husband the truck .	your boss lost your doctor 's son 's mother 's husband the truck .
the teacher gave your daughter 's sister 's teacher 's sister the book .	the teacher dropped your daughter 's sister 's teacher 's sister the book .
my friend bought my grandmother 's mom 's mother 's wife the hat .	my friend dropped my grandmother 's mom 's mother 's wife the hat .
my cousin sent your husband 's daughter 's mother 's brother the bag .	my cousin lost your husband 's daughter 's mother 's brother the bag .
your dentist showed your dentist 's husband 's doctor 's brother the hat .	your dentist held your dentist 's husband 's doctor 's brother the hat .
your cousin bought your husband 's wife 's mom 's dentist the bowl .	your cousin lost your husband 's wife 's mom 's dentist the bowl .
Christopher showed my doctor 's sister 's sister 's cousin the bag .	Christopher moved my doctor 's sister 's sister 's cousin the bag .
the person showed my friend 's wife 's cousin 's wife the car .	the person lost my friend 's wife 's cousin 's wife the car .
the patient gave your boss 's brother 's daughter 's brother the plate .	the patient cleaned your boss 's brother 's daughter 's brother the plate .
the adult showed your cousin 's wife 's husband 's sister the mirror .	the adult moved your cousin 's wife 's husband 's sister the mirror .
your friend bought my teacher 's mom 's husband 's dentist the bottle .	your friend cleaned my teacher 's mom 's husband 's dentist the bottle .
my cousin sent my mom 's mom 's son 's teacher the glass .	my cousin dropped my mom 's mom 's son 's teacher the glass .
the dentist gave your dad 's sister 's husband 's mom the ring .	the dentist shook your dad 's sister 's husband 's mom the ring .
the doctor gave my brother 's friend 's husband 's dentist the candle .	the doctor moved my brother 's friend 's husband 's dentist the candle .
your doctor showed my grandmother 's dad 's dad 's doctor the box .	your doctor lost my grandmother 's dad 's dad 's doctor the box .
Christopher gave my dad 's son 's mom 's dad the ship .	Christopher held my dad 's son 's mom 's dad the ship .
your cousin bought my daughter 's dentist 's father 's brother the ring .	your cousin kept my daughter 's dentist 's father 's brother the ring .
the customer bought your dentist 's mom 's sister 's cousin the picture .	the customer lost your dentist 's mom 's sister 's cousin the picture .
the doctor sent my mother 's friend 's dentist 's teacher the plane .	the doctor kept my mother 's friend 's dentist 's teacher the plane .
Sara sent your cousin 's brother 's father 's mom the boat .	Sara dropped your cousin 's brother 's father 's mom the boat .
my teacher showed my mom 's dad 's brother 's friend the door .	my teacher moved my mom 's dad 's brother 's friend the door .
Joseph sent my mother 's teacher 's doctor 's son the shirt .	Joseph kept my mother 's teacher 's doctor 's son the shirt .
Emily sent your doctor 's father 's wife 's son the plane .	Emily shook your doctor 's father 's wife 's son the plane .
my cousin gave your sister 's mother 's mother 's sister the plate .	my cousin held your sister 's mother 's mother 's sister the plate .
Adam sent your doctor 's doctor 's cousin 's boss the boat .	Adam dropped your doctor 's doctor 's cousin 's boss the boat .
Eric bought your husband 's friend 's wife 's friend the door .	Eric kept your husband 's friend 's wife 's friend the door .
my dentist gave my boss 's father 's wife 's cousin the dish .	my dentist shook my boss 's father 's wife 's cousin the dish .
my friend bought your husband 's dentist 's doctor 's mother the bowl .	my friend cleaned your husband 's dentist 's doctor 's mother the bowl .
my friend gave my dad 's friend 's friend 's sister the doll .	my friend lost my dad 's friend 's friend 's sister the doll .
the person showed your friend 's wife 's dentist 's doctor the boat .	the person shook your friend 's wife 's dentist 's doctor the boat .
my boss bought my mom 's son 's cousin 's wife the plane .	my boss kept my mom 's son 's cousin 's wife the plane .
the patient bought my daughter 's dad 's daughter 's friend the hat .	the patient kept my daughter 's dad 's daughter 's friend the hat .
Alexander showed your daughter 's husband 's dentist 's brother the ring .	Alexander moved your daughter 's husband 's dentist 's brother the ring .
the adult sent my teacher 's grandmother 's father 's wife the toy .	the adult cleaned my teacher 's grandmother 's father 's wife the toy .
your friend bought your sister 's mom 's son 's grandmother the dish .	your friend kept your sister 's mom 's son 's grandmother the dish .
your doctor showed my friend 's sister 's daughter 's doctor the chair .	your doctor kept my friend 's sister 's daughter 's doctor the chair .
your doctor sent your mother 's father 's dentist 's dentist the book .	your doctor dropped your mother 's father 's dentist 's dentist the book .
the dentist bought your father 's mother 's sister 's mother the candle .	the dentist moved your father 's mother 's sister 's mother the candle .
Jerry showed my boss 's teacher 's brother 's mother the door .	Jerry shook my boss 's teacher 's brother 's mother the door .
the child gave my boss 's grandmother 's mom 's mom the crayon .	the child shook my boss 's grandmother 's mom 's mom the crayon .
the child showed my boss 's dentist 's grandmother 's doctor the crayon .	the child cleaned my boss 's dentist 's grandmother 's doctor the crayon .
Bill bought your sister 's husband 's sister 's friend the car .	Bill held your sister 's husband 's sister 's friend the car .
the doctor showed your son 's boss 's husband 's dentist the truck .	the doctor dropped your son 's boss 's husband 's dentist the truck .
the person sent your mother 's sister 's father 's cousin the doll .	the person kept your mother 's sister 's father 's cousin the doll .
Dan gave your wife 's wife 's dad 's dad the bottle .	Dan shook your wife 's wife 's dad 's dad the bottle .
the adult bought my son 's grandmother 's teacher 's daughter the plane .	the adult held my son 's grandmother 's teacher 's daughter the plane .
Barbara sent your daughter 's sister 's son 's husband the rocket .	Barbara dropped your daughter 's sister 's son 's husband the rocket .
Guy sent your son 's brother 's son 's friend the rug .	Guy moved your son 's brother 's son 's friend the rug .
the child gave your sister 's sister 's teacher 's daughter the candle .	the child dropped your sister 's sister 's teacher 's daughter the candle .
Martin bought my friend 's mom 's grandmother 's brother the shirt .	Martin moved my friend 's mom 's grandmother 's brother the shirt .
Laura sent your dad 's mom 's dentist 's cousin the car .	Laura moved your dad 's mom 's dentist 's cousin the car .
the patient gave your cousin 's teacher 's grandmother 's dad the book .	the patient cleaned your cousin 's teacher 's grandmother 's dad the book .
my doctor sent your friend 's grandmother 's father 's grandmother the plate .	my doctor held your friend 's grandmother 's father 's grandmother the plate .
the child sent my doctor 's cousin 's dad 's wife the bed .	the child kept my doctor 's cousin 's dad 's wife the bed .
my friend bought your sister 's brother 's daughter 's sister the rocket .	my friend held your sister 's brother 's daughter 's sister the rocket .
my dentist sent your teacher 's cousin 's daughter 's teacher the hat .	my dentist shook your teacher 's cousin 's daughter 's teacher the hat .
Michelle gave my doctor 's grandmother 's doctor 's dentist the chair .	Michelle kept my doctor 's grandmother 's doctor 's dentist the chair .
your friend showed your grandmother 's friend 's grandmother 's father the bottle .	your friend shook your grandmother 's friend 's grandmother 's father the bottle .
my doctor gave your cousin 's mom 's husband 's sister the rug .	my doctor moved your cousin 's mom 's husband 's sister the rug .
the adult gave your husband 's friend 's wife 's boss the ring .	the adult kept your husband 's friend 's wife 's boss the ring .
Andrew bought your mom 's wife 's teacher 's husband the bicycle .	Andrew cleaned your mom 's wife 's teacher 's husband the bicycle .
your boss sent your dentist 's husband 's daughter 's sister the boat .	your boss dropped your dentist 's husband 's daughter 's sister the boat .
the person sent your daughter 's boss 's teacher 's boss the ring .	the person moved your daughter 's boss 's teacher 's boss the ring .
your friend gave your grandmother 's boss 's boss 's wife the door .	your friend moved your grandmother 's boss 's boss 's wife the door .
my teacher sent my daughter 's boss 's doctor 's dad the book .	my teacher dropped my daughter 's boss 's doctor 's dad the book .
Ronald showed my sister 's husband 's wife 's grandmother the rug .	Ronald dropped my sister 's husband 's wife 's grandmother the rug .
Michelle gave my brother 's sister 's doctor 's sister the door .	Michelle moved my brother 's sister 's doctor 's sister the door .
the teacher bought my friend 's grandmother 's grandmother 's son the bottle .	the teacher moved my friend 's grandmother 's grandmother 's son the bottle .
the doctor gave your son 's boss 's wife 's dentist the book .	the doctor moved your son 's boss 's wife 's dentist the book .
your cousin showed your teacher 's sister 's sister 's sister the shoe .	your cousin held your teacher 's sister 's sister 's sister the shoe .
Denise sent my son 's brother 's sister 's doctor the cup .	Denise dropped my son 's brother 's sister 's doctor the cup .
Bill gave your cousin 's mom 's cousin 's daughter the shirt .	Bill shook your cousin 's mom 's cousin 's daughter the shirt .
the person bought your friend 's boss 's mom 's sister the rug .	the person kept your friend 's boss 's mom 's sister the rug .
your boss gave my boss 's doctor 's grandmother 's mother the book .	your boss lost my boss 's doctor 's grandmother 's mother the book .
Lisa gave your cousin 's dentist 's daughter 's teacher the button .	Lisa held your cousin 's dentist 's daughter 's teacher the button .
my doctor sent your cousin 's mom 's daughter 's doctor the shirt .	my doctor held your cousin 's mom 's daughter 's doctor the shirt .
the doctor showed your brother 's dentist 's father 's boss the plane .	the doctor lost your brother 's dentist 's father 's boss the plane .
Catherine sent my grandmother 's dad 's friend 's dad the chair .	Catherine moved my grandmother 's dad 's friend 's dad the chair .
the doctor sent my grandmother 's dad 's boss 's sister the cup .	the doctor dropped my grandmother 's dad 's boss 's sister the cup .
your friend sent your father 's brother 's doctor 's dad the rug .	your friend shook your father 's brother 's doctor 's dad the rug .
the doctor showed my teacher 's husband 's father 's son the picture .	the doctor cleaned my teacher 's husband 's father 's son the picture .
the customer gave my father 's boss 's wife 's cousin the hat .	the customer held my father 's boss 's wife 's cousin the hat .
Cindy showed my mom 's daughter 's cousin 's son the dish .	Cindy shook my mom 's daughter 's cousin 's son the dish .
Rebecca gave your cousin 's sister 's friend 's boss the plane .	Rebecca held your cousin 's sister 's friend 's boss the plane .
the dancer showed your boss 's dad 's mom 's daughter the boat .	the dancer shook your boss 's dad 's mom 's daughter the boat .
the dancer gave my doctor 's boss 's teacher 's son the glass .	the dancer cleaned my doctor 's boss 's teacher 's son the glass .
Steve showed my cousin 's wife 's mom 's dentist the car .	Steve cleaned my cousin 's wife 's mom 's dentist the car .
Eric gave your dentist 's boss 's boss 's dentist the window .	Eric lost your dentist 's boss 's boss 's dentist the window .
Steven showed your teacher 's daughter 's teacher 's grandmother the plane .	Steven moved your teacher 's daughter 's teacher 's grandmother the plane .
Aaron sent your wife 's brother 's cousin 's husband the candle .	Aaron cleaned your wife 's brother 's cousin 's husband the candle .
Tracy showed your mother 's father 's dentist 's husband the ring .	Tracy shook your mother 's father 's dentist 's husband the ring .
the dentist bought your husband 's husband 's dad 's daughter the car .	the dentist kept your husband 's husband 's dad 's daughter the car .
the customer showed my friend 's dentist 's teacher 's dentist the bottle .	the customer dropped my friend 's dentist 's teacher 's dentist the bottle .
the doctor showed my dad 's boss 's mother 's boss the spoon .	the doctor cleaned my dad 's boss 's mother 's boss the spoon .
the driver gave your doctor 's friend 's teacher 's wife the window .	the driver held your doctor 's friend 's teacher 's wife the window .
Jerry gave your husband 's cousin 's cousin 's mother the bed .	Jerry kept your husband 's cousin 's cousin 's mother the bed .
Richard bought your dentist 's grandmother 's boss 's dentist the ship .	Richard kept your dentist 's grandmother 's boss 's dentist the ship .
my friend bought my brother 's cousin 's dad 's cousin the doll .	my friend kept my brother 's cousin 's dad 's cousin the doll .
Eric sent my brother 's husband 's doctor 's doctor the book .	Eric moved my brother 's husband 's doctor 's doctor the book .
my cousin showed your doctor 's son 's cousin 's father the chair .	my cousin held your doctor 's son 's cousin 's father the chair .
Liam sent my son 's teacher 's dentist 's mom the couch .	Liam shook my son 's teacher 's dentist 's mom the couch .
my boss gave my sister 's sister 's brother 's friend the bed .	my boss dropped my sister 's sister 's brother 's friend the bed .
Todd gave my dad 's father 's daughter 's dad the bag .	Todd kept my dad 's father 's daughter 's dad the bag .
my cousin gave your dentist 's friend 's wife 's grandmother the doll .	my cousin dropped your dentist 's friend 's wife 's grandmother the doll .
Lisa bought your father 's dad 's grandmother 's daughter the bicycle .	Lisa shook your father 's dad 's grandmother 's daughter the bicycle .
the customer bought my daughter 's cousin 's husband 's wife the toy .	the customer moved my daughter 's cousin 's husband 's wife the toy .
your teacher showed my daughter 's father 's boss 's grandmother the toy .	your teacher dropped my daughter 's father 's boss 's grandmother the toy .
your doctor sent my dentist 's doctor 's teacher 's dad the plane .	your doctor dropped my dentist 's doctor 's teacher 's dad the plane .
Nina gave your daughter 's friend 's sister 's boss the cup .	Nina kept your daughter 's friend 's sister 's boss the cup .
Lisa bought my mother 's wife 's doctor 's husband the chair .	Lisa held my mother 's wife 's doctor 's husband the chair .
the doctor bought your dentist 's mother 's cousin 's boss the bicycle .	the doctor cleaned your dentist 's mother 's cousin 's boss the bicycle .
my doctor showed my teacher 's daughter 's husband 's father the ship .	my doctor lost my teacher 's daughter 's husband 's father the ship .
your teacher gave your daughter 's teacher 's cousin 's son the boat .	your teacher moved your daughter 's teacher 's cousin 's son the boat .
Karen showed your father 's dad 's boss 's daughter the spoon .	Karen lost your father 's dad 's boss 's daughter the spoon .
my dentist sent my father 's dentist 's brother 's grandmother the picture .	my dentist lost my father 's dentist 's brother 's grandmother the picture .
my friend showed my sister 's cousin 's wife 's cousin the rug .	my friend shook my sister 's cousin 's wife 's cousin the rug .
the child showed your wife 's cousin 's husband 's mother the rug .	the child shook your wife 's cousin 's husband 's mother the rug .
John showed my mother 's brother 's dad 's wife the couch .	John shook my mother 's brother 's dad 's wife the couch .
Stephanie sent my daughter 's wife 's doctor 's dentist the glass .	Stephanie shook my daughter 's wife 's doctor 's dentist the glass .
Kevin bought my husband 's boss 's mom 's brother the hat .	Kevin cleaned my husband 's boss 's mom 's brother the hat .
the adult showed my husband 's sister 's mom 's dentist the door .	the adult held my husband 's sister 's mom 's dentist the door .
Elizabeth sent my daughter 's dentist 's mom 's dentist the hat .	Elizabeth kept my daughter 's dentist 's mom 's dentist the hat .
Susan bought my dentist 's dad 's dad 's wife the mirror .	Susan shook my dentist 's dad 's dad 's wife the mirror .
Renee gave my wife 's daughter 's doctor 's cousin the bag .	Renee shook my wife 's daughter 's doctor 's cousin the bag .
the adult sent my boss 's teacher 's father 's father the boat .	the adult held my boss 's teacher 's father 's father the boat .
Cindy bought my mom 's boss 's wife 's husband the truck .	Cindy lost my mom 's boss 's wife 's husband the truck .
the dancer showed your mom 's mother 's wife 's doctor the spoon .	the dancer moved your mom 's mother 's wife 's doctor the spoon .
the teacher showed my grandmother 's husband 's mother 's dad the doll .	the teacher held my grandmother 's husband 's mother 's dad the doll .
the patient gave your husband 's boss 's husband 's dad the ring .	the patient moved your husband 's boss 's husband 's dad the ring .
your dentist sent my mom 's dad 's friend 's friend the couch .	your dentist held my mom 's dad 's friend 's friend the couch .
your teacher showed my doctor 's cousin 's sister 's sister the shirt .	your teacher lost my doctor 's cousin 's sister 's sister the shirt .
Jennifer sent my dentist 's friend 's doctor 's son the shirt .	Jennifer moved my dentist 's friend 's doctor 's son the shirt .
the dancer showed your mom 's husband 's son 's mom the window .	the dancer moved your mom 's husband 's son 's mom the window .
my boss sent my brother 's daughter 's mom 's friend the hat .	my boss kept my brother 's daughter 's mom 's friend the hat .
Jason sent your husband 's son 's mother 's mother the car .	Jason dropped your husband 's son 's mother 's mother the car .
Ann showed my boss 's doctor 's daughter 's sister the car .	Ann cleaned my boss 's doctor 's daughter 's sister the car .
my cousin bought your dad 's doctor 's dentist 's cousin the window .	my cousin held your dad 's doctor 's dentist 's cousin the window .
my doctor gave your wife 's friend 's teacher 's mother the bed .	my doctor held your wife 's friend 's teacher 's mother the bed .
my cousin gave your wife 's grandmother 's friend 's brother the bag .	my cousin shook your wife 's grandmother 's friend 's brother the bag .
your doctor sent my cousin 's teacher 's son 's doctor the book .	your doctor moved my cousin 's teacher 's son 's doctor the book .
Melissa bought your sister 's father 's husband 's friend the bicycle .	Melissa moved your sister 's father 's husband 's friend the bicycle .
my cousin gave my son 's cousin 's daughter 's mom the picture .	my cousin held my son 's cousin 's daughter 's mom the picture .
my dentist sent your mom 's sister 's cousin 's brother the ship .	my dentist dropped your mom 's sister 's cousin 's brother the ship .
your friend sent my doctor 's mom 's father 's brother the rocket .	your friend held my doctor 's mom 's father 's brother the rocket .
the customer gave my son 's dad 's father 's mother the truck .	the customer moved my son 's dad 's father 's mother the truck .
Catherine bought my mom 's doctor 's mom 's boss the dish .	Catherine cleaned my mom 's doctor 's mom 's boss the dish .
my dentist showed your mom 's father 's cousin 's husband the ship .	my dentist dropped your mom 's father 's cousin 's husband the ship .
your doctor gave my brother 's daughter 's sister 's daughter the toy .	your doctor kept my brother 's daughter 's sister 's daughter the toy .
your dentist sent my mother 's brother 's daughter 's sister the toy .	your dentist held my mother 's brother 's daughter 's sister the toy .
the dancer showed your mom 's husband 's grandmother 's cousin the cup .	the dancer kept your mom 's husband 's grandmother 's cousin the cup .
the driver sent my mom 's brother 's son 's wife the dish .	the driver held my mom 's brother 's son 's wife the dish .
my boss showed your husband 's mom 's son 's grandmother the bottle .	my boss cleaned your husband 's mom 's son 's grandmother the bottle .
Steven sent my mom 's boss 's boss 's brother the chair .	Steven kept my mom 's boss 's boss 's brother the chair .
my doctor sent your grandmother 's daughter 's cousin 's wife the plate .	my doctor dropped your grandmother 's daughter 's cousin 's wife the plate .
your boss gave my friend 's dad 's grandmother 's father the shirt .	your boss cleaned my friend 's dad 's grandmother 's father the shirt .
the adult bought my father 's mom 's husband 's daughter the plane .	the adult shook my father 's mom 's husband 's daughter the plane .
Mark gave your dad 's father 's teacher 's doctor the ring .	Mark dropped your dad 's father 's teacher 's doctor the ring .
the dancer sent your dad 's grandmother 's boss 's daughter the book .	the dancer dropped your dad 's grandmother 's boss 's daughter the book .
Cindy gave my dentist 's mother 's teacher 's dad the plate .	Cindy dropped my dentist 's mother 's teacher 's dad the plate .
the person showed my brother 's husband 's mother 's son the ring .	the person shook my brother 's husband 's mother 's son the ring .
Liam bought your grandmother 's son 's grandmother 's mother the book .	Liam shook your grandmother 's son 's grandmother 's mother the book .
Laurie gave my father 's dentist 's grandmother 's daughter the mirror .	Laurie lost my father 's dentist 's grandmother 's daughter the mirror .
Jill sent my wife 's cousin 's dad 's teacher the toy .	Jill moved my wife 's cousin 's dad 's teacher the toy .
the child bought my friend 's cousin 's mom 's boss the car .	the child lost my friend 's cousin 's mom 's boss the car .
the child sent my father 's dad 's mom 's grandmother the box .	the child cleaned my father 's dad 's mom 's grandmother the box .
your teacher gave your cousin 's wife 's friend 's mom the rocket .	your teacher held your cousin 's wife 's friend 's mom the rocket .
the doctor bought your father 's daughter 's wife 's father the chair .	the doctor moved your father 's daughter 's wife 's father the chair .
the patient showed your cousin 's dentist 's daughter 's doctor the bottle .	the patient kept your cousin 's dentist 's daughter 's doctor the bottle .
the customer sent your dentist 's father 's son 's dad the shoe .	the customer cleaned your dentist 's father 's son 's dad the shoe .
Guy showed my brother 's cousin 's father 's grandmother the car .	Guy moved my brother 's cousin 's father 's grandmother the car .
Alice showed my dad 's son 's brother 's wife the mirror .	Alice shook my dad 's son 's brother 's wife the mirror .
your friend sent your grandmother 's dentist 's daughter 's dentist the book .	your friend lost your grandmother 's dentist 's daughter 's dentist the book .
your doctor gave your doctor 's cousin 's mother 's grandmother the shoe .	your doctor cleaned your doctor 's cousin 's mother 's grandmother the shoe .
the driver showed my son 's sister 's husband 's boss the fork .	the driver held my son 's sister 's husband 's boss the fork .
Linda showed my boss 's husband 's cousin 's brother the rug .	Linda lost my boss 's husband 's cousin 's brother the rug .
my friend showed your dentist 's mother 's friend 's mom the book .	my friend moved your dentist 's mother 's friend 's mom the book .
your dentist sent your dad 's brother 's boss 's brother the rocket .	your dentist held your dad 's brother 's boss 's brother the rocket .
Barbara gave your mom 's cousin 's friend 's brother the car .	Barbara held your mom 's cousin 's friend 's brother the car .
Donald showed my teacher 's mom 's dentist 's dad the mirror .	Donald moved my teacher 's mom 's dentist 's dad the mirror .
the dentist gave your dentist 's friend 's husband 's son the plate .	the dentist dropped your dentist 's friend 's husband 's son the plate .
the adult sent your dad 's husband 's wife 's brother the book .	the adult cleaned your dad 's husband 's wife 's brother the book .
Michael bought your grandmother 's wife 's father 's husband the car .	Michael shook your grandmother 's wife 's father 's husband the car .
the doctor gave your mother 's dentist 's daughter 's dad the bicycle .	the doctor cleaned your mother 's dentist 's daughter 's dad the bicycle .
Nina gave my cousin 's doctor 's mother 's boss the spoon .	Nina cleaned my cousin 's doctor 's mother 's boss the spoon .
Frank showed my mother 's wife 's dentist 's dentist the toy .	Frank lost my mother 's wife 's dentist 's dentist the toy .
my boss bought your boss 's teacher 's sister 's teacher the truck .	my boss moved your boss 's teacher 's sister 's teacher the truck .
the patient gave your sister 's son 's dentist 's father the fork .	the patient lost your sister 's son 's dentist 's father the fork .
Renee gave my dad 's son 's mom 's sister the hat .	Renee held my dad 's son 's mom 's sister the hat .
your dentist bought your doctor 's sister 's father 's mother the crayon .	your dentist dropped your doctor 's sister 's father 's mother the crayon .
your teacher gave your father 's mother 's wife 's dad the car .	your teacher held your father 's mother 's wife 's dad the car .
the driver bought my mom 's mom 's sister 's teacher the glass .	the driver moved my mom 's mom 's sister 's teacher the glass .
the teacher sent your mother 's sister 's wife 's wife the couch .	the teacher lost your mother 's sister 's wife 's wife the couch .
your dentist showed your wife 's teacher 's husband 's dad the bottle .	your dentist dropped your wife 's teacher 's husband 's dad the bottle .
Denise sent your brother 's daughter 's sister 's teacher the mirror .	Denise held your brother 's daughter 's sister 's teacher the mirror .
your doctor gave my husband 's dentist 's dad 's boss the doll .	your doctor moved my husband 's dentist 's dad 's boss the doll .
Sandra sent your grandmother 's daughter 's brother 's dad the rocket .	Sandra cleaned your grandmother 's daughter 's brother 's dad the rocket .
Martin gave my cousin 's father 's teacher 's brother the glass .	Martin held my cousin 's father 's teacher 's brother the glass .
Erin showed your teacher 's mom 's doctor 's doctor the bag .	Erin kept your teacher 's mom 's doctor 's doctor the bag .
the dancer bought my grandmother 's sister 's doctor 's husband the doll .	the dancer shook my grandmother 's sister 's doctor 's husband the doll .
Peter bought your grandmother 's doctor 's wife 's husband the cup .	Peter kept your grandmother 's doctor 's wife 's husband the cup .
my teacher gave your friend 's boss 's daughter 's son the bottle .	my teacher dropped your friend 's boss 's daughter 's son the bottle .
the doctor gave my boss 's husband 's husband 's friend the spoon .	the doctor shook my boss 's husband 's husband 's friend the spoon .
the driver gave your son 's dad 's husband 's boss the button .	the driver shook your son 's dad 's husband 's boss the button .
your dentist sent my son 's sister 's dentist 's teacher the fork .	your dentist dropped my son 's sister 's dentist 's teacher the fork .
my doctor sent my daughter 's father 's son 's wife the ring .	my doctor cleaned my daughter 's father 's son 's wife the ring .
the child showed my son 's brother 's dad 's husband the window .	the child cleaned my son 's brother 's dad 's husband the window .
your boss sent my cousin 's brother 's boss 's dentist the plane .	your boss cleaned my cousin 's brother 's boss 's dentist the plane .
the dancer gave your grandmother 's mother 's doctor 's grandmother the spoon .	the dancer held your grandmother 's mother 's doctor 's grandmother the spoon .
my doctor bought my father 's sister 's husband 's mom the plane .	my doctor moved my father 's sister 's husband 's mom the plane .
your boss sent my dentist 's father 's teacher 's teacher the plane .	your boss held my dentist 's father 's teacher 's teacher the plane .
Christopher bought your husband 's doctor 's husband 's son the car .	Christopher lost your husband 's doctor 's husband 's son the car .
the dentist sent your dad 's dentist 's daughter 's dentist the shirt .	the dentist lost your dad 's dentist 's daughter 's dentist the shirt .
Linda bought my boss 's brother 's teacher 's brother the button .	Linda lost my boss 's brother 's teacher 's brother the button .
Steve sent your dentist 's mother 's boss 's brother the rug .	Steve shook your dentist 's mother 's boss 's brother the rug .
Gregory showed your wife 's dad 's mother 's grandmother the book .	Gregory dropped your wife 's dad 's mother 's grandmother the book .
your doctor sent your grandmother 's son 's dentist 's teacher the couch .	your doctor moved your grandmother 's son 's dentist 's teacher the couch .
my boss showed my boss 's grandmother 's cousin 's doctor the button .	my boss cleaned my boss 's grandmother 's cousin 's doctor the button .
the adult showed your daughter 's cousin 's father 's sister the bowl .	the adult cleaned your daughter 's cousin 's father 's sister the bowl .
Laura bought my doctor 's brother 's grandmother 's dad the shoe .	Laura dropped my doctor 's brother 's grandmother 's dad the shoe .
the teacher showed your son 's dad 's mother 's grandmother the car .	the teacher lost your son 's dad 's mother 's grandmother the car .
John showed your boss 's son 's son 's brother the rocket .	John cleaned your boss 's son 's son 's brother the rocket .
the child bought your boss 's son 's doctor 's sister the shoe .	the child lost your boss 's son 's doctor 's sister the shoe .
the doctor showed my boss 's mother 's mom 's teacher the boat .	the doctor shook my boss 's mother 's mom 's teacher the boat .
the dentist gave your friend 's friend 's brother 's son the chair .	the dentist held your friend 's friend 's brother 's son the chair .
the doctor bought my friend 's boss 's wife 's mother the shirt .	the doctor shook my friend 's boss 's wife 's mother the shirt .
Mary showed your father 's daughter 's mother 's sister the door .	Mary dropped your father 's daughter 's mother 's sister the door .
the driver showed your daughter 's dentist 's mom 's cousin the rug .	the driver kept your daughter 's dentist 's mom 's cousin the rug .
Julie showed my cousin 's dentist 's brother 's dad the mirror .	Julie held my cousin 's dentist 's brother 's dad the mirror .
your dentist showed my dentist 's cousin 's brother 's dad the truck .	your dentist kept my dentist 's cousin 's brother 's dad the truck .
Frank showed my daughter 's sister 's sister 's daughter the book .	Frank moved my daughter 's sister 's sister 's daughter the book .
the dentist gave my daughter 's daughter 's dentist 's father the spoon .	the dentist moved my daughter 's daughter 's dentist 's father the spoon .
your dentist showed your mom 's mother 's father 's boss the mirror .	your dentist shook your mom 's mother 's father 's boss the mirror .
the adult bought your sister 's boss 's husband 's grandmother the spoon .	the adult shook your sister 's boss 's husband 's grandmother the spoon .
my dentist showed my son 's husband 's son 's mom the shoe .	my dentist lost my son 's husband 's son 's mom the shoe .
Brian gave my son 's teacher 's mom 's dad the cup .	Brian lost my son 's teacher 's mom 's dad the cup .
Ronald gave my dentist 's daughter 's dentist 's cousin the bed .	Ronald held my dentist 's daughter 's dentist 's cousin the bed .
your dentist gave your wife 's cousin 's grandmother 's sister the car .	your dentist kept your wife 's cousin 's grandmother 's sister the car .
the dancer sent my dad 's daughter 's mother 's friend the bicycle .	the dancer kept my dad 's daughter 's mother 's friend the bicycle .
my cousin sent your son 's friend 's brother 's husband the bag .	my cousin moved your son 's friend 's brother 's husband the bag .
Guy gave my boss 's son 's husband 's boss the couch .	Guy moved my boss 's son 's husband 's boss the couch .
your teacher sent your wife 's son 's doctor 's brother the toy .	your teacher moved your wife 's son 's doctor 's brother the toy .
your cousin sent your brother 's teacher 's grandmother 's friend the spoon .	your cousin kept your brother 's teacher 's grandmother 's friend the spoon .
your cousin gave my father 's boss 's brother 's cousin the button .	your cousin dropped my father 's boss 's brother 's cousin the button .
my boss sent your father 's teacher 's father 's husband the fork .	my boss cleaned your father 's teacher 's father 's husband the fork .
the adult bought your cousin 's teacher 's husband 's father the ring .	the adult cleaned your cousin 's teacher 's husband 's father the ring .
the dancer showed your daughter 's husband 's doctor 's son the window .	the dancer held your daughter 's husband 's doctor 's son the window .
the doctor sent my dentist 's cousin 's husband 's dad the fork .	the doctor lost my dentist 's cousin 's husband 's dad the fork .
your teacher bought your boss 's husband 's doctor 's husband the shoe .	your teacher dropped your boss 's husband 's doctor 's husband the shoe .
my dentist showed my son 's doctor 's mom 's husband the hat .	my dentist lost my son 's doctor 's mom 's husband the hat .
your cousin showed your cousin 's brother 's wife 's friend the candle .	your cousin dropped your cousin 's brother 's wife 's friend the candle .
Peter sent your grandmother 's sister 's daughter 's son the cup .	Peter moved your grandmother 's sister 's daughter 's son the cup .
the customer bought my sister 's cousin 's mother 's cousin the chair .	the customer held my sister 's cousin 's mother 's cousin the chair .
the customer gave my husband 's husband 's father 's grandmother the rug .	the customer moved my husband 's husband 's father 's grandmother the rug .
Richard bought your teacher 's mother 's friend 's doctor the shoe .	Richard kept your teacher 's mother 's friend 's doctor the shoe .
your friend showed your sister 's mother 's teacher 's doctor the shirt .	your friend held your sister 's mother 's teacher 's doctor the shirt .
the teacher gave your wife 's teacher 's friend 's friend the toy .	the teacher moved your wife 's teacher 's friend 's friend the toy .
Aaron sent your doctor 's brother 's teacher 's father the hat .	Aaron shook your doctor 's brother 's teacher 's father the hat .
Peter bought your sister 's sister 's father 's brother the mirror .	Peter lost your sister 's sister 's father 's brother the mirror .
your teacher gave your son 's mother 's daughter 's doctor the plate .	your teacher lost your son 's mother 's daughter 's doctor the plate .
your teacher bought my son 's husband 's son 's mother the door .	your teacher shook my son 's husband 's son 's mother the door .
the person showed your brother 's teacher 's father 's doctor the bottle .	the person lost your brother 's teacher 's father 's doctor the bottle .
my teacher sent my friend 's mom 's mother 's mom the book .	my teacher dropped my friend 's mom 's mother 's mom the book .
the patient gave my wife 's cousin 's husband 's cousin the plate .	the patient moved my wife 's cousin 's husband 's cousin the plate .
my dentist sent my boss 's son 's son 's wife the bag .	my dentist lost my boss 's son 's son 's wife the bag .
my teacher bought my cousin 's mom 's friend 's daughter the hat .	my teacher lost my cousin 's mom 's friend 's daughter the hat .
the driver showed your husband 's dentist 's sister 's boss the shirt .	the driver kept your husband 's dentist 's sister 's boss the shirt .
the child sent your father 's dentist 's dad 's mother the chair .	the child kept your father 's dentist 's dad 's mother the chair .
my friend bought your brother 's mom 's cousin 's mother the bowl .	my friend held your brother 's mom 's cousin 's mother the bowl .
the dancer showed my cousin 's husband 's brother 's mom the chair .	the dancer lost my cousin 's husband 's brother 's mom the chair .
your friend bought my sister 's dentist 's mom 's son the bed .	your friend held my sister 's dentist 's mom 's son the bed .
your cousin showed my father 's dad 's doctor 's teacher the mirror .	your cousin held my father 's dad 's doctor 's teacher the mirror .
Donna bought your mother 's sister 's brother 's grandmother the bottle .	Donna held your mother 's sister 's brother 's grandmother the bottle .
the child bought your husband 's husband 's sister 's mother the book .	the child lost your husband 's husband 's sister 's mother the book .
the person sent your mom 's friend 's friend 's cousin the cup .	the person shook your mom 's friend 's friend 's cousin the cup .
the dentist sent your brother 's father 's mom 's son the car .	the dentist dropped your brother 's father 's mom 's son the car .
the dancer gave my doctor 's son 's mom 's mother the shirt .	the dancer moved my doctor 's son 's mom 's mother the shirt .
my cousin gave my son 's teacher 's wife 's mother the picture .	my cousin cleaned my son 's teacher 's wife 's mother the picture .
the teacher gave your dad 's father 's dad 's friend the ring .	the teacher shook your dad 's father 's dad 's friend the ring .
my doctor sent your son 's doctor 's wife 's mom the couch .	my doctor moved your son 's doctor 's wife 's mom the couch .
your cousin sent your father 's brother 's sister 's friend the book .	your cousin kept your father 's brother 's sister 's friend the book .
Noah gave your grandmother 's dentist 's boss 's grandmother the box .	Noah cleaned your grandmother 's dentist 's boss 's grandmother the box .
my boss bought your dentist 's dentist 's friend 's dad the truck .	my boss dropped your dentist 's dentist 's friend 's dad the truck .
my boss bought my son 's friend 's son 's wife the picture .	my boss cleaned my son 's friend 's son 's wife the picture .
Carol sent my wife 's sister 's boss 's dentist the book .	Carol lost my wife 's sister 's boss 's dentist the book .
the dancer bought your son 's friend 's daughter 's cousin the couch .	the dancer dropped your son 's friend 's daughter 's cousin the couch .
Naomi gave your father 's son 's teacher 's grandmother the car .	Naomi held your father 's son 's teacher 's grandmother the car .
the patient bought my mom 's father 's brother 's doctor the plate .	the patient shook my mom 's father 's brother 's doctor the plate .
your cousin showed your sister 's brother 's husband 's daughter the bowl .	your cousin cleaned your sister 's brother 's husband 's daughter the bowl .
Aaron gave my teacher 's doctor 's grandmother 's son the book .	Aaron dropped my teacher 's doctor 's grandmother 's son the book .
the teacher showed my husband 's doctor 's sister 's son the dish .	the teacher moved my husband 's doctor 's sister 's son the dish .
Guy bought my wife 's doctor 's teacher 's wife the bowl .	Guy held my wife 's doctor 's teacher 's wife the bowl .
my cousin bought my mom 's sister 's dad 's teacher the candle .	my cousin shook my mom 's sister 's dad 's teacher the candle .
Steve bought your teacher 's dad 's daughter 's mom the rug .	Steve shook your teacher 's dad 's daughter 's mom the rug .
the child showed your mother 's mother 's grandmother 's sister the shoe .	the child lost your mother 's mother 's grandmother 's sister the shoe .
the teacher showed my friend 's cousin 's boss 's mom the bowl .	the teacher dropped my friend 's cousin 's boss 's mom the bowl .
Michael bought your husband 's mother 's teacher 's daughter the truck .	Michael lost your husband 's mother 's teacher 's daughter the truck .
the patient gave your wife 's boss 's father 's daughter the bowl .	the patient held your wife 's boss 's father 's daughter the bowl .
the driver sent my mother 's father 's son 's sister the toy .	the driver dropped my mother 's father 's son 's sister the toy .
your dentist showed my doctor 's wife 's sister 's doctor the glass .	your dentist lost my doctor 's wife 's sister 's doctor the glass .
the adult sent your wife 's dad 's mother 's boss the couch .	the adult moved your wife 's dad 's mother 's boss the couch .
the child showed your dad 's grandmother 's son 's mom the candle .	the child held your dad 's grandmother 's son 's mom the candle .
Kayla sent your dad 's son 's husband 's sister the fork .	Kayla cleaned your dad 's son 's husband 's sister the fork .
the child gave your sister 's friend 's wife 's husband the bicycle .	the child held your sister 's friend 's wife 's husband the bicycle .
my boss sent my doctor 's dentist 's sister 's friend the book .	my boss cleaned my doctor 's dentist 's sister 's friend the book .
Allison sent my husband 's wife 's boss 's cousin the doll .	Allison kept my husband 's wife 's boss 's cousin the doll .
the person sent your mother 's dad 's dad 's dentist the plate .	the person kept your mother 's dad 's dad 's dentist the plate .
the doctor bought your mother 's mother 's mother 's daughter the doll .	the doctor dropped your mother 's mother 's mother 's daughter the doll .
the dentist gave your dad 's friend 's mother 's mom the picture .	the dentist shook your dad 's friend 's mother 's mom the picture .
Donald showed your mother 's teacher 's mom 's sister the door .	Donald cleaned your mother 's teacher 's mom 's sister the door .
your doctor showed my daughter 's brother 's teacher 's father the bag .	your doctor kept my daughter 's brother 's teacher 's father the bag .
the adult showed my mom 's brother 's doctor 's teacher the couch .	the adult moved my mom 's brother 's doctor 's teacher the couch .
the driver gave your mother 's husband 's mother 's wife the picture .	the driver held your mother 's husband 's mother 's wife the picture .
your teacher sent your brother 's son 's son 's dentist the boat .	your teacher held your brother 's son 's son 's dentist the boat .
Kristen showed your son 's husband 's doctor 's mother the glass .	Kristen moved your son 's husband 's doctor 's mother the glass .
the teacher showed my wife 's son 's dad 's wife the toy .	the teacher cleaned my wife 's son 's dad 's wife the toy .
the driver bought my mom 's grandmother 's teacher 's dad the spoon .	the driver dropped my mom 's grandmother 's teacher 's dad the spoon .
Ronald gave my doctor 's son 's friend 's friend the door .	Ronald shook my doctor 's son 's friend 's friend the door .
the doctor sent your teacher 's grandmother 's mother 's wife the book .	the doctor kept your teacher 's grandmother 's mother 's wife the book .
the dentist gave your father 's sister 's brother 's daughter the door .	the dentist moved your father 's sister 's brother 's daughter the door .
my doctor sent your cousin 's father 's wife 's friend the glass .	my doctor shook your cousin 's father 's wife 's friend the glass .
my cousin bought my son 's doctor 's husband 's father the picture .	my cousin dropped my son 's doctor 's husband 's father the picture .
the teacher gave your brother 's brother 's cousin 's sister the couch .	the teacher kept your brother 's brother 's cousin 's sister the couch .
the dancer bought your mother 's friend 's mother 's son the car .	the dancer shook your mother 's friend 's mother 's son the car .
my cousin sent my daughter 's husband 's daughter 's mom the window .	my cousin held my daughter 's husband 's daughter 's mom the window .
Liam gave your doctor 's grandmother 's father 's grandmother the glass .	Liam shook your doctor 's grandmother 's father 's grandmother the glass .
Todd sent my dad 's mom 's daughter 's mother the bicycle .	Todd kept my dad 's mom 's daughter 's mother the bicycle .
your friend showed my friend 's daughter 's wife 's dad the truck .	your friend cleaned my friend 's daughter 's wife 's dad the truck .
Amelia showed my son 's brother 's grandmother 's husband the hat .	Amelia cleaned my son 's brother 's grandmother 's husband the hat .
my doctor showed your son 's daughter 's doctor 's friend the rocket .	my doctor shook your son 's daughter 's doctor 's friend the rocket .
my boss sent your husband 's husband 's father 's brother the bowl .	my boss lost your husband 's husband 's father 's brother the bowl .
the child sent your dentist 's dentist 's dentist 's cousin the book .	the child lost your dentist 's dentist 's dentist 's cousin the book .
the teacher sent your dad 's mom 's father 's boss the hat .	the teacher held your dad 's mom 's father 's boss the hat .
my cousin bought my grandmother 's wife 's boss 's father the toy .	my cousin cleaned my grandmother 's wife 's boss 's father the toy .
the doctor showed my mother 's mother 's husband 's mother the hat .	the doctor moved my mother 's mother 's husband 's mother the hat .
the dentist gave my doctor 's daughter 's boss 's friend the couch .	the dentist moved my doctor 's daughter 's boss 's friend the couch .
your dentist bought my mom 's doctor 's dentist 's mother the boat .	your dentist kept my mom 's doctor 's dentist 's mother the boat .
your doctor bought my daughter 's friend 's mom 's friend the rocket .	your doctor held my daughter 's friend 's mom 's friend the rocket .
Tracy showed your cousin 's boss 's dentist 's friend the dish .	Tracy held your cousin 's boss 's dentist 's friend the dish .
Marie sent my friend 's mom 's dentist 's father the plane .	Marie kept my friend 's mom 's dentist 's father the plane .
Nancy showed your wife 's brother 's teacher 's sister the ship .	Nancy dropped your wife 's brother 's teacher 's sister the ship .
Donna bought my sister 's friend 's grandmother 's brother the boat .	Donna cleaned my sister 's friend 's grandmother 's brother the boat .
Peter sent my father 's boss 's sister 's wife the fork .	Peter cleaned my father 's boss 's sister 's wife the fork .
the driver showed my husband 's wife 's wife 's doctor the hat .	the driver lost my husband 's wife 's wife 's doctor the hat .
my teacher sent your wife 's sister 's husband 's sister the truck .	my teacher held your wife 's sister 's husband 's sister the truck .
my cousin sent your friend 's mother 's doctor 's boss the chair .	my cousin dropped your friend 's mother 's doctor 's boss the chair .
Liam sent your grandmother 's doctor 's grandmother 's friend the bicycle .	Liam kept your grandmother 's doctor 's grandmother 's friend the bicycle .
the patient sent your daughter 's mom 's daughter 's cousin the cup .	the patient moved your daughter 's mom 's daughter 's cousin the cup .
Vanessa bought my sister 's mother 's son 's son the book .	Vanessa dropped my sister 's mother 's son 's son the book .
my dentist showed your dad 's son 's mom 's friend the bicycle .	my dentist shook your dad 's son 's mom 's friend the bicycle .
my cousin gave your teacher 's dentist 's wife 's husband the fork .	my cousin cleaned your teacher 's dentist 's wife 's husband the fork .
Jane showed your cousin 's dad 's husband 's cousin the rocket .	Jane held your cousin 's dad 's husband 's cousin the rocket .
George showed your friend 's mom 's friend 's cousin the door .	George kept your friend 's mom 's friend 's cousin the door .
your doctor sent my boss 's wife 's friend 's cousin the car .	your doctor moved my boss 's wife 's friend 's cousin the car .
your friend bought your cousin 's friend 's grandmother 's son the boat .	your friend kept your cousin 's friend 's grandmother 's son the boat .
your friend showed my doctor 's sister 's cousin 's doctor the bed .	your friend cleaned my doctor 's sister 's cousin 's doctor the bed .
my cousin gave my grandmother 's friend 's wife 's mom the bed .	my cousin held my grandmother 's friend 's wife 's mom the bed .
the customer gave my teacher 's grandmother 's grandmother 's grandmother the box .	the customer dropped my teacher 's grandmother 's grandmother 's grandmother the box .
the person showed my sister 's teacher 's boss 's cousin the bicycle .	the person cleaned my sister 's teacher 's boss 's cousin the bicycle .
the teacher sent my cousin 's husband 's boss 's friend the couch .	the teacher lost my cousin 's husband 's boss 's friend the couch .
the patient bought your mom 's wife 's cousin 's son the glass .	the patient cleaned your mom 's wife 's cousin 's son the glass .
the child sent my mom 's friend 's friend 's friend the toy .	the child shook my mom 's friend 's friend 's friend the toy .
the driver bought my doctor 's cousin 's husband 's daughter the bottle .	the driver dropped my doctor 's cousin 's husband 's daughter the bottle .
Catherine bought my dad 's wife 's mom 's grandmother the car .	Catherine shook my dad 's wife 's mom 's grandmother the car .
Renee bought my son 's dentist 's teacher 's wife the glass .	Renee dropped my son 's dentist 's teacher 's wife the glass .
Becca showed your sister 's dentist 's husband 's doctor the bicycle .	Becca moved your sister 's dentist 's husband 's doctor the bicycle .
your cousin showed your doctor 's husband 's friend 's sister the bed .	your cousin dropped your doctor 's husband 's friend 's sister the bed .
your boss sent my sister 's daughter 's father 's son the glass .	your boss cleaned my sister 's daughter 's father 's son the glass .
my teacher sent your friend 's wife 's dentist 's grandmother the glass .	my teacher lost your friend 's wife 's dentist 's grandmother the glass .
Rachel bought my father 's mom 's dad 's father the cup .	Rachel lost my father 's mom 's dad 's father the cup .
Julia bought my brother 's sister 's grandmother 's father the picture .	Julia moved my brother 's sister 's grandmother 's father the picture .
my boss sent my father 's teacher 's brother 's sister the window .	my boss held my father 's teacher 's brother 's sister the window .
Dan sent my dad 's wife 's husband 's son the bed .	Dan shook my dad 's wife 's husband 's son the bed .
my teacher gave your father 's teacher 's mother 's wife the shirt .	my teacher cleaned your father 's teacher 's mother 's wife the shirt .
the driver sent your husband 's husband 's grandmother 's grandmother the shoe .	the driver lost your husband 's husband 's grandmother 's grandmother the shoe .
my doctor sent your husband 's father 's mother 's mom the plane .	my doctor cleaned your husband 's father 's mother 's mom the plane .
my cousin showed my grandmother 's grandmother 's grandmother 's mother the chair .	my cousin kept my grandmother 's grandmother 's grandmother 's mother the chair .
my doctor sent my teacher 's dentist 's doctor 's sister the fork .	my doctor shook my teacher 's dentist 's doctor 's sister the fork .
the adult showed your father 's teacher 's teacher 's doctor the box .	the adult held your father 's teacher 's teacher 's doctor the box .
the dentist bought your son 's mother 's dentist 's boss the book .	the dentist cleaned your son 's mother 's dentist 's boss the book .
the doctor bought your boss 's friend 's brother 's teacher the candle .	the doctor held your boss 's friend 's brother 's teacher the candle .
the dancer gave your wife 's dad 's sister 's boss the rug .	the dancer dropped your wife 's dad 's sister 's boss the rug .
my cousin bought my dad 's father 's sister 's dad the plane .	my cousin shook my dad 's father 's sister 's dad the plane .
the adult bought my husband 's wife 's cousin 's friend the window .	the adult shook my husband 's wife 's cousin 's friend the window .
the child gave my husband 's mother 's husband 's wife the bowl .	the child shook my husband 's mother 's husband 's wife the bowl .
Leslie showed your sister 's mother 's friend 's wife the bottle .	Leslie shook your sister 's mother 's friend 's wife the bottle .
my boss bought my daughter 's dentist 's daughter 's daughter the rug .	my boss held my daughter 's dentist 's daughter 's daughter the rug .
your teacher showed your mom 's sister 's husband 's wife the button .	your teacher cleaned your mom 's sister 's husband 's wife the button .
your boss showed my husband 's cousin 's mom 's friend the book .	your boss kept my husband 's cousin 's mom 's friend the book .
Martin gave my doctor 's mother 's daughter 's dad the plane .	Martin cleaned my doctor 's mother 's daughter 's dad the plane .
your friend sent my father 's husband 's son 's daughter the book .	your friend lost my father 's husband 's son 's daughter the book .
Jill gave my teacher 's son 's wife 's doctor the car .	Jill shook my teacher 's son 's wife 's doctor the car .
Jennifer gave your cousin 's doctor 's son 's doctor the hat .	Jennifer lost your cousin 's doctor 's son 's doctor the hat .
the dentist sent my teacher 's father 's mother 's sister the chair .	the dentist cleaned my teacher 's father 's mother 's sister the chair .
my friend gave your doctor 's daughter 's dentist 's grandmother the bed .	my friend dropped your doctor 's daughter 's dentist 's grandmother the bed .
Frank gave your son 's father 's mother 's wife the bed .	Frank moved your son 's father 's mother 's wife the bed .
my teacher showed your doctor 's wife 's doctor 's mom the picture .	my teacher cleaned your doctor 's wife 's doctor 's mom the picture .
Laura showed your grandmother 's mother 's wife 's mom the box .	Laura shook your grandmother 's mother 's wife 's mom the box .
Patrick showed your husband 's mom 's husband 's mother the picture .	Patrick held your husband 's mom 's husband 's mother the picture .
the dentist sent my mother 's cousin 's wife 's husband the book .	the dentist moved my mother 's cousin 's wife 's husband the book .
my teacher bought your grandmother 's dad 's teacher 's husband the dish .	my teacher lost your grandmother 's dad 's teacher 's husband the dish .
my teacher bought my mother 's cousin 's father 's mother the book .	my teacher lost my mother 's cousin 's father 's mother the book .
Thomas gave my boss 's brother 's son 's doctor the bed .	Thomas lost my boss 's brother 's son 's doctor the bed .
Brian showed your doctor 's cousin 's friend 's grandmother the rug .	Brian shook your doctor 's cousin 's friend 's grandmother the rug .
my cousin bought your wife 's daughter 's brother 's dentist the candle .	my cousin cleaned your wife 's daughter 's brother 's dentist the candle .
Christopher gave my brother 's brother 's sister 's dentist the book .	Christopher moved my brother 's brother 's sister 's dentist the book .
your friend showed your cousin 's grandmother 's daughter 's son the bed .	your friend held your cousin 's grandmother 's daughter 's son the bed .
Linda bought your mother 's boss 's doctor 's doctor the button .	Linda moved your mother 's boss 's doctor 's doctor the button .
my boss showed your friend 's teacher 's friend 's husband the book .	my boss lost your friend 's teacher 's friend 's husband the book .
the doctor gave my dad 's teacher 's boss 's grandmother the button .	the doctor dropped my dad 's teacher 's boss 's grandmother the button .
my doctor sent your wife 's mom 's cousin 's son the bicycle .	my doctor lost your wife 's mom 's cousin 's son the bicycle .
Donald sent my husband 's son 's sister 's doctor the bowl .	Donald moved my husband 's son 's sister 's doctor the bowl .
Travis showed your dad 's brother 's cousin 's wife the crayon .	Travis shook your dad 's brother 's cousin 's wife the crayon .
the dancer showed your teacher 's wife 's doctor 's friend the window .	the dancer kept your teacher 's wife 's doctor 's friend the window .
the dancer gave my sister 's brother 's son 's doctor the rug .	the dancer moved my sister 's brother 's son 's doctor the rug .
your friend sent your boss 's mom 's mother 's daughter the plate .	your friend shook your boss 's mom 's mother 's daughter the plate .
my teacher sent my doctor 's husband 's father 's dad the doll .	my teacher kept my doctor 's husband 's father 's dad the doll .
Brian sent my friend 's brother 's sister 's mom the toy .	Brian lost my friend 's brother 's sister 's mom the toy .
my dentist sent your father 's mom 's teacher 's boss the car .	my dentist moved your father 's mom 's teacher 's boss the car .
Tracy sent your son 's sister 's grandmother 's mother the fork .	Tracy held your son 's sister 's grandmother 's mother the fork .
my dentist sent my friend 's friend 's cousin 's mother the shirt .	my dentist dropped my friend 's friend 's cousin 's mother the shirt .
Catherine gave my father 's husband 's dad 's mom the plate .	Catherine lost my father 's husband 's dad 's mom the plate .
the doctor sent your husband 's dad 's brother 's mom the box .	the doctor moved your husband 's dad 's brother 's mom the box .
your doctor showed your brother 's mom 's cousin 's doctor the cup .	your doctor cleaned your brother 's mom 's cousin 's doctor the cup .
your doctor sent my dentist 's dentist 's brother 's grandmother the hat .	your doctor moved my dentist 's dentist 's brother 's grandmother the hat .
the teacher sent your dentist 's doctor 's mother 's sister the fork .	the teacher kept your dentist 's doctor 's mother 's sister the fork .
Robert showed your dentist 's mom 's daughter 's daughter the shirt .	Robert moved your dentist 's mom 's daughter 's daughter the shirt .
Emily showed my son 's grandmother 's mom 's mother the cup .	Emily shook my son 's grandmother 's mom 's mother the cup .
the dentist showed your dad 's doctor 's son 's mom the box .	the dentist held your dad 's doctor 's son 's mom the box .
Brett gave my son 's son 's sister 's husband the bicycle .	Brett moved my son 's son 's sister 's husband the bicycle .
my teacher bought my friend 's mother 's sister 's friend the candle .	my teacher lost my friend 's mother 's sister 's friend the candle .
the driver sent my brother 's dad 's dentist 's mother the shirt .	the driver held my brother 's dad 's dentist 's mother the shirt .
the person gave your brother 's boss 's father 's doctor the dish .	the person dropped your brother 's boss 's father 's doctor the dish .
the adult gave your sister 's cousin 's grandmother 's doctor the bowl .	the adult dropped your sister 's cousin 's grandmother 's doctor the bowl .
Renee showed my teacher 's cousin 's brother 's dentist the cup .	Renee kept my teacher 's cousin 's brother 's dentist the cup .
Sally bought your boss 's son 's wife 's father the cup .	Sally dropped your boss 's son 's wife 's father the cup .
David showed your grandmother 's cousin 's dentist 's mother the bottle .	David dropped your grandmother 's cousin 's dentist 's mother the bottle .
my boss gave your son 's doctor 's mother 's boss the ring .	my boss held your son 's doctor 's mother 's boss the ring .
Mary sent my father 's husband 's mother 's mother the toy .	Mary kept my father 's husband 's mother 's mother the toy .
my boss sent your teacher 's dad 's boss 's boss the shoe .	my boss kept your teacher 's dad 's boss 's boss the shoe .
Tracy showed my dad 's friend 's grandmother 's mom the cup .	Tracy cleaned my dad 's friend 's grandmother 's mom the cup .
the person gave my grandmother 's boss 's teacher 's doctor the glass .	the person shook my grandmother 's boss 's teacher 's doctor the glass .
Donna showed your friend 's boss 's grandmother 's brother the hat .	Donna lost your friend 's boss 's grandmother 's brother the hat .
the patient showed your dad 's friend 's dad 's sister the picture .	the patient cleaned your dad 's friend 's dad 's sister the picture .
Carol gave my grandmother 's mom 's friend 's wife the boat .	Carol shook my grandmother 's mom 's friend 's wife the boat .
the doctor showed your mother 's daughter 's husband 's boss the plane .	the doctor lost your mother 's daughter 's husband 's boss the plane .
the driver showed my father 's wife 's dentist 's daughter the shirt .	the driver cleaned my father 's wife 's dentist 's daughter the shirt .
Steve showed my father 's grandmother 's brother 's friend the bottle .	Steve cleaned my father 's grandmother 's brother 's friend the bottle .
Cindy sent your dad 's teacher 's sister 's dad the car .	Cindy moved your dad 's teacher 's sister 's dad the car .
the driver gave your boss 's wife 's doctor 's sister the rocket .	the driver lost your boss 's wife 's doctor 's sister the rocket .
your dentist gave your teacher 's son 's wife 's sister the boat .	your dentist held your teacher 's son 's wife 's sister the boat .
Becky sent my daughter 's mother 's daughter 's wife the truck .	Becky lost my daughter 's mother 's daughter 's wife the truck .
my boss bought my brother 's husband 's dentist 's brother the book .	my boss kept my brother 's husband 's dentist 's brother the book .
my cousin showed your mother 's daughter 's father 's brother the couch .	my cousin moved your mother 's daughter 's father 's brother the couch .
the adult sent my mom 's doctor 's teacher 's son the chair .	the adult cleaned my mom 's doctor 's teacher 's son the chair .
Julie gave my sister 's wife 's teacher 's mother the button .	Julie kept my sister 's wife 's teacher 's mother the button .
Amelia showed my mom 's brother 's father 's mother the chair .	Amelia dropped my mom 's brother 's father 's mother the chair .
my teacher gave my mother 's friend 's dad 's sister the bed .	my teacher kept my mother 's friend 's dad 's sister the bed .
the dentist bought my friend 's dentist 's daughter 's friend the candle .	the dentist cleaned my friend 's dentist 's daughter 's friend the candle .
the adult bought my cousin 's wife 's cousin 's wife the window .	the adult shook my cousin 's wife 's cousin 's wife the window .
Dan showed your sister 's daughter 's sister 's husband the bottle .	Dan held your sister 's daughter 's sister 's husband the bottle .
Robert sent your mother 's dentist 's mother 's friend the car .	Robert moved your mother 's dentist 's mother 's friend the car .
Jerry showed my friend 's son 's wife 's mother the bag .	Jerry cleaned my friend 's son 's wife 's mother the bag .
the dentist bought your son 's doctor 's daughter 's son the plate .	the dentist dropped your son 's doctor 's daughter 's son the plate .
Michael showed my grandmother 's wife 's brother 's brother the bed .	Michael moved my grandmother 's wife 's brother 's brother the bed .
my teacher showed your son 's mom 's brother 's mom the door .	my teacher lost your son 's mom 's brother 's mom the door .
my dentist bought your mom 's mom 's mother 's father the shoe .	my dentist held your mom 's mom 's mother 's father the shoe .
your boss showed my doctor 's sister 's cousin 's boss the rug .	your boss moved my doctor 's sister 's cousin 's boss the rug .
Daniel gave your dentist 's cousin 's dentist 's mom the plane .	Daniel shook your dentist 's cousin 's dentist 's mom the plane .
the customer showed my dentist 's mother 's dad 's mom the bed .	the customer held my dentist 's mother 's dad 's mom the bed .
April sent your sister 's doctor 's cousin 's brother the button .	April moved your sister 's doctor 's cousin 's brother the button .
your doctor sent my son 's wife 's brother 's cousin the couch .	your doctor shook my son 's wife 's brother 's cousin the couch .
Joseph sent your cousin 's wife 's dad 's wife the chair .	Joseph shook your cousin 's wife 's dad 's wife the chair .
Rebecca bought your daughter 's brother 's teacher 's mom the spoon .	Rebecca held your daughter 's brother 's teacher 's mom the spoon .
the patient sent your father 's father 's brother 's wife the boat .	the patient shook your father 's father 's brother 's wife the boat .
the doctor gave my boss 's mother 's doctor 's wife the candle .	the doctor shook my boss 's mother 's doctor 's wife the candle .
Stephanie gave my friend 's doctor 's daughter 's father the couch .	Stephanie held my friend 's doctor 's daughter 's father the couch .
Jennifer showed your dad 's daughter 's friend 's dad the bag .	Jennifer dropped your dad 's daughter 's friend 's dad the bag .
my teacher sent my cousin 's teacher 's mom 's husband the bed .	my teacher cleaned my cousin 's teacher 's mom 's husband the bed .
your friend showed my mom 's mom 's friend 's daughter the bicycle .	your friend shook my mom 's mom 's friend 's daughter the bicycle .
Sandra bought my teacher 's mom 's friend 's father the glass .	Sandra held my teacher 's mom 's friend 's father the glass .
your dentist sent your boss 's mother 's boss 's boss the bicycle .	your dentist kept your boss 's mother 's boss 's boss the bicycle .
Allison sent my brother 's teacher 's grandmother 's teacher the car .	Allison kept my brother 's teacher 's grandmother 's teacher the car .
the teacher showed your mom 's cousin 's daughter 's sister the shirt .	the teacher kept your mom 's cousin 's daughter 's sister the shirt .
Robert bought your sister 's daughter 's doctor 's cousin the chair .	Robert cleaned your sister 's daughter 's doctor 's cousin the chair .
the dancer showed my cousin 's wife 's boss 's sister the bottle .	the dancer moved my cousin 's wife 's boss 's sister the bottle .
the driver gave your wife 's daughter 's father 's doctor the truck .	the driver shook your wife 's daughter 's father 's doctor the truck .
the teacher sent my son 's mother 's wife 's friend the book .	the teacher lost my son 's mother 's wife 's friend the book .
my doctor showed my son 's doctor 's husband 's father the rocket .	my doctor kept my son 's doctor 's husband 's father the rocket .
my cousin gave my doctor 's brother 's boss 's daughter the car .	my cousin shook my doctor 's brother 's boss 's daughter the car .
Ronald sent my grandmother 's brother 's dad 's father the chair .	Ronald held my grandmother 's brother 's dad 's father the chair .
the teacher gave your dad 's brother 's cousin 's husband the bicycle .	the teacher moved your dad 's brother 's cousin 's husband the bicycle .
Nicole sent my teacher 's husband 's cousin 's dad the bag .	Nicole held my teacher 's husband 's cousin 's dad the bag .
my teacher showed your husband 's dentist 's son 's friend the ship .	my teacher shook your husband 's dentist 's son 's friend the ship .
your cousin sent my father 's boss 's mom 's grandmother the bowl .	your cousin cleaned my father 's boss 's mom 's grandmother the bowl .
my cousin sent my cousin 's dentist 's brother 's mother the boat .	my cousin lost my cousin 's dentist 's brother 's mother the boat .
the doctor gave your son 's boss 's sister 's sister the button .	the doctor shook your son 's boss 's sister 's sister the button .
the driver showed my father 's doctor 's grandmother 's grandmother the window .	the driver kept my father 's doctor 's grandmother 's grandmother the window .
Nicole bought your husband 's wife 's brother 's cousin the bed .	Nicole shook your husband 's wife 's brother 's cousin the bed .
Emily bought my grandmother 's dad 's dentist 's doctor the spoon .	Emily kept my grandmother 's dad 's dentist 's doctor the spoon .
my friend gave your cousin 's grandmother 's dentist 's father the doll .	my friend kept your cousin 's grandmother 's dentist 's father the doll .
Kristen gave your sister 's grandmother 's friend 's father the truck .	Kristen moved your sister 's grandmother 's friend 's father the truck .
the dancer sent your dad 's father 's cousin 's sister the plane .	the dancer moved your dad 's father 's cousin 's sister the plane .
your friend bought your son 's dad 's mother 's sister the rug .	your friend moved your son 's dad 's mother 's sister the rug .
Todd bought my sister 's mother 's friend 's daughter the bicycle .	Todd moved my sister 's mother 's friend 's daughter the bicycle .
the teacher sent my daughter 's boss 's teacher 's dentist the hat .	the teacher cleaned my daughter 's boss 's teacher 's dentist the hat .
the customer sent your cousin 's father 's wife 's cousin the couch .	the customer kept your cousin 's father 's wife 's cousin the couch .
the dancer sent your sister 's doctor 's husband 's mother the box .	the dancer moved your sister 's doctor 's husband 's mother the box .
the dentist gave your dentist 's father 's dad 's dad the glass .	the dentist kept your dentist 's father 's dad 's dad the glass .
Emily sent your daughter 's mother 's cousin 's daughter the book .	Emily dropped your daughter 's mother 's cousin 's daughter the book .
the patient showed my dentist 's father 's teacher 's daughter the ship .	the patient held my dentist 's father 's teacher 's daughter the ship .
Alexander gave your dentist 's husband 's sister 's father the plate .	Alexander moved your dentist 's husband 's sister 's father the plate .
the doctor showed your doctor 's daughter 's father 's sister the dish .	the doctor kept your doctor 's daughter 's father 's sister the dish .
Ronald bought my sister 's husband 's father 's mother the book .	Ronald held my sister 's husband 's father 's mother the book .
Amelia gave my boss 's sister 's dentist 's teacher the mirror .	Amelia kept my boss 's sister 's dentist 's teacher the mirror .
the teacher bought your dentist 's wife 's father 's sister the truck .	the teacher shook your dentist 's wife 's father 's sister the truck .
the adult sent my son 's dentist 's daughter 's mother the spoon .	the adult moved my son 's dentist 's daughter 's mother the spoon .
the patient gave my father 's teacher 's dentist 's doctor the spoon .	the patient moved my father 's teacher 's dentist 's doctor the spoon .
Rachel showed my father 's husband 's husband 's brother the plane .	Rachel dropped my father 's husband 's husband 's brother the plane .
Mark gave my cousin 's boss 's dad 's husband the window .	Mark moved my cousin 's boss 's dad 's husband the window .
the dentist gave your dad 's doctor 's mother 's dentist the boat .	the dentist cleaned your dad 's doctor 's mother 's dentist the boat .
Sarah bought your mom 's mom 's sister 's friend the bicycle .	Sarah dropped your mom 's mom 's sister 's friend the bicycle .
the dentist showed your doctor 's mother 's son 's dad the toy .	the dentist kept your doctor 's mother 's son 's dad the toy .
Jennifer gave your dad 's father 's brother 's teacher the glass .	Jennifer shook your dad 's father 's brother 's teacher the glass .
my cousin sent my father 's mother 's mom 's cousin the bottle .	my cousin held my father 's mother 's mom 's cousin the bottle .
Michael sent your cousin 's cousin 's grandmother 's dentist the book .	Michael held your cousin 's cousin 's grandmother 's dentist the book .
my dentist bought your boss 's dentist 's wife 's grandmother the shoe .	my dentist lost your boss 's dentist 's wife 's grandmother the shoe .
Jason gave my cousin 's sister 's father 's son the cup .	Jason shook my cousin 's sister 's father 's son the cup .
Carl gave your sister 's daughter 's cousin 's son the bottle .	Carl moved your sister 's daughter 's cousin 's son the bottle .
the dancer gave your doctor 's mother 's boss 's sister the window .	the dancer cleaned your doctor 's mother 's boss 's sister the window .
the patient gave my boss 's mother 's father 's friend the couch .	the patient dropped my boss 's mother 's father 's friend the couch .
your cousin showed my teacher 's cousin 's son 's wife the glass .	your cousin cleaned my teacher 's cousin 's son 's wife the glass .
the teacher gave my father 's daughter 's doctor 's friend the dish .	the teacher shook my father 's daughter 's doctor 's friend the dish .
my boss bought your dad 's boss 's boss 's wife the car .	my boss kept your dad 's boss 's boss 's wife the car .
the patient showed your mother 's cousin 's brother 's sister the toy .	the patient kept your mother 's cousin 's brother 's sister the toy .
Julie sent my boss 's husband 's son 's grandmother the mirror .	Julie dropped my boss 's husband 's son 's grandmother the mirror .
my doctor sent my dentist 's mom 's daughter 's mom the plate .	my doctor held my dentist 's mom 's daughter 's mom the plate .
Joseph sent your wife 's boss 's sister 's brother the plate .	Joseph held your wife 's boss 's sister 's brother the plate .
the teacher showed my brother 's teacher 's sister 's son the car .	the teacher held my brother 's teacher 's sister 's son the car .
Patrick gave your mom 's brother 's boss 's cousin the book .	Patrick held your mom 's brother 's boss 's cousin the book .
the driver bought my mom 's son 's grandmother 's son the truck .	the driver dropped my mom 's son 's grandmother 's son the truck .
the person gave your mother 's sister 's friend 's mother the cup .	the person kept your mother 's sister 's friend 's mother the cup .
the dancer sent my husband 's daughter 's son 's friend the ring .	the dancer kept my husband 's daughter 's son 's friend the ring .
my boss sent my dad 's mom 's dentist 's mom the box .	my boss cleaned my dad 's mom 's dentist 's mom the box .
the person gave your dentist 's boss 's father 's sister the couch .	the person shook your dentist 's boss 's father 's sister the couch .
my teacher showed my teacher 's daughter 's grandmother 's husband the car .	my teacher moved my teacher 's daughter 's grandmother 's husband the car .
