the doctor showed your doctor 's dentist 's brother 's brother 's teacher the plate .	the doctor dropped your doctor 's dentist 's brother 's brother 's teacher the plate .
the patient gave my mom 's grandmother 's friend 's daughter 's wife the door .	the patient cleaned my mom 's grandmother 's friend 's daughter 's wife the door .
my friend gave my son 's cousin 's husband 's boss 's mom the boat .	my friend dropped my son 's cousin 's husband 's boss 's mom the boat .
my cousin gave my husband 's mother 's father 's dad 's mother the rocket .	my cousin dropped my husband 's mother 's father 's dad 's mother the rocket .
Mary gave my mom 's doctor 's dad 's husband 's teacher the plate .	Mary dropped my mom 's doctor 's dad 's husband 's teacher the plate .
my doctor showed my dentist 's grandmother 's sister 's mother 's dentist the rocket .	my doctor shook my dentist 's grandmother 's sister 's mother 's dentist the rocket .
Laurie showed my daughter 's doctor 's daughter 's son 's grandmother the dish .	Laurie shook my daughter 's doctor 's daughter 's son 's grandmother the dish .
Amy showed your doctor 's mother 's mother 's daughter 's brother the book .	Amy moved your doctor 's mother 's mother 's daughter 's brother the book .
Joseph gave your friend 's son 's friend 's mother 's doctor the crayon .	Joseph cleaned your friend 's son 's friend 's mother 's doctor the crayon .
your friend bought your brother 's grandmother 's dentist 's brother 's father the toy .	your friend moved your brother 's grandmother 's dentist 's brother 's father the toy .
Amy showed my dad 's doctor 's brother 's cousin 's mom the toy .	Amy cleaned my dad 's doctor 's brother 's cousin 's mom the toy .
your cousin showed your husband 's daughter 's dad 's grandmother 's daughter the car .	your cousin cleaned your husband 's daughter 's dad 's grandmother 's daughter the car .
my boss showed my brother 's grandmother 's mom 's grandmother 's mom the picture .	my boss shook my brother 's grandmother 's mom 's grandmother 's mom the picture .
Jerry bought my cousin 's doctor 's dad 's teacher 's mother the bottle .	Jerry shook my cousin 's doctor 's dad 's teacher 's mother the bottle .
the patient bought your dentist 's brother 's daughter 's teacher 's dad the door .	the patient held your dentist 's brother 's daughter 's teacher 's dad the door .
the adult gave your mother 's brother 's husband 's doctor 's cousin the shirt .	the adult cleaned your mother 's brother 's husband 's doctor 's cousin the shirt .
my friend showed your sister 's boss 's doctor 's boss 's boss the button .	my friend cleaned your sister 's boss 's doctor 's boss 's boss the button .
the adult bought my cousin 's cousin 's mom 's wife 's daughter the bowl .	the adult moved my cousin 's cousin 's mom 's wife 's daughter the bowl .
Alexander gave my mother 's husband 's dentist 's doctor 's friend the truck .	Alexander lost my mother 's husband 's dentist 's doctor 's friend the truck .
your cousin bought your father 's brother 's dad 's wife 's teacher the book .	your cousin moved your father 's brother 's dad 's wife 's teacher the book .
Laura showed my boss 's friend 's mom 's teacher 's dad the car .	Laura kept my boss 's friend 's mom 's teacher 's dad the car .
Lisa showed my cousin 's sister 's son 's mom 's father the car .	Lisa cleaned my cousin 's sister 's son 's mom 's father the car .
my friend gave my dad 's dentist 's teacher 's husband 's mother the truck .	my friend cleaned my dad 's dentist 's teacher 's husband 's mother the truck .
Adam sent my daughter 's brother 's boss 's boss 's cousin the bicycle .	Adam shook my daughter 's brother 's boss 's boss 's cousin the bicycle .
your friend sent my wife 's wife 's brother 's dad 's teacher the bed .	your friend kept my wife 's wife 's brother 's dad 's teacher the bed .
the doctor sent your son 's mom 's brother 's dad 's sister the car .	the doctor kept your son 's mom 's brother 's dad 's sister the car .
your doctor bought your friend 's mother 's brother 's boss 's mom the bowl .	your doctor shook your friend 's mother 's brother 's boss 's mom the bowl .
Jessica bought your mother 's boss 's son 's grandmother 's cousin the book .	Jessica held your mother 's boss 's son 's grandmother 's cousin the book .
Guy showed my dentist 's son 's son 's sister 's mother the bed .	Guy dropped my dentist 's son 's son 's sister 's mother the bed .
your dentist bought your friend 's sister 's husband 's son 's sister the plane .	your dentist moved your friend 's sister 's husband 's son 's sister the plane .
the child bought your mom 's mom 's mother 's dad 's teacher the doll .	the child cleaned your mom 's mom 's mother 's dad 's teacher the doll .
my friend showed my dentist 's wife 's dentist 's boss 's doctor the bottle .	my friend shook my dentist 's wife 's dentist 's boss 's doctor the bottle .
the adult bought your husband 's daughter 's friend 's dentist 's sister the ring .	the adult moved your husband 's daughter 's friend 's dentist 's sister the ring .
the patient bought your daughter 's friend 's daughter 's wife 's dad the couch .	the patient shook your daughter 's friend 's daughter 's wife 's dad the couch .
Donald sent my boss 's mom 's husband 's husband 's brother the mirror .	Donald kept my boss 's mom 's husband 's husband 's brother the mirror .
Steve sent my son 's dad 's cousin 's brother 's son the ship .	Steve moved my son 's dad 's cousin 's brother 's son the ship .
the doctor showed your boss 's father 's husband 's brother 's boss the plane .	the doctor shook your boss 's father 's husband 's brother 's boss the plane .
my cousin showed your cousin 's son 's father 's wife 's doctor the fork .	my cousin kept your cousin 's son 's father 's wife 's doctor the fork .
the child showed my cousin 's cousin 's son 's son 's mom the spoon .	the child moved my cousin 's cousin 's son 's son 's mom the spoon .
Paul showed your sister 's mother 's dentist 's teacher 's husband the shoe .	Paul shook your sister 's mother 's dentist 's teacher 's husband the shoe .
Aaron gave your husband 's sister 's wife 's mother 's brother the ship .	Aaron cleaned your husband 's sister 's wife 's mother 's brother the ship .
Wendy gave your wife 's mother 's friend 's grandmother 's cousin the couch .	Wendy lost your wife 's mother 's friend 's grandmother 's cousin the couch .
your teacher bought your teacher 's wife 's sister 's brother 's cousin the bicycle .	your teacher moved your teacher 's wife 's sister 's brother 's cousin the bicycle .
my doctor bought my cousin 's grandmother 's mom 's wife 's friend the door .	my doctor held my cousin 's grandmother 's mom 's wife 's friend the door .
Ann sent your father 's mom 's mother 's mom 's grandmother the picture .	Ann lost your father 's mom 's mother 's mom 's grandmother the picture .
the patient bought my dad 's sister 's grandmother 's grandmother 's friend the truck .	the patient shook my dad 's sister 's grandmother 's grandmother 's friend the truck .
my cousin showed your son 's sister 's teacher 's wife 's grandmother the book .	my cousin shook your son 's sister 's teacher 's wife 's grandmother the book .
the teacher showed my daughter 's daughter 's sister 's son 's dentist the cup .	the teacher kept my daughter 's daughter 's sister 's son 's dentist the cup .
the customer gave my doctor 's dad 's son 's dentist 's dad the book .	the customer dropped my doctor 's dad 's son 's dentist 's dad the book .
Rebecca sent my sister 's mother 's cousin 's son 's grandmother the toy .	Rebecca lost my sister 's mother 's cousin 's son 's grandmother the toy .
my dentist sent your sister 's doctor 's mom 's sister 's son the rug .	my dentist cleaned your sister 's doctor 's mom 's sister 's son the rug .
the teacher gave my dentist 's doctor 's daughter 's teacher 's husband the glass .	the teacher lost my dentist 's doctor 's daughter 's teacher 's husband the glass .
the adult sent your friend 's father 's sister 's mother 's father the bed .	the adult kept your friend 's father 's sister 's mother 's father the bed .
your friend bought my doctor 's wife 's daughter 's grandmother 's father the bottle .	your friend held my doctor 's wife 's daughter 's grandmother 's father the bottle .
Dan gave my teacher 's friend 's wife 's boss 's wife the spoon .	Dan held my teacher 's friend 's wife 's boss 's wife the spoon .
your cousin sent your father 's father 's mother 's dad 's doctor the shirt .	your cousin lost your father 's father 's mother 's dad 's doctor the shirt .
my friend showed my dentist 's sister 's dentist 's son 's dad the couch .	my friend lost my dentist 's sister 's dentist 's son 's dad the couch .
Nina bought my daughter 's doctor 's father 's doctor 's daughter the shoe .	Nina held my daughter 's doctor 's father 's doctor 's daughter the shoe .
the dentist gave your husband 's dentist 's cousin 's teacher 's cousin the crayon .	the dentist shook your husband 's dentist 's cousin 's teacher 's cousin the crayon .
Vanessa showed your friend 's son 's cousin 's son 's son the boat .	Vanessa dropped your friend 's son 's cousin 's son 's son the boat .
the dentist bought your sister 's mother 's friend 's boss 's teacher the chair .	the dentist dropped your sister 's mother 's friend 's boss 's teacher the chair .
your cousin sent your father 's cousin 's grandmother 's cousin 's husband the boat .	your cousin cleaned your father 's cousin 's grandmother 's cousin 's husband the boat .
my teacher gave your grandmother 's son 's wife 's mom 's friend the book .	my teacher dropped your grandmother 's son 's wife 's mom 's friend the book .
Eric bought your cousin 's husband 's dad 's boss 's dad the plane .	Eric moved your cousin 's husband 's dad 's boss 's dad the plane .
my cousin gave your mom 's dad 's mom 's friend 's husband the shoe .	my cousin lost your mom 's dad 's mom 's friend 's husband the shoe .
my friend sent your mom 's cousin 's dentist 's grandmother 's husband the ship .	my friend dropped your mom 's cousin 's dentist 's grandmother 's husband the ship .
your friend sent my mom 's son 's dentist 's dentist 's mother the cup .	your friend moved my mom 's son 's dentist 's dentist 's mother the cup .
the person showed your boss 's friend 's brother 's dad 's cousin the cup .	the person moved your boss 's friend 's brother 's dad 's cousin the cup .
the adult gave my mother 's mother 's grandmother 's husband 's wife the candle .	the adult shook my mother 's mother 's grandmother 's husband 's wife the candle .
Steven bought your dentist 's boss 's sister 's sister 's mother the book .	Steven shook your dentist 's boss 's sister 's sister 's mother the book .
the child showed my boss 's teacher 's sister 's dentist 's grandmother the bed .	the child kept my boss 's teacher 's sister 's dentist 's grandmother the bed .
my dentist showed my dentist 's wife 's doctor 's dad 's dentist the book .	my dentist shook my dentist 's wife 's doctor 's dad 's dentist the book .
Travis showed your husband 's brother 's wife 's son 's sister the plane .	Travis cleaned your husband 's brother 's wife 's son 's sister the plane .
Rebecca gave your sister 's daughter 's cousin 's mother 's boss the truck .	Rebecca kept your sister 's daughter 's cousin 's mother 's boss the truck .
Deborah showed your husband 's husband 's friend 's boss 's cousin the plane .	Deborah moved your husband 's husband 's friend 's boss 's cousin the plane .
the patient bought your mom 's cousin 's wife 's daughter 's daughter the fork .	the patient moved your mom 's cousin 's wife 's daughter 's daughter the fork .
my doctor showed your wife 's dentist 's dentist 's boss 's mom the hat .	my doctor moved your wife 's dentist 's dentist 's boss 's mom the hat .
Jane showed my son 's grandmother 's husband 's dad 's son the candle .	Jane moved my son 's grandmother 's husband 's dad 's son the candle .
Deborah sent my cousin 's dentist 's son 's teacher 's daughter the mirror .	Deborah held my cousin 's dentist 's son 's teacher 's daughter the mirror .
the dancer gave my doctor 's doctor 's teacher 's cousin 's teacher the cup .	the dancer dropped my doctor 's doctor 's teacher 's cousin 's teacher the cup .
my dentist sent my dentist 's mother 's dad 's teacher 's doctor the bowl .	my dentist shook my dentist 's mother 's dad 's teacher 's doctor the bowl .
Cindy bought your friend 's boss 's wife 's daughter 's teacher the car .	Cindy dropped your friend 's boss 's wife 's daughter 's teacher the car .
my cousin sent your friend 's daughter 's friend 's dad 's grandmother the plane .	my cousin held your friend 's daughter 's friend 's dad 's grandmother the plane .
my friend sent my son 's father 's mom 's boss 's mother the ship .	my friend held my son 's father 's mom 's boss 's mother the ship .
your teacher sent your dad 's daughter 's son 's son 's cousin the glass .	your teacher moved your dad 's daughter 's son 's son 's cousin the glass .
the patient gave your friend 's father 's cousin 's dentist 's son the plane .	the patient held your friend 's father 's cousin 's dentist 's son the plane .
your dentist sent your dad 's dad 's cousin 's boss 's husband the chair .	your dentist kept your dad 's dad 's cousin 's boss 's husband the chair .
the dancer showed my father 's wife 's wife 's daughter 's sister the bottle .	the dancer shook my father 's wife 's wife 's daughter 's sister the bottle .
the driver sent my mom 's cousin 's brother 's mom 's sister the doll .	the driver held my mom 's cousin 's brother 's mom 's sister the doll .
my doctor gave your daughter 's friend 's daughter 's grandmother 's sister the bottle .	my doctor kept your daughter 's friend 's daughter 's grandmother 's sister the bottle .
Mary gave your sister 's brother 's daughter 's dentist 's boss the car .	Mary dropped your sister 's brother 's daughter 's dentist 's boss the car .
my friend bought your brother 's mother 's brother 's mom 's sister the glass .	my friend moved your brother 's mother 's brother 's mom 's sister the glass .
your doctor sent your teacher 's grandmother 's wife 's friend 's sister the plane .	your doctor moved your teacher 's grandmother 's wife 's friend 's sister the plane .
my dentist sent your sister 's wife 's sister 's wife 's brother the door .	my dentist moved your sister 's wife 's sister 's wife 's brother the door .
Jennifer sent my father 's mom 's teacher 's friend 's brother the boat .	Jennifer moved my father 's mom 's teacher 's friend 's brother the boat .
the customer sent my mother 's daughter 's dentist 's wife 's brother the picture .	the customer dropped my mother 's daughter 's dentist 's wife 's brother the picture .
Catherine sent your grandmother 's daughter 's dentist 's father 's sister the plate .	Catherine held your grandmother 's daughter 's dentist 's father 's sister the plate .
the child sent my daughter 's son 's boss 's wife 's grandmother the rocket .	the child dropped my daughter 's son 's boss 's wife 's grandmother the rocket .
your doctor sent my friend 's dentist 's wife 's boss 's son the plane .	your doctor kept my friend 's dentist 's wife 's boss 's son the plane .
the patient bought your brother 's mother 's mother 's grandmother 's son the shoe .	the patient kept your brother 's mother 's mother 's grandmother 's son the shoe .
my boss bought my brother 's sister 's mother 's mom 's son the picture .	my boss dropped my brother 's sister 's mother 's mom 's son the picture .
Alexander gave your brother 's doctor 's mom 's dad 's brother the truck .	Alexander lost your brother 's doctor 's mom 's dad 's brother the truck .
the patient gave my mother 's son 's father 's mom 's father the chair .	the patient moved my mother 's son 's father 's mom 's father the chair .
the child sent my wife 's friend 's grandmother 's friend 's wife the window .	the child dropped my wife 's friend 's grandmother 's friend 's wife the window .
the adult sent your mother 's friend 's son 's dentist 's sister the couch .	the adult held your mother 's friend 's son 's dentist 's sister the couch .
the customer showed your husband 's mom 's husband 's grandmother 's cousin the book .	the customer shook your husband 's mom 's husband 's grandmother 's cousin the book .
the dancer bought my father 's brother 's sister 's grandmother 's doctor the car .	the dancer moved my father 's brother 's sister 's grandmother 's doctor the car .
the customer sent your doctor 's son 's brother 's son 's sister the window .	the customer moved your doctor 's son 's brother 's son 's sister the window .
your doctor showed my mother 's dentist 's dad 's mom 's dad the dish .	your doctor cleaned my mother 's dentist 's dad 's mom 's dad the dish .
the teacher showed my cousin 's cousin 's son 's mother 's grandmother the boat .	the teacher lost my cousin 's cousin 's son 's mother 's grandmother the boat .
Amy sent my teacher 's brother 's grandmother 's mother 's daughter the bicycle .	Amy kept my teacher 's brother 's grandmother 's mother 's daughter the bicycle .
your friend gave my teacher 's father 's friend 's daughter 's father the bag .	your friend dropped my teacher 's father 's friend 's daughter 's father the bag .
the adult showed my wife 's daughter 's cousin 's friend 's friend the bottle .	the adult shook my wife 's daughter 's cousin 's friend 's friend the bottle .
the doctor bought my mother 's brother 's wife 's sister 's doctor the glass .	the doctor kept my mother 's brother 's wife 's sister 's doctor the glass .
the customer sent your wife 's teacher 's doctor 's dentist 's sister the mirror .	the customer shook your wife 's teacher 's doctor 's dentist 's sister the mirror .
the dancer gave your grandmother 's friend 's dad 's father 's dad the shoe .	the dancer cleaned your grandmother 's friend 's dad 's father 's dad the shoe .
my boss gave my grandmother 's husband 's brother 's brother 's doctor the cup .	my boss shook my grandmother 's husband 's brother 's brother 's doctor the cup .
the person sent my dentist 's wife 's wife 's boss 's brother the car .	the person moved my dentist 's wife 's wife 's boss 's brother the car .
my cousin gave my sister 's doctor 's father 's husband 's husband the bottle .	my cousin shook my sister 's doctor 's father 's husband 's husband the bottle .
my teacher sent my husband 's boss 's boss 's father 's cousin the boat .	my teacher kept my husband 's boss 's boss 's father 's cousin the boat .
Lisa bought my dentist 's father 's son 's cousin 's husband the bag .	Lisa lost my dentist 's father 's son 's cousin 's husband the bag .
the child showed your doctor 's mother 's mother 's cousin 's daughter the doll .	the child moved your doctor 's mother 's mother 's cousin 's daughter the doll .
your dentist gave my wife 's mother 's mom 's doctor 's teacher the shoe .	your dentist kept my wife 's mother 's mom 's doctor 's teacher the shoe .
your cousin bought my father 's brother 's grandmother 's mother 's sister the car .	your cousin held my father 's brother 's grandmother 's mother 's sister the car .
Thomas showed my sister 's grandmother 's friend 's friend 's sister the rocket .	Thomas lost my sister 's grandmother 's friend 's friend 's sister the rocket .
my doctor showed my father 's brother 's father 's doctor 's brother the chair .	my doctor dropped my father 's brother 's father 's doctor 's brother the chair .
Renee showed my father 's doctor 's boss 's mom 's brother the couch .	Renee cleaned my father 's doctor 's boss 's mom 's brother the couch .
the child sent your son 's father 's boss 's boss 's mom the rug .	the child shook your son 's father 's boss 's boss 's mom the rug .
my cousin gave your mother 's mother 's mother 's dentist 's wife the boat .	my cousin held your mother 's mother 's mother 's dentist 's wife the boat .
your boss gave your teacher 's boss 's son 's wife 's mother the rug .	your boss kept your teacher 's boss 's son 's wife 's mother the rug .
the doctor sent your doctor 's friend 's father 's teacher 's doctor the bowl .	the doctor dropped your doctor 's friend 's father 's teacher 's doctor the bowl .
Paul bought your dad 's mother 's mother 's grandmother 's wife the book .	Paul dropped your dad 's mother 's mother 's grandmother 's wife the book .
the driver sent my wife 's dad 's husband 's mom 's brother the plane .	the driver lost my wife 's dad 's husband 's mom 's brother the plane .
my cousin gave your cousin 's brother 's grandmother 's husband 's husband the hat .	my cousin lost your cousin 's brother 's grandmother 's husband 's husband the hat .
the driver gave your teacher 's doctor 's cousin 's husband 's daughter the boat .	the driver kept your teacher 's doctor 's cousin 's husband 's daughter the boat .
Donna bought my dentist 's dad 's boss 's sister 's mother the ring .	Donna dropped my dentist 's dad 's boss 's sister 's mother the ring .
the dancer sent your doctor 's wife 's son 's wife 's teacher the dish .	the dancer cleaned your doctor 's wife 's son 's wife 's teacher the dish .
Scott showed my wife 's mom 's mom 's father 's boss the bottle .	Scott moved my wife 's mom 's mom 's father 's boss the bottle .
the dancer sent your mother 's boss 's dad 's mother 's friend the couch .	the dancer moved your mother 's boss 's dad 's mother 's friend the couch .
April sent my dad 's wife 's sister 's husband 's grandmother the ring .	April dropped my dad 's wife 's sister 's husband 's grandmother the ring .
Joseph gave my doctor 's doctor 's dentist 's mom 's cousin the boat .	Joseph kept my doctor 's doctor 's dentist 's mom 's cousin the boat .
the adult bought your mom 's dentist 's grandmother 's dentist 's dad the hat .	the adult cleaned your mom 's dentist 's grandmother 's dentist 's dad the hat .
your teacher showed your husband 's wife 's wife 's grandmother 's boss the bag .	your teacher kept your husband 's wife 's wife 's grandmother 's boss the bag .
your dentist gave my grandmother 's son 's daughter 's doctor 's mom the plate .	your dentist held my grandmother 's son 's daughter 's doctor 's mom the plate .
my cousin showed your friend 's wife 's brother 's doctor 's dad the couch .	my cousin dropped your friend 's wife 's brother 's doctor 's dad the couch .
the adult showed my cousin 's grandmother 's daughter 's mom 's teacher the door .	the adult held my cousin 's grandmother 's daughter 's mom 's teacher the door .
my cousin showed your teacher 's doctor 's boss 's mom 's son the bag .	my cousin dropped your teacher 's doctor 's boss 's mom 's son the bag .
Daniel bought your father 's mother 's cousin 's sister 's dad the bottle .	Daniel held your father 's mother 's cousin 's sister 's dad the bottle .
Becca showed your wife 's mother 's sister 's dentist 's brother the ship .	Becca shook your wife 's mother 's sister 's dentist 's brother the ship .
Janet bought my dad 's friend 's dad 's doctor 's cousin the couch .	Janet shook my dad 's friend 's dad 's doctor 's cousin the couch .
the dancer gave my father 's wife 's grandmother 's teacher 's father the couch .	the dancer kept my father 's wife 's grandmother 's teacher 's father the couch .
the dancer gave my daughter 's dentist 's brother 's mom 's cousin the fork .	the dancer shook my daughter 's dentist 's brother 's mom 's cousin the fork .
Jessica gave my grandmother 's teacher 's cousin 's dad 's grandmother the doll .	Jessica held my grandmother 's teacher 's cousin 's dad 's grandmother the doll .
the dancer showed my husband 's father 's friend 's dentist 's cousin the bottle .	the dancer held my husband 's father 's friend 's dentist 's cousin the bottle .
the teacher showed my wife 's boss 's dentist 's sister 's doctor the ring .	the teacher shook my wife 's boss 's dentist 's sister 's doctor the ring .
Eric showed my mom 's brother 's brother 's dentist 's father the bag .	Eric moved my mom 's brother 's brother 's dentist 's father the bag .
the person bought my brother 's doctor 's friend 's daughter 's daughter the candle .	the person lost my brother 's doctor 's friend 's daughter 's daughter the candle .
the adult gave your cousin 's son 's doctor 's cousin 's teacher the ship .	the adult moved your cousin 's son 's doctor 's cousin 's teacher the ship .
your doctor bought your friend 's friend 's sister 's daughter 's daughter the truck .	your doctor lost your friend 's friend 's sister 's daughter 's daughter the truck .
Adam showed your wife 's sister 's brother 's grandmother 's wife the rocket .	Adam kept your wife 's sister 's brother 's grandmother 's wife the rocket .
your teacher showed my mom 's cousin 's doctor 's wife 's husband the cup .	your teacher kept my mom 's cousin 's doctor 's wife 's husband the cup .
your friend sent your doctor 's grandmother 's dentist 's grandmother 's cousin the window .	your friend moved your doctor 's grandmother 's dentist 's grandmother 's cousin the window .
the person showed my sister 's husband 's brother 's cousin 's teacher the button .	the person held my sister 's husband 's brother 's cousin 's teacher the button .
Anne sent your doctor 's mom 's doctor 's teacher 's friend the window .	Anne lost your doctor 's mom 's doctor 's teacher 's friend the window .
the person gave my doctor 's doctor 's husband 's friend 's doctor the hat .	the person lost my doctor 's doctor 's husband 's friend 's doctor the hat .
your doctor bought your friend 's dad 's wife 's dentist 's doctor the dish .	your doctor held your friend 's dad 's wife 's dentist 's doctor the dish .
Travis bought your boss 's teacher 's son 's teacher 's cousin the button .	Travis shook your boss 's teacher 's son 's teacher 's cousin the button .
Nicole showed my dentist 's husband 's mom 's dentist 's doctor the fork .	Nicole kept my dentist 's husband 's mom 's dentist 's doctor the fork .
the customer showed my teacher 's boss 's father 's doctor 's friend the book .	the customer lost my teacher 's boss 's father 's doctor 's friend the book .
Jill sent my friend 's dentist 's father 's doctor 's boss the cup .	Jill lost my friend 's dentist 's father 's doctor 's boss the cup .
the dentist showed your teacher 's wife 's daughter 's husband 's cousin the rocket .	the dentist kept your teacher 's wife 's daughter 's husband 's cousin the rocket .
Dan gave my boss 's husband 's dad 's doctor 's mother the plate .	Dan shook my boss 's husband 's dad 's doctor 's mother the plate .
my doctor showed your husband 's wife 's sister 's teacher 's daughter the window .	my doctor kept your husband 's wife 's sister 's teacher 's daughter the window .
Daniel gave my husband 's mom 's cousin 's friend 's grandmother the ship .	Daniel lost my husband 's mom 's cousin 's friend 's grandmother the ship .
Ronald bought your son 's brother 's dentist 's boss 's father the plate .	Ronald dropped your son 's brother 's dentist 's boss 's father the plate .
Cindy sent my father 's dentist 's father 's dad 's doctor the book .	Cindy moved my father 's dentist 's father 's dad 's doctor the book .
my cousin gave your husband 's mom 's teacher 's cousin 's grandmother the chair .	my cousin shook your husband 's mom 's teacher 's cousin 's grandmother the chair .
my boss sent my brother 's dad 's friend 's mom 's husband the button .	my boss shook my brother 's dad 's friend 's mom 's husband the button .
Judy sent your brother 's mother 's sister 's teacher 's husband the picture .	Judy dropped your brother 's mother 's sister 's teacher 's husband the picture .
Timothy sent my sister 's daughter 's brother 's teacher 's grandmother the shoe .	Timothy held my sister 's daughter 's brother 's teacher 's grandmother the shoe .
your boss showed your sister 's grandmother 's wife 's son 's mom the couch .	your boss kept your sister 's grandmother 's wife 's son 's mom the couch .
Renee gave my dentist 's mom 's mother 's mom 's sister the plane .	Renee held my dentist 's mom 's mother 's mom 's sister the plane .
Nancy sent your mother 's father 's cousin 's boss 's husband the spoon .	Nancy shook your mother 's father 's cousin 's boss 's husband the spoon .
the dancer gave your dad 's sister 's grandmother 's grandmother 's dentist the mirror .	the dancer kept your dad 's sister 's grandmother 's grandmother 's dentist the mirror .
my cousin sent your friend 's teacher 's mother 's dentist 's son the mirror .	my cousin dropped your friend 's teacher 's mother 's dentist 's son the mirror .
your cousin bought your grandmother 's father 's grandmother 's teacher 's sister the couch .	your cousin cleaned your grandmother 's father 's grandmother 's teacher 's sister the couch .
the dentist sent your husband 's daughter 's boss 's doctor 's mother the plate .	the dentist kept your husband 's daughter 's boss 's doctor 's mother the plate .
the driver gave my son 's dad 's wife 's dentist 's son the fork .	the driver moved my son 's dad 's wife 's dentist 's son the fork .
my teacher gave my father 's grandmother 's dentist 's dad 's sister the fork .	my teacher held my father 's grandmother 's dentist 's dad 's sister the fork .
the dancer sent my dad 's grandmother 's father 's son 's doctor the button .	the dancer lost my dad 's grandmother 's father 's son 's doctor the button .
the customer bought my doctor 's grandmother 's wife 's husband 's dentist the ring .	the customer cleaned my doctor 's grandmother 's wife 's husband 's dentist the ring .
Becca sent my friend 's doctor 's husband 's teacher 's boss the chair .	Becca lost my friend 's doctor 's husband 's teacher 's boss the chair .
Amy gave your grandmother 's sister 's doctor 's husband 's boss the chair .	Amy dropped your grandmother 's sister 's doctor 's husband 's boss the chair .
the adult sent my sister 's dad 's cousin 's wife 's cousin the spoon .	the adult shook my sister 's dad 's cousin 's wife 's cousin the spoon .
my friend showed your brother 's doctor 's wife 's boss 's friend the rocket .	my friend held your brother 's doctor 's wife 's boss 's friend the rocket .
Joseph gave my mom 's mother 's teacher 's mom 's friend the toy .	Joseph dropped my mom 's mother 's teacher 's mom 's friend the toy .
Michelle gave my grandmother 's dad 's brother 's father 's doctor the glass .	Michelle lost my grandmother 's dad 's brother 's father 's doctor the glass .
Scott showed your dentist 's daughter 's brother 's sister 's daughter the fork .	Scott cleaned your dentist 's daughter 's brother 's sister 's daughter the fork .
the customer showed my son 's doctor 's son 's brother 's mom the plane .	the customer cleaned my son 's doctor 's son 's brother 's mom the plane .
your teacher showed your doctor 's brother 's mother 's doctor 's doctor the ring .	your teacher lost your doctor 's brother 's mother 's doctor 's doctor the ring .
the child gave your dad 's dentist 's cousin 's husband 's sister the glass .	the child cleaned your dad 's dentist 's cousin 's husband 's sister the glass .
Alexander gave my wife 's teacher 's wife 's daughter 's cousin the picture .	Alexander lost my wife 's teacher 's wife 's daughter 's cousin the picture .
my friend showed my sister 's wife 's mom 's wife 's sister the candle .	my friend kept my sister 's wife 's mom 's wife 's sister the candle .
the child bought my cousin 's teacher 's grandmother 's daughter 's brother the spoon .	the child held my cousin 's teacher 's grandmother 's daughter 's brother the spoon .
your doctor sent my husband 's grandmother 's sister 's doctor 's daughter the bowl .	your doctor shook my husband 's grandmother 's sister 's doctor 's daughter the bowl .
my teacher gave your doctor 's grandmother 's teacher 's daughter 's mother the plane .	my teacher held your doctor 's grandmother 's teacher 's daughter 's mother the plane .
my friend gave my dad 's wife 's dentist 's daughter 's daughter the button .	my friend lost my dad 's wife 's dentist 's daughter 's daughter the button .
the child gave your boss 's doctor 's husband 's daughter 's mother the plane .	the child held your boss 's doctor 's husband 's daughter 's mother the plane .
the person gave my sister 's dentist 's daughter 's father 's doctor the shoe .	the person held my sister 's dentist 's daughter 's father 's doctor the shoe .
the patient gave your son 's dentist 's teacher 's sister 's son the toy .	the patient lost your son 's dentist 's teacher 's sister 's son the toy .
Amy gave your dad 's husband 's father 's friend 's son the fork .	Amy cleaned your dad 's husband 's father 's friend 's son the fork .
Patrick sent your grandmother 's sister 's cousin 's dad 's doctor the box .	Patrick cleaned your grandmother 's sister 's cousin 's dad 's doctor the box .
the teacher showed my grandmother 's daughter 's mom 's father 's sister the rug .	the teacher kept my grandmother 's daughter 's mom 's father 's sister the rug .
your teacher bought my doctor 's doctor 's cousin 's cousin 's dad the ring .	your teacher shook my doctor 's doctor 's cousin 's cousin 's dad the ring .
my friend gave my friend 's dentist 's father 's sister 's father the bottle .	my friend lost my friend 's dentist 's father 's sister 's father the bottle .
Carol gave my husband 's wife 's dad 's brother 's father the spoon .	Carol shook my husband 's wife 's dad 's brother 's father the spoon .
your teacher bought my father 's brother 's son 's daughter 's mom the crayon .	your teacher kept my father 's brother 's son 's daughter 's mom the crayon .
my teacher sent my brother 's husband 's son 's dentist 's sister the spoon .	my teacher held my brother 's husband 's son 's dentist 's sister the spoon .
Amy gave my dad 's father 's daughter 's teacher 's father the box .	Amy cleaned my dad 's father 's daughter 's teacher 's father the box .
Janet gave your grandmother 's cousin 's dentist 's teacher 's grandmother the plane .	Janet moved your grandmother 's cousin 's dentist 's teacher 's grandmother the plane .
the dancer gave my teacher 's husband 's doctor 's wife 's teacher the picture .	the dancer lost my teacher 's husband 's doctor 's wife 's teacher the picture .
the dancer bought your teacher 's boss 's boss 's mother 's grandmother the door .	the dancer lost your teacher 's boss 's boss 's mother 's grandmother the door .
Julie sent your mother 's cousin 's mother 's friend 's mother the candle .	Julie moved your mother 's cousin 's mother 's friend 's mother the candle .
my doctor bought my brother 's wife 's sister 's brother 's dad the bottle .	my doctor dropped my brother 's wife 's sister 's brother 's dad the bottle .
the child showed your mom 's husband 's teacher 's brother 's teacher the cup .	the child held your mom 's husband 's teacher 's brother 's teacher the cup .
the doctor showed my mom 's sister 's father 's son 's teacher the toy .	the doctor cleaned my mom 's sister 's father 's son 's teacher the toy .
your friend gave your mother 's mother 's boss 's husband 's friend the chair .	your friend shook your mother 's mother 's boss 's husband 's friend the chair .
my friend sent your sister 's doctor 's boss 's grandmother 's son the shoe .	my friend kept your sister 's doctor 's boss 's grandmother 's son the shoe .
your cousin gave my brother 's friend 's son 's father 's mom the book .	your cousin dropped my brother 's friend 's son 's father 's mom the book .
my cousin showed your mother 's teacher 's friend 's mom 's brother the rug .	my cousin moved your mother 's teacher 's friend 's mom 's brother the rug .
Bill bought your dad 's husband 's daughter 's grandmother 's doctor the book .	Bill held your dad 's husband 's daughter 's grandmother 's doctor the book .
Gregory sent your father 's wife 's doctor 's grandmother 's grandmother the box .	Gregory held your father 's wife 's doctor 's grandmother 's grandmother the box .
your boss sent your daughter 's father 's grandmother 's cousin 's brother the cup .	your boss dropped your daughter 's father 's grandmother 's cousin 's brother the cup .
Donna showed your doctor 's husband 's dad 's sister 's father the rug .	Donna dropped your doctor 's husband 's dad 's sister 's father the rug .
your friend showed my daughter 's father 's son 's daughter 's wife the fork .	your friend held my daughter 's father 's son 's daughter 's wife the fork .
my boss gave my husband 's daughter 's daughter 's father 's husband the bag .	my boss held my husband 's daughter 's daughter 's father 's husband the bag .
the driver bought my boss 's teacher 's son 's cousin 's daughter the plane .	the driver shook my boss 's teacher 's son 's cousin 's daughter the plane .
the child showed my wife 's dentist 's wife 's teacher 's husband the ring .	the child cleaned my wife 's dentist 's wife 's teacher 's husband the ring .
Becky gave your dentist 's cousin 's wife 's dad 's teacher the ship .	Becky dropped your dentist 's cousin 's wife 's dad 's teacher the ship .
the child bought my dentist 's husband 's grandmother 's cousin 's brother the dish .	the child held my dentist 's husband 's grandmother 's cousin 's brother the dish .
Jason bought my dentist 's dentist 's husband 's dentist 's wife the bed .	Jason kept my dentist 's dentist 's husband 's dentist 's wife the bed .
Deborah bought my son 's son 's grandmother 's dad 's father the mirror .	Deborah lost my son 's son 's grandmother 's dad 's father the mirror .
the doctor showed your doctor 's son 's dad 's grandmother 's father the book .	the doctor moved your doctor 's son 's dad 's grandmother 's father the book .
your friend gave my dad 's grandmother 's husband 's son 's sister the ship .	your friend held my dad 's grandmother 's husband 's son 's sister the ship .
Joseph showed your dentist 's dad 's boss 's dentist 's doctor the bottle .	Joseph kept your dentist 's dad 's boss 's dentist 's doctor the bottle .
the patient sent my brother 's friend 's cousin 's mother 's sister the doll .	the patient kept my brother 's friend 's cousin 's mother 's sister the doll .
my doctor sent your brother 's cousin 's husband 's doctor 's boss the door .	my doctor moved your brother 's cousin 's husband 's doctor 's boss the door .
Sally bought your cousin 's wife 's son 's boss 's father the hat .	Sally held your cousin 's wife 's son 's boss 's father the hat .
the customer showed your dentist 's grandmother 's dentist 's brother 's brother the book .	the customer cleaned your dentist 's grandmother 's dentist 's brother 's brother the book .
Jennifer sent your daughter 's friend 's brother 's mother 's dentist the mirror .	Jennifer cleaned your daughter 's friend 's brother 's mother 's dentist the mirror .
your teacher sent my mom 's daughter 's sister 's brother 's cousin the boat .	your teacher lost my mom 's daughter 's sister 's brother 's cousin the boat .
the adult gave my brother 's dentist 's friend 's wife 's doctor the plate .	the adult kept my brother 's dentist 's friend 's wife 's doctor the plate .
Amy showed your grandmother 's brother 's mom 's brother 's grandmother the bicycle .	Amy kept your grandmother 's brother 's mom 's brother 's grandmother the bicycle .
Ann bought your cousin 's father 's brother 's sister 's mom the book .	Ann dropped your cousin 's father 's brother 's sister 's mom the book .
Robert showed your daughter 's boss 's mother 's daughter 's brother the rocket .	Robert moved your daughter 's boss 's mother 's daughter 's brother the rocket .
my doctor bought your teacher 's dad 's sister 's grandmother 's daughter the book .	my doctor lost your teacher 's dad 's sister 's grandmother 's daughter the book .
Tracy showed my husband 's friend 's dad 's wife 's teacher the toy .	Tracy held my husband 's friend 's dad 's wife 's teacher the toy .
Peter showed my grandmother 's doctor 's friend 's mom 's brother the ship .	Peter lost my grandmother 's doctor 's friend 's mom 's brother the ship .
your doctor bought your son 's wife 's boss 's brother 's cousin the mirror .	your doctor kept your son 's wife 's boss 's brother 's cousin the mirror .
Rachel sent your boss 's husband 's dad 's mother 's friend the hat .	Rachel dropped your boss 's husband 's dad 's mother 's friend the hat .
Laurie bought your son 's wife 's sister 's cousin 's dentist the door .	Laurie moved your son 's wife 's sister 's cousin 's dentist the door .
the adult bought your dentist 's wife 's sister 's wife 's wife the door .	the adult held your dentist 's wife 's sister 's wife 's wife the door .
your friend sent your teacher 's mother 's boss 's father 's mother the ship .	your friend moved your teacher 's mother 's boss 's father 's mother the ship .
your cousin showed your daughter 's dad 's sister 's husband 's wife the book .	your cousin kept your daughter 's dad 's sister 's husband 's wife the book .
Adam bought your boss 's mom 's son 's daughter 's dentist the glass .	Adam held your boss 's mom 's son 's daughter 's dentist the glass .
Nicole bought your son 's teacher 's husband 's cousin 's mother the crayon .	Nicole lost your son 's teacher 's husband 's cousin 's mother the crayon .
Sally bought your daughter 's boss 's doctor 's dentist 's friend the car .	Sally shook your daughter 's boss 's doctor 's dentist 's friend the car .
the customer sent your husband 's boss 's doctor 's teacher 's dentist the truck .	the customer kept your husband 's boss 's doctor 's teacher 's dentist the truck .
Liam gave my dentist 's dentist 's brother 's dentist 's father the ring .	Liam cleaned my dentist 's dentist 's brother 's dentist 's father the ring .
James sent your wife 's wife 's cousin 's mother 's dad the bag .	James held your wife 's wife 's cousin 's mother 's dad the bag .
Judy gave my friend 's teacher 's boss 's dad 's mother the couch .	Judy cleaned my friend 's teacher 's boss 's dad 's mother the couch .
the person showed my father 's grandmother 's grandmother 's sister 's dentist the car .	the person lost my father 's grandmother 's grandmother 's sister 's dentist the car .
the patient bought your brother 's husband 's father 's son 's dentist the glass .	the patient kept your brother 's husband 's father 's son 's dentist the glass .
Jill showed your grandmother 's dentist 's doctor 's husband 's sister the bicycle .	Jill cleaned your grandmother 's dentist 's doctor 's husband 's sister the bicycle .
your doctor showed my dad 's dentist 's brother 's teacher 's mother the car .	your doctor kept my dad 's dentist 's brother 's teacher 's mother the car .
the patient sent your sister 's father 's dad 's sister 's son the chair .	the patient moved your sister 's father 's dad 's sister 's son the chair .
the child bought my grandmother 's dentist 's mom 's boss 's wife the window .	the child kept my grandmother 's dentist 's mom 's boss 's wife the window .
Joseph bought your dad 's wife 's doctor 's sister 's brother the book .	Joseph dropped your dad 's wife 's doctor 's sister 's brother the book .
my teacher gave my dad 's sister 's mom 's doctor 's father the car .	my teacher shook my dad 's sister 's mom 's doctor 's father the car .
my cousin bought my dentist 's father 's sister 's son 's cousin the mirror .	my cousin lost my dentist 's father 's sister 's son 's cousin the mirror .
the person showed your brother 's sister 's wife 's boss 's mom the picture .	the person shook your brother 's sister 's wife 's boss 's mom the picture .
the child bought your dentist 's daughter 's boss 's mom 's brother the doll .	the child dropped your dentist 's daughter 's boss 's mom 's brother the doll .
the adult bought your dad 's dad 's brother 's teacher 's dentist the rug .	the adult kept your dad 's dad 's brother 's teacher 's dentist the rug .
the patient sent my husband 's mother 's husband 's father 's father the bowl .	the patient shook my husband 's mother 's husband 's father 's father the bowl .
Sandra bought your dentist 's brother 's friend 's boss 's sister the mirror .	Sandra dropped your dentist 's brother 's friend 's boss 's sister the mirror .
my cousin sent my boss 's boss 's dad 's brother 's teacher the glass .	my cousin moved my boss 's boss 's dad 's brother 's teacher the glass .
my cousin bought my father 's husband 's daughter 's dentist 's mom the truck .	my cousin kept my father 's husband 's daughter 's dentist 's mom the truck .
your friend gave my mom 's boss 's daughter 's son 's teacher the truck .	your friend held my mom 's boss 's daughter 's son 's teacher the truck .
Denise sent my father 's sister 's brother 's friend 's brother the glass .	Denise held my father 's sister 's brother 's friend 's brother the glass .
your doctor gave your husband 's friend 's father 's daughter 's teacher the picture .	your doctor cleaned your husband 's friend 's father 's daughter 's teacher the picture .
Andrew sent your teacher 's dentist 's dad 's sister 's wife the glass .	Andrew shook your teacher 's dentist 's dad 's sister 's wife the glass .
the person gave my daughter 's brother 's mother 's son 's dad the couch .	the person shook my daughter 's brother 's mother 's son 's dad the couch .
my doctor showed my brother 's mom 's dentist 's husband 's boss the chair .	my doctor cleaned my brother 's mom 's dentist 's husband 's boss the chair .
my dentist gave your dentist 's father 's daughter 's teacher 's doctor the doll .	my dentist shook your dentist 's father 's daughter 's teacher 's doctor the doll .
my dentist bought my grandmother 's mom 's brother 's doctor 's brother the picture .	my dentist cleaned my grandmother 's mom 's brother 's doctor 's brother the picture .
Linda gave my mom 's husband 's wife 's grandmother 's mother the plane .	Linda lost my mom 's husband 's wife 's grandmother 's mother the plane .
your teacher sent my daughter 's husband 's cousin 's boss 's mother the bottle .	your teacher kept my daughter 's husband 's cousin 's boss 's mother the bottle .
the doctor sent my boss 's sister 's mother 's friend 's mom the mirror .	the doctor held my boss 's sister 's mother 's friend 's mom the mirror .
Erin bought my wife 's son 's dentist 's wife 's dad the plate .	Erin dropped my wife 's son 's dentist 's wife 's dad the plate .
the adult bought your dentist 's doctor 's doctor 's dentist 's husband the shoe .	the adult lost your dentist 's doctor 's doctor 's dentist 's husband the shoe .
Karen gave my cousin 's friend 's doctor 's wife 's brother the bottle .	Karen dropped my cousin 's friend 's doctor 's wife 's brother the bottle .
Naomi sent your boss 's dentist 's grandmother 's friend 's friend the candle .	Naomi lost your boss 's dentist 's grandmother 's friend 's friend the candle .
my dentist gave your sister 's teacher 's brother 's teacher 's dad the bottle .	my dentist lost your sister 's teacher 's brother 's teacher 's dad the bottle .
Kristen gave my daughter 's boss 's grandmother 's father 's brother the plate .	Kristen moved my daughter 's boss 's grandmother 's father 's brother the plate .
my boss bought my husband 's daughter 's mom 's wife 's cousin the bed .	my boss cleaned my husband 's daughter 's mom 's wife 's cousin the bed .
the child sent my father 's wife 's brother 's husband 's wife the shoe .	the child held my father 's wife 's brother 's husband 's wife the shoe .
Nicole showed your mother 's son 's brother 's grandmother 's dentist the bicycle .	Nicole lost your mother 's son 's brother 's grandmother 's dentist the bicycle .
my cousin sent your friend 's sister 's father 's doctor 's cousin the fork .	my cousin held your friend 's sister 's father 's doctor 's cousin the fork .
my cousin bought my father 's wife 's wife 's husband 's grandmother the button .	my cousin held my father 's wife 's wife 's husband 's grandmother the button .
your teacher showed my mother 's boss 's dentist 's son 's dad the car .	your teacher kept my mother 's boss 's dentist 's son 's dad the car .
Becca showed my doctor 's teacher 's mother 's wife 's cousin the book .	Becca lost my doctor 's teacher 's mother 's wife 's cousin the book .
Deborah bought your grandmother 's mother 's grandmother 's husband 's cousin the bed .	Deborah moved your grandmother 's mother 's grandmother 's husband 's cousin the bed .
my boss sent your daughter 's dad 's friend 's mom 's mom the cup .	my boss kept your daughter 's dad 's friend 's mom 's mom the cup .
my cousin sent my cousin 's dentist 's brother 's daughter 's father the bowl .	my cousin kept my cousin 's dentist 's brother 's daughter 's father the bowl .
your teacher sent your grandmother 's friend 's wife 's doctor 's cousin the boat .	your teacher cleaned your grandmother 's friend 's wife 's doctor 's cousin the boat .
the person gave my father 's dad 's father 's wife 's daughter the hat .	the person dropped my father 's dad 's father 's wife 's daughter the hat .
the child sent your teacher 's mother 's dad 's dad 's doctor the chair .	the child cleaned your teacher 's mother 's dad 's dad 's doctor the chair .
your boss gave my dad 's daughter 's teacher 's dad 's husband the bed .	your boss dropped my dad 's daughter 's teacher 's dad 's husband the bed .
my doctor gave my boss 's sister 's brother 's teacher 's teacher the candle .	my doctor held my boss 's sister 's brother 's teacher 's teacher the candle .
your dentist bought your mom 's husband 's brother 's grandmother 's grandmother the boat .	your dentist cleaned your mom 's husband 's brother 's grandmother 's grandmother the boat .
your friend gave my friend 's teacher 's father 's boss 's dentist the window .	your friend lost my friend 's teacher 's father 's boss 's dentist the window .
Michelle gave my boss 's sister 's teacher 's boss 's daughter the plate .	Michelle shook my boss 's sister 's teacher 's boss 's daughter the plate .
April showed your cousin 's mother 's friend 's doctor 's dad the truck .	April cleaned your cousin 's mother 's friend 's doctor 's dad the truck .
the adult gave my brother 's mom 's friend 's daughter 's grandmother the plate .	the adult lost my brother 's mom 's friend 's daughter 's grandmother the plate .
Anne sent my husband 's boss 's mother 's husband 's mom the shoe .	Anne dropped my husband 's boss 's mother 's husband 's mom the shoe .
my cousin gave your dad 's boss 's dad 's teacher 's daughter the box .	my cousin cleaned your dad 's boss 's dad 's teacher 's daughter the box .
my teacher bought my dentist 's daughter 's father 's boss 's daughter the ship .	my teacher moved my dentist 's daughter 's father 's boss 's daughter the ship .
the patient bought my teacher 's brother 's teacher 's husband 's father the doll .	the patient kept my teacher 's brother 's teacher 's husband 's father the doll .
your friend bought your father 's mom 's boss 's sister 's father the car .	your friend held your father 's mom 's boss 's sister 's father the car .
my doctor gave my husband 's son 's doctor 's sister 's husband the toy .	my doctor shook my husband 's son 's doctor 's sister 's husband the toy .
your doctor showed my dentist 's dad 's grandmother 's doctor 's son the ship .	your doctor moved my dentist 's dad 's grandmother 's doctor 's son the ship .
my friend showed your dad 's friend 's doctor 's friend 's brother the plane .	my friend shook your dad 's friend 's doctor 's friend 's brother the plane .
my friend gave your grandmother 's cousin 's wife 's dentist 's son the ring .	my friend cleaned your grandmother 's cousin 's wife 's dentist 's son the ring .
the driver sent my doctor 's friend 's cousin 's father 's doctor the bottle .	the driver moved my doctor 's friend 's cousin 's father 's doctor the bottle .
the child showed my friend 's grandmother 's mother 's dentist 's sister the book .	the child held my friend 's grandmother 's mother 's dentist 's sister the book .
Catherine bought your mom 's mother 's dentist 's mother 's dentist the car .	Catherine held your mom 's mother 's dentist 's mother 's dentist the car .
the doctor bought my teacher 's dentist 's husband 's husband 's mom the bottle .	the doctor moved my teacher 's dentist 's husband 's husband 's mom the bottle .
my friend showed your sister 's father 's sister 's dad 's mother the toy .	my friend dropped your sister 's father 's sister 's dad 's mother the toy .
the adult sent my husband 's son 's teacher 's dad 's brother the bicycle .	the adult cleaned my husband 's son 's teacher 's dad 's brother the bicycle .
my teacher sent my friend 's doctor 's dentist 's mom 's mom the bag .	my teacher lost my friend 's doctor 's dentist 's mom 's mom the bag .
my doctor sent my daughter 's mom 's son 's mother 's father the dish .	my doctor lost my daughter 's mom 's son 's mother 's father the dish .
Nancy showed your wife 's mom 's cousin 's teacher 's husband the fork .	Nancy cleaned your wife 's mom 's cousin 's teacher 's husband the fork .
my dentist gave your friend 's son 's doctor 's mom 's doctor the car .	my dentist kept your friend 's son 's doctor 's mom 's doctor the car .
the child showed your dad 's grandmother 's grandmother 's dentist 's sister the couch .	the child shook your dad 's grandmother 's grandmother 's dentist 's sister the couch .
Emily sent your friend 's mom 's grandmother 's son 's wife the picture .	Emily kept your friend 's mom 's grandmother 's son 's wife the picture .
your boss bought my husband 's wife 's father 's husband 's daughter the fork .	your boss shook my husband 's wife 's father 's husband 's daughter the fork .
the child showed my mom 's friend 's wife 's doctor 's daughter the chair .	the child kept my mom 's friend 's wife 's doctor 's daughter the chair .
the dancer showed my wife 's friend 's sister 's friend 's dad the bicycle .	the dancer held my wife 's friend 's sister 's friend 's dad the bicycle .
Marie showed your dad 's friend 's doctor 's cousin 's wife the glass .	Marie cleaned your dad 's friend 's doctor 's cousin 's wife the glass .
the teacher bought your husband 's dad 's father 's teacher 's sister the car .	the teacher shook your husband 's dad 's father 's teacher 's sister the car .
Samantha bought your teacher 's boss 's sister 's dentist 's doctor the bed .	Samantha dropped your teacher 's boss 's sister 's dentist 's doctor the bed .
my boss sent my mother 's son 's dad 's boss 's mother the car .	my boss moved my mother 's son 's dad 's boss 's mother the car .
my dentist sent my sister 's friend 's teacher 's dentist 's teacher the cup .	my dentist lost my sister 's friend 's teacher 's dentist 's teacher the cup .
Julia showed your teacher 's friend 's mom 's son 's mother the book .	Julia moved your teacher 's friend 's mom 's son 's mother the book .
Rachel bought your cousin 's mom 's mother 's doctor 's mother the chair .	Rachel moved your cousin 's mom 's mother 's doctor 's mother the chair .
Cindy showed your friend 's boss 's daughter 's mother 's boss the spoon .	Cindy shook your friend 's boss 's daughter 's mother 's boss the spoon .
the dancer bought my son 's dentist 's daughter 's dentist 's sister the dish .	the dancer lost my son 's dentist 's daughter 's dentist 's sister the dish .
the patient gave your dad 's wife 's doctor 's wife 's father the book .	the patient kept your dad 's wife 's doctor 's wife 's father the book .
Richard showed your daughter 's cousin 's dad 's husband 's wife the car .	Richard cleaned your daughter 's cousin 's dad 's husband 's wife the car .
Michelle bought your brother 's cousin 's father 's sister 's mom the couch .	Michelle kept your brother 's cousin 's father 's sister 's mom the couch .
my cousin bought your grandmother 's dentist 's daughter 's sister 's boss the cup .	my cousin shook your grandmother 's dentist 's daughter 's sister 's boss the cup .
Denise showed my cousin 's boss 's sister 's father 's teacher the window .	Denise held my cousin 's boss 's sister 's father 's teacher the window .
Karen bought your son 's doctor 's grandmother 's doctor 's mother the hat .	Karen moved your son 's doctor 's grandmother 's doctor 's mother the hat .
Alice showed my cousin 's father 's brother 's grandmother 's daughter the bicycle .	Alice lost my cousin 's father 's brother 's grandmother 's daughter the bicycle .
your dentist showed your daughter 's mother 's doctor 's husband 's cousin the crayon .	your dentist cleaned your daughter 's mother 's doctor 's husband 's cousin the crayon .
my boss sent your daughter 's mom 's cousin 's wife 's friend the glass .	my boss cleaned your daughter 's mom 's cousin 's wife 's friend the glass .
Erin gave your son 's father 's brother 's dentist 's doctor the rug .	Erin shook your son 's father 's brother 's dentist 's doctor the rug .
the dentist sent my boss 's son 's dentist 's dentist 's friend the hat .	the dentist shook my boss 's son 's dentist 's dentist 's friend the hat .
Alexander showed your dentist 's grandmother 's husband 's doctor 's son the picture .	Alexander lost your dentist 's grandmother 's husband 's doctor 's son the picture .
the adult sent your son 's grandmother 's daughter 's cousin 's friend the car .	the adult held your son 's grandmother 's daughter 's cousin 's friend the car .
your teacher showed your doctor 's brother 's grandmother 's grandmother 's grandmother the car .	your teacher held your doctor 's brother 's grandmother 's grandmother 's grandmother the car .
the patient bought my mother 's friend 's daughter 's cousin 's friend the doll .	the patient shook my mother 's friend 's daughter 's cousin 's friend the doll .
your doctor showed your mom 's mom 's dentist 's mother 's friend the crayon .	your doctor held your mom 's mom 's dentist 's mother 's friend the crayon .
your teacher sent your cousin 's daughter 's son 's teacher 's grandmother the shoe .	your teacher held your cousin 's daughter 's son 's teacher 's grandmother the shoe .
your teacher bought your brother 's father 's grandmother 's brother 's mom the shirt .	your teacher shook your brother 's father 's grandmother 's brother 's mom the shirt .
my dentist gave your cousin 's brother 's wife 's daughter 's dad the spoon .	my dentist dropped your cousin 's brother 's wife 's daughter 's dad the spoon .
my boss bought your sister 's doctor 's daughter 's dentist 's sister the rocket .	my boss moved your sister 's doctor 's daughter 's dentist 's sister the rocket .
Anna bought my brother 's dentist 's grandmother 's doctor 's daughter the bicycle .	Anna held my brother 's dentist 's grandmother 's doctor 's daughter the bicycle .
the adult gave your cousin 's friend 's mom 's teacher 's mother the toy .	the adult shook your cousin 's friend 's mom 's teacher 's mother the toy .
the adult showed your mother 's teacher 's dad 's husband 's sister the doll .	the adult held your mother 's teacher 's dad 's husband 's sister the doll .
the customer sent your father 's mother 's sister 's dad 's son the bed .	the customer moved your father 's mother 's sister 's dad 's son the bed .
the customer gave my dentist 's cousin 's mother 's friend 's husband the truck .	the customer cleaned my dentist 's cousin 's mother 's friend 's husband the truck .
the teacher sent your son 's father 's mother 's mom 's mom the toy .	the teacher cleaned your son 's father 's mother 's mom 's mom the toy .
the customer gave my dad 's mom 's doctor 's cousin 's daughter the picture .	the customer held my dad 's mom 's doctor 's cousin 's daughter the picture .
my boss sent your grandmother 's brother 's wife 's brother 's daughter the dish .	my boss shook your grandmother 's brother 's wife 's brother 's daughter the dish .
the doctor bought my sister 's grandmother 's mother 's son 's son the dish .	the doctor cleaned my sister 's grandmother 's mother 's son 's son the dish .
Leslie showed my dentist 's doctor 's father 's sister 's brother the mirror .	Leslie shook my dentist 's doctor 's father 's sister 's brother the mirror .
your teacher showed your cousin 's cousin 's cousin 's mom 's sister the bowl .	your teacher held your cousin 's cousin 's cousin 's mom 's sister the bowl .
the person showed my grandmother 's grandmother 's husband 's teacher 's friend the shirt .	the person shook my grandmother 's grandmother 's husband 's teacher 's friend the shirt .
the doctor gave my teacher 's doctor 's husband 's brother 's sister the crayon .	the doctor cleaned my teacher 's doctor 's husband 's brother 's sister the crayon .
my dentist showed your husband 's wife 's doctor 's husband 's father the shirt .	my dentist held your husband 's wife 's doctor 's husband 's father the shirt .
Allison bought your daughter 's doctor 's teacher 's doctor 's brother the bottle .	Allison shook your daughter 's doctor 's teacher 's doctor 's brother the bottle .
the adult bought your mother 's grandmother 's brother 's teacher 's son the bed .	the adult held your mother 's grandmother 's brother 's teacher 's son the bed .
your cousin sent your son 's friend 's teacher 's wife 's mother the car .	your cousin cleaned your son 's friend 's teacher 's wife 's mother the car .
Timothy bought your cousin 's sister 's teacher 's brother 's mom the boat .	Timothy shook your cousin 's sister 's teacher 's brother 's mom the boat .
my cousin bought my son 's doctor 's grandmother 's doctor 's dad the crayon .	my cousin lost my son 's doctor 's grandmother 's doctor 's dad the crayon .
Mary bought your doctor 's wife 's grandmother 's cousin 's father the bottle .	Mary dropped your doctor 's wife 's grandmother 's cousin 's father the bottle .
my friend sent your dentist 's husband 's cousin 's dentist 's grandmother the doll .	my friend shook your dentist 's husband 's cousin 's dentist 's grandmother the doll .
the driver gave my dentist 's grandmother 's dad 's cousin 's daughter the boat .	the driver held my dentist 's grandmother 's dad 's cousin 's daughter the boat .
Jason sent your boss 's mother 's daughter 's teacher 's sister the car .	Jason held your boss 's mother 's daughter 's teacher 's sister the car .
the dentist gave my father 's son 's grandmother 's mom 's father the rocket .	the dentist kept my father 's son 's grandmother 's mom 's father the rocket .
the driver gave your cousin 's mother 's teacher 's teacher 's teacher the rug .	the driver shook your cousin 's mother 's teacher 's teacher 's teacher the rug .
David showed your father 's father 's father 's sister 's doctor the bed .	David kept your father 's father 's father 's sister 's doctor the bed .
my boss showed your mom 's cousin 's teacher 's husband 's dentist the rug .	my boss shook your mom 's cousin 's teacher 's husband 's dentist the rug .
the doctor showed my dentist 's grandmother 's son 's sister 's friend the car .	the doctor cleaned my dentist 's grandmother 's son 's sister 's friend the car .
Catherine sent your friend 's brother 's dentist 's husband 's dad the rug .	Catherine lost your friend 's brother 's dentist 's husband 's dad the rug .
Kayla gave your cousin 's father 's boss 's father 's grandmother the shirt .	Kayla shook your cousin 's father 's boss 's father 's grandmother the shirt .
my boss gave my daughter 's dentist 's teacher 's husband 's brother the couch .	my boss kept my daughter 's dentist 's teacher 's husband 's brother the couch .
the doctor gave my friend 's daughter 's grandmother 's sister 's sister the book .	the doctor moved my friend 's daughter 's grandmother 's sister 's sister the book .
Jessica gave my husband 's mother 's mom 's boss 's doctor the glass .	Jessica cleaned my husband 's mother 's mom 's boss 's doctor the glass .
the dancer gave my son 's father 's daughter 's teacher 's boss the picture .	the dancer moved my son 's father 's daughter 's teacher 's boss the picture .
the child bought my brother 's brother 's mom 's son 's teacher the rug .	the child cleaned my brother 's brother 's mom 's son 's teacher the rug .
your boss gave your doctor 's husband 's daughter 's boss 's mother the ring .	your boss lost your doctor 's husband 's daughter 's boss 's mother the ring .
your doctor showed your grandmother 's son 's father 's mom 's teacher the bicycle .	your doctor cleaned your grandmother 's son 's father 's mom 's teacher the bicycle .
Marie bought your husband 's daughter 's brother 's cousin 's dentist the plate .	Marie cleaned your husband 's daughter 's brother 's cousin 's dentist the plate .
the teacher sent your father 's mom 's dentist 's friend 's dad the bag .	the teacher lost your father 's mom 's dentist 's friend 's dad the bag .
your friend bought my father 's grandmother 's brother 's boss 's dad the spoon .	your friend lost my father 's grandmother 's brother 's boss 's dad the spoon .
the driver bought my teacher 's mother 's grandmother 's dad 's brother the glass .	the driver kept my teacher 's mother 's grandmother 's dad 's brother the glass .
Michael gave your doctor 's wife 's brother 's sister 's daughter the button .	Michael held your doctor 's wife 's brother 's sister 's daughter the button .
Sara bought your mother 's dad 's brother 's teacher 's mother the box .	Sara moved your mother 's dad 's brother 's teacher 's mother the box .
Renee showed your doctor 's dad 's sister 's dentist 's teacher the crayon .	Renee cleaned your doctor 's dad 's sister 's dentist 's teacher the crayon .
the dancer bought your friend 's friend 's brother 's dentist 's dad the cup .	the dancer lost your friend 's friend 's brother 's dentist 's dad the cup .
your doctor gave your father 's son 's brother 's teacher 's doctor the hat .	your doctor dropped your father 's son 's brother 's teacher 's doctor the hat .
Ronald bought your cousin 's daughter 's father 's son 's mother the cup .	Ronald dropped your cousin 's daughter 's father 's son 's mother the cup .
the patient gave your daughter 's brother 's wife 's teacher 's daughter the couch .	the patient held your daughter 's brother 's wife 's teacher 's daughter the couch .
the dentist gave your sister 's boss 's wife 's dad 's grandmother the book .	the dentist held your sister 's boss 's wife 's dad 's grandmother the book .
the child showed your son 's brother 's friend 's sister 's daughter the picture .	the child cleaned your son 's brother 's friend 's sister 's daughter the picture .
the driver showed your boss 's teacher 's grandmother 's mom 's friend the rug .	the driver held your boss 's teacher 's grandmother 's mom 's friend the rug .
the person gave your husband 's boss 's daughter 's mom 's mother the spoon .	the person cleaned your husband 's boss 's daughter 's mom 's mother the spoon .
Scott bought my mom 's sister 's dentist 's husband 's grandmother the plane .	Scott shook my mom 's sister 's dentist 's husband 's grandmother the plane .
the adult sent your teacher 's mother 's wife 's sister 's grandmother the mirror .	the adult moved your teacher 's mother 's wife 's sister 's grandmother the mirror .
the driver showed my friend 's grandmother 's friend 's dentist 's brother the car .	the driver kept my friend 's grandmother 's friend 's dentist 's brother the car .
the child gave my doctor 's wife 's brother 's wife 's dentist the cup .	the child shook my doctor 's wife 's brother 's wife 's dentist the cup .
Dan bought my friend 's boss 's father 's sister 's dad the candle .	Dan cleaned my friend 's boss 's father 's sister 's dad the candle .
the adult sent your wife 's dad 's mom 's brother 's sister the chair .	the adult moved your wife 's dad 's mom 's brother 's sister the chair .
Carl sent your boss 's son 's wife 's son 's friend the window .	Carl cleaned your boss 's son 's wife 's son 's friend the window .
my boss sent your grandmother 's sister 's mom 's dad 's father the toy .	my boss moved your grandmother 's sister 's mom 's dad 's father the toy .
my doctor bought your doctor 's grandmother 's sister 's father 's friend the door .	my doctor cleaned your doctor 's grandmother 's sister 's father 's friend the door .
Jill gave your brother 's son 's wife 's grandmother 's brother the book .	Jill shook your brother 's son 's wife 's grandmother 's brother the book .
Aaron gave my brother 's son 's husband 's brother 's boss the toy .	Aaron dropped my brother 's son 's husband 's brother 's boss the toy .
Jane sent my grandmother 's dentist 's husband 's sister 's friend the rocket .	Jane shook my grandmother 's dentist 's husband 's sister 's friend the rocket .
your teacher sent your dad 's friend 's husband 's son 's mother the toy .	your teacher held your dad 's friend 's husband 's son 's mother the toy .
Andrew showed your friend 's husband 's son 's wife 's grandmother the spoon .	Andrew cleaned your friend 's husband 's son 's wife 's grandmother the spoon .
the dancer showed my sister 's dad 's husband 's daughter 's brother the rocket .	the dancer lost my sister 's dad 's husband 's daughter 's brother the rocket .
the dancer bought my teacher 's doctor 's mom 's friend 's boss the spoon .	the dancer cleaned my teacher 's doctor 's mom 's friend 's boss the spoon .
my teacher bought my sister 's daughter 's dentist 's mom 's dentist the candle .	my teacher held my sister 's daughter 's dentist 's mom 's dentist the candle .
Michelle sent my husband 's friend 's daughter 's brother 's teacher the glass .	Michelle cleaned my husband 's friend 's daughter 's brother 's teacher the glass .
your friend sent your wife 's teacher 's boss 's teacher 's dentist the rug .	your friend shook your wife 's teacher 's boss 's teacher 's dentist the rug .
your friend sent my daughter 's son 's sister 's cousin 's brother the bag .	your friend kept my daughter 's son 's sister 's cousin 's brother the bag .
Nina gave my father 's father 's father 's friend 's dentist the bag .	Nina lost my father 's father 's father 's friend 's dentist the bag .
Jill gave my mother 's sister 's daughter 's son 's boss the toy .	Jill moved my mother 's sister 's daughter 's son 's boss the toy .
the doctor sent my mother 's friend 's husband 's friend 's husband the bottle .	the doctor shook my mother 's friend 's husband 's friend 's husband the bottle .
the child showed your grandmother 's daughter 's husband 's brother 's grandmother the box .	the child dropped your grandmother 's daughter 's husband 's brother 's grandmother the box .
the dancer bought my sister 's boss 's daughter 's sister 's mom the boat .	the dancer dropped my sister 's boss 's daughter 's sister 's mom the boat .
my doctor bought my dentist 's doctor 's friend 's cousin 's grandmother the dish .	my doctor kept my dentist 's doctor 's friend 's cousin 's grandmother the dish .
your boss sent your doctor 's dad 's wife 's doctor 's father the window .	your boss shook your doctor 's dad 's wife 's doctor 's father the window .
my friend sent your son 's mom 's teacher 's dad 's wife the chair .	my friend cleaned your son 's mom 's teacher 's dad 's wife the chair .
your friend showed my son 's husband 's sister 's cousin 's daughter the boat .	your friend shook my son 's husband 's sister 's cousin 's daughter the boat .
my boss gave my husband 's son 's dentist 's sister 's teacher the shirt .	my boss lost my husband 's son 's dentist 's sister 's teacher the shirt .
the child sent my doctor 's husband 's dad 's friend 's doctor the window .	the child cleaned my doctor 's husband 's dad 's friend 's doctor the window .
Sally gave your cousin 's teacher 's cousin 's boss 's dad the window .	Sally kept your cousin 's teacher 's cousin 's boss 's dad the window .
Becky bought your father 's wife 's dad 's grandmother 's husband the doll .	Becky moved your father 's wife 's dad 's grandmother 's husband the doll .
my dentist sent my cousin 's mother 's boss 's son 's daughter the box .	my dentist moved my cousin 's mother 's boss 's son 's daughter the box .
my friend gave my mom 's boss 's dad 's dad 's son the car .	my friend lost my mom 's boss 's dad 's dad 's son the car .
Gregory sent my wife 's boss 's brother 's mother 's dad the glass .	Gregory cleaned my wife 's boss 's brother 's mother 's dad the glass .
April bought my dad 's dad 's friend 's father 's wife the button .	April lost my dad 's dad 's friend 's father 's wife the button .
the customer sent your mom 's friend 's sister 's wife 's cousin the fork .	the customer lost your mom 's friend 's sister 's wife 's cousin the fork .
my dentist showed your teacher 's father 's daughter 's brother 's wife the dish .	my dentist held your teacher 's father 's daughter 's brother 's wife the dish .
Donna showed my daughter 's grandmother 's husband 's friend 's grandmother the bed .	Donna shook my daughter 's grandmother 's husband 's friend 's grandmother the bed .
the adult bought my mother 's cousin 's daughter 's grandmother 's grandmother the ship .	the adult dropped my mother 's cousin 's daughter 's grandmother 's grandmother the ship .
my teacher showed my brother 's boss 's dentist 's doctor 's doctor the box .	my teacher kept my brother 's boss 's dentist 's doctor 's doctor the box .
your cousin gave your grandmother 's husband 's father 's grandmother 's husband the car .	your cousin held your grandmother 's husband 's father 's grandmother 's husband the car .
your friend sent your dad 's doctor 's boss 's teacher 's husband the bed .	your friend dropped your dad 's doctor 's boss 's teacher 's husband the bed .
the dancer sent my dad 's friend 's wife 's brother 's sister the chair .	the dancer lost my dad 's friend 's wife 's brother 's sister the chair .
the child bought my dentist 's wife 's husband 's dentist 's brother the picture .	the child dropped my dentist 's wife 's husband 's dentist 's brother the picture .
the person bought my father 's brother 's son 's sister 's brother the ring .	the person cleaned my father 's brother 's son 's sister 's brother the ring .
Elizabeth bought my husband 's wife 's boss 's sister 's dentist the rug .	Elizabeth cleaned my husband 's wife 's boss 's sister 's dentist the rug .
the child showed my mother 's husband 's son 's mother 's wife the dish .	the child lost my mother 's husband 's son 's mother 's wife the dish .
my doctor gave my friend 's husband 's friend 's mom 's friend the glass .	my doctor shook my friend 's husband 's friend 's mom 's friend the glass .
the child gave your grandmother 's boss 's brother 's friend 's doctor the dish .	the child cleaned your grandmother 's boss 's brother 's friend 's doctor the dish .
Daniel showed my friend 's boss 's mother 's brother 's dad the car .	Daniel dropped my friend 's boss 's mother 's brother 's dad the car .
the child gave your father 's doctor 's wife 's husband 's brother the picture .	the child moved your father 's doctor 's wife 's husband 's brother the picture .
the person gave your dad 's son 's wife 's mom 's dad the dish .	the person moved your dad 's son 's wife 's mom 's dad the dish .
your cousin sent your father 's brother 's cousin 's grandmother 's husband the rug .	your cousin dropped your father 's brother 's cousin 's grandmother 's husband the rug .
Patrick sent my father 's cousin 's husband 's son 's son the cup .	Patrick lost my father 's cousin 's husband 's son 's son the cup .
my cousin showed your dentist 's teacher 's husband 's dad 's brother the shirt .	my cousin shook your dentist 's teacher 's husband 's dad 's brother the shirt .
the person showed your father 's father 's husband 's dentist 's wife the ring .	the person shook your father 's father 's husband 's dentist 's wife the ring .
your doctor showed your teacher 's sister 's daughter 's dentist 's son the crayon .	your doctor cleaned your teacher 's sister 's daughter 's dentist 's son the crayon .
the teacher bought my doctor 's father 's dad 's teacher 's teacher the toy .	the teacher lost my doctor 's father 's dad 's teacher 's teacher the toy .
the patient sent my mom 's cousin 's boss 's dad 's father the boat .	the patient lost my mom 's cousin 's boss 's dad 's father the boat .
Allison showed my wife 's teacher 's dentist 's friend 's brother the door .	Allison dropped my wife 's teacher 's dentist 's friend 's brother the door .
my cousin sent my dad 's mother 's son 's father 's sister the candle .	my cousin lost my dad 's mother 's son 's father 's sister the candle .
the child sent your teacher 's boss 's brother 's grandmother 's teacher the cup .	the child shook your teacher 's boss 's brother 's grandmother 's teacher the cup .
Judy sent my grandmother 's dentist 's dad 's teacher 's cousin the dish .	Judy shook my grandmother 's dentist 's dad 's teacher 's cousin the dish .
Susan showed your daughter 's cousin 's dad 's cousin 's brother the bicycle .	Susan held your daughter 's cousin 's dad 's cousin 's brother the bicycle .
Becky showed your father 's doctor 's father 's daughter 's friend the shirt .	Becky moved your father 's doctor 's father 's daughter 's friend the shirt .
Patrick showed your grandmother 's teacher 's boss 's cousin 's husband the button .	Patrick held your grandmother 's teacher 's boss 's cousin 's husband the button .
Robert sent your teacher 's dentist 's son 's sister 's doctor the plate .	Robert dropped your teacher 's dentist 's son 's sister 's doctor the plate .
Jane bought my boss 's boss 's wife 's son 's mother the fork .	Jane dropped my boss 's boss 's wife 's son 's mother the fork .
Noah bought your dad 's doctor 's husband 's friend 's doctor the ring .	Noah shook your dad 's doctor 's husband 's friend 's doctor the ring .
my cousin showed my teacher 's father 's daughter 's brother 's mom the bowl .	my cousin shook my teacher 's father 's daughter 's brother 's mom the bowl .
your friend bought my mom 's wife 's wife 's dad 's dentist the ring .	your friend shook my mom 's wife 's wife 's dad 's dentist the ring .
your friend gave your cousin 's wife 's grandmother 's sister 's dad the cup .	your friend held your cousin 's wife 's grandmother 's sister 's dad the cup .
the dancer bought my son 's father 's boss 's teacher 's brother the boat .	the dancer cleaned my son 's father 's boss 's teacher 's brother the boat .
the dancer sent your dentist 's boss 's sister 's son 's friend the crayon .	the dancer shook your dentist 's boss 's sister 's son 's friend the crayon .
the person bought my wife 's mother 's brother 's son 's teacher the candle .	the person dropped my wife 's mother 's brother 's son 's teacher the candle .
my teacher bought my cousin 's boss 's boss 's boss 's dentist the box .	my teacher held my cousin 's boss 's boss 's boss 's dentist the box .
your cousin sent my cousin 's husband 's mother 's dad 's doctor the dish .	your cousin moved my cousin 's husband 's mother 's dad 's doctor the dish .
Julie bought my mom 's daughter 's sister 's grandmother 's grandmother the plane .	Julie lost my mom 's daughter 's sister 's grandmother 's grandmother the plane .
Donald gave my grandmother 's wife 's mom 's dentist 's daughter the crayon .	Donald moved my grandmother 's wife 's mom 's dentist 's daughter the crayon .
your boss bought your mother 's sister 's husband 's grandmother 's brother the couch .	your boss moved your mother 's sister 's husband 's grandmother 's brother the couch .
the dancer showed your friend 's brother 's friend 's grandmother 's husband the window .	the dancer held your friend 's brother 's friend 's grandmother 's husband the window .
your boss bought my boss 's cousin 's sister 's sister 's boss the shirt .	your boss kept my boss 's cousin 's sister 's sister 's boss the shirt .
your boss showed your teacher 's dentist 's husband 's doctor 's wife the dish .	your boss moved your teacher 's dentist 's husband 's doctor 's wife the dish .
my cousin showed your sister 's father 's grandmother 's wife 's brother the doll .	my cousin dropped your sister 's father 's grandmother 's wife 's brother the doll .
the child bought my grandmother 's mom 's son 's friend 's dad the couch .	the child shook my grandmother 's mom 's son 's friend 's dad the couch .
the adult bought my daughter 's dad 's mother 's friend 's cousin the candle .	the adult kept my daughter 's dad 's mother 's friend 's cousin the candle .
the doctor sent my friend 's son 's dad 's husband 's friend the candle .	the doctor held my friend 's son 's dad 's husband 's friend the candle .
the patient sent my wife 's boss 's mom 's cousin 's father the box .	the patient moved my wife 's boss 's mom 's cousin 's father the box .
your cousin showed your dad 's daughter 's wife 's doctor 's wife the fork .	your cousin kept your dad 's daughter 's wife 's doctor 's wife the fork .
Patrick sent my boss 's dentist 's brother 's sister 's boss the spoon .	Patrick moved my boss 's dentist 's brother 's sister 's boss the spoon .
my friend bought my teacher 's grandmother 's grandmother 's cousin 's husband the picture .	my friend held my teacher 's grandmother 's grandmother 's cousin 's husband the picture .
the customer sent your doctor 's mom 's daughter 's grandmother 's mother the cup .	the customer dropped your doctor 's mom 's daughter 's grandmother 's mother the cup .
Richard sent your doctor 's son 's wife 's boss 's friend the couch .	Richard kept your doctor 's son 's wife 's boss 's friend the couch .
Samantha bought your daughter 's dad 's father 's teacher 's boss the button .	Samantha dropped your daughter 's dad 's father 's teacher 's boss the button .
Samantha gave my husband 's doctor 's husband 's cousin 's doctor the boat .	Samantha cleaned my husband 's doctor 's husband 's cousin 's doctor the boat .
the adult bought your brother 's cousin 's grandmother 's brother 's son the shirt .	the adult kept your brother 's cousin 's grandmother 's brother 's son the shirt .
your boss gave my brother 's teacher 's doctor 's brother 's teacher the rug .	your boss held my brother 's teacher 's doctor 's brother 's teacher the rug .
Michelle bought your cousin 's husband 's friend 's boss 's dentist the toy .	Michelle held your cousin 's husband 's friend 's boss 's dentist the toy .
my doctor bought your sister 's son 's sister 's teacher 's friend the chair .	my doctor lost your sister 's son 's sister 's teacher 's friend the chair .
the person sent my sister 's grandmother 's doctor 's cousin 's husband the car .	the person moved my sister 's grandmother 's doctor 's cousin 's husband the car .
my dentist gave my wife 's brother 's brother 's daughter 's teacher the hat .	my dentist moved my wife 's brother 's brother 's daughter 's teacher the hat .
my doctor showed my daughter 's wife 's son 's wife 's wife the plate .	my doctor held my daughter 's wife 's son 's wife 's wife the plate .
the dentist sent your dentist 's doctor 's daughter 's teacher 's wife the door .	the dentist held your dentist 's doctor 's daughter 's teacher 's wife the door .
your dentist showed your friend 's son 's daughter 's father 's brother the bicycle .	your dentist dropped your friend 's son 's daughter 's father 's brother the bicycle .
my boss gave your sister 's cousin 's mom 's friend 's wife the bag .	my boss dropped your sister 's cousin 's mom 's friend 's wife the bag .
the customer showed my sister 's mom 's son 's daughter 's dad the truck .	the customer lost my sister 's mom 's son 's daughter 's dad the truck .
your doctor bought my boss 's boss 's teacher 's father 's mother the shoe .	your doctor dropped my boss 's boss 's teacher 's father 's mother the shoe .
your teacher bought your daughter 's wife 's cousin 's son 's cousin the fork .	your teacher lost your daughter 's wife 's cousin 's son 's cousin the fork .
the teacher bought my teacher 's doctor 's husband 's dentist 's doctor the button .	the teacher lost my teacher 's doctor 's husband 's dentist 's doctor the button .
the teacher bought my wife 's son 's doctor 's boss 's dentist the box .	the teacher shook my wife 's son 's doctor 's boss 's dentist the box .
the patient sent my husband 's grandmother 's mother 's sister 's friend the shirt .	the patient lost my husband 's grandmother 's mother 's sister 's friend the shirt .
the customer sent my boss 's doctor 's sister 's boss 's sister the hat .	the customer moved my boss 's doctor 's sister 's boss 's sister the hat .
your cousin showed your dad 's brother 's teacher 's doctor 's wife the candle .	your cousin cleaned your dad 's brother 's teacher 's doctor 's wife the candle .
my dentist gave my mom 's brother 's cousin 's mother 's father the dish .	my dentist lost my mom 's brother 's cousin 's mother 's father the dish .
Wendy sent my mother 's dad 's mom 's cousin 's brother the bed .	Wendy dropped my mother 's dad 's mom 's cousin 's brother the bed .
Becca showed your boss 's father 's father 's dad 's dentist the shoe .	Becca shook your boss 's father 's father 's dad 's dentist the shoe .
Laura sent my grandmother 's friend 's brother 's husband 's mother the bottle .	Laura shook my grandmother 's friend 's brother 's husband 's mother the bottle .
the dentist sent my father 's husband 's daughter 's husband 's son the plate .	the dentist shook my father 's husband 's daughter 's husband 's son the plate .
the dentist showed your mom 's cousin 's cousin 's son 's husband the book .	the dentist dropped your mom 's cousin 's cousin 's son 's husband the book .
David sent your sister 's son 's father 's mother 's dentist the door .	David kept your sister 's son 's father 's mother 's dentist the door .
my friend sent your cousin 's sister 's friend 's father 's teacher the dish .	my friend cleaned your cousin 's sister 's friend 's father 's teacher the dish .
Carl bought my teacher 's son 's mom 's boss 's grandmother the dish .	Carl cleaned my teacher 's son 's mom 's boss 's grandmother the dish .
the customer sent my cousin 's boss 's father 's teacher 's sister the rug .	the customer shook my cousin 's boss 's father 's teacher 's sister the rug .
Richard showed my son 's husband 's boss 's son 's doctor the bottle .	Richard lost my son 's husband 's boss 's son 's doctor the bottle .
the dancer showed your dentist 's grandmother 's cousin 's husband 's mother the boat .	the dancer shook your dentist 's grandmother 's cousin 's husband 's mother the boat .
the doctor sent your dentist 's mom 's cousin 's teacher 's boss the spoon .	the doctor held your dentist 's mom 's cousin 's teacher 's boss the spoon .
your dentist bought my boss 's husband 's father 's mom 's teacher the picture .	your dentist moved my boss 's husband 's father 's mom 's teacher the picture .
Paul showed my friend 's cousin 's daughter 's wife 's grandmother the plate .	Paul held my friend 's cousin 's daughter 's wife 's grandmother the plate .
Kristen showed my boss 's teacher 's dad 's son 's friend the bowl .	Kristen dropped my boss 's teacher 's dad 's son 's friend the bowl .
the dancer sent your wife 's sister 's sister 's cousin 's mom the box .	the dancer dropped your wife 's sister 's sister 's cousin 's mom the box .
the adult gave my dentist 's dad 's grandmother 's wife 's grandmother the rug .	the adult shook my dentist 's dad 's grandmother 's wife 's grandmother the rug .
the dancer gave my mother 's daughter 's mother 's mother 's sister the shoe .	the dancer moved my mother 's daughter 's mother 's mother 's sister the shoe .
Erin bought my dentist 's father 's doctor 's dad 's sister the boat .	Erin dropped my dentist 's father 's doctor 's dad 's sister the boat .
the adult bought your husband 's husband 's mom 's dad 's brother the shirt .	the adult held your husband 's husband 's mom 's dad 's brother the shirt .
your friend gave your son 's cousin 's sister 's teacher 's mother the spoon .	your friend dropped your son 's cousin 's sister 's teacher 's mother the spoon .
Carl gave your son 's father 's mom 's wife 's boss the doll .	Carl dropped your son 's father 's mom 's wife 's boss the doll .
the person sent my daughter 's wife 's father 's mom 's wife the bed .	the person shook my daughter 's wife 's father 's mom 's wife the bed .
the dentist sent my grandmother 's mom 's wife 's cousin 's dentist the bag .	the dentist cleaned my grandmother 's mom 's wife 's cousin 's dentist the bag .
the driver gave my mother 's cousin 's grandmother 's dad 's wife the shoe .	the driver cleaned my mother 's cousin 's grandmother 's dad 's wife the shoe .
the doctor bought my daughter 's grandmother 's mom 's dentist 's wife the book .	the doctor moved my daughter 's grandmother 's mom 's dentist 's wife the book .
your teacher bought my mom 's sister 's boss 's dad 's husband the bag .	your teacher lost my mom 's sister 's boss 's dad 's husband the bag .
my dentist bought my mother 's mom 's husband 's husband 's teacher the ship .	my dentist kept my mother 's mom 's husband 's husband 's teacher the ship .
Allison sent my mother 's mother 's grandmother 's son 's teacher the fork .	Allison lost my mother 's mother 's grandmother 's son 's teacher the fork .
Wendy sent your son 's mother 's brother 's mother 's mom the car .	Wendy shook your son 's mother 's brother 's mother 's mom the car .
Patrick bought my dad 's dad 's husband 's mom 's mom the spoon .	Patrick kept my dad 's dad 's husband 's mom 's mom the spoon .
the dentist gave my teacher 's son 's grandmother 's father 's brother the door .	the dentist dropped my teacher 's son 's grandmother 's father 's brother the door .
the driver showed my son 's dentist 's husband 's teacher 's dentist the car .	the driver moved my son 's dentist 's husband 's teacher 's dentist the car .
Judy sent my dad 's doctor 's friend 's dad 's brother the bag .	Judy shook my dad 's doctor 's friend 's dad 's brother the bag .
John bought your dad 's doctor 's son 's dad 's father the glass .	John cleaned your dad 's doctor 's son 's dad 's father the glass .
the person bought your daughter 's doctor 's father 's teacher 's cousin the fork .	the person kept your daughter 's doctor 's father 's teacher 's cousin the fork .
my dentist sent my grandmother 's son 's dad 's wife 's doctor the toy .	my dentist lost my grandmother 's son 's dad 's wife 's doctor the toy .
Brian bought my dentist 's doctor 's mom 's friend 's brother the rocket .	Brian cleaned my dentist 's doctor 's mom 's friend 's brother the rocket .
my cousin gave my doctor 's boss 's dentist 's sister 's dentist the spoon .	my cousin lost my doctor 's boss 's dentist 's sister 's dentist the spoon .
your teacher sent your friend 's father 's doctor 's grandmother 's daughter the truck .	your teacher moved your friend 's father 's doctor 's grandmother 's daughter the truck .
Robert sent my mother 's boss 's doctor 's cousin 's friend the book .	Robert moved my mother 's boss 's doctor 's cousin 's friend the book .
the dentist sent your father 's teacher 's wife 's dad 's cousin the button .	the dentist shook your father 's teacher 's wife 's dad 's cousin the button .
your doctor showed my teacher 's wife 's mother 's dentist 's mother the bag .	your doctor kept my teacher 's wife 's mother 's dentist 's mother the bag .
my cousin sent your daughter 's mother 's son 's daughter 's husband the hat .	my cousin held your daughter 's mother 's son 's daughter 's husband the hat .
Robert bought my sister 's dentist 's mother 's mother 's doctor the shoe .	Robert lost my sister 's dentist 's mother 's mother 's doctor the shoe .
Judy gave your cousin 's husband 's father 's boss 's doctor the button .	Judy kept your cousin 's husband 's father 's boss 's doctor the button .
Nicole showed your teacher 's mom 's teacher 's son 's sister the ring .	Nicole dropped your teacher 's mom 's teacher 's son 's sister the ring .
the patient showed your teacher 's mom 's father 's daughter 's husband the window .	the patient kept your teacher 's mom 's father 's daughter 's husband the window .
the person gave your cousin 's wife 's daughter 's boss 's father the car .	the person lost your cousin 's wife 's daughter 's boss 's father the car .
Eric bought my doctor 's daughter 's friend 's doctor 's husband the chair .	Eric lost my doctor 's daughter 's friend 's doctor 's husband the chair .
my doctor bought my son 's wife 's mother 's doctor 's dentist the bed .	my doctor held my son 's wife 's mother 's doctor 's dentist the bed .
your doctor sent my grandmother 's husband 's son 's daughter 's father the shoe .	your doctor lost my grandmother 's husband 's son 's daughter 's father the shoe .
Ann bought my father 's mother 's daughter 's mom 's brother the bicycle .	Ann kept my father 's mother 's daughter 's mom 's brother the bicycle .
Michael sent my friend 's cousin 's sister 's friend 's boss the bicycle .	Michael shook my friend 's cousin 's sister 's friend 's boss the bicycle .
Kayla sent your grandmother 's sister 's sister 's wife 's husband the dish .	Kayla shook your grandmother 's sister 's sister 's wife 's husband the dish .
the driver gave your teacher 's doctor 's doctor 's doctor 's husband the fork .	the driver cleaned your teacher 's doctor 's doctor 's doctor 's husband the fork .
your cousin gave your cousin 's brother 's wife 's doctor 's son the boat .	your cousin lost your cousin 's brother 's wife 's doctor 's son the boat .
the patient showed your doctor 's teacher 's mom 's sister 's mother the hat .	the patient dropped your doctor 's teacher 's mom 's sister 's mother the hat .
Becca bought your cousin 's doctor 's teacher 's teacher 's doctor the crayon .	Becca held your cousin 's doctor 's teacher 's teacher 's doctor the crayon .
Robert sent my mom 's daughter 's sister 's dad 's teacher the ring .	Robert dropped my mom 's daughter 's sister 's dad 's teacher the ring .
the adult gave your dad 's boss 's friend 's husband 's daughter the shoe .	the adult kept your dad 's boss 's friend 's husband 's daughter the shoe .
Nina sent your wife 's father 's wife 's mom 's brother the spoon .	Nina dropped your wife 's father 's wife 's mom 's brother the spoon .
my teacher bought your father 's boss 's boss 's sister 's doctor the spoon .	my teacher cleaned your father 's boss 's boss 's sister 's doctor the spoon .
the person bought my mom 's dentist 's father 's mom 's doctor the toy .	the person moved my mom 's dentist 's father 's mom 's doctor the toy .
Thomas showed my teacher 's mother 's dentist 's friend 's boss the door .	Thomas cleaned my teacher 's mother 's dentist 's friend 's boss the door .
my doctor bought your mother 's brother 's dad 's dentist 's grandmother the picture .	my doctor shook your mother 's brother 's dad 's dentist 's grandmother the picture .
your boss bought my teacher 's father 's mom 's daughter 's dentist the candle .	your boss kept my teacher 's father 's mom 's daughter 's dentist the candle .
Richard bought my boss 's mother 's doctor 's boss 's teacher the plate .	Richard held my boss 's mother 's doctor 's boss 's teacher the plate .
my cousin sent your dentist 's mom 's teacher 's boss 's boss the book .	my cousin held your dentist 's mom 's teacher 's boss 's boss the book .
your doctor gave my wife 's son 's mother 's sister 's dad the car .	your doctor kept my wife 's son 's mother 's sister 's dad the car .
your teacher gave your dentist 's wife 's cousin 's doctor 's teacher the couch .	your teacher cleaned your dentist 's wife 's cousin 's doctor 's teacher the couch .
my dentist sent your daughter 's brother 's husband 's mother 's wife the chair .	my dentist moved your daughter 's brother 's husband 's mother 's wife the chair .
my teacher bought your grandmother 's mom 's dentist 's teacher 's cousin the doll .	my teacher kept your grandmother 's mom 's dentist 's teacher 's cousin the doll .
the dentist showed my teacher 's mother 's husband 's dad 's mother the plane .	the dentist kept my teacher 's mother 's husband 's dad 's mother the plane .
the adult sent my mother 's dad 's cousin 's mother 's daughter the door .	the adult dropped my mother 's dad 's cousin 's mother 's daughter the door .
my teacher gave my friend 's friend 's mom 's cousin 's dentist the doll .	my teacher moved my friend 's friend 's mom 's cousin 's dentist the doll .
the dancer bought my mom 's husband 's son 's son 's mother the glass .	the dancer cleaned my mom 's husband 's son 's son 's mother the glass .
the person sent your boss 's father 's teacher 's dentist 's mom the rocket .	the person cleaned your boss 's father 's teacher 's dentist 's mom the rocket .
the driver gave your boss 's grandmother 's teacher 's grandmother 's dad the chair .	the driver shook your boss 's grandmother 's teacher 's grandmother 's dad the chair .
Anne sent your wife 's father 's doctor 's sister 's teacher the bowl .	Anne held your wife 's father 's doctor 's sister 's teacher the bowl .
the dentist sent my grandmother 's wife 's grandmother 's boss 's teacher the couch .	the dentist cleaned my grandmother 's wife 's grandmother 's boss 's teacher the couch .
my teacher bought my boss 's dad 's wife 's dad 's friend the book .	my teacher held my boss 's dad 's wife 's dad 's friend the book .
Robert showed my father 's wife 's brother 's sister 's doctor the picture .	Robert shook my father 's wife 's brother 's sister 's doctor the picture .
the dentist showed your husband 's wife 's mom 's grandmother 's teacher the bottle .	the dentist kept your husband 's wife 's mom 's grandmother 's teacher the bottle .
the dancer bought your father 's cousin 's cousin 's father 's sister the hat .	the dancer cleaned your father 's cousin 's cousin 's father 's sister the hat .
my boss sent my cousin 's dad 's friend 's dentist 's mom the plate .	my boss held my cousin 's dad 's friend 's dentist 's mom the plate .
Erin bought my dentist 's husband 's daughter 's wife 's dad the door .	Erin moved my dentist 's husband 's daughter 's wife 's dad the door .
the doctor gave my dad 's dad 's mother 's sister 's son the window .	the doctor moved my dad 's dad 's mother 's sister 's son the window .
Amelia bought your doctor 's dad 's doctor 's boss 's father the spoon .	Amelia kept your doctor 's dad 's doctor 's boss 's father the spoon .
my friend gave my father 's dad 's mom 's teacher 's teacher the crayon .	my friend lost my father 's dad 's mom 's teacher 's teacher the crayon .
Ronald showed your dad 's mother 's teacher 's dentist 's sister the plate .	Ronald dropped your dad 's mother 's teacher 's dentist 's sister the plate .
your friend bought your boss 's mom 's mother 's sister 's mother the truck .	your friend moved your boss 's mom 's mother 's sister 's mother the truck .
my boss bought my husband 's daughter 's grandmother 's mother 's brother the glass .	my boss moved my husband 's daughter 's grandmother 's mother 's brother the glass .
Adam bought my wife 's husband 's mother 's teacher 's brother the doll .	Adam held my wife 's husband 's mother 's teacher 's brother the doll .
Erin showed my teacher 's grandmother 's son 's husband 's friend the crayon .	Erin kept my teacher 's grandmother 's son 's husband 's friend the crayon .
Kayla showed my father 's mother 's brother 's son 's husband the candle .	Kayla held my father 's mother 's brother 's son 's husband the candle .
the patient showed your friend 's son 's cousin 's doctor 's son the bowl .	the patient moved your friend 's son 's cousin 's doctor 's son the bowl .
your dentist gave your mom 's mom 's grandmother 's mom 's wife the door .	your dentist cleaned your mom 's mom 's grandmother 's mom 's wife the door .
the teacher sent your mother 's grandmother 's friend 's wife 's doctor the rocket .	the teacher moved your mother 's grandmother 's friend 's wife 's doctor the rocket .
the doctor sent your daughter 's friend 's daughter 's doctor 's daughter the box .	the doctor held your daughter 's friend 's daughter 's doctor 's daughter the box .
your teacher bought your brother 's grandmother 's wife 's father 's brother the glass .	your teacher kept your brother 's grandmother 's wife 's father 's brother the glass .
my boss sent your grandmother 's sister 's grandmother 's doctor 's dad the car .	my boss lost your grandmother 's sister 's grandmother 's doctor 's dad the car .
your dentist showed your son 's brother 's dad 's sister 's grandmother the mirror .	your dentist moved your son 's brother 's dad 's sister 's grandmother the mirror .
the child gave my dentist 's dentist 's brother 's daughter 's daughter the bottle .	the child shook my dentist 's dentist 's brother 's daughter 's daughter the bottle .
Nancy gave my dentist 's dentist 's boss 's sister 's wife the fork .	Nancy lost my dentist 's dentist 's boss 's sister 's wife the fork .
the teacher showed your daughter 's father 's husband 's sister 's mother the candle .	the teacher dropped your daughter 's father 's husband 's sister 's mother the candle .
Kristen sent my daughter 's wife 's cousin 's dentist 's teacher the spoon .	Kristen dropped my daughter 's wife 's cousin 's dentist 's teacher the spoon .
Liam gave your father 's son 's husband 's son 's wife the car .	Liam held your father 's son 's husband 's son 's wife the car .
George showed your son 's brother 's mom 's cousin 's grandmother the book .	George cleaned your son 's brother 's mom 's cousin 's grandmother the book .
my cousin gave your mother 's friend 's boss 's doctor 's son the book .	my cousin shook your mother 's friend 's boss 's doctor 's son the book .
your friend showed your daughter 's dentist 's son 's brother 's dentist the dish .	your friend held your daughter 's dentist 's son 's brother 's dentist the dish .
your boss sent your boss 's doctor 's doctor 's wife 's mother the hat .	your boss lost your boss 's doctor 's doctor 's wife 's mother the hat .
the doctor showed my son 's dentist 's dentist 's dentist 's friend the box .	the doctor shook my son 's dentist 's dentist 's dentist 's friend the box .
your boss sent your mother 's friend 's friend 's brother 's dentist the bowl .	your boss kept your mother 's friend 's friend 's brother 's dentist the bowl .
the dentist showed my brother 's sister 's father 's dentist 's brother the book .	the dentist held my brother 's sister 's father 's dentist 's brother the book .
the adult showed your mom 's dad 's dad 's wife 's teacher the mirror .	the adult cleaned your mom 's dad 's dad 's wife 's teacher the mirror .
John bought my dentist 's grandmother 's boss 's teacher 's doctor the couch .	John held my dentist 's grandmother 's boss 's teacher 's doctor the couch .
Jessica gave your boss 's mother 's wife 's wife 's mother the couch .	Jessica shook your boss 's mother 's wife 's wife 's mother the couch .
your doctor bought your husband 's cousin 's dentist 's boss 's brother the ship .	your doctor kept your husband 's cousin 's dentist 's boss 's brother the ship .
Laura showed your friend 's daughter 's sister 's teacher 's teacher the hat .	Laura held your friend 's daughter 's sister 's teacher 's teacher the hat .
Julie gave your mom 's cousin 's mother 's sister 's dentist the crayon .	Julie cleaned your mom 's cousin 's mother 's sister 's dentist the crayon .
Mark bought my daughter 's daughter 's dentist 's husband 's mother the book .	Mark moved my daughter 's daughter 's dentist 's husband 's mother the book .
James sent my boss 's teacher 's teacher 's cousin 's brother the ring .	James held my boss 's teacher 's teacher 's cousin 's brother the ring .
my cousin bought your boss 's brother 's dad 's teacher 's husband the spoon .	my cousin lost your boss 's brother 's dad 's teacher 's husband the spoon .
Becky showed my dad 's daughter 's father 's father 's boss the bowl .	Becky held my dad 's daughter 's father 's father 's boss the bowl .
the patient bought my doctor 's father 's dad 's dad 's boss the plane .	the patient dropped my doctor 's father 's dad 's dad 's boss the plane .
the dentist showed my doctor 's daughter 's cousin 's doctor 's dad the cup .	the dentist moved my doctor 's daughter 's cousin 's doctor 's dad the cup .
your boss gave my boss 's dentist 's son 's daughter 's sister the bicycle .	your boss shook my boss 's dentist 's son 's daughter 's sister the bicycle .
the teacher showed my brother 's son 's son 's daughter 's teacher the cup .	the teacher cleaned my brother 's son 's son 's daughter 's teacher the cup .
George showed my grandmother 's husband 's sister 's dad 's cousin the book .	George cleaned my grandmother 's husband 's sister 's dad 's cousin the book .
the customer showed your doctor 's friend 's father 's mom 's teacher the plate .	the customer lost your doctor 's friend 's father 's mom 's teacher the plate .
Steven showed your husband 's teacher 's father 's daughter 's father the hat .	Steven cleaned your husband 's teacher 's father 's daughter 's father the hat .
my friend sent my dentist 's boss 's teacher 's sister 's son the boat .	my friend kept my dentist 's boss 's teacher 's sister 's son the boat .
Carol showed your sister 's boss 's husband 's doctor 's mom the boat .	Carol cleaned your sister 's boss 's husband 's doctor 's mom the boat .
my boss showed my wife 's doctor 's daughter 's friend 's wife the car .	my boss kept my wife 's doctor 's daughter 's friend 's wife the car .
Amy sent your grandmother 's sister 's sister 's son 's doctor the rug .	Amy kept your grandmother 's sister 's sister 's son 's doctor the rug .
your dentist showed your mother 's brother 's doctor 's wife 's dentist the truck .	your dentist moved your mother 's brother 's doctor 's wife 's dentist the truck .
your doctor sent my dentist 's brother 's friend 's daughter 's doctor the rocket .	your doctor lost my dentist 's brother 's friend 's daughter 's doctor the rocket .
Scott showed my doctor 's grandmother 's doctor 's daughter 's mom the ring .	Scott moved my doctor 's grandmother 's doctor 's daughter 's mom the ring .
the adult sent my wife 's brother 's brother 's dentist 's boss the ship .	the adult dropped my wife 's brother 's brother 's dentist 's boss the ship .
your dentist bought my mom 's teacher 's doctor 's sister 's dad the hat .	your dentist shook my mom 's teacher 's doctor 's sister 's dad the hat .
your teacher sent my friend 's cousin 's grandmother 's friend 's boss the chair .	your teacher moved my friend 's cousin 's grandmother 's friend 's boss the chair .
Nicole bought my boss 's mom 's boss 's mom 's daughter the door .	Nicole held my boss 's mom 's boss 's mom 's daughter the door .
Amy showed your sister 's doctor 's brother 's father 's doctor the dish .	Amy moved your sister 's doctor 's brother 's father 's doctor the dish .
your teacher gave your husband 's boss 's teacher 's husband 's sister the door .	your teacher shook your husband 's boss 's teacher 's husband 's sister the door .
the dancer bought your dad 's wife 's dad 's sister 's sister the book .	the dancer kept your dad 's wife 's dad 's sister 's sister the book .
Richard gave my wife 's dentist 's brother 's mother 's father the bottle .	Richard kept my wife 's dentist 's brother 's mother 's father the bottle .
my dentist bought your husband 's friend 's grandmother 's dentist 's son the window .	my dentist held your husband 's friend 's grandmother 's dentist 's son the window .
your dentist bought my sister 's mom 's wife 's sister 's doctor the button .	your dentist moved my sister 's mom 's wife 's sister 's doctor the button .
your doctor showed your boss 's dad 's brother 's son 's brother the truck .	your doctor cleaned your boss 's dad 's brother 's son 's brother the truck .
Elizabeth showed my doctor 's brother 's cousin 's dad 's mom the rocket .	Elizabeth moved my doctor 's brother 's cousin 's dad 's mom the rocket .
the customer gave my boss 's son 's father 's dentist 's sister the bottle .	the customer lost my boss 's son 's father 's dentist 's sister the bottle .
your boss bought your daughter 's friend 's cousin 's daughter 's friend the toy .	your boss shook your daughter 's friend 's cousin 's daughter 's friend the toy .
the teacher sent my sister 's husband 's mom 's brother 's son the spoon .	the teacher shook my sister 's husband 's mom 's brother 's son the spoon .
Mark gave my daughter 's friend 's sister 's dentist 's doctor the door .	Mark lost my daughter 's friend 's sister 's dentist 's doctor the door .
my cousin showed my boss 's husband 's dad 's cousin 's teacher the couch .	my cousin shook my boss 's husband 's dad 's cousin 's teacher the couch .
Sarah showed your dentist 's daughter 's teacher 's wife 's grandmother the doll .	Sarah moved your dentist 's daughter 's teacher 's wife 's grandmother the doll .
your friend sent your mother 's friend 's husband 's daughter 's father the doll .	your friend moved your mother 's friend 's husband 's daughter 's father the doll .
the child gave your father 's grandmother 's friend 's brother 's father the bowl .	the child held your father 's grandmother 's friend 's brother 's father the bowl .
Kayla sent your mother 's sister 's wife 's husband 's cousin the bowl .	Kayla moved your mother 's sister 's wife 's husband 's cousin the bowl .
the teacher gave my boss 's daughter 's cousin 's dentist 's boss the car .	the teacher lost my boss 's daughter 's cousin 's dentist 's boss the car .
the customer showed my daughter 's friend 's husband 's dad 's father the ship .	the customer shook my daughter 's friend 's husband 's dad 's father the ship .
your doctor gave my daughter 's doctor 's boss 's boss 's brother the picture .	your doctor held my daughter 's doctor 's boss 's boss 's brother the picture .
the person showed your cousin 's friend 's grandmother 's sister 's grandmother the plate .	the person dropped your cousin 's friend 's grandmother 's sister 's grandmother the plate .
Judy bought my son 's dad 's grandmother 's husband 's daughter the window .	Judy moved my son 's dad 's grandmother 's husband 's daughter the window .
the dancer sent your daughter 's dentist 's doctor 's sister 's husband the plane .	the dancer shook your daughter 's dentist 's doctor 's sister 's husband the plane .
the teacher bought my teacher 's mother 's dentist 's friend 's friend the box .	the teacher dropped my teacher 's mother 's dentist 's friend 's friend the box .
the customer bought my father 's dentist 's father 's husband 's wife the picture .	the customer dropped my father 's dentist 's father 's husband 's wife the picture .
the person sent your teacher 's mother 's mother 's dad 's sister the dish .	the person kept your teacher 's mother 's mother 's dad 's sister the dish .
your teacher sent your daughter 's sister 's dentist 's doctor 's doctor the bag .	your teacher dropped your daughter 's sister 's dentist 's doctor 's doctor the bag .
your teacher sent your mother 's boss 's brother 's friend 's brother the shirt .	your teacher shook your mother 's boss 's brother 's friend 's brother the shirt .
Rebecca gave your father 's friend 's boss 's mom 's husband the car .	Rebecca held your father 's friend 's boss 's mom 's husband the car .
the child gave my cousin 's dad 's wife 's cousin 's daughter the hat .	the child kept my cousin 's dad 's wife 's cousin 's daughter the hat .
the adult showed your brother 's grandmother 's mom 's dad 's teacher the couch .	the adult moved your brother 's grandmother 's mom 's dad 's teacher the couch .
Deborah sent my sister 's doctor 's boss 's father 's dentist the ring .	Deborah cleaned my sister 's doctor 's boss 's father 's dentist the ring .
the doctor sent my brother 's mom 's teacher 's mother 's dentist the plate .	the doctor moved my brother 's mom 's teacher 's mother 's dentist the plate .
Scott gave my wife 's mom 's father 's dentist 's dentist the bowl .	Scott lost my wife 's mom 's father 's dentist 's dentist the bowl .
Steve gave my doctor 's father 's brother 's boss 's grandmother the spoon .	Steve held my doctor 's father 's brother 's boss 's grandmother the spoon .
your friend sent your daughter 's wife 's dad 's cousin 's doctor the rug .	your friend held your daughter 's wife 's dad 's cousin 's doctor the rug .
my boss gave my husband 's dad 's grandmother 's sister 's friend the plane .	my boss lost my husband 's dad 's grandmother 's sister 's friend the plane .
the customer gave your sister 's teacher 's sister 's wife 's sister the glass .	the customer kept your sister 's teacher 's sister 's wife 's sister the glass .
Denise bought my mother 's mom 's grandmother 's father 's dentist the book .	Denise lost my mother 's mom 's grandmother 's father 's dentist the book .
the teacher bought my dad 's wife 's dentist 's daughter 's husband the car .	the teacher kept my dad 's wife 's dentist 's daughter 's husband the car .
Andrew sent your dentist 's son 's friend 's husband 's cousin the bicycle .	Andrew held your dentist 's son 's friend 's husband 's cousin the bicycle .
my teacher gave your daughter 's husband 's son 's son 's doctor the fork .	my teacher shook your daughter 's husband 's son 's son 's doctor the fork .
Paul showed your cousin 's dad 's mom 's teacher 's grandmother the plane .	Paul shook your cousin 's dad 's mom 's teacher 's grandmother the plane .
the customer gave your mother 's doctor 's mom 's father 's brother the glass .	the customer moved your mother 's doctor 's mom 's father 's brother the glass .
Naomi sent your boss 's daughter 's wife 's dad 's husband the chair .	Naomi cleaned your boss 's daughter 's wife 's dad 's husband the chair .
Bill showed my wife 's daughter 's daughter 's friend 's doctor the car .	Bill lost my wife 's daughter 's daughter 's friend 's doctor the car .
the adult bought my son 's cousin 's son 's mom 's doctor the book .	the adult dropped my son 's cousin 's son 's mom 's doctor the book .
the driver gave my mother 's wife 's sister 's dad 's teacher the bottle .	the driver dropped my mother 's wife 's sister 's dad 's teacher the bottle .
Becca showed your boss 's mom 's mother 's father 's dad the couch .	Becca shook your boss 's mom 's mother 's father 's dad the couch .
the child sent my grandmother 's wife 's boss 's brother 's cousin the rocket .	the child shook my grandmother 's wife 's boss 's brother 's cousin the rocket .
Naomi sent my mom 's dentist 's wife 's brother 's friend the bottle .	Naomi moved my mom 's dentist 's wife 's brother 's friend the bottle .
Ronald showed my boss 's friend 's cousin 's mom 's husband the car .	Ronald kept my boss 's friend 's cousin 's mom 's husband the car .
the doctor bought your friend 's dad 's sister 's mother 's mom the picture .	the doctor held your friend 's dad 's sister 's mother 's mom the picture .
Barbara bought my friend 's brother 's dad 's father 's husband the car .	Barbara held my friend 's brother 's dad 's father 's husband the car .
the driver sent my boss 's son 's dad 's cousin 's teacher the truck .	the driver shook my boss 's son 's dad 's cousin 's teacher the truck .
Amelia showed your son 's brother 's friend 's husband 's sister the plate .	Amelia moved your son 's brother 's friend 's husband 's sister the plate .
my teacher sent your father 's mother 's grandmother 's friend 's wife the truck .	my teacher lost your father 's mother 's grandmother 's friend 's wife the truck .
Travis gave your dentist 's friend 's mother 's teacher 's boss the fork .	Travis kept your dentist 's friend 's mother 's teacher 's boss the fork .
my doctor showed your friend 's friend 's grandmother 's brother 's friend the doll .	my doctor moved your friend 's friend 's grandmother 's brother 's friend the doll .
Paul bought your mom 's friend 's father 's mom 's son the dish .	Paul cleaned your mom 's friend 's father 's mom 's son the dish .
Renee showed your mother 's father 's doctor 's daughter 's mother the candle .	Renee lost your mother 's father 's doctor 's daughter 's mother the candle .
my boss showed your dad 's mom 's cousin 's husband 's boss the couch .	my boss moved your dad 's mom 's cousin 's husband 's boss the couch .
Travis sent my mother 's boss 's son 's daughter 's father the hat .	Travis lost my mother 's boss 's son 's daughter 's father the hat .
the driver gave my teacher 's father 's boss 's sister 's dad the ship .	the driver dropped my teacher 's father 's boss 's sister 's dad the ship .
your doctor gave your mom 's son 's dad 's doctor 's boss the ship .	your doctor held your mom 's son 's dad 's doctor 's boss the ship .
Travis sent my daughter 's dad 's daughter 's husband 's grandmother the bowl .	Travis dropped my daughter 's dad 's daughter 's husband 's grandmother the bowl .
the person sent your brother 's son 's sister 's sister 's grandmother the ring .	the person held your brother 's son 's sister 's sister 's grandmother the ring .
the adult bought my sister 's boss 's grandmother 's doctor 's brother the shirt .	the adult shook my sister 's boss 's grandmother 's doctor 's brother the shirt .
George bought my mom 's doctor 's friend 's wife 's brother the book .	George held my mom 's doctor 's friend 's wife 's brother the book .
my cousin bought my doctor 's dentist 's doctor 's husband 's husband the picture .	my cousin moved my doctor 's dentist 's doctor 's husband 's husband the picture .
Catherine bought my sister 's boss 's dad 's husband 's brother the truck .	Catherine shook my sister 's boss 's dad 's husband 's brother the truck .
the dentist bought my daughter 's son 's mother 's sister 's father the door .	the dentist cleaned my daughter 's son 's mother 's sister 's father the door .
the adult gave your friend 's grandmother 's boss 's friend 's sister the hat .	the adult held your friend 's grandmother 's boss 's friend 's sister the hat .
Gregory sent your mother 's boss 's cousin 's cousin 's doctor the bottle .	Gregory held your mother 's boss 's cousin 's cousin 's doctor the bottle .
the dentist bought your mother 's friend 's father 's brother 's son the plate .	the dentist held your mother 's friend 's father 's brother 's son the plate .
your boss sent your mom 's wife 's son 's grandmother 's mother the glass .	your boss shook your mom 's wife 's son 's grandmother 's mother the glass .
the child sent my teacher 's husband 's husband 's brother 's brother the door .	the child shook my teacher 's husband 's husband 's brother 's brother the door .
Samantha bought my doctor 's brother 's dentist 's sister 's dentist the toy .	Samantha dropped my doctor 's brother 's dentist 's sister 's dentist the toy .
Nina sent my husband 's teacher 's wife 's wife 's teacher the bed .	Nina dropped my husband 's teacher 's wife 's wife 's teacher the bed .
your boss bought my dad 's dentist 's wife 's mom 's father the fork .	your boss shook my dad 's dentist 's wife 's mom 's father the fork .
Alexander bought your brother 's mom 's brother 's friend 's wife the dish .	Alexander moved your brother 's mom 's brother 's friend 's wife the dish .
Travis gave your teacher 's mother 's sister 's teacher 's cousin the bowl .	Travis moved your teacher 's mother 's sister 's teacher 's cousin the bowl .
the child gave your brother 's boss 's daughter 's sister 's grandmother the rug .	the child lost your brother 's boss 's daughter 's sister 's grandmother the rug .
the dentist sent my boss 's mother 's mom 's son 's brother the book .	the dentist kept my boss 's mother 's mom 's son 's brother the book .
Becca showed my boss 's brother 's dentist 's cousin 's boss the bag .	Becca cleaned my boss 's brother 's dentist 's cousin 's boss the bag .
the person gave your mom 's mom 's mom 's boss 's grandmother the doll .	the person dropped your mom 's mom 's mom 's boss 's grandmother the doll .
the child sent my son 's cousin 's mother 's brother 's cousin the boat .	the child cleaned my son 's cousin 's mother 's brother 's cousin the boat .
my teacher bought my teacher 's mom 's friend 's teacher 's brother the rug .	my teacher held my teacher 's mom 's friend 's teacher 's brother the rug .
the child showed your doctor 's dentist 's grandmother 's husband 's friend the shirt .	the child moved your doctor 's dentist 's grandmother 's husband 's friend the shirt .
your friend sent my cousin 's friend 's wife 's daughter 's boss the spoon .	your friend held my cousin 's friend 's wife 's daughter 's boss the spoon .
the customer bought your cousin 's boss 's cousin 's sister 's dad the car .	the customer shook your cousin 's boss 's cousin 's sister 's dad the car .
your friend sent my dentist 's boss 's wife 's mom 's husband the spoon .	your friend cleaned my dentist 's boss 's wife 's mom 's husband the spoon .
Steven sent your grandmother 's son 's teacher 's husband 's dentist the hat .	Steven cleaned your grandmother 's son 's teacher 's husband 's dentist the hat .
Nina showed my doctor 's friend 's wife 's son 's doctor the glass .	Nina dropped my doctor 's friend 's wife 's son 's doctor the glass .
Nancy bought your grandmother 's brother 's sister 's dad 's father the book .	Nancy dropped your grandmother 's brother 's sister 's dad 's father the book .
your friend gave my cousin 's husband 's mother 's wife 's husband the boat .	your friend held my cousin 's husband 's mother 's wife 's husband the boat .
Kayla bought my doctor 's teacher 's mother 's sister 's grandmother the spoon .	Kayla kept my doctor 's teacher 's mother 's sister 's grandmother the spoon .
your cousin bought my cousin 's dad 's teacher 's mother 's husband the shoe .	your cousin dropped my cousin 's dad 's teacher 's mother 's husband the shoe .
the customer gave your friend 's dad 's grandmother 's husband 's teacher the bowl .	the customer dropped your friend 's dad 's grandmother 's husband 's teacher the bowl .
the doctor gave my dentist 's mom 's teacher 's cousin 's mom the dish .	the doctor dropped my dentist 's mom 's teacher 's cousin 's mom the dish .
the adult showed my teacher 's father 's wife 's doctor 's daughter the bicycle .	the adult cleaned my teacher 's father 's wife 's doctor 's daughter the bicycle .
the teacher sent my dentist 's boss 's dentist 's dentist 's mother the bed .	the teacher shook my dentist 's boss 's dentist 's dentist 's mother the bed .
Amelia showed your son 's doctor 's teacher 's husband 's mom the rocket .	Amelia held your son 's doctor 's teacher 's husband 's mom the rocket .
your doctor showed my cousin 's father 's mom 's dad 's daughter the plate .	your doctor dropped my cousin 's father 's mom 's dad 's daughter the plate .
your boss bought my sister 's friend 's brother 's wife 's father the shirt .	your boss dropped my sister 's friend 's brother 's wife 's father the shirt .
your cousin showed my daughter 's boss 's boss 's husband 's daughter the ring .	your cousin lost my daughter 's boss 's boss 's husband 's daughter the ring .
your dentist showed my son 's brother 's boss 's daughter 's husband the rocket .	your dentist cleaned my son 's brother 's boss 's daughter 's husband the rocket .
the patient showed my wife 's dentist 's teacher 's sister 's doctor the shirt .	the patient shook my wife 's dentist 's teacher 's sister 's doctor the shirt .
Amy bought my doctor 's sister 's sister 's wife 's dentist the couch .	Amy shook my doctor 's sister 's sister 's wife 's dentist the couch .
your doctor bought your mother 's wife 's cousin 's cousin 's mom the bowl .	your doctor lost your mother 's wife 's cousin 's cousin 's mom the bowl .
Susan showed my dad 's wife 's grandmother 's son 's wife the book .	Susan lost my dad 's wife 's grandmother 's son 's wife the book .
my boss gave your dentist 's sister 's daughter 's wife 's father the bicycle .	my boss lost your dentist 's sister 's daughter 's wife 's father the bicycle .
your dentist showed my dentist 's boss 's mom 's boss 's wife the glass .	your dentist kept my dentist 's boss 's mom 's boss 's wife the glass .
the teacher sent my son 's son 's wife 's dentist 's daughter the bag .	the teacher shook my son 's son 's wife 's dentist 's daughter the bag .
April showed my mom 's father 's husband 's boss 's dentist the rug .	April cleaned my mom 's father 's husband 's boss 's dentist the rug .
Michelle gave my doctor 's boss 's dentist 's wife 's dad the rug .	Michelle moved my doctor 's boss 's dentist 's wife 's dad the rug .
James showed your friend 's friend 's dentist 's friend 's father the bottle .	James held your friend 's friend 's dentist 's friend 's father the bottle .
the driver sent your grandmother 's mom 's boss 's doctor 's teacher the candle .	the driver dropped your grandmother 's mom 's boss 's doctor 's teacher the candle .
the dentist showed your brother 's boss 's father 's dentist 's grandmother the ring .	the dentist kept your brother 's boss 's father 's dentist 's grandmother the ring .
your dentist gave my husband 's teacher 's doctor 's boss 's teacher the glass .	your dentist cleaned my husband 's teacher 's doctor 's boss 's teacher the glass .
my boss bought your cousin 's friend 's mom 's teacher 's teacher the car .	my boss moved your cousin 's friend 's mom 's teacher 's teacher the car .
my friend gave my daughter 's sister 's daughter 's sister 's son the plane .	my friend moved my daughter 's sister 's daughter 's sister 's son the plane .
Alice sent my brother 's doctor 's daughter 's cousin 's boss the ship .	Alice dropped my brother 's doctor 's daughter 's cousin 's boss the ship .
the child sent my husband 's friend 's dentist 's doctor 's dad the couch .	the child moved my husband 's friend 's dentist 's doctor 's dad the couch .
your cousin gave my husband 's cousin 's boss 's mother 's father the ship .	your cousin held my husband 's cousin 's boss 's mother 's father the ship .
the teacher gave my husband 's daughter 's brother 's brother 's grandmother the car .	the teacher lost my husband 's daughter 's brother 's brother 's grandmother the car .
Todd bought my wife 's sister 's cousin 's sister 's doctor the plate .	Todd held my wife 's sister 's cousin 's sister 's doctor the plate .
Michael sent your teacher 's brother 's friend 's mother 's daughter the car .	Michael held your teacher 's brother 's friend 's mother 's daughter the car .
my friend gave my son 's father 's husband 's dentist 's dentist the ring .	my friend lost my son 's father 's husband 's dentist 's dentist the ring .
the doctor sent your daughter 's dentist 's husband 's sister 's daughter the boat .	the doctor lost your daughter 's dentist 's husband 's sister 's daughter the boat .
the customer showed my father 's grandmother 's dad 's mom 's sister the rocket .	the customer shook my father 's grandmother 's dad 's mom 's sister the rocket .
Kristen sent my doctor 's grandmother 's daughter 's son 's mom the dish .	Kristen dropped my doctor 's grandmother 's daughter 's son 's mom the dish .
Jill gave your grandmother 's friend 's daughter 's wife 's cousin the candle .	Jill shook your grandmother 's friend 's daughter 's wife 's cousin the candle .
my dentist gave your boss 's sister 's boss 's sister 's sister the shoe .	my dentist kept your boss 's sister 's boss 's sister 's sister the shoe .
my teacher bought your brother 's doctor 's friend 's husband 's cousin the book .	my teacher cleaned your brother 's doctor 's friend 's husband 's cousin the book .
the teacher sent your mom 's son 's husband 's grandmother 's brother the mirror .	the teacher cleaned your mom 's son 's husband 's grandmother 's brother the mirror .
John bought my mother 's friend 's brother 's son 's cousin the crayon .	John lost my mother 's friend 's brother 's son 's cousin the crayon .
your boss showed your dentist 's brother 's daughter 's doctor 's cousin the candle .	your boss lost your dentist 's brother 's daughter 's doctor 's cousin the candle .
Erin sent my father 's cousin 's dentist 's cousin 's dentist the ring .	Erin dropped my father 's cousin 's dentist 's cousin 's dentist the ring .
my teacher gave your grandmother 's sister 's daughter 's wife 's dad the truck .	my teacher moved your grandmother 's sister 's daughter 's wife 's dad the truck .
my teacher bought my sister 's teacher 's cousin 's mom 's boss the ship .	my teacher dropped my sister 's teacher 's cousin 's mom 's boss the ship .
the teacher sent your husband 's daughter 's doctor 's mother 's father the picture .	the teacher dropped your husband 's daughter 's doctor 's mother 's father the picture .
your doctor sent your teacher 's sister 's doctor 's brother 's teacher the plane .	your doctor cleaned your teacher 's sister 's doctor 's brother 's teacher the plane .
my teacher gave my dad 's dad 's husband 's sister 's dad the bed .	my teacher dropped my dad 's dad 's husband 's sister 's dad the bed .
Sandra bought my dad 's brother 's brother 's son 's friend the rocket .	Sandra cleaned my dad 's brother 's brother 's son 's friend the rocket .
your teacher bought my brother 's mom 's mother 's dad 's doctor the boat .	your teacher kept my brother 's mom 's mother 's dad 's doctor the boat .
the child showed my teacher 's brother 's husband 's brother 's daughter the book .	the child dropped my teacher 's brother 's husband 's brother 's daughter the book .
your friend sent my dentist 's mother 's mom 's wife 's teacher the car .	your friend dropped my dentist 's mother 's mom 's wife 's teacher the car .
the driver gave my friend 's wife 's mom 's dad 's father the crayon .	the driver cleaned my friend 's wife 's mom 's dad 's father the crayon .
the person showed your mom 's husband 's teacher 's mother 's cousin the window .	the person lost your mom 's husband 's teacher 's mother 's cousin the window .
the adult sent your brother 's dentist 's daughter 's dentist 's dad the toy .	the adult kept your brother 's dentist 's daughter 's dentist 's dad the toy .
the customer showed my dad 's sister 's sister 's mother 's teacher the bottle .	the customer dropped my dad 's sister 's sister 's mother 's teacher the bottle .
the patient gave my boss 's wife 's cousin 's sister 's dad the doll .	the patient held my boss 's wife 's cousin 's sister 's dad the doll .
the driver showed your mother 's brother 's mom 's grandmother 's mother the chair .	the driver held your mother 's brother 's mom 's grandmother 's mother the chair .
Christopher gave my doctor 's father 's cousin 's brother 's daughter the mirror .	Christopher held my doctor 's father 's cousin 's brother 's daughter the mirror .
Karen showed your mom 's teacher 's dentist 's teacher 's husband the crayon .	Karen moved your mom 's teacher 's dentist 's teacher 's husband the crayon .
Robert sent my father 's friend 's sister 's grandmother 's friend the ring .	Robert lost my father 's friend 's sister 's grandmother 's friend the ring .
Mark gave my doctor 's doctor 's son 's mom 's wife the bicycle .	Mark shook my doctor 's doctor 's son 's mom 's wife the bicycle .
your cousin showed my father 's teacher 's dad 's dad 's brother the shoe .	your cousin dropped my father 's teacher 's dad 's dad 's brother the shoe .
the customer showed my sister 's son 's cousin 's husband 's dentist the plane .	the customer shook my sister 's son 's cousin 's husband 's dentist the plane .
Brian bought your daughter 's grandmother 's dad 's son 's teacher the truck .	Brian cleaned your daughter 's grandmother 's dad 's son 's teacher the truck .
my teacher sent my son 's son 's dad 's wife 's brother the window .	my teacher lost my son 's son 's dad 's wife 's brother the window .
your dentist showed your son 's wife 's husband 's teacher 's husband the car .	your dentist cleaned your son 's wife 's husband 's teacher 's husband the car .
your boss showed my father 's mother 's mother 's mother 's cousin the plate .	your boss lost my father 's mother 's mother 's mother 's cousin the plate .
the adult gave my doctor 's boss 's dentist 's boss 's mother the boat .	the adult held my doctor 's boss 's dentist 's boss 's mother the boat .
the person gave my dad 's cousin 's brother 's cousin 's boss the ring .	the person kept my dad 's cousin 's brother 's cousin 's boss the ring .
the customer bought your mother 's teacher 's dad 's wife 's dentist the bottle .	the customer held your mother 's teacher 's dad 's wife 's dentist the bottle .
my doctor sent my daughter 's cousin 's husband 's teacher 's father the car .	my doctor dropped my daughter 's cousin 's husband 's teacher 's father the car .
my cousin sent your husband 's boss 's mother 's son 's dentist the mirror .	my cousin held your husband 's boss 's mother 's son 's dentist the mirror .
the child sent my daughter 's daughter 's teacher 's grandmother 's dad the candle .	the child moved my daughter 's daughter 's teacher 's grandmother 's dad the candle .
Lisa bought my daughter 's daughter 's mom 's friend 's friend the mirror .	Lisa moved my daughter 's daughter 's mom 's friend 's friend the mirror .
my cousin showed your dad 's grandmother 's sister 's mom 's dentist the button .	my cousin shook your dad 's grandmother 's sister 's mom 's dentist the button .
my dentist gave your dad 's wife 's husband 's father 's mom the book .	my dentist kept your dad 's wife 's husband 's father 's mom the book .
Ann showed your dad 's teacher 's teacher 's mother 's doctor the shoe .	Ann lost your dad 's teacher 's teacher 's mother 's doctor the shoe .
Daniel bought my son 's doctor 's daughter 's dentist 's son the ship .	Daniel dropped my son 's doctor 's daughter 's dentist 's son the ship .
your doctor gave your brother 's brother 's mother 's teacher 's boss the chair .	your doctor shook your brother 's brother 's mother 's teacher 's boss the chair .
the driver showed your friend 's boss 's daughter 's mom 's father the door .	the driver dropped your friend 's boss 's daughter 's mom 's father the door .
the customer bought my boss 's wife 's grandmother 's mom 's daughter the mirror .	the customer dropped my boss 's wife 's grandmother 's mom 's daughter the mirror .
the customer showed your doctor 's sister 's doctor 's doctor 's cousin the plane .	the customer moved your doctor 's sister 's doctor 's doctor 's cousin the plane .
the dancer sent your boss 's dentist 's mom 's sister 's mom the plate .	the dancer dropped your boss 's dentist 's mom 's sister 's mom the plate .
the child showed your mother 's doctor 's cousin 's husband 's mother the toy .	the child lost your mother 's doctor 's cousin 's husband 's mother the toy .
your cousin sent your son 's wife 's husband 's cousin 's grandmother the boat .	your cousin kept your son 's wife 's husband 's cousin 's grandmother the boat .
Robert bought your grandmother 's boss 's dentist 's brother 's father the button .	Robert lost your grandmother 's boss 's dentist 's brother 's father the button .
the child gave my mother 's wife 's brother 's cousin 's son the dish .	the child kept my mother 's wife 's brother 's cousin 's son the dish .
my dentist sent my boss 's teacher 's husband 's cousin 's son the doll .	my dentist cleaned my boss 's teacher 's husband 's cousin 's son the doll .
my boss gave my friend 's daughter 's sister 's cousin 's sister the box .	my boss cleaned my friend 's daughter 's sister 's cousin 's sister the box .
my cousin sent your mom 's husband 's mother 's grandmother 's dad the bed .	my cousin held your mom 's husband 's mother 's grandmother 's dad the bed .
your doctor sent my friend 's friend 's doctor 's husband 's dentist the car .	your doctor dropped my friend 's friend 's doctor 's husband 's dentist the car .
Wendy gave my friend 's cousin 's dentist 's wife 's teacher the window .	Wendy shook my friend 's cousin 's dentist 's wife 's teacher the window .
Andrew showed your son 's dentist 's father 's friend 's teacher the doll .	Andrew cleaned your son 's dentist 's father 's friend 's teacher the doll .
the child showed your dad 's father 's wife 's daughter 's mother the rug .	the child cleaned your dad 's father 's wife 's daughter 's mother the rug .
my doctor showed my friend 's sister 's mom 's mother 's dad the dish .	my doctor kept my friend 's sister 's mom 's mother 's dad the dish .
the customer gave your boss 's wife 's cousin 's doctor 's son the picture .	the customer dropped your boss 's wife 's cousin 's doctor 's son the picture .
my teacher sent my mom 's brother 's daughter 's father 's grandmother the crayon .	my teacher held my mom 's brother 's daughter 's father 's grandmother the crayon .
your boss gave your doctor 's cousin 's dentist 's mother 's daughter the dish .	your boss dropped your doctor 's cousin 's dentist 's mother 's daughter the dish .
my cousin gave my sister 's friend 's mom 's brother 's boss the book .	my cousin held my sister 's friend 's mom 's brother 's boss the book .
Liam sent your dad 's son 's friend 's doctor 's daughter the plate .	Liam cleaned your dad 's son 's friend 's doctor 's daughter the plate .
Travis gave my dentist 's sister 's father 's dad 's wife the button .	Travis kept my dentist 's sister 's father 's dad 's wife the button .
Karen sent your brother 's doctor 's mother 's boss 's brother the car .	Karen lost your brother 's doctor 's mother 's boss 's brother the car .
the person bought my grandmother 's teacher 's cousin 's sister 's son the boat .	the person kept my grandmother 's teacher 's cousin 's sister 's son the boat .
the child gave your mom 's dad 's friend 's sister 's daughter the chair .	the child dropped your mom 's dad 's friend 's sister 's daughter the chair .
your dentist showed my boss 's friend 's mom 's wife 's father the bed .	your dentist shook my boss 's friend 's mom 's wife 's father the bed .
the adult bought my father 's mother 's father 's dentist 's doctor the crayon .	the adult cleaned my father 's mother 's father 's dentist 's doctor the crayon .
William showed my dentist 's dentist 's mom 's husband 's cousin the bicycle .	William kept my dentist 's dentist 's mom 's husband 's cousin the bicycle .
my friend gave your wife 's mom 's teacher 's grandmother 's doctor the cup .	my friend kept your wife 's mom 's teacher 's grandmother 's doctor the cup .
Travis sent your cousin 's friend 's mother 's mom 's friend the bowl .	Travis moved your cousin 's friend 's mother 's mom 's friend the bowl .
the person gave my boss 's mother 's sister 's friend 's boss the rug .	the person moved my boss 's mother 's sister 's friend 's boss the rug .
George gave my mother 's father 's son 's brother 's dad the fork .	George dropped my mother 's father 's son 's brother 's dad the fork .
the dentist showed your teacher 's grandmother 's son 's sister 's boss the couch .	the dentist dropped your teacher 's grandmother 's son 's sister 's boss the couch .
the dentist sent your grandmother 's cousin 's boss 's cousin 's wife the button .	the dentist cleaned your grandmother 's cousin 's boss 's cousin 's wife the button .
your cousin showed your husband 's dentist 's mother 's husband 's dentist the bottle .	your cousin moved your husband 's dentist 's mother 's husband 's dentist the bottle .
the teacher showed my dad 's doctor 's sister 's sister 's father the spoon .	the teacher cleaned my dad 's doctor 's sister 's sister 's father the spoon .
Carl showed my friend 's mother 's mom 's husband 's teacher the doll .	Carl held my friend 's mother 's mom 's husband 's teacher the doll .
Aaron showed my friend 's husband 's friend 's husband 's teacher the book .	Aaron held my friend 's husband 's friend 's husband 's teacher the book .
your boss gave your friend 's son 's wife 's son 's dad the couch .	your boss moved your friend 's son 's wife 's son 's dad the couch .
my cousin gave your son 's sister 's dentist 's daughter 's boss the car .	my cousin moved your son 's sister 's dentist 's daughter 's boss the car .
the adult sent your dentist 's father 's dad 's dentist 's cousin the doll .	the adult kept your dentist 's father 's dad 's dentist 's cousin the doll .
the teacher gave your teacher 's friend 's son 's husband 's husband the bed .	the teacher shook your teacher 's friend 's son 's husband 's husband the bed .
the adult sent my wife 's wife 's father 's father 's son the window .	the adult dropped my wife 's wife 's father 's father 's son the window .
Liam gave my friend 's son 's daughter 's husband 's boss the dish .	Liam cleaned my friend 's son 's daughter 's husband 's boss the dish .
my boss gave my dentist 's wife 's mother 's wife 's son the candle .	my boss kept my dentist 's wife 's mother 's wife 's son the candle .
the patient showed my teacher 's husband 's husband 's mother 's boss the spoon .	the patient cleaned my teacher 's husband 's husband 's mother 's boss the spoon .
your friend gave your father 's father 's doctor 's cousin 's sister the chair .	your friend held your father 's father 's doctor 's cousin 's sister the chair .
your cousin sent my husband 's husband 's doctor 's dentist 's teacher the bottle .	your cousin lost my husband 's husband 's doctor 's dentist 's teacher the bottle .
the customer sent your husband 's teacher 's doctor 's friend 's dentist the cup .	the customer shook your husband 's teacher 's doctor 's friend 's dentist the cup .
the adult bought my dad 's friend 's grandmother 's daughter 's father the toy .	the adult held my dad 's friend 's grandmother 's daughter 's father the toy .
Jane showed my sister 's doctor 's doctor 's dad 's mom the shirt .	Jane moved my sister 's doctor 's doctor 's dad 's mom the shirt .
your teacher gave my doctor 's father 's boss 's grandmother 's husband the box .	your teacher kept my doctor 's father 's boss 's grandmother 's husband the box .
Noah bought your dentist 's cousin 's dad 's husband 's father the toy .	Noah kept your dentist 's cousin 's dad 's husband 's father the toy .
the patient bought my cousin 's mother 's daughter 's friend 's dad the truck .	the patient dropped my cousin 's mother 's daughter 's friend 's dad the truck .
Nicole bought your wife 's friend 's mom 's sister 's dad the book .	Nicole shook your wife 's friend 's mom 's sister 's dad the book .
the child gave my wife 's son 's teacher 's friend 's dad the candle .	the child cleaned my wife 's son 's teacher 's friend 's dad the candle .
Sarah showed my wife 's doctor 's sister 's wife 's son the fork .	Sarah dropped my wife 's doctor 's sister 's wife 's son the fork .
Brett gave my doctor 's boss 's friend 's husband 's father the rug .	Brett kept my doctor 's boss 's friend 's husband 's father the rug .
the child bought your sister 's dad 's dentist 's friend 's sister the box .	the child dropped your sister 's dad 's dentist 's friend 's sister the box .
Barbara gave your son 's sister 's doctor 's sister 's boss the bicycle .	Barbara dropped your son 's sister 's doctor 's sister 's boss the bicycle .
my teacher gave my husband 's father 's boss 's wife 's cousin the rocket .	my teacher kept my husband 's father 's boss 's wife 's cousin the rocket .
your boss showed your dentist 's mom 's father 's daughter 's boss the glass .	your boss kept your dentist 's mom 's father 's daughter 's boss the glass .
your teacher sent your son 's mother 's daughter 's wife 's wife the mirror .	your teacher moved your son 's mother 's daughter 's wife 's wife the mirror .
your boss showed your dad 's father 's husband 's teacher 's friend the chair .	your boss shook your dad 's father 's husband 's teacher 's friend the chair .
your teacher sent my dad 's dad 's grandmother 's sister 's mother the couch .	your teacher held my dad 's dad 's grandmother 's sister 's mother the couch .
James showed your dad 's daughter 's dad 's friend 's grandmother the glass .	James moved your dad 's daughter 's dad 's friend 's grandmother the glass .
the driver bought my doctor 's son 's wife 's mom 's dad the hat .	the driver kept my doctor 's son 's wife 's mom 's dad the hat .
my dentist showed my grandmother 's daughter 's boss 's sister 's daughter the rug .	my dentist lost my grandmother 's daughter 's boss 's sister 's daughter the rug .
your cousin sent your sister 's sister 's dad 's mom 's sister the rug .	your cousin cleaned your sister 's sister 's dad 's mom 's sister the rug .
Allison sent your cousin 's husband 's son 's father 's son the bowl .	Allison lost your cousin 's husband 's son 's father 's son the bowl .
Rebecca gave your brother 's daughter 's wife 's husband 's boss the couch .	Rebecca moved your brother 's daughter 's wife 's husband 's boss the couch .
Anna showed your dentist 's sister 's teacher 's husband 's husband the spoon .	Anna kept your dentist 's sister 's teacher 's husband 's husband the spoon .
your dentist showed my teacher 's mom 's dentist 's friend 's cousin the button .	your dentist cleaned my teacher 's mom 's dentist 's friend 's cousin the button .
your boss showed my brother 's doctor 's brother 's dad 's grandmother the shirt .	your boss cleaned my brother 's doctor 's brother 's dad 's grandmother the shirt .
Jerry gave my boss 's mother 's wife 's husband 's wife the ring .	Jerry shook my boss 's mother 's wife 's husband 's wife the ring .
the teacher sent your mom 's father 's cousin 's dentist 's son the fork .	the teacher lost your mom 's father 's cousin 's dentist 's son the fork .
Alice bought my wife 's cousin 's dentist 's brother 's dentist the spoon .	Alice held my wife 's cousin 's dentist 's brother 's dentist the spoon .
the doctor bought your teacher 's cousin 's husband 's boss 's son the hat .	the doctor shook your teacher 's cousin 's husband 's boss 's son the hat .
Gregory showed your husband 's brother 's grandmother 's daughter 's teacher the truck .	Gregory shook your husband 's brother 's grandmother 's daughter 's teacher the truck .
your teacher gave your boss 's brother 's sister 's mother 's boss the bicycle .	your teacher held your boss 's brother 's sister 's mother 's boss the bicycle .
Brett showed my father 's dentist 's sister 's son 's dentist the picture .	Brett cleaned my father 's dentist 's sister 's son 's dentist the picture .
my teacher showed your cousin 's dad 's grandmother 's brother 's friend the crayon .	my teacher dropped your cousin 's dad 's grandmother 's brother 's friend the crayon .
Rachel bought your boss 's dentist 's wife 's dentist 's mom the bag .	Rachel cleaned your boss 's dentist 's wife 's dentist 's mom the bag .
the driver gave my dentist 's mother 's boss 's dentist 's boss the dish .	the driver lost my dentist 's mother 's boss 's dentist 's boss the dish .
the doctor gave your friend 's mother 's wife 's mother 's mom the car .	the doctor kept your friend 's mother 's wife 's mother 's mom the car .
Todd showed my son 's grandmother 's son 's friend 's dentist the bed .	Todd moved my son 's grandmother 's son 's friend 's dentist the bed .
Kayla gave my brother 's dad 's sister 's son 's wife the plane .	Kayla dropped my brother 's dad 's sister 's son 's wife the plane .
Janet bought your boss 's mother 's friend 's dentist 's husband the picture .	Janet lost your boss 's mother 's friend 's dentist 's husband the picture .
the customer sent my teacher 's brother 's son 's doctor 's mother the chair .	the customer cleaned my teacher 's brother 's son 's doctor 's mother the chair .
the adult gave your husband 's cousin 's sister 's boss 's boss the rocket .	the adult cleaned your husband 's cousin 's sister 's boss 's boss the rocket .
Tracy sent your teacher 's cousin 's husband 's sister 's wife the picture .	Tracy lost your teacher 's cousin 's husband 's sister 's wife the picture .
Kevin showed your doctor 's sister 's doctor 's wife 's boss the cup .	Kevin cleaned your doctor 's sister 's doctor 's wife 's boss the cup .
your dentist sent my wife 's daughter 's husband 's brother 's dentist the book .	your dentist cleaned my wife 's daughter 's husband 's brother 's dentist the book .
the teacher sent your dad 's wife 's father 's mom 's teacher the doll .	the teacher moved your dad 's wife 's father 's mom 's teacher the doll .
your cousin gave my friend 's doctor 's father 's grandmother 's doctor the toy .	your cousin held my friend 's doctor 's father 's grandmother 's doctor the toy .
the teacher sent your mother 's boss 's daughter 's teacher 's husband the chair .	the teacher moved your mother 's boss 's daughter 's teacher 's husband the chair .
the adult bought my cousin 's friend 's doctor 's grandmother 's grandmother the boat .	the adult shook my cousin 's friend 's doctor 's grandmother 's grandmother the boat .
the driver sent my teacher 's mom 's doctor 's friend 's mother the shoe .	the driver held my teacher 's mom 's doctor 's friend 's mother the shoe .
my boss bought my brother 's friend 's dad 's husband 's dad the dish .	my boss held my brother 's friend 's dad 's husband 's dad the dish .
the dentist showed your boss 's friend 's mother 's wife 's mom the hat .	the dentist cleaned your boss 's friend 's mother 's wife 's mom the hat .
the dentist showed your teacher 's husband 's brother 's mom 's mom the chair .	the dentist kept your teacher 's husband 's brother 's mom 's mom the chair .
your friend gave my dentist 's wife 's sister 's daughter 's brother the ring .	your friend cleaned my dentist 's wife 's sister 's daughter 's brother the ring .
your doctor bought your mom 's daughter 's boss 's friend 's doctor the door .	your doctor kept your mom 's daughter 's boss 's friend 's doctor the door .
Becca sent my sister 's mom 's mother 's mom 's friend the truck .	Becca shook my sister 's mom 's mother 's mom 's friend the truck .
Joseph bought my grandmother 's father 's mom 's son 's brother the bicycle .	Joseph shook my grandmother 's father 's mom 's son 's brother the bicycle .
the adult bought my brother 's wife 's teacher 's husband 's teacher the toy .	the adult moved my brother 's wife 's teacher 's husband 's teacher the toy .
my boss showed my sister 's dad 's doctor 's wife 's father the chair .	my boss held my sister 's dad 's doctor 's wife 's father the chair .
your teacher bought your brother 's brother 's husband 's daughter 's dad the dish .	your teacher held your brother 's brother 's husband 's daughter 's dad the dish .
Christopher gave your dad 's daughter 's mom 's dentist 's father the bottle .	Christopher cleaned your dad 's daughter 's mom 's dentist 's father the bottle .
the customer sent my mom 's boss 's cousin 's father 's dad the mirror .	the customer lost my mom 's boss 's cousin 's father 's dad the mirror .
the patient showed your son 's grandmother 's grandmother 's sister 's doctor the bed .	the patient shook your son 's grandmother 's grandmother 's sister 's doctor the bed .
Leslie bought your dentist 's daughter 's dad 's wife 's daughter the hat .	Leslie cleaned your dentist 's daughter 's dad 's wife 's daughter the hat .
the driver sent your mother 's mother 's wife 's friend 's son the box .	the driver lost your mother 's mother 's wife 's friend 's son the box .
the doctor sent my dentist 's brother 's husband 's sister 's brother the button .	the doctor dropped my dentist 's brother 's husband 's sister 's brother the button .
my cousin gave my husband 's husband 's dad 's cousin 's husband the boat .	my cousin held my husband 's husband 's dad 's cousin 's husband the boat .
Laura gave your boss 's teacher 's husband 's daughter 's brother the fork .	Laura moved your boss 's teacher 's husband 's daughter 's brother the fork .
your dentist sent my boss 's cousin 's mom 's husband 's grandmother the ring .	your dentist dropped my boss 's cousin 's mom 's husband 's grandmother the ring .
my boss showed my father 's sister 's father 's son 's sister the crayon .	my boss dropped my father 's sister 's father 's son 's sister the crayon .
my doctor sent your teacher 's brother 's boss 's dad 's son the crayon .	my doctor held your teacher 's brother 's boss 's dad 's son the crayon .
your friend gave my mom 's husband 's mom 's grandmother 's father the book .	your friend moved my mom 's husband 's mom 's grandmother 's father the book .
your dentist showed my friend 's wife 's grandmother 's sister 's sister the bowl .	your dentist dropped my friend 's wife 's grandmother 's sister 's sister the bowl .
the adult bought my cousin 's husband 's husband 's dad 's doctor the fork .	the adult shook my cousin 's husband 's husband 's dad 's doctor the fork .
the driver gave your daughter 's boss 's cousin 's boss 's teacher the box .	the driver kept your daughter 's boss 's cousin 's boss 's teacher the box .
Joseph showed my teacher 's father 's brother 's boss 's mom the candle .	Joseph held my teacher 's father 's brother 's boss 's mom the candle .
the driver sent your dad 's dad 's cousin 's sister 's boss the bottle .	the driver held your dad 's dad 's cousin 's sister 's boss the bottle .
the doctor showed my son 's daughter 's teacher 's mom 's brother the spoon .	the doctor dropped my son 's daughter 's teacher 's mom 's brother the spoon .
my doctor bought your dentist 's daughter 's wife 's doctor 's grandmother the couch .	my doctor shook your dentist 's daughter 's wife 's doctor 's grandmother the couch .
Noah sent my wife 's doctor 's dad 's grandmother 's teacher the plate .	Noah moved my wife 's doctor 's dad 's grandmother 's teacher the plate .
the doctor showed your doctor 's father 's mom 's brother 's mom the boat .	the doctor moved your doctor 's father 's mom 's brother 's mom the boat .
my doctor showed my mom 's husband 's cousin 's teacher 's son the candle .	my doctor lost my mom 's husband 's cousin 's teacher 's son the candle .
Guy sent your wife 's teacher 's grandmother 's teacher 's father the doll .	Guy dropped your wife 's teacher 's grandmother 's teacher 's father the doll .
my cousin bought my cousin 's doctor 's sister 's mom 's doctor the couch .	my cousin dropped my cousin 's doctor 's sister 's mom 's doctor the couch .
Steve gave my husband 's doctor 's dad 's cousin 's brother the bicycle .	Steve cleaned my husband 's doctor 's dad 's cousin 's brother the bicycle .
my cousin bought my brother 's son 's teacher 's teacher 's grandmother the shirt .	my cousin cleaned my brother 's son 's teacher 's teacher 's grandmother the shirt .
your teacher sent your mother 's brother 's brother 's dad 's son the rocket .	your teacher shook your mother 's brother 's brother 's dad 's son the rocket .
Timothy sent your cousin 's brother 's dentist 's wife 's boss the truck .	Timothy kept your cousin 's brother 's dentist 's wife 's boss the truck .
