the fork sitting on the floor by the chair is friendly .	the fork sits on the floor by the chair is friendly .
the button sitting by the ship in the mall is gentle .	the button sits by the ship in the mall is gentle .
the rug sitting in the school in the park is strong .	the rug sits in the school in the park is strong .
the chair sitting in the museum in the room is friendly .	the chair sits in the museum in the room is friendly .
the chair sitting on the stool in the hospital is curious .	the chair sits on the stool in the hospital is curious .
the hat sitting in the bank in the restaurant is busy .	the hat sits in the bank in the restaurant is busy .
the glass sitting on the table in the mall is important .	the glass sits on the table in the mall is important .
the shirt sitting by the rug on the bed is sleepy .	the shirt sits by the rug on the bed is sleepy .
the window sitting on the street in the bank is hungry .	the window sits on the street in the bank is hungry .
the picture sitting by the bottle in the hospital is sleepy .	the picture sits by the bottle in the hospital is sleepy .
the ship sitting on the couch on the table is kind .	the ship sits on the couch on the table is kind .
the shirt sitting on the ground in the museum is friendly .	the shirt sits on the ground in the museum is friendly .
the dish sitting in the museum in the hospital is excited .	the dish sits in the museum in the hospital is excited .
the hat sitting in the school by the bottle is gentle .	the hat sits in the school by the bottle is gentle .
the ring sitting by the crayon on the floor is hungry .	the ring sits by the crayon on the floor is hungry .
the doll sitting in the museum in the bank is young .	the doll sits in the museum in the bank is young .
the rocket sitting on the stool on the couch is healthy .	the rocket sits on the stool on the couch is healthy .
the crayon sitting in the library on the floor is lucky .	the crayon sits in the library on the floor is lucky .
the rug sitting in the bank on the street is helpful .	the rug sits in the bank on the street is helpful .
the rug sitting by the ship by the truck is helpful .	the rug sits by the ship by the truck is helpful .
the car sitting on the couch on the street is careful .	the car sits on the couch on the street is careful .
the crayon sitting in the park in the library is quiet .	the crayon sits in the park in the library is quiet .
the rug sitting in the hospital on the street is upset .	the rug sits in the hospital on the street is upset .
the chair sitting in the room on the floor is smart .	the chair sits in the room on the floor is smart .
the plate sitting in the bank by the book is kind .	the plate sits in the bank by the book is kind .
the boat sitting by the bag on the table is busy .	the boat sits by the bag on the table is busy .
the dish sitting on the floor in the restaurant is sleepy .	the dish sits on the floor in the restaurant is sleepy .
the truck sitting in the museum on the stool is curious .	the truck sits in the museum on the stool is curious .
the chair sitting on the bed by the doll is surprised .	the chair sits on the bed by the doll is surprised .
the chair sitting by the bed by the couch is friendly .	the chair sits by the bed by the couch is friendly .
the spoon sitting by the ring by the shirt is careful .	the spoon sits by the ring by the shirt is careful .
the plane sitting by the couch on the stool is quiet .	the plane sits by the couch on the stool is quiet .
the crayon sitting by the bowl by the hat is gentle .	the crayon sits by the bowl by the hat is gentle .
the bowl sitting by the bed on the couch is clever .	the bowl sits by the bed on the couch is clever .
the glass sitting on the couch on the stool is bored .	the glass sits on the couch on the stool is bored .
the cup sitting in the park on the table is hungry .	the cup sits in the park on the table is hungry .
the rocket sitting in the bank on the ground is lucky .	the rocket sits in the bank on the ground is lucky .
the hat sitting on the stool on the table is happy .	the hat sits on the stool on the table is happy .
the doll sitting in the restaurant in the mall is clever .	the doll sits in the restaurant in the mall is clever .
the button sitting by the door in the restaurant is busy .	the button sits by the door in the restaurant is busy .
the couch sitting in the restaurant on the ground is careful .	the couch sits in the restaurant on the ground is careful .
the glass sitting on the chair on the bed is strong .	the glass sits on the chair on the bed is strong .
the ring sitting on the bed on the couch is healthy .	the ring sits on the bed on the couch is healthy .
the cup sitting on the floor in the mall is clever .	the cup sits on the floor in the mall is clever .
the rug sitting in the kitchen by the chair is tired .	the rug sits in the kitchen by the chair is tired .
the bottle sitting by the box on the stool is curious .	the bottle sits by the box on the stool is curious .
the mirror sitting on the street in the kitchen is strong .	the mirror sits on the street in the kitchen is strong .
the ship sitting in the school in the bank is healthy .	the ship sits in the school in the bank is healthy .
the window sitting on the bed on the floor is healthy .	the window sits on the bed on the floor is healthy .
the rocket sitting in the museum in the hospital is bored .	the rocket sits in the museum in the hospital is bored .
the box sitting by the chair in the bank is angry .	the box sits by the chair in the bank is angry .
the bottle sitting on the table in the hospital is healthy .	the bottle sits on the table in the hospital is healthy .
the plane sitting on the floor on the chair is wrong .	the plane sits on the floor on the chair is wrong .
the cup sitting in the kitchen on the floor is angry .	the cup sits in the kitchen on the floor is angry .
the ring sitting by the rug by the window is smart .	the ring sits by the rug by the window is smart .
the car sitting by the chair in the bank is sleepy .	the car sits by the chair in the bank is sleepy .
the hat sitting in the park on the ground is tired .	the hat sits in the park on the ground is tired .
the bicycle sitting in the museum on the couch is excited .	the bicycle sits in the museum on the couch is excited .
the ship sitting in the museum by the car is upset .	the ship sits in the museum by the car is upset .
the crayon sitting on the bed on the ground is tired .	the crayon sits on the bed on the ground is tired .
the window sitting by the book in the kitchen is clever .	the window sits by the book in the kitchen is clever .
the bicycle sitting by the rocket in the park is quiet .	the bicycle sits by the rocket in the park is quiet .
the couch sitting on the couch by the bag is quiet .	the couch sits on the couch by the bag is quiet .
the picture sitting on the bed by the plane is kind .	the picture sits on the bed by the plane is kind .
the book sitting by the book by the window is important .	the book sits by the book by the window is important .
the bag sitting in the library in the library is important .	the bag sits in the library in the library is important .
the bowl sitting on the stool on the floor is friendly .	the bowl sits on the stool on the floor is friendly .
the picture sitting in the school in the museum is excited .	the picture sits in the school in the museum is excited .
the book sitting by the bag in the restaurant is friendly .	the book sits by the bag in the restaurant is friendly .
the ship sitting in the museum on the floor is lucky .	the ship sits in the museum on the floor is lucky .
the car sitting by the door by the door is upset .	the car sits by the door by the door is upset .
the door sitting by the plate on the chair is strong .	the door sits by the plate on the chair is strong .
the book sitting on the chair on the ground is lucky .	the book sits on the chair on the ground is lucky .
the candle sitting in the mall on the street is important .	the candle sits in the mall on the street is important .
the shoe sitting in the museum in the library is sleepy .	the shoe sits in the museum in the library is sleepy .
the truck sitting on the chair in the hospital is clever .	the truck sits on the chair in the hospital is clever .
the box sitting by the ring on the stool is upset .	the box sits by the ring on the stool is upset .
the book sitting by the bed by the truck is sleepy .	the book sits by the bed by the truck is sleepy .
the rocket sitting in the school by the truck is healthy .	the rocket sits in the school by the truck is healthy .
the mirror sitting in the library on the chair is curious .	the mirror sits in the library on the chair is curious .
the bed sitting by the book on the ground is careful .	the bed sits by the book on the ground is careful .
the car sitting by the mirror in the hospital is upset .	the car sits by the mirror in the hospital is upset .
the dish sitting in the museum in the kitchen is important .	the dish sits in the museum in the kitchen is important .
the hat sitting by the ship by the glass is curious .	the hat sits by the ship by the glass is curious .
the box sitting by the toy by the glass is angry .	the box sits by the toy by the glass is angry .
the doll sitting by the bowl by the bottle is sleepy .	the doll sits by the bowl by the bottle is sleepy .
the spoon sitting on the bed by the mirror is important .	the spoon sits on the bed by the mirror is important .
the shoe sitting by the window in the museum is smart .	the shoe sits by the window in the museum is smart .
the toy sitting on the street in the library is healthy .	the toy sits on the street in the library is healthy .
the book sitting by the shirt in the kitchen is quiet .	the book sits by the shirt in the kitchen is quiet .
the window sitting on the couch by the ship is bored .	the window sits on the couch by the ship is bored .
the car sitting on the ground by the ring is tall .	the car sits on the ground by the ring is tall .
the bed sitting on the table in the library is healthy .	the bed sits on the table in the library is healthy .
the ring sitting on the bed in the park is gentle .	the ring sits on the bed in the park is gentle .
the bottle sitting on the table on the chair is lucky .	the bottle sits on the table on the chair is lucky .
the crayon sitting on the bed on the chair is happy .	the crayon sits on the bed on the chair is happy .
the shoe sitting on the chair on the table is healthy .	the shoe sits on the chair on the table is healthy .
the chair sitting in the school on the couch is strong .	the chair sits in the school on the couch is strong .
the truck sitting by the hat by the fork is healthy .	the truck sits by the hat by the fork is healthy .
the mirror sitting on the stool on the bed is wrong .	the mirror sits on the stool on the bed is wrong .
the bottle sitting in the hospital in the kitchen is important .	the bottle sits in the hospital in the kitchen is important .
the cup sitting on the ground by the ring is surprised .	the cup sits on the ground by the ring is surprised .
the box sitting on the ground by the plane is friendly .	the box sits on the ground by the plane is friendly .
the ship sitting in the kitchen by the plate is strong .	the ship sits in the kitchen by the plate is strong .
the chair sitting in the school on the chair is wrong .	the chair sits in the school on the chair is wrong .
the plate sitting in the kitchen in the mall is strong .	the plate sits in the kitchen in the mall is strong .
the ring sitting on the table on the ground is tired .	the ring sits on the table on the ground is tired .
the rug sitting on the street in the bank is lucky .	the rug sits on the street in the bank is lucky .
the doll sitting in the restaurant in the hospital is confused .	the doll sits in the restaurant in the hospital is confused .
the ring sitting in the museum in the park is healthy .	the ring sits in the museum in the park is healthy .
the toy sitting by the mirror by the ring is upset .	the toy sits by the mirror by the ring is upset .
the bed sitting by the button in the hospital is hungry .	the bed sits by the button in the hospital is hungry .
the couch sitting by the car on the couch is boring .	the couch sits by the car on the couch is boring .
the bag sitting by the book in the library is wrong .	the bag sits by the book in the library is wrong .
the dish sitting in the mall by the spoon is strong .	the dish sits in the mall by the spoon is strong .
the truck sitting on the couch by the ring is bored .	the truck sits on the couch by the ring is bored .
the bed sitting in the bank by the candle is strong .	the bed sits in the bank by the candle is strong .
the bag sitting by the boat in the library is important .	the bag sits by the boat in the library is important .
the cup sitting by the fork by the hat is confused .	the cup sits by the fork by the hat is confused .
the dish sitting on the chair in the hospital is sleepy .	the dish sits on the chair in the hospital is sleepy .
the mirror sitting on the stool on the chair is curious .	the mirror sits on the stool on the chair is curious .
the candle sitting in the hospital in the kitchen is young .	the candle sits in the hospital in the kitchen is young .
the window sitting in the library in the school is strong .	the window sits in the library in the school is strong .
the fork sitting in the school on the street is quiet .	the fork sits in the school on the street is quiet .
the doll sitting by the toy on the couch is quiet .	the doll sits by the toy on the couch is quiet .
the doll sitting by the shirt in the restaurant is wrong .	the doll sits by the shirt in the restaurant is wrong .
the hat sitting in the museum by the truck is quiet .	the hat sits in the museum by the truck is quiet .
the bag sitting in the kitchen in the restaurant is angry .	the bag sits in the kitchen in the restaurant is angry .
the bowl sitting on the stool on the street is gentle .	the bowl sits on the stool on the street is gentle .
the button sitting in the room by the box is bored .	the button sits in the room by the box is bored .
the rug sitting by the shoe on the chair is excited .	the rug sits by the shoe on the chair is excited .
the picture sitting by the rug by the mirror is healthy .	the picture sits by the rug by the mirror is healthy .
the dish sitting in the kitchen by the picture is nice .	the dish sits in the kitchen by the picture is nice .
the plane sitting on the ground by the ship is kind .	the plane sits on the ground by the ship is kind .
the truck sitting on the stool in the restaurant is helpful .	the truck sits on the stool in the restaurant is helpful .
the picture sitting in the mall by the book is upset .	the picture sits in the mall by the book is upset .
the car sitting on the floor by the truck is confused .	the car sits on the floor by the truck is confused .
the rug sitting on the street on the ground is excited .	the rug sits on the street on the ground is excited .
the shirt sitting by the doll in the mall is curious .	the shirt sits by the doll in the mall is curious .
the bag sitting by the truck by the rocket is kind .	the bag sits by the truck by the rocket is kind .
the picture sitting on the street in the library is quiet .	the picture sits on the street in the library is quiet .
the cup sitting by the dish by the plate is tired .	the cup sits by the dish by the plate is tired .
the doll sitting on the couch by the bicycle is angry .	the doll sits on the couch by the bicycle is angry .
the car sitting in the library by the window is kind .	the car sits in the library by the window is kind .
the bowl sitting in the school by the rocket is hungry .	the bowl sits in the school by the rocket is hungry .
the toy sitting in the bank on the floor is boring .	the toy sits in the bank on the floor is boring .
the plate sitting on the stool by the crayon is hungry .	the plate sits on the stool by the crayon is hungry .
the bicycle sitting on the chair in the mall is busy .	the bicycle sits on the chair in the mall is busy .
the shoe sitting on the stool by the crayon is wrong .	the shoe sits on the stool by the crayon is wrong .
the bowl sitting by the car on the ground is confused .	the bowl sits by the car on the ground is confused .
the plane sitting in the library by the hat is careful .	the plane sits in the library by the hat is careful .
the button sitting by the hat by the doll is angry .	the button sits by the hat by the doll is angry .
the toy sitting on the chair in the hospital is confused .	the toy sits on the chair in the hospital is confused .
the shoe sitting by the picture by the window is strong .	the shoe sits by the picture by the window is strong .
the glass sitting on the floor in the park is boring .	the glass sits on the floor in the park is boring .
the hat sitting in the hospital on the floor is clever .	the hat sits in the hospital on the floor is clever .
the ship sitting in the hospital on the stool is upset .	the ship sits in the hospital on the stool is upset .
the bottle sitting in the museum on the ground is helpful .	the bottle sits in the museum on the ground is helpful .
the shoe sitting on the chair by the doll is nice .	the shoe sits on the chair by the doll is nice .
the crayon sitting on the table by the fork is hungry .	the crayon sits on the table by the fork is hungry .
the book sitting by the rocket in the restaurant is surprised .	the book sits by the rocket in the restaurant is surprised .
the spoon sitting by the box on the table is angry .	the spoon sits by the box on the table is angry .
the bicycle sitting by the car by the rug is curious .	the bicycle sits by the car by the rug is curious .
the box sitting in the library by the ring is angry .	the box sits in the library by the ring is angry .
the ship sitting on the ground on the ground is boring .	the ship sits on the ground on the ground is boring .
the hat sitting in the bank in the room is helpful .	the hat sits in the bank in the room is helpful .
the book sitting by the plate in the park is smart .	the book sits by the plate in the park is smart .
the boat sitting on the ground by the doll is boring .	the boat sits on the ground by the doll is boring .
the plate sitting on the couch in the library is careful .	the plate sits on the couch in the library is careful .
the shirt sitting on the ground on the table is tired .	the shirt sits on the ground on the table is tired .
the plane sitting by the picture on the floor is gentle .	the plane sits by the picture on the floor is gentle .
the book sitting in the kitchen by the bicycle is surprised .	the book sits in the kitchen by the bicycle is surprised .
the picture sitting by the bowl on the floor is tired .	the picture sits by the bowl on the floor is tired .
the doll sitting on the stool by the couch is happy .	the doll sits on the stool by the couch is happy .
the bowl sitting in the hospital in the bank is smart .	the bowl sits in the hospital in the bank is smart .
the spoon sitting in the kitchen by the glass is clever .	the spoon sits in the kitchen by the glass is clever .
the bicycle sitting by the bag by the plate is bored .	the bicycle sits by the bag by the plate is bored .
the rocket sitting on the bed in the park is healthy .	the rocket sits on the bed in the park is healthy .
the car sitting on the bed in the library is busy .	the car sits on the bed in the library is busy .
the couch sitting by the crayon by the ring is angry .	the couch sits by the crayon by the ring is angry .
the box sitting by the bottle on the ground is friendly .	the box sits by the bottle on the ground is friendly .
the candle sitting on the ground on the bed is kind .	the candle sits on the ground on the bed is kind .
the ship sitting on the bed on the couch is friendly .	the ship sits on the bed on the couch is friendly .
the bag sitting by the couch by the window is strong .	the bag sits by the couch by the window is strong .
the bicycle sitting on the chair in the park is bored .	the bicycle sits on the chair in the park is bored .
the door sitting on the floor on the couch is kind .	the door sits on the floor on the couch is kind .
the toy sitting on the ground in the restaurant is upset .	the toy sits on the ground in the restaurant is upset .
the door sitting by the spoon in the park is young .	the door sits by the spoon in the park is young .
the ring sitting on the couch by the door is important .	the ring sits on the couch by the door is important .
the book sitting by the ring in the bank is kind .	the book sits by the ring in the bank is kind .
the cup sitting on the table by the bowl is helpful .	the cup sits on the table by the bowl is helpful .
the couch sitting by the plate in the bank is smart .	the couch sits by the plate in the bank is smart .
the door sitting on the stool by the spoon is healthy .	the door sits on the stool by the spoon is healthy .
the fork sitting by the bottle in the restaurant is surprised .	the fork sits by the bottle in the restaurant is surprised .
the car sitting in the school in the mall is confused .	the car sits in the school in the mall is confused .
the candle sitting in the school by the spoon is healthy .	the candle sits in the school by the spoon is healthy .
the boat sitting by the candle in the hospital is important .	the boat sits by the candle in the hospital is important .
the hat sitting by the plane by the rocket is kind .	the hat sits by the plane by the rocket is kind .
the spoon sitting by the window on the chair is clever .	the spoon sits by the window on the chair is clever .
the shirt sitting in the mall by the plane is boring .	the shirt sits in the mall by the plane is boring .
the window sitting on the table in the hospital is hungry .	the window sits on the table in the hospital is hungry .
the bowl sitting by the mirror in the bank is boring .	the bowl sits by the mirror in the bank is boring .
the rug sitting by the book in the library is nice .	the rug sits by the book in the library is nice .
the bottle sitting by the hat in the museum is angry .	the bottle sits by the hat in the museum is angry .
the bottle sitting in the mall by the car is happy .	the bottle sits in the mall by the car is happy .
the plate sitting in the kitchen by the couch is clever .	the plate sits in the kitchen by the couch is clever .
the bottle sitting in the room on the floor is healthy .	the bottle sits in the room on the floor is healthy .
the mirror sitting in the school in the restaurant is healthy .	the mirror sits in the school in the restaurant is healthy .
the truck sitting on the stool in the hospital is nice .	the truck sits on the stool in the hospital is nice .
the hat sitting on the chair by the rug is bored .	the hat sits on the chair by the rug is bored .
the picture sitting by the ring by the plate is kind .	the picture sits by the ring by the plate is kind .
the book sitting by the mirror on the ground is important .	the book sits by the mirror on the ground is important .
the bag sitting by the car in the school is tired .	the bag sits by the car in the school is tired .
the boat sitting in the bank on the ground is curious .	the boat sits in the bank on the ground is curious .
the bag sitting on the stool on the street is tired .	the bag sits on the stool on the street is tired .
the chair sitting on the bed by the candle is angry .	the chair sits on the bed by the candle is angry .
the toy sitting in the kitchen on the floor is strong .	the toy sits in the kitchen on the floor is strong .
the bowl sitting by the hat on the couch is bored .	the bowl sits by the hat on the couch is bored .
the shoe sitting by the shirt on the street is upset .	the shoe sits by the shirt on the street is upset .
the fork sitting by the toy by the mirror is tired .	the fork sits by the toy by the mirror is tired .
the truck sitting by the dish by the button is surprised .	the truck sits by the dish by the button is surprised .
the hat sitting on the table on the stool is excited .	the hat sits on the table on the stool is excited .
the hat sitting in the bank on the ground is healthy .	the hat sits in the bank on the ground is healthy .
the rocket sitting in the park in the library is quiet .	the rocket sits in the park in the library is quiet .
the window sitting on the ground in the school is happy .	the window sits on the ground in the school is happy .
the bowl sitting on the couch in the restaurant is gentle .	the bowl sits on the couch in the restaurant is gentle .
the mirror sitting in the bank by the car is tired .	the mirror sits in the bank by the car is tired .
the picture sitting by the bottle on the stool is careful .	the picture sits by the bottle on the stool is careful .
the picture sitting on the ground on the bed is young .	the picture sits on the ground on the bed is young .
the shoe sitting in the restaurant in the school is clever .	the shoe sits in the restaurant in the school is clever .
the truck sitting on the stool by the spoon is young .	the truck sits on the stool by the spoon is young .
the bottle sitting on the floor by the bed is tired .	the bottle sits on the floor by the bed is tired .
the rocket sitting on the chair on the bed is hungry .	the rocket sits on the chair on the bed is hungry .
the spoon sitting on the chair in the restaurant is smart .	the spoon sits on the chair in the restaurant is smart .
the rug sitting in the hospital by the bag is curious .	the rug sits in the hospital by the bag is curious .
the door sitting on the chair on the street is busy .	the door sits on the chair on the street is busy .
the ring sitting by the ship on the floor is surprised .	the ring sits by the ship on the floor is surprised .
the book sitting by the truck on the chair is happy .	the book sits by the truck on the chair is happy .
the truck sitting on the table by the boat is tired .	the truck sits on the table by the boat is tired .
the chair sitting in the hospital on the chair is excited .	the chair sits in the hospital on the chair is excited .
the toy sitting on the floor on the couch is quiet .	the toy sits on the floor on the couch is quiet .
the couch sitting in the room on the street is angry .	the couch sits in the room on the street is angry .
the bowl sitting on the chair on the floor is gentle .	the bowl sits on the chair on the floor is gentle .
the plane sitting on the street by the bed is nice .	the plane sits on the street by the bed is nice .
the bottle sitting in the library on the couch is kind .	the bottle sits in the library on the couch is kind .
the book sitting by the chair on the chair is confused .	the book sits by the chair on the chair is confused .
the bicycle sitting by the bed in the school is quiet .	the bicycle sits by the bed in the school is quiet .
the crayon sitting in the school in the library is happy .	the crayon sits in the school in the library is happy .
the bottle sitting on the couch on the bed is important .	the bottle sits on the couch on the bed is important .
the doll sitting on the floor in the park is nice .	the doll sits on the floor in the park is nice .
the couch sitting in the kitchen by the bag is important .	the couch sits in the kitchen by the bag is important .
the car sitting in the park in the hospital is helpful .	the car sits in the park in the hospital is helpful .
the rocket sitting by the book by the bowl is curious .	the rocket sits by the book by the bowl is curious .
the ship sitting on the floor on the stool is upset .	the ship sits on the floor on the stool is upset .
the button sitting by the crayon on the floor is sleepy .	the button sits by the crayon on the floor is sleepy .
the mirror sitting by the couch on the table is gentle .	the mirror sits by the couch on the table is gentle .
the truck sitting on the stool by the boat is kind .	the truck sits on the stool by the boat is kind .
the book sitting in the school by the cup is hungry .	the book sits in the school by the cup is hungry .
the doll sitting on the table in the school is sleepy .	the doll sits on the table in the school is sleepy .
the plate sitting by the chair by the chair is bored .	the plate sits by the chair by the chair is bored .
the rug sitting by the chair on the ground is confused .	the rug sits by the chair on the ground is confused .
the dish sitting in the restaurant on the couch is nice .	the dish sits in the restaurant on the couch is nice .
the doll sitting in the bank in the hospital is nice .	the doll sits in the bank in the hospital is nice .
the doll sitting in the kitchen on the couch is healthy .	the doll sits in the kitchen on the couch is healthy .
the bicycle sitting on the couch on the chair is upset .	the bicycle sits on the couch on the chair is upset .
the crayon sitting on the couch in the school is nice .	the crayon sits on the couch in the school is nice .
the doll sitting on the floor in the school is excited .	the doll sits on the floor in the school is excited .
the plane sitting on the street by the book is strong .	the plane sits on the street by the book is strong .
the book sitting by the hat by the plane is tired .	the book sits by the hat by the plane is tired .
the rug sitting on the bed on the ground is gentle .	the rug sits on the bed on the ground is gentle .
the bed sitting by the shoe in the kitchen is strong .	the bed sits by the shoe in the kitchen is strong .
the ship sitting on the floor by the car is strong .	the ship sits on the floor by the car is strong .
the window sitting in the hospital by the glass is young .	the window sits in the hospital by the glass is young .
the boat sitting in the hospital by the fork is friendly .	the boat sits in the hospital by the fork is friendly .
the bowl sitting by the bicycle on the table is young .	the bowl sits by the bicycle on the table is young .
the bottle sitting on the ground by the couch is confused .	the bottle sits on the ground by the couch is confused .
the fork sitting on the ground in the park is wrong .	the fork sits on the ground in the park is wrong .
the plane sitting in the mall on the stool is important .	the plane sits in the mall on the stool is important .
the dish sitting in the museum in the room is bored .	the dish sits in the museum in the room is bored .
the book sitting by the button on the ground is excited .	the book sits by the button on the ground is excited .
the shirt sitting by the bicycle on the stool is tall .	the shirt sits by the bicycle on the stool is tall .
the shirt sitting in the school in the room is kind .	the shirt sits in the school in the room is kind .
the car sitting by the mirror by the book is smart .	the car sits by the mirror by the book is smart .
the spoon sitting by the window on the bed is friendly .	the spoon sits by the window on the bed is friendly .
the candle sitting in the mall in the park is upset .	the candle sits in the mall in the park is upset .
the doll sitting by the bag in the mall is helpful .	the doll sits by the bag in the mall is helpful .
the hat sitting on the bed on the street is careful .	the hat sits on the bed on the street is careful .
the crayon sitting on the street in the hospital is busy .	the crayon sits on the street in the hospital is busy .
the fork sitting by the plane in the restaurant is kind .	the fork sits by the plane in the restaurant is kind .
the bottle sitting on the stool by the truck is strong .	the bottle sits on the stool by the truck is strong .
the window sitting in the bank in the mall is busy .	the window sits in the bank in the mall is busy .
the ship sitting by the glass in the library is busy .	the ship sits by the glass in the library is busy .
the bottle sitting by the box on the couch is strong .	the bottle sits by the box on the couch is strong .
the cup sitting by the rocket by the chair is smart .	the cup sits by the rocket by the chair is smart .
the spoon sitting on the floor on the chair is sleepy .	the spoon sits on the floor on the chair is sleepy .
the picture sitting on the ground by the plane is strong .	the picture sits on the ground by the plane is strong .
the mirror sitting on the table in the museum is happy .	the mirror sits on the table in the museum is happy .
the bottle sitting on the street in the room is hungry .	the bottle sits on the street in the room is hungry .
the car sitting by the mirror on the chair is healthy .	the car sits by the mirror on the chair is healthy .
the shoe sitting by the doll in the museum is lucky .	the shoe sits by the doll in the museum is lucky .
the plate sitting by the car on the street is angry .	the plate sits by the car on the street is angry .
the bottle sitting on the bed in the mall is happy .	the bottle sits on the bed in the mall is happy .
the truck sitting on the chair by the rug is excited .	the truck sits on the chair by the rug is excited .
the rocket sitting on the table by the car is clever .	the rocket sits on the table by the car is clever .
the bowl sitting in the kitchen in the park is excited .	the bowl sits in the kitchen in the park is excited .
the doll sitting on the couch in the school is nice .	the doll sits on the couch in the school is nice .
the door sitting in the hospital on the ground is angry .	the door sits in the hospital on the ground is angry .
the car sitting on the table in the room is boring .	the car sits on the table in the room is boring .
the bed sitting in the restaurant on the table is healthy .	the bed sits in the restaurant on the table is healthy .
the window sitting by the book in the bank is boring .	the window sits by the book in the bank is boring .
the bowl sitting on the table by the picture is careful .	the bowl sits on the table by the picture is careful .
the boat sitting in the room in the kitchen is clever .	the boat sits in the room in the kitchen is clever .
the chair sitting by the couch in the school is helpful .	the chair sits by the couch in the school is helpful .
the glass sitting on the table on the bed is nice .	the glass sits on the table on the bed is nice .
the ring sitting on the chair by the doll is nice .	the ring sits on the chair by the doll is nice .
the spoon sitting by the glass on the chair is tall .	the spoon sits by the glass on the chair is tall .
the bed sitting by the car in the room is excited .	the bed sits by the car in the room is excited .
the hat sitting on the chair by the box is friendly .	the hat sits on the chair by the box is friendly .
the hat sitting on the ground by the fork is important .	the hat sits on the ground by the fork is important .
the cup sitting in the restaurant by the bottle is excited .	the cup sits in the restaurant by the bottle is excited .
the bowl sitting in the library in the mall is lucky .	the bowl sits in the library in the mall is lucky .
the ship sitting on the stool by the doll is tired .	the ship sits on the stool by the doll is tired .
the bicycle sitting by the truck on the ground is tall .	the bicycle sits by the truck on the ground is tall .
the spoon sitting by the couch on the stool is healthy .	the spoon sits by the couch on the stool is healthy .
the spoon sitting on the bed by the rug is excited .	the spoon sits on the bed by the rug is excited .
the hat sitting on the floor in the hospital is hungry .	the hat sits on the floor in the hospital is hungry .
the cup sitting by the toy on the table is bored .	the cup sits by the toy on the table is bored .
the hat sitting by the rocket on the bed is friendly .	the hat sits by the rocket on the bed is friendly .
the spoon sitting on the ground by the book is curious .	the spoon sits on the ground by the book is curious .
the ring sitting on the bed by the glass is kind .	the ring sits on the bed by the glass is kind .
the mirror sitting in the room by the bicycle is busy .	the mirror sits in the room by the bicycle is busy .
the bed sitting on the bed on the table is hungry .	the bed sits on the bed on the table is hungry .
the rocket sitting by the car by the ring is helpful .	the rocket sits by the car by the ring is helpful .
the shoe sitting in the kitchen on the table is confused .	the shoe sits in the kitchen on the table is confused .
the shirt sitting on the stool in the park is excited .	the shirt sits on the stool in the park is excited .
the bed sitting by the book on the bed is hungry .	the bed sits by the book on the bed is hungry .
the bottle sitting in the library in the park is smart .	the bottle sits in the library in the park is smart .
the crayon sitting in the school on the table is tired .	the crayon sits in the school on the table is tired .
the hat sitting in the restaurant on the bed is hungry .	the hat sits in the restaurant on the bed is hungry .
the couch sitting in the school in the school is nice .	the couch sits in the school in the school is nice .
the picture sitting on the street in the school is tall .	the picture sits on the street in the school is tall .
the bag sitting on the street on the ground is sleepy .	the bag sits on the street on the ground is sleepy .
the dish sitting by the boat in the room is young .	the dish sits by the boat in the room is young .
the doll sitting by the shoe on the stool is young .	the doll sits by the shoe on the stool is young .
the hat sitting in the restaurant by the bowl is boring .	the hat sits in the restaurant by the bowl is boring .
the glass sitting by the plane on the couch is clever .	the glass sits by the plane on the couch is clever .
the door sitting on the stool on the street is careful .	the door sits on the stool on the street is careful .
the picture sitting on the chair in the school is angry .	the picture sits on the chair in the school is angry .
the ship sitting on the ground on the stool is careful .	the ship sits on the ground on the stool is careful .
the cup sitting by the cup by the window is excited .	the cup sits by the cup by the window is excited .
the candle sitting by the cup on the stool is bored .	the candle sits by the cup on the stool is bored .
the rug sitting by the bowl by the book is surprised .	the rug sits by the bowl by the book is surprised .
the plane sitting in the hospital by the boat is bored .	the plane sits in the hospital by the boat is bored .
the spoon sitting on the floor by the bed is careful .	the spoon sits on the floor by the bed is careful .
the bowl sitting in the bank on the table is strong .	the bowl sits in the bank on the table is strong .
the candle sitting in the school in the hospital is healthy .	the candle sits in the school in the hospital is healthy .
the hat sitting on the table by the candle is strong .	the hat sits on the table by the candle is strong .
the bottle sitting in the park in the restaurant is busy .	the bottle sits in the park in the restaurant is busy .
the couch sitting by the plate on the table is nice .	the couch sits by the plate on the table is nice .
the plate sitting by the glass by the mirror is gentle .	the plate sits by the glass by the mirror is gentle .
the book sitting in the kitchen in the museum is excited .	the book sits in the kitchen in the museum is excited .
the button sitting by the book in the museum is tall .	the button sits by the book in the museum is tall .
the spoon sitting on the floor by the door is curious .	the spoon sits on the floor by the door is curious .
the bicycle sitting in the bank on the floor is upset .	the bicycle sits in the bank on the floor is upset .
the rocket sitting on the street by the picture is young .	the rocket sits on the street by the picture is young .
the bowl sitting on the bed on the couch is tired .	the bowl sits on the bed on the couch is tired .
the book sitting in the room in the school is gentle .	the book sits in the room in the school is gentle .
the bed sitting by the plate in the park is confused .	the bed sits by the plate in the park is confused .
the candle sitting in the museum on the stool is excited .	the candle sits in the museum on the stool is excited .
the toy sitting on the street in the kitchen is smart .	the toy sits on the street in the kitchen is smart .
the shoe sitting on the bed by the car is bored .	the shoe sits on the bed by the car is bored .
the ship sitting by the bed in the mall is busy .	the ship sits by the bed in the mall is busy .
the book sitting in the room in the mall is confused .	the book sits in the room in the mall is confused .
the car sitting by the toy in the museum is boring .	the car sits by the toy in the museum is boring .
the spoon sitting by the plate by the candle is confused .	the spoon sits by the plate by the candle is confused .
the bowl sitting on the stool by the couch is smart .	the bowl sits on the stool by the couch is smart .
the glass sitting in the restaurant on the floor is boring .	the glass sits in the restaurant on the floor is boring .
the bed sitting on the bed by the bottle is bored .	the bed sits on the bed by the bottle is bored .
the spoon sitting on the chair by the bag is boring .	the spoon sits on the chair by the bag is boring .
the dish sitting in the park on the bed is bored .	the dish sits in the park on the bed is bored .
the doll sitting in the room on the stool is busy .	the doll sits in the room on the stool is busy .
the shirt sitting in the restaurant by the mirror is boring .	the shirt sits in the restaurant by the mirror is boring .
the dish sitting on the bed on the ground is young .	the dish sits on the bed on the ground is young .
the spoon sitting by the book on the chair is healthy .	the spoon sits by the book on the chair is healthy .
the couch sitting on the couch in the school is gentle .	the couch sits on the couch in the school is gentle .
the door sitting on the stool by the book is hungry .	the door sits on the stool by the book is hungry .
the boat sitting in the school by the plate is kind .	the boat sits in the school by the plate is kind .
the car sitting in the kitchen in the room is hungry .	the car sits in the kitchen in the room is hungry .
the car sitting by the picture in the school is friendly .	the car sits by the picture in the school is friendly .
the toy sitting by the bicycle in the room is friendly .	the toy sits by the bicycle in the room is friendly .
the car sitting on the stool by the bottle is careful .	the car sits on the stool by the bottle is careful .
the mirror sitting by the ship on the bed is angry .	the mirror sits by the ship on the bed is angry .
the crayon sitting on the bed by the rug is kind .	the crayon sits on the bed by the rug is kind .
the candle sitting on the stool in the school is surprised .	the candle sits on the stool in the school is surprised .
the boat sitting by the glass by the ring is clever .	the boat sits by the glass by the ring is clever .
the candle sitting in the park by the window is clever .	the candle sits in the park by the window is clever .
the ship sitting by the rocket in the mall is angry .	the ship sits by the rocket in the mall is angry .
the picture sitting by the glass on the chair is sleepy .	the picture sits by the glass on the chair is sleepy .
the truck sitting in the museum in the park is nice .	the truck sits in the museum in the park is nice .
the candle sitting by the shoe by the shirt is young .	the candle sits by the shoe by the shirt is young .
the fork sitting by the shirt by the plate is healthy .	the fork sits by the shirt by the plate is healthy .
the button sitting in the mall by the dish is confused .	the button sits in the mall by the dish is confused .
the box sitting on the bed by the button is important .	the box sits on the bed by the button is important .
the truck sitting on the ground on the stool is young .	the truck sits on the ground on the stool is young .
the couch sitting in the school on the stool is happy .	the couch sits in the school on the stool is happy .
the button sitting on the street by the spoon is tired .	the button sits on the street by the spoon is tired .
the glass sitting in the school on the street is angry .	the glass sits in the school on the street is angry .
the bag sitting in the mall by the shirt is friendly .	the bag sits in the mall by the shirt is friendly .
the bottle sitting by the doll on the couch is sleepy .	the bottle sits by the doll on the couch is sleepy .
the plate sitting in the school by the picture is gentle .	the plate sits in the school by the picture is gentle .
the toy sitting on the couch in the kitchen is surprised .	the toy sits on the couch in the kitchen is surprised .
the ring sitting by the book on the bed is surprised .	the ring sits by the book on the bed is surprised .
the toy sitting by the window in the restaurant is important .	the toy sits by the window in the restaurant is important .
the hat sitting by the bag on the table is smart .	the hat sits by the bag on the table is smart .
the crayon sitting by the glass in the mall is lucky .	the crayon sits by the glass in the mall is lucky .
the spoon sitting on the bed by the hat is helpful .	the spoon sits on the bed by the hat is helpful .
the fork sitting on the couch by the cup is angry .	the fork sits on the couch by the cup is angry .
the ring sitting on the table in the kitchen is tired .	the ring sits on the table in the kitchen is tired .
the bowl sitting on the floor by the cup is important .	the bowl sits on the floor by the cup is important .
the dish sitting in the room on the ground is strong .	the dish sits in the room on the ground is strong .
the plane sitting by the rug on the street is curious .	the plane sits by the rug on the street is curious .
the spoon sitting by the doll by the button is angry .	the spoon sits by the doll by the button is angry .
the door sitting by the plate on the street is excited .	the door sits by the plate on the street is excited .
the picture sitting by the picture on the chair is hungry .	the picture sits by the picture on the chair is hungry .
the bowl sitting in the museum in the park is smart .	the bowl sits in the museum in the park is smart .
the car sitting in the school in the museum is tired .	the car sits in the school in the museum is tired .
the ring sitting by the car by the ring is strong .	the ring sits by the car by the ring is strong .
the plate sitting in the library by the plane is gentle .	the plate sits in the library by the plane is gentle .
the bed sitting on the bed by the spoon is sleepy .	the bed sits on the bed by the spoon is sleepy .
the glass sitting by the bicycle in the room is clever .	the glass sits by the bicycle in the room is clever .
the truck sitting by the mirror in the bank is important .	the truck sits by the mirror in the bank is important .
the book sitting in the park on the floor is curious .	the book sits in the park on the floor is curious .
the toy sitting by the window in the kitchen is curious .	the toy sits by the window in the kitchen is curious .
the door sitting in the park in the park is curious .	the door sits in the park in the park is curious .
the toy sitting by the rocket on the street is smart .	the toy sits by the rocket on the street is smart .
the plane sitting in the library on the chair is hungry .	the plane sits in the library on the chair is hungry .
the box sitting in the school on the stool is friendly .	the box sits in the school on the stool is friendly .
the boat sitting on the bed by the bed is lucky .	the boat sits on the bed by the bed is lucky .
the window sitting on the couch in the school is gentle .	the window sits on the couch in the school is gentle .
the bicycle sitting by the door by the plane is important .	the bicycle sits by the door by the plane is important .
the dish sitting on the street by the boat is gentle .	the dish sits on the street by the boat is gentle .
the button sitting in the restaurant by the glass is important .	the button sits in the restaurant by the glass is important .
the cup sitting on the chair by the bicycle is curious .	the cup sits on the chair by the bicycle is curious .
the bottle sitting by the crayon on the chair is sleepy .	the bottle sits by the crayon on the chair is sleepy .
the bowl sitting by the toy on the table is nice .	the bowl sits by the toy on the table is nice .
the car sitting on the floor by the truck is tired .	the car sits on the floor by the truck is tired .
the car sitting by the rocket on the street is upset .	the car sits by the rocket on the street is upset .
the bag sitting on the floor by the spoon is kind .	the bag sits on the floor by the spoon is kind .
the bag sitting on the floor in the room is angry .	the bag sits on the floor in the room is angry .
the candle sitting by the crayon by the book is kind .	the candle sits by the crayon by the book is kind .
the car sitting on the table on the street is important .	the car sits on the table on the street is important .
the bag sitting on the bed by the doll is strong .	the bag sits on the bed by the doll is strong .
the plate sitting in the school by the car is lucky .	the plate sits in the school by the car is lucky .
the plate sitting by the rug on the floor is tired .	the plate sits by the rug on the floor is tired .
the bowl sitting in the library on the table is careful .	the bowl sits in the library on the table is careful .
the toy sitting on the ground on the stool is bored .	the toy sits on the ground on the stool is bored .
the crayon sitting by the cup by the fork is happy .	the crayon sits by the cup by the fork is happy .
the car sitting by the window in the room is hungry .	the car sits by the window in the room is hungry .
the car sitting by the picture on the chair is curious .	the car sits by the picture on the chair is curious .
the boat sitting in the park on the ground is smart .	the boat sits in the park on the ground is smart .
the fork sitting in the bank by the car is helpful .	the fork sits in the bank by the car is helpful .
the rug sitting on the table in the school is bored .	the rug sits on the table in the school is bored .
the truck sitting in the restaurant in the school is upset .	the truck sits in the restaurant in the school is upset .
the bed sitting by the bag on the table is upset .	the bed sits by the bag on the table is upset .
the crayon sitting in the bank by the fork is careful .	the crayon sits in the bank by the fork is careful .
the bowl sitting in the hospital by the car is young .	the bowl sits in the hospital by the car is young .
the toy sitting on the chair on the chair is upset .	the toy sits on the chair on the chair is upset .
the bowl sitting by the button on the stool is nice .	the bowl sits by the button on the stool is nice .
the bowl sitting by the car in the restaurant is helpful .	the bowl sits by the car in the restaurant is helpful .
the picture sitting in the school by the car is confused .	the picture sits in the school by the car is confused .
the bowl sitting on the bed in the school is strong .	the bowl sits on the bed in the school is strong .
the book sitting in the library in the bank is bored .	the book sits in the library in the bank is bored .
the plane sitting by the car in the school is excited .	the plane sits by the car in the school is excited .
the plate sitting on the street by the car is upset .	the plate sits on the street by the car is upset .
the cup sitting in the library on the table is happy .	the cup sits in the library on the table is happy .
the car sitting on the couch on the street is clever .	the car sits on the couch on the street is clever .
the cup sitting on the table by the door is smart .	the cup sits on the table by the door is smart .
the boat sitting on the stool by the mirror is hungry .	the boat sits on the stool by the mirror is hungry .
the car sitting by the ring on the table is careful .	the car sits by the ring on the table is careful .
the hat sitting on the couch in the kitchen is sleepy .	the hat sits on the couch in the kitchen is sleepy .
the book sitting by the plane by the shirt is healthy .	the book sits by the plane by the shirt is healthy .
the crayon sitting on the chair in the kitchen is hungry .	the crayon sits on the chair in the kitchen is hungry .
the shoe sitting on the chair on the bed is angry .	the shoe sits on the chair on the bed is angry .
the picture sitting in the park in the bank is tall .	the picture sits in the park in the bank is tall .
the button sitting on the stool on the table is tired .	the button sits on the stool on the table is tired .
the plane sitting in the restaurant by the hat is upset .	the plane sits in the restaurant by the hat is upset .
the picture sitting on the stool in the park is quiet .	the picture sits on the stool in the park is quiet .
the ship sitting by the ship in the hospital is clever .	the ship sits by the ship in the hospital is clever .
the rug sitting by the car on the street is kind .	the rug sits by the car on the street is kind .
the toy sitting on the bed on the table is quiet .	the toy sits on the bed on the table is quiet .
the mirror sitting in the school in the school is boring .	the mirror sits in the school in the school is boring .
the picture sitting on the chair on the floor is healthy .	the picture sits on the chair on the floor is healthy .
the rug sitting on the floor on the couch is excited .	the rug sits on the floor on the couch is excited .
the cup sitting by the ship on the ground is strong .	the cup sits by the ship on the ground is strong .
the car sitting in the mall by the window is busy .	the car sits in the mall by the window is busy .
the book sitting in the mall on the floor is friendly .	the book sits in the mall on the floor is friendly .
the shirt sitting on the chair by the window is wrong .	the shirt sits on the chair by the window is wrong .
the rocket sitting by the rug by the rocket is strong .	the rocket sits by the rug by the rocket is strong .
the box sitting on the chair on the ground is confused .	the box sits on the chair on the ground is confused .
the candle sitting in the hospital in the library is strong .	the candle sits in the hospital in the library is strong .
the ring sitting on the ground in the park is young .	the ring sits on the ground in the park is young .
the shoe sitting on the floor by the mirror is tired .	the shoe sits on the floor by the mirror is tired .
the ship sitting by the cup by the truck is lucky .	the ship sits by the cup by the truck is lucky .
the rocket sitting by the couch on the street is angry .	the rocket sits by the couch on the street is angry .
the car sitting on the stool in the school is careful .	the car sits on the stool in the school is careful .
the couch sitting by the couch on the bed is nice .	the couch sits by the couch on the bed is nice .
the picture sitting in the bank in the museum is upset .	the picture sits in the bank in the museum is upset .
the dish sitting by the door in the hospital is gentle .	the dish sits by the door in the hospital is gentle .
the shirt sitting on the floor in the kitchen is quiet .	the shirt sits on the floor in the kitchen is quiet .
the plane sitting on the ground by the boat is curious .	the plane sits on the ground by the boat is curious .
the bowl sitting in the school on the bed is friendly .	the bowl sits in the school on the bed is friendly .
the truck sitting in the hospital in the mall is sleepy .	the truck sits in the hospital in the mall is sleepy .
the couch sitting by the boat in the library is gentle .	the couch sits by the boat in the library is gentle .
the bed sitting on the stool in the school is nice .	the bed sits on the stool in the school is nice .
the toy sitting by the bicycle by the book is strong .	the toy sits by the bicycle by the book is strong .
the spoon sitting on the stool by the mirror is smart .	the spoon sits on the stool by the mirror is smart .
the doll sitting by the chair in the park is kind .	the doll sits by the chair in the park is kind .
the candle sitting by the doll in the school is quiet .	the candle sits by the doll in the school is quiet .
the crayon sitting by the bottle in the kitchen is friendly .	the crayon sits by the bottle in the kitchen is friendly .
the bowl sitting in the museum in the library is kind .	the bowl sits in the museum in the library is kind .
the candle sitting on the bed in the museum is nice .	the candle sits on the bed in the museum is nice .
the toy sitting on the floor in the mall is kind .	the toy sits on the floor in the mall is kind .
the crayon sitting on the table in the school is sleepy .	the crayon sits on the table in the school is sleepy .
the box sitting in the park on the ground is important .	the box sits in the park on the ground is important .
the bed sitting in the kitchen by the toy is sleepy .	the bed sits in the kitchen by the toy is sleepy .
the ship sitting by the shirt in the school is bored .	the ship sits by the shirt in the school is bored .
the window sitting in the museum on the street is wrong .	the window sits in the museum on the street is wrong .
the book sitting on the table by the plate is surprised .	the book sits on the table by the plate is surprised .
the glass sitting in the park on the stool is gentle .	the glass sits in the park on the stool is gentle .
the cup sitting on the street on the bed is healthy .	the cup sits on the street on the bed is healthy .
the chair sitting on the floor by the window is excited .	the chair sits on the floor by the window is excited .
the ring sitting on the ground by the doll is tired .	the ring sits on the ground by the doll is tired .
the dish sitting on the floor by the bottle is sleepy .	the dish sits on the floor by the bottle is sleepy .
the window sitting on the chair by the bicycle is confused .	the window sits on the chair by the bicycle is confused .
the crayon sitting on the chair in the mall is hungry .	the crayon sits on the chair in the mall is hungry .
the plate sitting on the ground by the spoon is helpful .	the plate sits on the ground by the spoon is helpful .
the window sitting by the book on the table is angry .	the window sits by the book on the table is angry .
the shoe sitting by the plane on the floor is kind .	the shoe sits by the plane on the floor is kind .
the rocket sitting on the couch on the couch is boring .	the rocket sits on the couch on the couch is boring .
the bicycle sitting on the chair in the park is smart .	the bicycle sits on the chair in the park is smart .
the mirror sitting in the library on the bed is clever .	the mirror sits in the library on the bed is clever .
the bag sitting by the dish in the hospital is clever .	the bag sits by the dish in the hospital is clever .
the book sitting on the floor on the ground is surprised .	the book sits on the floor on the ground is surprised .
the hat sitting by the button by the glass is happy .	the hat sits by the button by the glass is happy .
the book sitting in the bank by the door is helpful .	the book sits in the bank by the door is helpful .
the ring sitting on the floor by the glass is clever .	the ring sits on the floor by the glass is clever .
the car sitting in the kitchen in the museum is tired .	the car sits in the kitchen in the museum is tired .
the dish sitting in the kitchen in the restaurant is lucky .	the dish sits in the kitchen in the restaurant is lucky .
the rocket sitting on the street in the school is wrong .	the rocket sits on the street in the school is wrong .
the fork sitting by the candle in the restaurant is boring .	the fork sits by the candle in the restaurant is boring .
the chair sitting in the kitchen in the park is bored .	the chair sits in the kitchen in the park is bored .
the bag sitting in the restaurant in the restaurant is excited .	the bag sits in the restaurant in the restaurant is excited .
the spoon sitting on the bed on the table is tall .	the spoon sits on the bed on the table is tall .
the cup sitting in the library by the mirror is nice .	the cup sits in the library by the mirror is nice .
the dish sitting in the room on the stool is curious .	the dish sits in the room on the stool is curious .
the rocket sitting in the kitchen in the room is friendly .	the rocket sits in the kitchen in the room is friendly .
the bag sitting in the bank in the hospital is careful .	the bag sits in the bank in the hospital is careful .
the car sitting in the library in the restaurant is curious .	the car sits in the library in the restaurant is curious .
the candle sitting by the boat on the floor is busy .	the candle sits by the boat on the floor is busy .
the glass sitting in the mall in the library is lucky .	the glass sits in the mall in the library is lucky .
the car sitting by the bicycle by the bicycle is lucky .	the car sits by the bicycle by the bicycle is lucky .
the shirt sitting by the rug in the school is hungry .	the shirt sits by the rug in the school is hungry .
the ring sitting on the floor in the school is angry .	the ring sits on the floor in the school is angry .
the door sitting by the rug on the chair is tired .	the door sits by the rug on the chair is tired .
the glass sitting on the floor on the street is friendly .	the glass sits on the floor on the street is friendly .
the fork sitting by the boat on the street is upset .	the fork sits by the boat on the street is upset .
the cup sitting on the stool in the mall is angry .	the cup sits on the stool in the mall is angry .
the plane sitting in the park by the bag is nice .	the plane sits in the park by the bag is nice .
the plate sitting on the chair in the kitchen is gentle .	the plate sits on the chair in the kitchen is gentle .
the ship sitting by the chair by the plane is clever .	the ship sits by the chair by the plane is clever .
the dish sitting by the truck in the room is happy .	the dish sits by the truck in the room is happy .
the book sitting in the hospital in the kitchen is happy .	the book sits in the hospital in the kitchen is happy .
the couch sitting by the picture on the street is tall .	the couch sits by the picture on the street is tall .
the doll sitting by the crayon on the floor is healthy .	the doll sits by the crayon on the floor is healthy .
the hat sitting in the library on the ground is smart .	the hat sits in the library on the ground is smart .
the rug sitting by the shoe by the chair is clever .	the rug sits by the shoe by the chair is clever .
the toy sitting on the stool in the mall is surprised .	the toy sits on the stool in the mall is surprised .
the mirror sitting in the hospital in the room is lucky .	the mirror sits in the hospital in the room is lucky .
the shoe sitting by the dish in the library is tired .	the shoe sits by the dish in the library is tired .
the toy sitting in the bank by the ship is busy .	the toy sits in the bank by the ship is busy .
the rocket sitting on the chair on the stool is happy .	the rocket sits on the chair on the stool is happy .
the picture sitting in the hospital by the window is excited .	the picture sits in the hospital by the window is excited .
the plate sitting on the street by the candle is happy .	the plate sits on the street by the candle is happy .
the fork sitting on the chair in the museum is busy .	the fork sits on the chair in the museum is busy .
the crayon sitting on the table on the ground is hungry .	the crayon sits on the table on the ground is hungry .
the bed sitting in the bank on the chair is excited .	the bed sits in the bank on the chair is excited .
the glass sitting by the dish on the street is happy .	the glass sits by the dish on the street is happy .
the ring sitting by the ring on the ground is gentle .	the ring sits by the ring on the ground is gentle .
the mirror sitting on the chair in the school is careful .	the mirror sits on the chair in the school is careful .
the glass sitting by the couch on the ground is sleepy .	the glass sits by the couch on the ground is sleepy .
the shoe sitting in the restaurant on the ground is nice .	the shoe sits in the restaurant on the ground is nice .
the plane sitting on the table in the bank is hungry .	the plane sits on the table in the bank is hungry .
the plane sitting by the truck by the boat is confused .	the plane sits by the truck by the boat is confused .
the door sitting by the glass on the table is excited .	the door sits by the glass on the table is excited .
the box sitting by the chair by the bottle is kind .	the box sits by the chair by the bottle is kind .
the boat sitting in the school by the truck is surprised .	the boat sits in the school by the truck is surprised .
the rocket sitting by the door on the ground is smart .	the rocket sits by the door on the ground is smart .
the ring sitting on the bed by the car is friendly .	the ring sits on the bed by the car is friendly .
the cup sitting in the mall by the ship is careful .	the cup sits in the mall by the ship is careful .
the car sitting by the car on the bed is quiet .	the car sits by the car on the bed is quiet .
the plate sitting on the street by the hat is smart .	the plate sits on the street by the hat is smart .
the ring sitting on the ground by the dish is friendly .	the ring sits on the ground by the dish is friendly .
the book sitting in the school on the table is angry .	the book sits in the school on the table is angry .
the toy sitting by the ring in the hospital is careful .	the toy sits by the ring in the hospital is careful .
the bowl sitting by the hat on the floor is confused .	the bowl sits by the hat on the floor is confused .
the glass sitting by the bowl by the box is surprised .	the glass sits by the bowl by the box is surprised .
the dish sitting by the picture by the plane is friendly .	the dish sits by the picture by the plane is friendly .
the bottle sitting by the spoon by the couch is clever .	the bottle sits by the spoon by the couch is clever .
the window sitting by the rug on the table is excited .	the window sits by the rug on the table is excited .
the shirt sitting on the street on the bed is friendly .	the shirt sits on the street on the bed is friendly .
the dish sitting on the bed on the table is bored .	the dish sits on the bed on the table is bored .
the chair sitting in the kitchen on the bed is lucky .	the chair sits in the kitchen on the bed is lucky .
the hat sitting by the bottle on the bed is hungry .	the hat sits by the bottle on the bed is hungry .
the picture sitting by the door in the room is bored .	the picture sits by the door in the room is bored .
the glass sitting in the mall by the bottle is careful .	the glass sits in the mall by the bottle is careful .
the shoe sitting in the library in the library is bored .	the shoe sits in the library in the library is bored .
the ship sitting in the room on the stool is busy .	the ship sits in the room on the stool is busy .
the crayon sitting in the kitchen in the restaurant is healthy .	the crayon sits in the kitchen in the restaurant is healthy .
the cup sitting by the bicycle by the crayon is nice .	the cup sits by the bicycle by the crayon is nice .
the bed sitting by the car in the park is strong .	the bed sits by the car in the park is strong .
the bottle sitting in the park on the chair is boring .	the bottle sits in the park on the chair is boring .
the button sitting on the table on the ground is surprised .	the button sits on the table on the ground is surprised .
the bowl sitting by the crayon in the school is tall .	the bowl sits by the crayon in the school is tall .
the shoe sitting by the dish in the museum is young .	the shoe sits by the dish in the museum is young .
the bed sitting in the kitchen in the library is nice .	the bed sits in the kitchen in the library is nice .
the crayon sitting in the school by the mirror is happy .	the crayon sits in the school by the mirror is happy .
the bed sitting on the couch by the crayon is tall .	the bed sits on the couch by the crayon is tall .
the fork sitting in the school by the book is healthy .	the fork sits in the school by the book is healthy .
the boat sitting in the museum on the street is careful .	the boat sits in the museum on the street is careful .
the book sitting on the couch in the museum is smart .	the book sits on the couch in the museum is smart .
the cup sitting in the bank by the ship is healthy .	the cup sits in the bank by the ship is healthy .
the dish sitting on the stool in the restaurant is wrong .	the dish sits on the stool in the restaurant is wrong .
the shirt sitting on the ground in the school is careful .	the shirt sits on the ground in the school is careful .
the rocket sitting by the doll by the dish is kind .	the rocket sits by the doll by the dish is kind .
the rocket sitting in the library in the room is careful .	the rocket sits in the library in the room is careful .
the plane sitting in the library in the park is careful .	the plane sits in the library in the park is careful .
the boat sitting by the plate on the bed is hungry .	the boat sits by the plate on the bed is hungry .
the bicycle sitting on the floor on the table is lucky .	the bicycle sits on the floor on the table is lucky .
the car sitting in the park by the chair is young .	the car sits in the park by the chair is young .
the door sitting on the street on the stool is busy .	the door sits on the street on the stool is busy .
the crayon sitting by the doll by the crayon is sleepy .	the crayon sits by the doll by the crayon is sleepy .
the spoon sitting on the couch by the ring is young .	the spoon sits on the couch by the ring is young .
the button sitting in the library in the museum is tall .	the button sits in the library in the museum is tall .
the truck sitting on the bed on the table is kind .	the truck sits on the bed on the table is kind .
the book sitting by the hat in the mall is happy .	the book sits by the hat in the mall is happy .
the couch sitting by the bag in the mall is important .	the couch sits by the bag in the mall is important .
the crayon sitting by the car by the door is lucky .	the crayon sits by the car by the door is lucky .
the bowl sitting by the hat on the chair is careful .	the bowl sits by the hat on the chair is careful .
the book sitting on the bed by the mirror is tall .	the book sits on the bed by the mirror is tall .
the shirt sitting in the school by the shoe is lucky .	the shirt sits in the school by the shoe is lucky .
the crayon sitting on the stool by the hat is sleepy .	the crayon sits on the stool by the hat is sleepy .
the ring sitting on the ground by the rocket is boring .	the ring sits on the ground by the rocket is boring .
the shoe sitting in the restaurant on the stool is helpful .	the shoe sits in the restaurant on the stool is helpful .
the picture sitting in the restaurant in the room is healthy .	the picture sits in the restaurant in the room is healthy .
the box sitting in the kitchen by the crayon is careful .	the box sits in the kitchen by the crayon is careful .
the door sitting in the school in the park is boring .	the door sits in the school in the park is boring .
the shoe sitting on the stool in the hospital is hungry .	the shoe sits on the stool in the hospital is hungry .
the bottle sitting in the kitchen on the street is upset .	the bottle sits in the kitchen on the street is upset .
the picture sitting by the crayon in the museum is friendly .	the picture sits by the crayon in the museum is friendly .
the box sitting on the chair on the ground is wrong .	the box sits on the chair on the ground is wrong .
the ring sitting in the restaurant by the chair is nice .	the ring sits in the restaurant by the chair is nice .
the bag sitting by the hat on the floor is helpful .	the bag sits by the hat on the floor is helpful .
the shirt sitting in the library in the school is kind .	the shirt sits in the library in the school is kind .
the rug sitting on the floor by the boat is angry .	the rug sits on the floor by the boat is angry .
the bicycle sitting in the museum by the ring is angry .	the bicycle sits in the museum by the ring is angry .
the doll sitting on the couch on the floor is wrong .	the doll sits on the couch on the floor is wrong .
the ship sitting in the school in the bank is tired .	the ship sits in the school in the bank is tired .
the cup sitting by the plane in the park is smart .	the cup sits by the plane in the park is smart .
the mirror sitting by the bag on the floor is busy .	the mirror sits by the bag on the floor is busy .
the spoon sitting in the hospital by the cup is young .	the spoon sits in the hospital by the cup is young .
the doll sitting on the table on the bed is clever .	the doll sits on the table on the bed is clever .
the bag sitting by the couch in the room is hungry .	the bag sits by the couch in the room is hungry .
the fork sitting on the table in the school is strong .	the fork sits on the table in the school is strong .
the rug sitting by the bottle by the truck is lucky .	the rug sits by the bottle by the truck is lucky .
the toy sitting in the kitchen by the boat is nice .	the toy sits in the kitchen by the boat is nice .
the spoon sitting on the table by the bowl is upset .	the spoon sits on the table by the bowl is upset .
the shirt sitting in the library by the picture is upset .	the shirt sits in the library by the picture is upset .
the shirt sitting on the ground in the kitchen is healthy .	the shirt sits on the ground in the kitchen is healthy .
the hat sitting in the mall on the chair is excited .	the hat sits in the mall on the chair is excited .
the truck sitting in the restaurant on the table is nice .	the truck sits in the restaurant on the table is nice .
the rocket sitting in the mall in the hospital is important .	the rocket sits in the mall in the hospital is important .
the book sitting in the mall in the hospital is nice .	the book sits in the mall in the hospital is nice .
the truck sitting in the room in the library is hungry .	the truck sits in the room in the library is hungry .
the toy sitting in the room on the chair is friendly .	the toy sits in the room on the chair is friendly .
the truck sitting in the school by the doll is wrong .	the truck sits in the school by the doll is wrong .
the chair sitting in the mall on the table is excited .	the chair sits in the mall on the table is excited .
the shoe sitting by the bed in the hospital is hungry .	the shoe sits by the bed in the hospital is hungry .
the book sitting in the hospital in the school is careful .	the book sits in the hospital in the school is careful .
the dish sitting on the chair in the library is curious .	the dish sits on the chair in the library is curious .
the bicycle sitting by the chair by the plate is clever .	the bicycle sits by the chair by the plate is clever .
the glass sitting on the street on the couch is happy .	the glass sits on the street on the couch is happy .
the box sitting by the rug on the bed is helpful .	the box sits by the rug on the bed is helpful .
the ring sitting on the stool on the street is gentle .	the ring sits on the stool on the street is gentle .
the cup sitting on the stool on the floor is wrong .	the cup sits on the stool on the floor is wrong .
the spoon sitting on the bed in the park is gentle .	the spoon sits on the bed in the park is gentle .
the bicycle sitting in the mall by the fork is bored .	the bicycle sits in the mall by the fork is bored .
the doll sitting on the bed by the ring is angry .	the doll sits on the bed by the ring is angry .
the chair sitting on the couch by the spoon is healthy .	the chair sits on the couch by the spoon is healthy .
the fork sitting on the ground on the stool is tall .	the fork sits on the ground on the stool is tall .
the rug sitting on the chair on the chair is tall .	the rug sits on the chair on the chair is tall .
the rocket sitting by the picture by the candle is lucky .	the rocket sits by the picture by the candle is lucky .
the plane sitting on the table by the book is tall .	the plane sits on the table by the book is tall .
the dish sitting by the glass in the school is strong .	the dish sits by the glass in the school is strong .
the crayon sitting in the school in the library is angry .	the crayon sits in the school in the library is angry .
the book sitting by the rug on the floor is strong .	the book sits by the rug on the floor is strong .
the door sitting by the window on the floor is careful .	the door sits by the window on the floor is careful .
the bicycle sitting by the crayon on the chair is upset .	the bicycle sits by the crayon on the chair is upset .
the book sitting in the museum by the doll is quiet .	the book sits in the museum by the doll is quiet .
the shirt sitting on the bed by the picture is gentle .	the shirt sits on the bed by the picture is gentle .
the fork sitting in the restaurant on the couch is hungry .	the fork sits in the restaurant on the couch is hungry .
the car sitting on the floor on the couch is smart .	the car sits on the floor on the couch is smart .
the picture sitting in the school on the floor is helpful .	the picture sits in the school on the floor is helpful .
the window sitting on the couch on the ground is hungry .	the window sits on the couch on the ground is hungry .
the boat sitting by the rocket in the room is helpful .	the boat sits by the rocket in the room is helpful .
the rocket sitting by the couch by the crayon is clever .	the rocket sits by the couch by the crayon is clever .
the cup sitting in the kitchen on the couch is busy .	the cup sits in the kitchen on the couch is busy .
the bicycle sitting by the hat by the bag is helpful .	the bicycle sits by the hat by the bag is helpful .
the cup sitting on the street in the room is young .	the cup sits on the street in the room is young .
the book sitting on the street on the ground is curious .	the book sits on the street on the ground is curious .
the bed sitting in the bank in the hospital is tall .	the bed sits in the bank in the hospital is tall .
the dish sitting by the bicycle in the library is wrong .	the dish sits by the bicycle in the library is wrong .
the boat sitting in the hospital by the box is happy .	the boat sits in the hospital by the box is happy .
the rug sitting in the school by the bed is excited .	the rug sits in the school by the bed is excited .
the spoon sitting in the hospital by the shirt is busy .	the spoon sits in the hospital by the shirt is busy .
the rug sitting on the floor by the couch is upset .	the rug sits on the floor by the couch is upset .
the rug sitting by the candle by the ring is sleepy .	the rug sits by the candle by the ring is sleepy .
the shoe sitting by the bottle on the bed is strong .	the shoe sits by the bottle on the bed is strong .
the plane sitting in the school by the bicycle is nice .	the plane sits in the school by the bicycle is nice .
the fork sitting by the window in the hospital is confused .	the fork sits by the window in the hospital is confused .
the ship sitting on the bed in the school is tall .	the ship sits on the bed in the school is tall .
the couch sitting on the ground by the spoon is angry .	the couch sits on the ground by the spoon is angry .
the dish sitting on the chair in the mall is healthy .	the dish sits on the chair in the mall is healthy .
the hat sitting on the street by the window is angry .	the hat sits on the street by the window is angry .
the toy sitting in the hospital by the ship is smart .	the toy sits in the hospital by the ship is smart .
the spoon sitting on the floor by the car is helpful .	the spoon sits on the floor by the car is helpful .
the ship sitting in the kitchen by the cup is angry .	the ship sits in the kitchen by the cup is angry .
the car sitting in the park on the ground is sleepy .	the car sits in the park on the ground is sleepy .
the ship sitting by the shirt on the bed is strong .	the ship sits by the shirt on the bed is strong .
the spoon sitting on the stool by the plate is friendly .	the spoon sits on the stool by the plate is friendly .
the glass sitting by the bicycle in the bank is strong .	the glass sits by the bicycle in the bank is strong .
the picture sitting on the chair in the hospital is clever .	the picture sits on the chair in the hospital is clever .
the crayon sitting on the bed in the museum is lucky .	the crayon sits on the bed in the museum is lucky .
the hat sitting on the floor in the mall is young .	the hat sits on the floor in the mall is young .
the shirt sitting in the room by the car is sleepy .	the shirt sits in the room by the car is sleepy .
the shoe sitting by the picture by the bottle is gentle .	the shoe sits by the picture by the bottle is gentle .
the mirror sitting in the park by the door is angry .	the mirror sits in the park by the door is angry .
the mirror sitting in the park on the couch is sleepy .	the mirror sits in the park on the couch is sleepy .
the doll sitting on the stool in the museum is nice .	the doll sits on the stool in the museum is nice .
the doll sitting on the bed by the rug is wrong .	the doll sits on the bed by the rug is wrong .
the mirror sitting in the park in the museum is sleepy .	the mirror sits in the park in the museum is sleepy .
the couch sitting by the button by the bowl is boring .	the couch sits by the button by the bowl is boring .
the fork sitting by the car by the shoe is clever .	the fork sits by the car by the shoe is clever .
the bed sitting by the car on the bed is bored .	the bed sits by the car on the bed is bored .
the bed sitting by the rocket on the floor is boring .	the bed sits by the rocket on the floor is boring .
the car sitting by the truck on the chair is angry .	the car sits by the truck on the chair is angry .
the doll sitting on the chair on the street is kind .	the doll sits on the chair on the street is kind .
the button sitting in the museum on the couch is happy .	the button sits in the museum on the couch is happy .
the button sitting by the bicycle by the book is sleepy .	the button sits by the bicycle by the book is sleepy .
the dish sitting on the stool on the ground is excited .	the dish sits on the stool on the ground is excited .
the fork sitting in the park on the table is clever .	the fork sits in the park on the table is clever .
the toy sitting by the plate on the table is boring .	the toy sits by the plate on the table is boring .
the cup sitting in the library on the bed is strong .	the cup sits in the library on the bed is strong .
the shirt sitting in the school on the street is lucky .	the shirt sits in the school on the street is lucky .
the door sitting by the truck on the stool is hungry .	the door sits by the truck on the stool is hungry .
the bed sitting by the shirt on the couch is lucky .	the bed sits by the shirt on the couch is lucky .
the dish sitting on the couch by the truck is helpful .	the dish sits on the couch by the truck is helpful .
the rocket sitting on the bed in the hospital is sleepy .	the rocket sits on the bed in the hospital is sleepy .
the mirror sitting on the couch by the doll is confused .	the mirror sits on the couch by the doll is confused .
the candle sitting by the plane in the museum is wrong .	the candle sits by the plane in the museum is wrong .
the ring sitting on the chair in the bank is busy .	the ring sits on the chair in the bank is busy .
the candle sitting on the chair by the plate is kind .	the candle sits on the chair by the plate is kind .
the bowl sitting by the bowl on the street is young .	the bowl sits by the bowl on the street is young .
the window sitting in the school by the bottle is strong .	the window sits in the school by the bottle is strong .
the car sitting by the cup by the rocket is kind .	the car sits by the cup by the rocket is kind .
the hat sitting in the hospital by the glass is excited .	the hat sits in the hospital by the glass is excited .
the bed sitting by the box in the restaurant is important .	the bed sits by the box in the restaurant is important .
the shoe sitting on the couch by the couch is happy .	the shoe sits on the couch by the couch is happy .
the book sitting in the school by the ship is boring .	the book sits in the school by the ship is boring .
the glass sitting on the ground on the stool is friendly .	the glass sits on the ground on the stool is friendly .
the plate sitting by the plane in the kitchen is wrong .	the plate sits by the plane in the kitchen is wrong .
the rocket sitting by the button on the chair is tired .	the rocket sits by the button on the chair is tired .
the cup sitting in the room on the stool is sleepy .	the cup sits in the room on the stool is sleepy .
the bicycle sitting in the school on the bed is gentle .	the bicycle sits in the school on the bed is gentle .
the ship sitting in the school by the cup is bored .	the ship sits in the school by the cup is bored .
the window sitting in the school by the car is healthy .	the window sits in the school by the car is healthy .
the shoe sitting on the floor by the shirt is tired .	the shoe sits on the floor by the shirt is tired .
the candle sitting by the crayon on the couch is helpful .	the candle sits by the crayon on the couch is helpful .
the ring sitting on the ground by the candle is young .	the ring sits on the ground by the candle is young .
the glass sitting on the stool on the stool is smart .	the glass sits on the stool on the stool is smart .
the door sitting by the car in the park is hungry .	the door sits by the car in the park is hungry .
the shirt sitting on the table by the window is young .	the shirt sits on the table by the window is young .
the car sitting in the library on the stool is upset .	the car sits in the library on the stool is upset .
the window sitting on the street by the boat is curious .	the window sits on the street by the boat is curious .
the button sitting in the library by the hat is gentle .	the button sits in the library by the hat is gentle .
the bowl sitting on the stool on the chair is important .	the bowl sits on the stool on the chair is important .
the bowl sitting on the couch by the picture is friendly .	the bowl sits on the couch by the picture is friendly .
the toy sitting in the school on the bed is confused .	the toy sits in the school on the bed is confused .
the rug sitting by the rocket by the rocket is excited .	the rug sits by the rocket by the rocket is excited .
the picture sitting by the box on the bed is bored .	the picture sits by the box on the bed is bored .
the ring sitting in the library in the museum is surprised .	the ring sits in the library in the museum is surprised .
the toy sitting by the chair on the stool is important .	the toy sits by the chair on the stool is important .
the truck sitting in the restaurant in the restaurant is surprised .	the truck sits in the restaurant in the restaurant is surprised .
the glass sitting on the street by the car is bored .	the glass sits on the street by the car is bored .
the crayon sitting by the spoon in the restaurant is sleepy .	the crayon sits by the spoon in the restaurant is sleepy .
the bed sitting in the park on the floor is friendly .	the bed sits in the park on the floor is friendly .
the plate sitting by the boat by the rug is excited .	the plate sits by the boat by the rug is excited .
the crayon sitting on the stool on the street is lucky .	the crayon sits on the stool on the street is lucky .
the spoon sitting by the couch in the hospital is boring .	the spoon sits by the couch in the hospital is boring .
the picture sitting by the picture in the school is boring .	the picture sits by the picture in the school is boring .
the bowl sitting by the car by the book is angry .	the bowl sits by the car by the book is angry .
the ring sitting by the plane by the toy is tired .	the ring sits by the plane by the toy is tired .
the bowl sitting in the museum by the bag is curious .	the bowl sits in the museum by the bag is curious .
the mirror sitting on the ground by the candle is boring .	the mirror sits on the ground by the candle is boring .
the door sitting on the table by the window is upset .	the door sits on the table by the window is upset .
the bicycle sitting by the chair in the bank is boring .	the bicycle sits by the chair in the bank is boring .
the doll sitting in the park by the doll is hungry .	the doll sits in the park by the doll is hungry .
the bottle sitting in the kitchen by the car is careful .	the bottle sits in the kitchen by the car is careful .
the window sitting in the hospital in the kitchen is surprised .	the window sits in the hospital in the kitchen is surprised .
the book sitting on the couch in the museum is gentle .	the book sits on the couch in the museum is gentle .
the crayon sitting in the mall on the stool is kind .	the crayon sits in the mall on the stool is kind .
the ring sitting on the table by the spoon is upset .	the ring sits on the table by the spoon is upset .
the plate sitting on the table in the park is angry .	the plate sits on the table in the park is angry .
the ring sitting on the chair by the button is healthy .	the ring sits on the chair by the button is healthy .
the dish sitting in the hospital in the school is busy .	the dish sits in the hospital in the school is busy .
the fork sitting on the bed in the restaurant is tired .	the fork sits on the bed in the restaurant is tired .
the bowl sitting on the bed on the table is gentle .	the bowl sits on the bed on the table is gentle .
the boat sitting by the truck on the chair is strong .	the boat sits by the truck on the chair is strong .
the book sitting by the glass on the floor is careful .	the book sits by the glass on the floor is careful .
the plate sitting by the fork in the room is gentle .	the plate sits by the fork in the room is gentle .
the car sitting on the couch in the room is important .	the car sits on the couch in the room is important .
the fork sitting in the kitchen by the dish is friendly .	the fork sits in the kitchen by the dish is friendly .
the candle sitting by the rug in the hospital is hungry .	the candle sits by the rug in the hospital is hungry .
the ship sitting by the mirror in the school is tired .	the ship sits by the mirror in the school is tired .
the car sitting by the ship by the car is boring .	the car sits by the ship by the car is boring .
the spoon sitting on the floor on the bed is quiet .	the spoon sits on the floor on the bed is quiet .
the truck sitting by the mirror on the street is tired .	the truck sits by the mirror on the street is tired .
the cup sitting in the school in the kitchen is angry .	the cup sits in the school in the kitchen is angry .
the couch sitting in the restaurant by the bottle is healthy .	the couch sits in the restaurant by the bottle is healthy .
the crayon sitting by the ship in the school is upset .	the crayon sits by the ship in the school is upset .
the box sitting in the park in the library is tired .	the box sits in the park in the library is tired .
the shoe sitting by the plate by the dish is nice .	the shoe sits by the plate by the dish is nice .
the truck sitting in the library on the table is quiet .	the truck sits in the library on the table is quiet .
the bed sitting in the room on the stool is tall .	the bed sits in the room on the stool is tall .
the bag sitting by the plate by the dish is curious .	the bag sits by the plate by the dish is curious .
the crayon sitting on the bed on the ground is wrong .	the crayon sits on the bed on the ground is wrong .
the cup sitting in the library in the library is important .	the cup sits in the library in the library is important .
the dish sitting on the chair by the doll is gentle .	the dish sits on the chair by the doll is gentle .
the chair sitting by the plane in the bank is hungry .	the chair sits by the plane in the bank is hungry .
the bicycle sitting by the chair by the box is hungry .	the bicycle sits by the chair by the box is hungry .
the shirt sitting in the school by the cup is helpful .	the shirt sits in the school by the cup is helpful .
the glass sitting on the bed on the chair is hungry .	the glass sits on the bed on the chair is hungry .
the book sitting on the ground by the picture is tall .	the book sits on the ground by the picture is tall .
the book sitting by the bowl by the chair is surprised .	the book sits by the bowl by the chair is surprised .
the couch sitting by the hat in the mall is sleepy .	the couch sits by the hat in the mall is sleepy .
the truck sitting in the restaurant in the park is confused .	the truck sits in the restaurant in the park is confused .
the ship sitting on the stool on the chair is upset .	the ship sits on the stool on the chair is upset .
the book sitting on the floor by the ring is smart .	the book sits on the floor by the ring is smart .
the plate sitting in the hospital by the fork is healthy .	the plate sits in the hospital by the fork is healthy .
the window sitting on the bed by the spoon is healthy .	the window sits on the bed by the spoon is healthy .
the car sitting by the door by the rocket is sleepy .	the car sits by the door by the rocket is sleepy .
the crayon sitting in the school in the restaurant is helpful .	the crayon sits in the school in the restaurant is helpful .
the doll sitting on the floor by the spoon is sleepy .	the doll sits on the floor by the spoon is sleepy .
the couch sitting in the school in the mall is busy .	the couch sits in the school in the mall is busy .
the rug sitting by the spoon by the bed is careful .	the rug sits by the spoon by the bed is careful .
the boat sitting on the street by the rug is smart .	the boat sits on the street by the rug is smart .
the car sitting by the spoon in the room is kind .	the car sits by the spoon in the room is kind .
the hat sitting by the button on the floor is boring .	the hat sits by the button on the floor is boring .
the picture sitting on the ground on the table is curious .	the picture sits on the ground on the table is curious .
the mirror sitting on the table on the floor is lucky .	the mirror sits on the table on the floor is lucky .
the book sitting in the park by the bag is careful .	the book sits in the park by the bag is careful .
the boat sitting in the school in the park is busy .	the boat sits in the school in the park is busy .
the cup sitting by the plane by the dish is gentle .	the cup sits by the plane by the dish is gentle .
the couch sitting on the table in the kitchen is lucky .	the couch sits on the table in the kitchen is lucky .
the couch sitting by the glass by the bicycle is important .	the couch sits by the glass by the bicycle is important .
the ship sitting on the couch in the hospital is helpful .	the ship sits on the couch in the hospital is helpful .
the book sitting by the couch in the bank is boring .	the book sits by the couch in the bank is boring .
the rocket sitting by the boat on the table is excited .	the rocket sits by the boat on the table is excited .
the ring sitting on the stool by the plate is upset .	the ring sits on the stool by the plate is upset .
the door sitting by the toy in the school is sleepy .	the door sits by the toy in the school is sleepy .
the shirt sitting on the chair by the window is sleepy .	the shirt sits on the chair by the window is sleepy .
the plate sitting in the hospital by the shirt is bored .	the plate sits in the hospital by the shirt is bored .
the picture sitting on the floor on the street is quiet .	the picture sits on the floor on the street is quiet .
the book sitting in the room on the table is important .	the book sits in the room on the table is important .
the fork sitting in the library in the hospital is surprised .	the fork sits in the library in the hospital is surprised .
the window sitting in the room in the school is young .	the window sits in the room in the school is young .
the bicycle sitting by the crayon by the ship is young .	the bicycle sits by the crayon by the ship is young .
the picture sitting in the park on the floor is quiet .	the picture sits in the park on the floor is quiet .
the button sitting by the boat in the room is busy .	the button sits by the boat in the room is busy .
the ship sitting on the street by the boat is lucky .	the ship sits on the street by the boat is lucky .
the ring sitting on the chair on the floor is hungry .	the ring sits on the chair on the floor is hungry .
the glass sitting on the ground by the shoe is nice .	the glass sits on the ground by the shoe is nice .
the bowl sitting on the table in the hospital is healthy .	the bowl sits on the table in the hospital is healthy .
the dish sitting on the couch on the table is angry .	the dish sits on the couch on the table is angry .
the fork sitting in the bank by the ring is curious .	the fork sits in the bank by the ring is curious .
the door sitting on the stool on the bed is helpful .	the door sits on the stool on the bed is helpful .
the shoe sitting on the street on the ground is hungry .	the shoe sits on the street on the ground is hungry .
the shirt sitting on the couch on the stool is busy .	the shirt sits on the couch on the stool is busy .
the chair sitting on the stool by the candle is smart .	the chair sits on the stool by the candle is smart .
the cup sitting in the hospital by the mirror is kind .	the cup sits in the hospital by the mirror is kind .
the plane sitting on the floor in the school is strong .	the plane sits on the floor in the school is strong .
the chair sitting by the toy in the restaurant is helpful .	the chair sits by the toy in the restaurant is helpful .
the doll sitting on the bed on the floor is young .	the doll sits on the bed on the floor is young .
the dish sitting in the kitchen by the bicycle is careful .	the dish sits in the kitchen by the bicycle is careful .
the ship sitting on the chair in the school is curious .	the ship sits on the chair in the school is curious .
the bicycle sitting in the restaurant by the glass is smart .	the bicycle sits in the restaurant by the glass is smart .
the candle sitting in the museum on the ground is gentle .	the candle sits in the museum on the ground is gentle .
the chair sitting on the table by the picture is lucky .	the chair sits on the table by the picture is lucky .
the hat sitting on the bed in the room is strong .	the hat sits on the bed in the room is strong .
the dish sitting in the school on the stool is tall .	the dish sits in the school on the stool is tall .
the shoe sitting in the school in the school is sleepy .	the shoe sits in the school in the school is sleepy .
the box sitting on the stool in the museum is tall .	the box sits on the stool in the museum is tall .
the rug sitting in the restaurant in the mall is hungry .	the rug sits in the restaurant in the mall is hungry .
the bed sitting in the hospital by the ring is boring .	the bed sits in the hospital by the ring is boring .
the car sitting on the street in the kitchen is angry .	the car sits on the street in the kitchen is angry .
the button sitting by the shirt on the ground is bored .	the button sits by the shirt on the ground is bored .
the doll sitting by the bowl by the toy is curious .	the doll sits by the bowl by the toy is curious .
the glass sitting in the hospital by the mirror is bored .	the glass sits in the hospital by the mirror is bored .
the rug sitting on the ground in the park is confused .	the rug sits on the ground in the park is confused .
the plane sitting by the crayon in the restaurant is busy .	the plane sits by the crayon in the restaurant is busy .
the book sitting in the mall on the ground is bored .	the book sits in the mall on the ground is bored .
the picture sitting on the street on the street is boring .	the picture sits on the street on the street is boring .
the couch sitting by the bowl on the stool is curious .	the couch sits by the bowl on the stool is curious .
the candle sitting on the ground in the restaurant is hungry .	the candle sits on the ground in the restaurant is hungry .
the car sitting on the bed by the boat is clever .	the car sits on the bed by the boat is clever .
the ring sitting in the restaurant in the school is nice .	the ring sits in the restaurant in the school is nice .
the bag sitting on the floor on the table is busy .	the bag sits on the floor on the table is busy .
the rug sitting in the hospital in the park is lucky .	the rug sits in the hospital in the park is lucky .
the shirt sitting in the room on the chair is smart .	the shirt sits in the room on the chair is smart .
the picture sitting in the bank in the museum is hungry .	the picture sits in the bank in the museum is hungry .
the bottle sitting by the fork on the couch is bored .	the bottle sits by the fork on the couch is bored .
the bicycle sitting by the ship on the couch is helpful .	the bicycle sits by the ship on the couch is helpful .
the plane sitting in the hospital by the shoe is boring .	the plane sits in the hospital by the shoe is boring .
the candle sitting on the table in the museum is tired .	the candle sits on the table in the museum is tired .
the spoon sitting on the street on the stool is smart .	the spoon sits on the street on the stool is smart .
the window sitting on the ground on the chair is boring .	the window sits on the ground on the chair is boring .
the mirror sitting in the restaurant by the bottle is helpful .	the mirror sits in the restaurant by the bottle is helpful .
the doll sitting on the bed by the doll is angry .	the doll sits on the bed by the doll is angry .
the door sitting by the glass on the chair is curious .	the door sits by the glass on the chair is curious .
the plane sitting by the bowl on the chair is boring .	the plane sits by the bowl on the chair is boring .
the fork sitting by the shoe on the ground is busy .	the fork sits by the shoe on the ground is busy .
the window sitting in the restaurant by the candle is excited .	the window sits in the restaurant by the candle is excited .
the toy sitting on the table in the museum is careful .	the toy sits on the table in the museum is careful .
the window sitting by the plate on the bed is bored .	the window sits by the plate on the bed is bored .
the ship sitting by the couch by the couch is excited .	the ship sits by the couch by the couch is excited .
the car sitting by the chair on the bed is excited .	the car sits by the chair on the bed is excited .
the crayon sitting by the truck in the library is confused .	the crayon sits by the truck in the library is confused .
the book sitting on the bed on the bed is helpful .	the book sits on the bed on the bed is helpful .
the spoon sitting in the library on the chair is surprised .	the spoon sits in the library on the chair is surprised .
the fork sitting on the street on the couch is healthy .	the fork sits on the street on the couch is healthy .
the ship sitting on the bed in the museum is friendly .	the ship sits on the bed in the museum is friendly .
the window sitting by the crayon by the rocket is gentle .	the window sits by the crayon by the rocket is gentle .
the ring sitting in the restaurant in the library is smart .	the ring sits in the restaurant in the library is smart .
the door sitting on the table on the floor is strong .	the door sits on the table on the floor is strong .
the plate sitting in the library on the chair is strong .	the plate sits in the library on the chair is strong .
the bed sitting by the couch in the library is important .	the bed sits by the couch in the library is important .
the bottle sitting on the table on the street is clever .	the bottle sits on the table on the street is clever .
the car sitting by the toy in the library is important .	the car sits by the toy in the library is important .
the couch sitting in the park by the ship is smart .	the couch sits in the park by the ship is smart .
the plane sitting on the stool by the hat is tall .	the plane sits on the stool by the hat is tall .
the rocket sitting in the library by the ship is boring .	the rocket sits in the library by the ship is boring .
the bed sitting by the candle on the stool is tired .	the bed sits by the candle on the stool is tired .
the ship sitting in the bank on the bed is friendly .	the ship sits in the bank on the bed is friendly .
the bicycle sitting on the couch by the plane is tired .	the bicycle sits on the couch by the plane is tired .
the window sitting in the school on the floor is curious .	the window sits in the school on the floor is curious .
the book sitting by the fork on the floor is angry .	the book sits by the fork on the floor is angry .
the glass sitting on the stool in the mall is confused .	the glass sits on the stool in the mall is confused .
the toy sitting in the kitchen on the table is lucky .	the toy sits in the kitchen on the table is lucky .
the mirror sitting by the bowl by the spoon is surprised .	the mirror sits by the bowl by the spoon is surprised .
the toy sitting on the floor in the library is upset .	the toy sits on the floor in the library is upset .
the door sitting by the dish by the truck is important .	the door sits by the dish by the truck is important .
the ring sitting on the street on the floor is wrong .	the ring sits on the street on the floor is wrong .
the truck sitting on the couch by the spoon is careful .	the truck sits on the couch by the spoon is careful .
the doll sitting on the chair on the table is surprised .	the doll sits on the chair on the table is surprised .
the car sitting by the plate by the shoe is busy .	the car sits by the plate by the shoe is busy .
the shoe sitting by the chair by the ship is busy .	the shoe sits by the chair by the ship is busy .
the book sitting on the bed in the room is healthy .	the book sits on the bed in the room is healthy .
the boat sitting by the plane on the street is excited .	the boat sits by the plane on the street is excited .
the cup sitting in the restaurant in the restaurant is nice .	the cup sits in the restaurant in the restaurant is nice .
the crayon sitting by the rug in the library is helpful .	the crayon sits by the rug in the library is helpful .
the crayon sitting in the bank on the stool is gentle .	the crayon sits in the bank on the stool is gentle .
the bottle sitting by the rug by the door is tired .	the bottle sits by the rug by the door is tired .
the box sitting by the cup by the hat is lucky .	the box sits by the cup by the hat is lucky .
the hat sitting in the library in the museum is tall .	the hat sits in the library in the museum is tall .
the doll sitting by the spoon by the window is wrong .	the doll sits by the spoon by the window is wrong .
the shirt sitting in the hospital by the crayon is lucky .	the shirt sits in the hospital by the crayon is lucky .
the rocket sitting in the restaurant in the bank is sleepy .	the rocket sits in the restaurant in the bank is sleepy .
the mirror sitting on the ground in the restaurant is smart .	the mirror sits on the ground in the restaurant is smart .
the toy sitting by the spoon in the park is angry .	the toy sits by the spoon in the park is angry .
the bag sitting by the bicycle on the floor is busy .	the bag sits by the bicycle on the floor is busy .
the bowl sitting in the restaurant on the couch is wrong .	the bowl sits in the restaurant on the couch is wrong .
the box sitting by the picture on the table is boring .	the box sits by the picture on the table is boring .
the car sitting on the stool by the dish is upset .	the car sits on the stool by the dish is upset .
the spoon sitting on the chair in the library is quiet .	the spoon sits on the chair in the library is quiet .
the button sitting by the plate on the street is sleepy .	the button sits by the plate on the street is sleepy .
the spoon sitting by the car in the park is confused .	the spoon sits by the car in the park is confused .
the book sitting in the restaurant by the doll is careful .	the book sits in the restaurant by the doll is careful .
the glass sitting on the chair on the chair is surprised .	the glass sits on the chair on the chair is surprised .
the hat sitting on the chair by the car is strong .	the hat sits on the chair by the car is strong .
the toy sitting by the rocket in the mall is happy .	the toy sits by the rocket in the mall is happy .
the shirt sitting by the bottle on the floor is healthy .	the shirt sits by the bottle on the floor is healthy .
