the bottle sitting is cool .	the bottle sits is cool .
the bag sitting is orange .	the bag sits is orange .
the book sitting is white .	the book sits is white .
the dish sitting is broken .	the dish sits is broken .
the bed sitting is cute .	the bed sits is cute .
the book sitting is whole .	the book sits is whole .
the bicycle sitting is purple .	the bicycle sits is purple .
the shirt sitting is cool .	the shirt sits is cool .
the toy sitting is gray .	the toy sits is gray .
the bag sitting is missing .	the bag sits is missing .
the window sitting is hot .	the window sits is hot .
the bottle sitting is green .	the bottle sits is green .
the glass sitting is big .	the glass sits is big .
the button sitting is whole .	the button sits is whole .
the box sitting is yellow .	the box sits is yellow .
the doll sitting is purple .	the doll sits is purple .
the door sitting is fine .	the door sits is fine .
the bed sitting is important .	the bed sits is important .
the hat sitting is yellow .	the hat sits is yellow .
the box sitting is whole .	the box sits is whole .
the car sitting is amazing .	the car sits is amazing .
the rocket sitting is boring .	the rocket sits is boring .
the candle sitting is boring .	the candle sits is boring .
the button sitting is hot .	the button sits is hot .
the doll sitting is new .	the doll sits is new .
the book sitting is red .	the book sits is red .
the mirror sitting is cute .	the mirror sits is cute .
the bag sitting is amazing .	the bag sits is amazing .
the window sitting is green .	the window sits is green .
the car sitting is expensive .	the car sits is expensive .
the picture sitting is big .	the picture sits is big .
the book sitting is cool .	the book sits is cool .
the shirt sitting is black .	the shirt sits is black .
the boat sitting is blue .	the boat sits is blue .
the crayon sitting is awesome .	the crayon sits is awesome .
the hat sitting is brown .	the hat sits is brown .
the fork sitting is important .	the fork sits is important .
the bed sitting is white .	the bed sits is white .
the bottle sitting is big .	the bottle sits is big .
the bottle sitting is black .	the bottle sits is black .
the dish sitting is blue .	the dish sits is blue .
the couch sitting is old .	the couch sits is old .
the rug sitting is gray .	the rug sits is gray .
the bowl sitting is purple .	the bowl sits is purple .
the truck sitting is purple .	the truck sits is purple .
the cup sitting is big .	the cup sits is big .
the ring sitting is red .	the ring sits is red .
the glass sitting is fine .	the glass sits is fine .
the bag sitting is brown .	the bag sits is brown .
the toy sitting is small .	the toy sits is small .
the picture sitting is small .	the picture sits is small .
the plane sitting is cute .	the plane sits is cute .
the boat sitting is broken .	the boat sits is broken .
the mirror sitting is missing .	the mirror sits is missing .
the couch sitting is red .	the couch sits is red .
the shoe sitting is boring .	the shoe sits is boring .
the ship sitting is missing .	the ship sits is missing .
the bottle sitting is important .	the bottle sits is important .
the car sitting is broken .	the car sits is broken .
the car sitting is red .	the car sits is red .
the cup sitting is amazing .	the cup sits is amazing .
the button sitting is big .	the button sits is big .
the toy sitting is white .	the toy sits is white .
the chair sitting is gray .	the chair sits is gray .
the couch sitting is dry .	the couch sits is dry .
the ring sitting is small .	the ring sits is small .
the cup sitting is cold .	the cup sits is cold .
the plane sitting is green .	the plane sits is green .
the door sitting is dry .	the door sits is dry .
the bottle sitting is gray .	the bottle sits is gray .
the rocket sitting is important .	the rocket sits is important .
the bowl sitting is dry .	the bowl sits is dry .
the bowl sitting is fine .	the bowl sits is fine .
the shoe sitting is missing .	the shoe sits is missing .
the shirt sitting is gray .	the shirt sits is gray .
the car sitting is cold .	the car sits is cold .
the ring sitting is cold .	the ring sits is cold .
the plane sitting is great .	the plane sits is great .
the candle sitting is cold .	the candle sits is cold .
the book sitting is black .	the book sits is black .
the bag sitting is dry .	the bag sits is dry .
the fork sitting is purple .	the fork sits is purple .
the window sitting is boring .	the window sits is boring .
the mirror sitting is orange .	the mirror sits is orange .
the car sitting is purple .	the car sits is purple .
the rocket sitting is gray .	the rocket sits is gray .
the shoe sitting is black .	the shoe sits is black .
the door sitting is whole .	the door sits is whole .
the ring sitting is new .	the ring sits is new .
the bag sitting is expensive .	the bag sits is expensive .
the rug sitting is orange .	the rug sits is orange .
the glass sitting is whole .	the glass sits is whole .
the book sitting is awesome .	the book sits is awesome .
the crayon sitting is important .	the crayon sits is important .
the bottle sitting is missing .	the bottle sits is missing .
the bottle sitting is dry .	the bottle sits is dry .
the ship sitting is red .	the ship sits is red .
the fork sitting is awesome .	the fork sits is awesome .
the ship sitting is awesome .	the ship sits is awesome .
the window sitting is black .	the window sits is black .
the bag sitting is broken .	the bag sits is broken .
the bed sitting is red .	the bed sits is red .
the bowl sitting is amazing .	the bowl sits is amazing .
the car sitting is fine .	the car sits is fine .
the doll sitting is great .	the doll sits is great .
the rocket sitting is expensive .	the rocket sits is expensive .
the candle sitting is broken .	the candle sits is broken .
the chair sitting is new .	the chair sits is new .
the door sitting is important .	the door sits is important .
the dish sitting is purple .	the dish sits is purple .
the truck sitting is amazing .	the truck sits is amazing .
the window sitting is big .	the window sits is big .
the cup sitting is gray .	the cup sits is gray .
the car sitting is whole .	the car sits is whole .
the boat sitting is whole .	the boat sits is whole .
the picture sitting is hot .	the picture sits is hot .
the boat sitting is dry .	the boat sits is dry .
the shirt sitting is important .	the shirt sits is important .
the glass sitting is white .	the glass sits is white .
the toy sitting is red .	the toy sits is red .
the car sitting is awesome .	the car sits is awesome .
the ship sitting is white .	the ship sits is white .
the doll sitting is yellow .	the doll sits is yellow .
the spoon sitting is whole .	the spoon sits is whole .
the plane sitting is hot .	the plane sits is hot .
the boat sitting is green .	the boat sits is green .
the book sitting is hot .	the book sits is hot .
the candle sitting is great .	the candle sits is great .
the ship sitting is gray .	the ship sits is gray .
the car sitting is cute .	the car sits is cute .
the glass sitting is important .	the glass sits is important .
the bowl sitting is broken .	the bowl sits is broken .
the bed sitting is purple .	the bed sits is purple .
the boat sitting is gray .	the boat sits is gray .
the picture sitting is purple .	the picture sits is purple .
the couch sitting is hot .	the couch sits is hot .
the ship sitting is brown .	the ship sits is brown .
the hat sitting is gray .	the hat sits is gray .
the box sitting is blue .	the box sits is blue .
the cup sitting is red .	the cup sits is red .
the plate sitting is boring .	the plate sits is boring .
the bag sitting is black .	the bag sits is black .
the box sitting is purple .	the box sits is purple .
the truck sitting is whole .	the truck sits is whole .
the rug sitting is amazing .	the rug sits is amazing .
the hat sitting is boring .	the hat sits is boring .
the glass sitting is cute .	the glass sits is cute .
the rocket sitting is whole .	the rocket sits is whole .
the bed sitting is broken .	the bed sits is broken .
the fork sitting is cold .	the fork sits is cold .
the toy sitting is brown .	the toy sits is brown .
the dish sitting is green .	the dish sits is green .
the cup sitting is new .	the cup sits is new .
the book sitting is boring .	the book sits is boring .
the mirror sitting is boring .	the mirror sits is boring .
the bicycle sitting is dry .	the bicycle sits is dry .
the car sitting is brown .	the car sits is brown .
the fork sitting is boring .	the fork sits is boring .
the book sitting is old .	the book sits is old .
the fork sitting is green .	the fork sits is green .
the doll sitting is important .	the doll sits is important .
the picture sitting is awesome .	the picture sits is awesome .
the mirror sitting is brown .	the mirror sits is brown .
the window sitting is dry .	the window sits is dry .
the box sitting is missing .	the box sits is missing .
the ship sitting is fine .	the ship sits is fine .
the rug sitting is missing .	the rug sits is missing .
the glass sitting is expensive .	the glass sits is expensive .
the button sitting is black .	the button sits is black .
the boat sitting is orange .	the boat sits is orange .
the car sitting is important .	the car sits is important .
the ring sitting is expensive .	the ring sits is expensive .
the truck sitting is expensive .	the truck sits is expensive .
the couch sitting is amazing .	the couch sits is amazing .
the doll sitting is gray .	the doll sits is gray .
the door sitting is new .	the door sits is new .
the chair sitting is yellow .	the chair sits is yellow .
the cup sitting is cool .	the cup sits is cool .
the car sitting is hot .	the car sits is hot .
the mirror sitting is dry .	the mirror sits is dry .
the ship sitting is purple .	the ship sits is purple .
the truck sitting is small .	the truck sits is small .
the ring sitting is white .	the ring sits is white .
the spoon sitting is small .	the spoon sits is small .
the car sitting is yellow .	the car sits is yellow .
the shoe sitting is important .	the shoe sits is important .
the chair sitting is cool .	the chair sits is cool .
the mirror sitting is hot .	the mirror sits is hot .
the picture sitting is brown .	the picture sits is brown .
the glass sitting is amazing .	the glass sits is amazing .
the car sitting is black .	the car sits is black .
the toy sitting is great .	the toy sits is great .
the rocket sitting is dry .	the rocket sits is dry .
the toy sitting is missing .	the toy sits is missing .
the plate sitting is blue .	the plate sits is blue .
the dish sitting is dry .	the dish sits is dry .
the plane sitting is big .	the plane sits is big .
the boat sitting is missing .	the boat sits is missing .
the bicycle sitting is cute .	the bicycle sits is cute .
the mirror sitting is green .	the mirror sits is green .
the ship sitting is blue .	the ship sits is blue .
the candle sitting is important .	the candle sits is important .
the fork sitting is great .	the fork sits is great .
the spoon sitting is dry .	the spoon sits is dry .
the hat sitting is black .	the hat sits is black .
the glass sitting is broken .	the glass sits is broken .
the glass sitting is yellow .	the glass sits is yellow .
the couch sitting is boring .	the couch sits is boring .
the couch sitting is cute .	the couch sits is cute .
the hat sitting is blue .	the hat sits is blue .
the couch sitting is cool .	the couch sits is cool .
the plane sitting is red .	the plane sits is red .
the crayon sitting is fine .	the crayon sits is fine .
the book sitting is missing .	the book sits is missing .
the couch sitting is expensive .	the couch sits is expensive .
the bed sitting is gray .	the bed sits is gray .
the rocket sitting is cool .	the rocket sits is cool .
the plate sitting is dry .	the plate sits is dry .
the truck sitting is blue .	the truck sits is blue .
the fork sitting is new .	the fork sits is new .
the bag sitting is awesome .	the bag sits is awesome .
the picture sitting is broken .	the picture sits is broken .
the book sitting is new .	the book sits is new .
the couch sitting is fine .	the couch sits is fine .
the hat sitting is hot .	the hat sits is hot .
the ring sitting is big .	the ring sits is big .
the chair sitting is broken .	the chair sits is broken .
the rocket sitting is amazing .	the rocket sits is amazing .
the bag sitting is green .	the bag sits is green .
the crayon sitting is amazing .	the crayon sits is amazing .
the bed sitting is cool .	the bed sits is cool .
the book sitting is expensive .	the book sits is expensive .
the plane sitting is new .	the plane sits is new .
the doll sitting is missing .	the doll sits is missing .
the door sitting is missing .	the door sits is missing .
the spoon sitting is old .	the spoon sits is old .
the truck sitting is yellow .	the truck sits is yellow .
the plate sitting is awesome .	the plate sits is awesome .
the car sitting is old .	the car sits is old .
the box sitting is cold .	the box sits is cold .
the ship sitting is whole .	the ship sits is whole .
the bed sitting is orange .	the bed sits is orange .
the hat sitting is green .	the hat sits is green .
the button sitting is old .	the button sits is old .
the bowl sitting is red .	the bowl sits is red .
the chair sitting is green .	the chair sits is green .
the boat sitting is hot .	the boat sits is hot .
the glass sitting is small .	the glass sits is small .
the candle sitting is hot .	the candle sits is hot .
the button sitting is new .	the button sits is new .
the plate sitting is gray .	the plate sits is gray .
the toy sitting is cold .	the toy sits is cold .
the shoe sitting is small .	the shoe sits is small .
the mirror sitting is important .	the mirror sits is important .
the plate sitting is brown .	the plate sits is brown .
the window sitting is new .	the window sits is new .
the picture sitting is important .	the picture sits is important .
the glass sitting is orange .	the glass sits is orange .
the mirror sitting is cold .	the mirror sits is cold .
the ring sitting is dry .	the ring sits is dry .
the hat sitting is purple .	the hat sits is purple .
the couch sitting is brown .	the couch sits is brown .
the boat sitting is new .	the boat sits is new .
the candle sitting is amazing .	the candle sits is amazing .
the book sitting is broken .	the book sits is broken .
the chair sitting is expensive .	the chair sits is expensive .
the car sitting is small .	the car sits is small .
the crayon sitting is brown .	the crayon sits is brown .
the box sitting is broken .	the box sits is broken .
the rug sitting is white .	the rug sits is white .
the toy sitting is whole .	the toy sits is whole .
the bag sitting is big .	the bag sits is big .
the fork sitting is dry .	the fork sits is dry .
the hat sitting is whole .	the hat sits is whole .
the crayon sitting is white .	the crayon sits is white .
the plate sitting is red .	the plate sits is red .
the candle sitting is cool .	the candle sits is cool .
the picture sitting is amazing .	the picture sits is amazing .
the button sitting is awesome .	the button sits is awesome .
the box sitting is important .	the box sits is important .
the bowl sitting is important .	the bowl sits is important .
the toy sitting is cute .	the toy sits is cute .
the couch sitting is purple .	the couch sits is purple .
the ring sitting is broken .	the ring sits is broken .
the bag sitting is fine .	the bag sits is fine .
the plate sitting is old .	the plate sits is old .
the rug sitting is cute .	the rug sits is cute .
the glass sitting is awesome .	the glass sits is awesome .
the book sitting is important .	the book sits is important .
the candle sitting is new .	the candle sits is new .
the ring sitting is amazing .	the ring sits is amazing .
the ship sitting is boring .	the ship sits is boring .
the shirt sitting is orange .	the shirt sits is orange .
the doll sitting is old .	the doll sits is old .
the shoe sitting is expensive .	the shoe sits is expensive .
the car sitting is gray .	the car sits is gray .
the toy sitting is big .	the toy sits is big .
the fork sitting is fine .	the fork sits is fine .
the plane sitting is boring .	the plane sits is boring .
the hat sitting is new .	the hat sits is new .
the rug sitting is important .	the rug sits is important .
the crayon sitting is yellow .	the crayon sits is yellow .
the door sitting is white .	the door sits is white .
the chair sitting is hot .	the chair sits is hot .
the couch sitting is black .	the couch sits is black .
the bicycle sitting is white .	the bicycle sits is white .
the crayon sitting is cold .	the crayon sits is cold .
the book sitting is dry .	the book sits is dry .
the spoon sitting is cute .	the spoon sits is cute .
the chair sitting is dry .	the chair sits is dry .
the cup sitting is green .	the cup sits is green .
the door sitting is amazing .	the door sits is amazing .
the car sitting is green .	the car sits is green .
the bowl sitting is hot .	the bowl sits is hot .
the plane sitting is orange .	the plane sits is orange .
the door sitting is purple .	the door sits is purple .
the button sitting is expensive .	the button sits is expensive .
the cup sitting is small .	the cup sits is small .
the crayon sitting is small .	the crayon sits is small .
the spoon sitting is black .	the spoon sits is black .
the fork sitting is broken .	the fork sits is broken .
the door sitting is cool .	the door sits is cool .
the bag sitting is old .	the bag sits is old .
the cup sitting is cute .	the cup sits is cute .
the hat sitting is important .	the hat sits is important .
the couch sitting is cold .	the couch sits is cold .
the bottle sitting is fine .	the bottle sits is fine .
the hat sitting is orange .	the hat sits is orange .
the book sitting is small .	the book sits is small .
the car sitting is boring .	the car sits is boring .
the shoe sitting is broken .	the shoe sits is broken .
the rocket sitting is big .	the rocket sits is big .
the book sitting is yellow .	the book sits is yellow .
the bed sitting is boring .	the bed sits is boring .
the couch sitting is white .	the couch sits is white .
the plate sitting is small .	the plate sits is small .
the door sitting is awesome .	the door sits is awesome .
the spoon sitting is orange .	the spoon sits is orange .
the book sitting is cute .	the book sits is cute .
the dish sitting is brown .	the dish sits is brown .
the bicycle sitting is important .	the bicycle sits is important .
the plane sitting is cold .	the plane sits is cold .
the spoon sitting is brown .	the spoon sits is brown .
the chair sitting is awesome .	the chair sits is awesome .
the rug sitting is old .	the rug sits is old .
the glass sitting is cool .	the glass sits is cool .
the window sitting is whole .	the window sits is whole .
the doll sitting is orange .	the doll sits is orange .
the plate sitting is orange .	the plate sits is orange .
the spoon sitting is great .	the spoon sits is great .
the bicycle sitting is small .	the bicycle sits is small .
the plate sitting is green .	the plate sits is green .
the button sitting is dry .	the button sits is dry .
the couch sitting is yellow .	the couch sits is yellow .
the plane sitting is important .	the plane sits is important .
the truck sitting is big .	the truck sits is big .
the cup sitting is orange .	the cup sits is orange .
the plate sitting is yellow .	the plate sits is yellow .
the button sitting is red .	the button sits is red .
the bag sitting is cool .	the bag sits is cool .
the shirt sitting is brown .	the shirt sits is brown .
the glass sitting is old .	the glass sits is old .
the book sitting is gray .	the book sits is gray .
the crayon sitting is orange .	the crayon sits is orange .
the couch sitting is orange .	the couch sits is orange .
the rocket sitting is fine .	the rocket sits is fine .
the truck sitting is boring .	the truck sits is boring .
the ring sitting is important .	the ring sits is important .
the hat sitting is cool .	the hat sits is cool .
the bottle sitting is awesome .	the bottle sits is awesome .
the plane sitting is amazing .	the plane sits is amazing .
the shoe sitting is cool .	the shoe sits is cool .
the plane sitting is gray .	the plane sits is gray .
the plate sitting is black .	the plate sits is black .
the cup sitting is great .	the cup sits is great .
the dish sitting is expensive .	the dish sits is expensive .
the shoe sitting is new .	the shoe sits is new .
the spoon sitting is green .	the spoon sits is green .
the mirror sitting is broken .	the mirror sits is broken .
the plane sitting is blue .	the plane sits is blue .
the button sitting is brown .	the button sits is brown .
the fork sitting is amazing .	the fork sits is amazing .
the bowl sitting is old .	the bowl sits is old .
the car sitting is dry .	the car sits is dry .
the chair sitting is great .	the chair sits is great .
the mirror sitting is awesome .	the mirror sits is awesome .
the book sitting is brown .	the book sits is brown .
the spoon sitting is boring .	the spoon sits is boring .
the mirror sitting is old .	the mirror sits is old .
the hat sitting is awesome .	the hat sits is awesome .
the bowl sitting is cold .	the bowl sits is cold .
the ship sitting is green .	the ship sits is green .
the chair sitting is missing .	the chair sits is missing .
the hat sitting is red .	the hat sits is red .
the toy sitting is blue .	the toy sits is blue .
the shirt sitting is whole .	the shirt sits is whole .
the button sitting is great .	the button sits is great .
the dish sitting is new .	the dish sits is new .
the candle sitting is gray .	the candle sits is gray .
the truck sitting is great .	the truck sits is great .
the chair sitting is whole .	the chair sits is whole .
the rug sitting is small .	the rug sits is small .
the rug sitting is green .	the rug sits is green .
the cup sitting is white .	the cup sits is white .
the dish sitting is gray .	the dish sits is gray .
the button sitting is purple .	the button sits is purple .
the crayon sitting is red .	the crayon sits is red .
the picture sitting is gray .	the picture sits is gray .
the book sitting is great .	the book sits is great .
the boat sitting is small .	the boat sits is small .
the fork sitting is orange .	the fork sits is orange .
the window sitting is awesome .	the window sits is awesome .
the dish sitting is old .	the dish sits is old .
the ring sitting is brown .	the ring sits is brown .
the window sitting is expensive .	the window sits is expensive .
the window sitting is amazing .	the window sits is amazing .
the bowl sitting is cool .	the bowl sits is cool .
the bicycle sitting is missing .	the bicycle sits is missing .
the ring sitting is blue .	the ring sits is blue .
the spoon sitting is new .	the spoon sits is new .
the toy sitting is black .	the toy sits is black .
the shoe sitting is cute .	the shoe sits is cute .
the book sitting is orange .	the book sits is orange .
the rocket sitting is purple .	the rocket sits is purple .
the picture sitting is boring .	the picture sits is boring .
the bowl sitting is brown .	the bowl sits is brown .
the shirt sitting is old .	the shirt sits is old .
the bed sitting is blue .	the bed sits is blue .
the shirt sitting is awesome .	the shirt sits is awesome .
the toy sitting is yellow .	the toy sits is yellow .
the picture sitting is whole .	the picture sits is whole .
the car sitting is new .	the car sits is new .
the cup sitting is blue .	the cup sits is blue .
the couch sitting is small .	the couch sits is small .
the ring sitting is black .	the ring sits is black .
the dish sitting is yellow .	the dish sits is yellow .
the spoon sitting is important .	the spoon sits is important .
the door sitting is yellow .	the door sits is yellow .
the fork sitting is small .	the fork sits is small .
the window sitting is cute .	the window sits is cute .
the bed sitting is great .	the bed sits is great .
the bicycle sitting is brown .	the bicycle sits is brown .
the window sitting is red .	the window sits is red .
the toy sitting is important .	the toy sits is important .
the rocket sitting is cold .	the rocket sits is cold .
the picture sitting is new .	the picture sits is new .
the fork sitting is gray .	the fork sits is gray .
the shoe sitting is red .	the shoe sits is red .
the mirror sitting is blue .	the mirror sits is blue .
the truck sitting is orange .	the truck sits is orange .
the fork sitting is cool .	the fork sits is cool .
the hat sitting is expensive .	the hat sits is expensive .
the rug sitting is expensive .	the rug sits is expensive .
the mirror sitting is big .	the mirror sits is big .
the truck sitting is new .	the truck sits is new .
the doll sitting is awesome .	the doll sits is awesome .
the shoe sitting is great .	the shoe sits is great .
the ring sitting is cute .	the ring sits is cute .
the truck sitting is white .	the truck sits is white .
the mirror sitting is fine .	the mirror sits is fine .
the plane sitting is broken .	the plane sits is broken .
the doll sitting is blue .	the doll sits is blue .
the couch sitting is big .	the couch sits is big .
the crayon sitting is gray .	the crayon sits is gray .
the bottle sitting is cute .	the bottle sits is cute .
the ring sitting is awesome .	the ring sits is awesome .
the rocket sitting is awesome .	the rocket sits is awesome .
the crayon sitting is dry .	the crayon sits is dry .
the spoon sitting is amazing .	the spoon sits is amazing .
the fork sitting is big .	the fork sits is big .
the bag sitting is purple .	the bag sits is purple .
the ring sitting is purple .	the ring sits is purple .
the rug sitting is boring .	the rug sits is boring .
the candle sitting is brown .	the candle sits is brown .
the chair sitting is brown .	the chair sits is brown .
the bag sitting is great .	the bag sits is great .
the couch sitting is blue .	the couch sits is blue .
the crayon sitting is blue .	the crayon sits is blue .
the hat sitting is small .	the hat sits is small .
the doll sitting is cool .	the doll sits is cool .
the chair sitting is purple .	the chair sits is purple .
the book sitting is green .	the book sits is green .
the bag sitting is important .	the bag sits is important .
the button sitting is cool .	the button sits is cool .
the crayon sitting is cute .	the crayon sits is cute .
the doll sitting is black .	the doll sits is black .
the candle sitting is awesome .	the candle sits is awesome .
the ship sitting is expensive .	the ship sits is expensive .
the toy sitting is old .	the toy sits is old .
the rocket sitting is yellow .	the rocket sits is yellow .
the couch sitting is missing .	the couch sits is missing .
the spoon sitting is blue .	the spoon sits is blue .
the dish sitting is hot .	the dish sits is hot .
the ship sitting is orange .	the ship sits is orange .
the hat sitting is big .	the hat sits is big .
the bicycle sitting is amazing .	the bicycle sits is amazing .
the plane sitting is awesome .	the plane sits is awesome .
the picture sitting is cute .	the picture sits is cute .
the spoon sitting is yellow .	the spoon sits is yellow .
the rocket sitting is old .	the rocket sits is old .
the fork sitting is red .	the fork sits is red .
the bed sitting is missing .	the bed sits is missing .
the truck sitting is missing .	the truck sits is missing .
the truck sitting is old .	the truck sits is old .
the dish sitting is great .	the dish sits is great .
the couch sitting is gray .	the couch sits is gray .
the mirror sitting is great .	the mirror sits is great .
the bed sitting is cold .	the bed sits is cold .
the crayon sitting is black .	the crayon sits is black .
the dish sitting is small .	the dish sits is small .
the rug sitting is black .	the rug sits is black .
the cup sitting is dry .	the cup sits is dry .
the door sitting is black .	the door sits is black .
the doll sitting is whole .	the doll sits is whole .
the rug sitting is cool .	the rug sits is cool .
the ring sitting is great .	the ring sits is great .
the plane sitting is fine .	the plane sits is fine .
the window sitting is small .	the window sits is small .
the plate sitting is great .	the plate sits is great .
the shoe sitting is hot .	the shoe sits is hot .
the bed sitting is whole .	the bed sits is whole .
the spoon sitting is fine .	the spoon sits is fine .
the shirt sitting is blue .	the shirt sits is blue .
the rocket sitting is brown .	the rocket sits is brown .
the toy sitting is cool .	the toy sits is cool .
the bicycle sitting is fine .	the bicycle sits is fine .
the ship sitting is amazing .	the ship sits is amazing .
the ship sitting is old .	the ship sits is old .
the book sitting is purple .	the book sits is purple .
the shoe sitting is whole .	the shoe sits is whole .
the rocket sitting is red .	the rocket sits is red .
the ring sitting is cool .	the ring sits is cool .
the box sitting is awesome .	the box sits is awesome .
the mirror sitting is new .	the mirror sits is new .
the plate sitting is important .	the plate sits is important .
the chair sitting is boring .	the chair sits is boring .
the plane sitting is dry .	the plane sits is dry .
the door sitting is red .	the door sits is red .
the mirror sitting is small .	the mirror sits is small .
the picture sitting is dry .	the picture sits is dry .
the rug sitting is whole .	the rug sits is whole .
the crayon sitting is hot .	the crayon sits is hot .
the picture sitting is great .	the picture sits is great .
the shirt sitting is cold .	the shirt sits is cold .
the bicycle sitting is orange .	the bicycle sits is orange .
the doll sitting is red .	the doll sits is red .
the chair sitting is black .	the chair sits is black .
the cup sitting is old .	the cup sits is old .
the bowl sitting is black .	the bowl sits is black .
the picture sitting is red .	the picture sits is red .
the shoe sitting is old .	the shoe sits is old .
the box sitting is boring .	the box sits is boring .
the candle sitting is yellow .	the candle sits is yellow .
the truck sitting is black .	the truck sits is black .
the bowl sitting is boring .	the bowl sits is boring .
the bowl sitting is whole .	the bowl sits is whole .
the door sitting is big .	the door sits is big .
the bed sitting is expensive .	the bed sits is expensive .
the bowl sitting is orange .	the bowl sits is orange .
the dish sitting is white .	the dish sits is white .
the picture sitting is expensive .	the picture sits is expensive .
the toy sitting is new .	the toy sits is new .
the truck sitting is brown .	the truck sits is brown .
the spoon sitting is cool .	the spoon sits is cool .
the rocket sitting is new .	the rocket sits is new .
the shirt sitting is new .	the shirt sits is new .
the doll sitting is boring .	the doll sits is boring .
the window sitting is yellow .	the window sits is yellow .
the plane sitting is brown .	the plane sits is brown .
the hat sitting is missing .	the hat sits is missing .
the picture sitting is missing .	the picture sits is missing .
the window sitting is missing .	the window sits is missing .
the door sitting is small .	the door sits is small .
the bicycle sitting is red .	the bicycle sits is red .
the ship sitting is hot .	the ship sits is hot .
the dish sitting is cute .	the dish sits is cute .
the bed sitting is big .	the bed sits is big .
the mirror sitting is purple .	the mirror sits is purple .
the shoe sitting is fine .	the shoe sits is fine .
the button sitting is gray .	the button sits is gray .
the dish sitting is whole .	the dish sits is whole .
the bed sitting is fine .	the bed sits is fine .
the plane sitting is white .	the plane sits is white .
the rocket sitting is blue .	the rocket sits is blue .
the shirt sitting is amazing .	the shirt sits is amazing .
the box sitting is white .	the box sits is white .
the candle sitting is red .	the candle sits is red .
the bowl sitting is missing .	the bowl sits is missing .
the picture sitting is yellow .	the picture sits is yellow .
the ship sitting is big .	the ship sits is big .
the window sitting is great .	the window sits is great .
the shirt sitting is missing .	the shirt sits is missing .
the mirror sitting is white .	the mirror sits is white .
the bed sitting is green .	the bed sits is green .
the candle sitting is small .	the candle sits is small .
the doll sitting is cold .	the doll sits is cold .
the spoon sitting is purple .	the spoon sits is purple .
the shirt sitting is purple .	the shirt sits is purple .
the car sitting is big .	the car sits is big .
the door sitting is cold .	the door sits is cold .
the cup sitting is awesome .	the cup sits is awesome .
the door sitting is cute .	the door sits is cute .
the button sitting is cute .	the button sits is cute .
the rug sitting is purple .	the rug sits is purple .
the hat sitting is fine .	the hat sits is fine .
the glass sitting is gray .	the glass sits is gray .
the plate sitting is cold .	the plate sits is cold .
the chair sitting is important .	the chair sits is important .
the fork sitting is hot .	the fork sits is hot .
the rug sitting is awesome .	the rug sits is awesome .
the rug sitting is dry .	the rug sits is dry .
the crayon sitting is great .	the crayon sits is great .
the book sitting is fine .	the book sits is fine .
the bottle sitting is old .	the bottle sits is old .
the door sitting is green .	the door sits is green .
the truck sitting is red .	the truck sits is red .
the boat sitting is great .	the boat sits is great .
the plate sitting is expensive .	the plate sits is expensive .
the rug sitting is brown .	the rug sits is brown .
the candle sitting is white .	the candle sits is white .
the truck sitting is cute .	the truck sits is cute .
the box sitting is expensive .	the box sits is expensive .
the bottle sitting is orange .	the bottle sits is orange .
the toy sitting is amazing .	the toy sits is amazing .
the bowl sitting is yellow .	the bowl sits is yellow .
the button sitting is missing .	the button sits is missing .
the truck sitting is dry .	the truck sits is dry .
the dish sitting is missing .	the dish sits is missing .
the bed sitting is brown .	the bed sits is brown .
the door sitting is hot .	the door sits is hot .
the couch sitting is new .	the couch sits is new .
the boat sitting is black .	the boat sits is black .
the button sitting is boring .	the button sits is boring .
the bottle sitting is expensive .	the bottle sits is expensive .
the cup sitting is yellow .	the cup sits is yellow .
the car sitting is blue .	the car sits is blue .
the plane sitting is yellow .	the plane sits is yellow .
the window sitting is broken .	the window sits is broken .
the bowl sitting is big .	the bowl sits is big .
the doll sitting is dry .	the doll sits is dry .
the plane sitting is old .	the plane sits is old .
the bottle sitting is new .	the bottle sits is new .
the rocket sitting is hot .	the rocket sits is hot .
the fork sitting is white .	the fork sits is white .
the bag sitting is yellow .	the bag sits is yellow .
the cup sitting is hot .	the cup sits is hot .
the crayon sitting is new .	the crayon sits is new .
the shirt sitting is expensive .	the shirt sits is expensive .
the ring sitting is yellow .	the ring sits is yellow .
the window sitting is cold .	the window sits is cold .
the couch sitting is green .	the couch sits is green .
the hat sitting is dry .	the hat sits is dry .
the chair sitting is orange .	the chair sits is orange .
the rocket sitting is green .	the rocket sits is green .
the chair sitting is old .	the chair sits is old .
the shirt sitting is boring .	the shirt sits is boring .
the rocket sitting is black .	the rocket sits is black .
the button sitting is blue .	the button sits is blue .
the crayon sitting is old .	the crayon sits is old .
the mirror sitting is amazing .	the mirror sits is amazing .
the ship sitting is cute .	the ship sits is cute .
the window sitting is cool .	the window sits is cool .
the box sitting is green .	the box sits is green .
the door sitting is orange .	the door sits is orange .
the bowl sitting is awesome .	the bowl sits is awesome .
the door sitting is broken .	the door sits is broken .
the picture sitting is green .	the picture sits is green .
the shirt sitting is white .	the shirt sits is white .
the doll sitting is white .	the doll sits is white .
the bottle sitting is cold .	the bottle sits is cold .
the door sitting is great .	the door sits is great .
the dish sitting is cold .	the dish sits is cold .
the bottle sitting is whole .	the bottle sits is whole .
the bicycle sitting is blue .	the bicycle sits is blue .
the bed sitting is dry .	the bed sits is dry .
the rocket sitting is great .	the rocket sits is great .
the box sitting is hot .	the box sits is hot .
the bowl sitting is new .	the bowl sits is new .
the mirror sitting is cool .	the mirror sits is cool .
the bag sitting is red .	the bag sits is red .
the bicycle sitting is great .	the bicycle sits is great .
the mirror sitting is black .	the mirror sits is black .
the candle sitting is blue .	the candle sits is blue .
the shoe sitting is purple .	the shoe sits is purple .
the box sitting is small .	the box sits is small .
the shirt sitting is dry .	the shirt sits is dry .
the bag sitting is hot .	the bag sits is hot .
the bowl sitting is green .	the bowl sits is green .
the chair sitting is fine .	the chair sits is fine .
the chair sitting is cute .	the chair sits is cute .
the ship sitting is yellow .	the ship sits is yellow .
the bowl sitting is great .	the bowl sits is great .
the toy sitting is hot .	the toy sits is hot .
the door sitting is boring .	the door sits is boring .
the shirt sitting is broken .	the shirt sits is broken .
the plate sitting is fine .	the plate sits is fine .
the bag sitting is small .	the bag sits is small .
the candle sitting is fine .	the candle sits is fine .
the boat sitting is old .	the boat sits is old .
the crayon sitting is missing .	the crayon sits is missing .
the bicycle sitting is yellow .	the bicycle sits is yellow .
the bag sitting is gray .	the bag sits is gray .
the fork sitting is yellow .	the fork sits is yellow .
the dish sitting is important .	the dish sits is important .
the shirt sitting is hot .	the shirt sits is hot .
the spoon sitting is red .	the spoon sits is red .
the rug sitting is hot .	the rug sits is hot .
the crayon sitting is cool .	the crayon sits is cool .
the fork sitting is missing .	the fork sits is missing .
the toy sitting is fine .	the toy sits is fine .
the chair sitting is cold .	the chair sits is cold .
the rocket sitting is orange .	the rocket sits is orange .
the doll sitting is fine .	the doll sits is fine .
the button sitting is orange .	the button sits is orange .
the doll sitting is big .	the doll sits is big .
the shoe sitting is brown .	the shoe sits is brown .
the couch sitting is great .	the couch sits is great .
the rug sitting is broken .	the rug sits is broken .
the plate sitting is white .	the plate sits is white .
the picture sitting is black .	the picture sits is black .
the bicycle sitting is boring .	the bicycle sits is boring .
the shoe sitting is yellow .	the shoe sits is yellow .
the box sitting is red .	the box sits is red .
the picture sitting is old .	the picture sits is old .
the box sitting is new .	the box sits is new .
the shoe sitting is dry .	the shoe sits is dry .
the bed sitting is new .	the bed sits is new .
the shirt sitting is small .	the shirt sits is small .
the hat sitting is old .	the hat sits is old .
the shoe sitting is amazing .	the shoe sits is amazing .
the bicycle sitting is whole .	the bicycle sits is whole .
the fork sitting is expensive .	the fork sits is expensive .
the plane sitting is missing .	the plane sits is missing .
the glass sitting is great .	the glass sits is great .
the doll sitting is cute .	the doll sits is cute .
the truck sitting is hot .	the truck sits is hot .
the plate sitting is cute .	the plate sits is cute .
the candle sitting is purple .	the candle sits is purple .
the ship sitting is small .	the ship sits is small .
the glass sitting is red .	the glass sits is red .
the shirt sitting is cute .	the shirt sits is cute .
the boat sitting is yellow .	the boat sits is yellow .
the toy sitting is boring .	the toy sits is boring .
the doll sitting is small .	the doll sits is small .
the chair sitting is white .	the chair sits is white .
the cup sitting is expensive .	the cup sits is expensive .
the dish sitting is awesome .	the dish sits is awesome .
the shirt sitting is fine .	the shirt sits is fine .
the car sitting is great .	the car sits is great .
the box sitting is old .	the box sits is old .
the shirt sitting is big .	the shirt sits is big .
the plane sitting is whole .	the plane sits is whole .
the book sitting is big .	the book sits is big .
the picture sitting is fine .	the picture sits is fine .
the mirror sitting is red .	the mirror sits is red .
the dish sitting is black .	the dish sits is black .
the box sitting is orange .	the box sits is orange .
the bag sitting is white .	the bag sits is white .
the boat sitting is important .	the boat sits is important .
the chair sitting is amazing .	the chair sits is amazing .
the ship sitting is dry .	the ship sits is dry .
the button sitting is cold .	the button sits is cold .
the doll sitting is amazing .	the doll sits is amazing .
the dish sitting is orange .	the dish sits is orange .
the window sitting is purple .	the window sits is purple .
the button sitting is amazing .	the button sits is amazing .
the shoe sitting is green .	the shoe sits is green .
the door sitting is brown .	the door sits is brown .
the plate sitting is cool .	the plate sits is cool .
the hat sitting is cold .	the hat sits is cold .
the bicycle sitting is awesome .	the bicycle sits is awesome .
the crayon sitting is big .	the crayon sits is big .
the candle sitting is old .	the candle sits is old .
the car sitting is missing .	the car sits is missing .
the box sitting is dry .	the box sits is dry .
the bicycle sitting is gray .	the bicycle sits is gray .
the glass sitting is cold .	the glass sits is cold .
the ring sitting is missing .	the ring sits is missing .
the dish sitting is red .	the dish sits is red .
the glass sitting is black .	the glass sits is black .
the book sitting is cold .	the book sits is cold .
the truck sitting is awesome .	the truck sits is awesome .
the truck sitting is cool .	the truck sits is cool .
the bag sitting is new .	the bag sits is new .
the car sitting is white .	the car sits is white .
the window sitting is old .	the window sits is old .
the window sitting is fine .	the window sits is fine .
the boat sitting is cool .	the boat sits is cool .
the doll sitting is broken .	the doll sits is broken .
the chair sitting is blue .	the chair sits is blue .
the candle sitting is whole .	the candle sits is whole .
the button sitting is green .	the button sits is green .
the bottle sitting is yellow .	the bottle sits is yellow .
the truck sitting is fine .	the truck sits is fine .
the bed sitting is small .	the bed sits is small .
the fork sitting is whole .	the fork sits is whole .
the dish sitting is cool .	the dish sits is cool .
the bicycle sitting is new .	the bicycle sits is new .
the door sitting is blue .	the door sits is blue .
the bottle sitting is broken .	the bottle sits is broken .
the mirror sitting is gray .	the mirror sits is gray .
the ship sitting is cool .	the ship sits is cool .
the shoe sitting is blue .	the shoe sits is blue .
the bottle sitting is white .	the bottle sits is white .
the button sitting is yellow .	the button sits is yellow .
the spoon sitting is hot .	the spoon sits is hot .
the toy sitting is broken .	the toy sits is broken .
the truck sitting is important .	the truck sits is important .
the box sitting is black .	the box sits is black .
the toy sitting is green .	the toy sits is green .
the bag sitting is cute .	the bag sits is cute .
the glass sitting is hot .	the glass sits is hot .
the cup sitting is brown .	the cup sits is brown .
the shoe sitting is gray .	the shoe sits is gray .
the ship sitting is new .	the ship sits is new .
the mirror sitting is expensive .	the mirror sits is expensive .
the glass sitting is purple .	the glass sits is purple .
the truck sitting is gray .	the truck sits is gray .
the bag sitting is blue .	the bag sits is blue .
the plate sitting is big .	the plate sits is big .
the rug sitting is new .	the rug sits is new .
the ring sitting is old .	the ring sits is old .
the window sitting is brown .	the window sits is brown .
the chair sitting is big .	the chair sits is big .
the bicycle sitting is expensive .	the bicycle sits is expensive .
the bag sitting is whole .	the bag sits is whole .
the bowl sitting is white .	the bowl sits is white .
the box sitting is gray .	the box sits is gray .
the hat sitting is white .	the hat sits is white .
the cup sitting is purple .	the cup sits is purple .
the bottle sitting is boring .	the bottle sits is boring .
the box sitting is amazing .	the box sits is amazing .
the bottle sitting is small .	the bottle sits is small .
the shoe sitting is big .	the shoe sits is big .
the shirt sitting is great .	the shirt sits is great .
the toy sitting is orange .	the toy sits is orange .
the fork sitting is old .	the fork sits is old .
the button sitting is important .	the button sits is important .
the cup sitting is black .	the cup sits is black .
the boat sitting is cold .	the boat sits is cold .
the window sitting is blue .	the window sits is blue .
the plate sitting is missing .	the plate sits is missing .
the cup sitting is broken .	the cup sits is broken .
the plate sitting is broken .	the plate sits is broken .
the rug sitting is fine .	the rug sits is fine .
the button sitting is broken .	the button sits is broken .
the bottle sitting is blue .	the bottle sits is blue .
the shoe sitting is white .	the shoe sits is white .
the plane sitting is purple .	the plane sits is purple .
the button sitting is fine .	the button sits is fine .
the boat sitting is amazing .	the boat sits is amazing .
the cup sitting is missing .	the cup sits is missing .
the bottle sitting is hot .	the bottle sits is hot .
the bowl sitting is gray .	the bowl sits is gray .
the toy sitting is awesome .	the toy sits is awesome .
the shirt sitting is yellow .	the shirt sits is yellow .
the bed sitting is awesome .	the bed sits is awesome .
the box sitting is big .	the box sits is big .
the door sitting is old .	the door sits is old .
the boat sitting is red .	the boat sits is red .
the truck sitting is green .	the truck sits is green .
the boat sitting is purple .	the boat sits is purple .
the picture sitting is white .	the picture sits is white .
the spoon sitting is broken .	the spoon sits is broken .
the plate sitting is purple .	the plate sits is purple .
the candle sitting is big .	the candle sits is big .
the bicycle sitting is hot .	the bicycle sits is hot .
the plate sitting is new .	the plate sits is new .
the plate sitting is whole .	the plate sits is whole .
the box sitting is cute .	the box sits is cute .
the glass sitting is green .	the glass sits is green .
the bottle sitting is purple .	the bottle sits is purple .
the glass sitting is dry .	the glass sits is dry .
the glass sitting is brown .	the glass sits is brown .
the spoon sitting is expensive .	the spoon sits is expensive .
the crayon sitting is broken .	the crayon sits is broken .
the rocket sitting is white .	the rocket sits is white .
the bowl sitting is expensive .	the bowl sits is expensive .
the car sitting is cool .	the car sits is cool .
the bicycle sitting is black .	the bicycle sits is black .
the rug sitting is cold .	the rug sits is cold .
the boat sitting is expensive .	the boat sits is expensive .
the button sitting is white .	the button sits is white .
the rug sitting is red .	the rug sits is red .
the candle sitting is orange .	the candle sits is orange .
the rug sitting is big .	the rug sits is big .
the ring sitting is hot .	the ring sits is hot .
the cup sitting is boring .	the cup sits is boring .
the bed sitting is yellow .	the bed sits is yellow .
the glass sitting is missing .	the glass sits is missing .
the shoe sitting is orange .	the shoe sits is orange .
the window sitting is white .	the window sits is white .
the rocket sitting is small .	the rocket sits is small .
the ship sitting is broken .	the ship sits is broken .
the picture sitting is orange .	the picture sits is orange .
the fork sitting is blue .	the fork sits is blue .
the crayon sitting is purple .	the crayon sits is purple .
the candle sitting is green .	the candle sits is green .
the doll sitting is hot .	the doll sits is hot .
the glass sitting is new .	the glass sits is new .
the box sitting is cool .	the box sits is cool .
the rocket sitting is broken .	the rocket sits is broken .
the spoon sitting is awesome .	the spoon sits is awesome .
the cup sitting is whole .	the cup sits is whole .
the boat sitting is boring .	the boat sits is boring .
the ring sitting is whole .	the ring sits is whole .
the toy sitting is expensive .	the toy sits is expensive .
the bed sitting is old .	the bed sits is old .
the bicycle sitting is cold .	the bicycle sits is cold .
the plane sitting is cool .	the plane sits is cool .
the spoon sitting is missing .	the spoon sits is missing .
the plane sitting is small .	the plane sits is small .
the bag sitting is boring .	the bag sits is boring .
the picture sitting is cold .	the picture sits is cold .
the hat sitting is amazing .	the hat sits is amazing .
the fork sitting is cute .	the fork sits is cute .
the fork sitting is black .	the fork sits is black .
the window sitting is orange .	the window sits is orange .
the ring sitting is boring .	the ring sits is boring .
the book sitting is blue .	the book sits is blue .
the couch sitting is awesome .	the couch sits is awesome .
the ship sitting is cold .	the ship sits is cold .
the dish sitting is amazing .	the dish sits is amazing .
the box sitting is fine .	the box sits is fine .
the window sitting is important .	the window sits is important .
the picture sitting is blue .	the picture sits is blue .
the button sitting is small .	the button sits is small .
the dish sitting is fine .	the dish sits is fine .
the hat sitting is cute .	the hat sits is cute .
the candle sitting is missing .	the candle sits is missing .
the chair sitting is red .	the chair sits is red .
the crayon sitting is green .	the crayon sits is green .
the bed sitting is amazing .	the bed sits is amazing .
the crayon sitting is expensive .	the crayon sits is expensive .
the picture sitting is cool .	the picture sits is cool .
the spoon sitting is cold .	the spoon sits is cold .
the rug sitting is yellow .	the rug sits is yellow .
the boat sitting is big .	the boat sits is big .
the shoe sitting is cold .	the shoe sits is cold .
the crayon sitting is whole .	the crayon sits is whole .
the door sitting is expensive .	the door sits is expensive .
the bicycle sitting is old .	the bicycle sits is old .
the boat sitting is cute .	the boat sits is cute .
the rocket sitting is missing .	the rocket sits is missing .
the shirt sitting is red .	the shirt sits is red .
the rocket sitting is cute .	the rocket sits is cute .
the car sitting is orange .	the car sits is orange .
the window sitting is gray .	the window sits is gray .
the shoe sitting is awesome .	the shoe sits is awesome .
the couch sitting is important .	the couch sits is important .
the bowl sitting is cute .	the bowl sits is cute .
the boat sitting is awesome .	the boat sits is awesome .
the book sitting is amazing .	the book sits is amazing .
the spoon sitting is big .	the spoon sits is big .
the boat sitting is fine .	the boat sits is fine .
the mirror sitting is whole .	the mirror sits is whole .
the toy sitting is purple .	the toy sits is purple .
the spoon sitting is white .	the spoon sits is white .
the candle sitting is expensive .	the candle sits is expensive .
the ship sitting is important .	the ship sits is important .
the doll sitting is green .	the doll sits is green .
the ring sitting is green .	the ring sits is green .
the rug sitting is blue .	the rug sits is blue .
the cup sitting is fine .	the cup sits is fine .
the door sitting is gray .	the door sits is gray .
the doll sitting is brown .	the doll sits is brown .
the bicycle sitting is big .	the bicycle sits is big .
the truck sitting is cold .	the truck sits is cold .
the plate sitting is amazing .	the plate sits is amazing .
the cup sitting is important .	the cup sits is important .
the bed sitting is hot .	the bed sits is hot .
the truck sitting is broken .	the truck sits is broken .
the box sitting is brown .	the box sits is brown .
the bag sitting is cold .	the bag sits is cold .
the dish sitting is big .	the dish sits is big .
the bicycle sitting is green .	the bicycle sits is green .
the couch sitting is broken .	the couch sits is broken .
the toy sitting is dry .	the toy sits is dry .
the crayon sitting is boring .	the crayon sits is boring .
the bottle sitting is red .	the bottle sits is red .
the bowl sitting is blue .	the bowl sits is blue .
the doll sitting is expensive .	the doll sits is expensive .
the ship sitting is black .	the ship sits is black .
the mirror sitting is yellow .	the mirror sits is yellow .
the bed sitting is black .	the bed sits is black .
the dish sitting is boring .	the dish sits is boring .
the ring sitting is gray .	the ring sits is gray .
the glass sitting is boring .	the glass sits is boring .
the hat sitting is great .	the hat sits is great .
the candle sitting is dry .	the candle sits is dry .
the ring sitting is fine .	the ring sits is fine .
the ship sitting is great .	the ship sits is great .
the glass sitting is blue .	the glass sits is blue .
the shirt sitting is green .	the shirt sits is green .
the chair sitting is small .	the chair sits is small .
the ring sitting is orange .	the ring sits is orange .
the boat sitting is brown .	the boat sits is brown .
the bicycle sitting is cool .	the bicycle sits is cool .
the candle sitting is cute .	the candle sits is cute .
the plane sitting is expensive .	the plane sits is expensive .
