the cup on the chair by the bottle in the kitchen was yellow .	the cup is on the chair by the bottle in the kitchen was yellow .
the hat on the chair by the ship on the bed is orange .	the hat was on the chair by the ship on the bed is orange .
the car by the doll in the school in the museum is hot .	the car was by the doll in the school in the museum is hot .
the truck by the box in the mall by the window is small .	the truck was by the box in the mall by the window is small .
the book by the doll in the museum by the hat is gray .	the book was by the doll in the museum by the hat is gray .
the candle on the stool in the hospital on the floor is orange .	the candle was on the stool in the hospital on the floor is orange .
the cup on the couch on the bed by the cup was expensive .	the cup is on the couch on the bed by the cup was expensive .
the couch by the doll by the bowl on the bed is small .	the couch was by the doll by the bowl on the bed is small .
the cup by the bag on the table by the spoon is purple .	the cup was by the bag on the table by the spoon is purple .
the rug by the spoon by the boat on the chair was red .	the rug is by the spoon by the boat on the chair was red .
the rug in the school by the book on the chair was old .	the rug is in the school by the book on the chair was old .
the window in the bank on the couch by the chair is broken .	the window was in the bank on the couch by the chair is broken .
the mirror in the park on the couch by the spoon is brown .	the mirror was in the park on the couch by the spoon is brown .
the truck by the plate by the car on the chair is gray .	the truck was by the plate by the car on the chair is gray .
the crayon in the hospital on the couch by the window was cute .	the crayon is in the hospital on the couch by the window was cute .
the button by the bicycle by the spoon on the couch was cute .	the button is by the bicycle by the spoon on the couch was cute .
the couch in the kitchen on the street by the rocket is cold .	the couch was in the kitchen on the street by the rocket is cold .
the cup by the bottle by the bag by the rocket is amazing .	the cup was by the bottle by the bag by the rocket is amazing .
the dish in the library in the school on the street is boring .	the dish was in the library in the school on the street is boring .
the fork on the street on the stool on the chair was boring .	the fork is on the street on the stool on the chair was boring .
the bowl in the museum in the kitchen by the fork was amazing .	the bowl is in the museum in the kitchen by the fork was amazing .
the bowl by the bicycle on the floor on the chair was red .	the bowl is by the bicycle on the floor on the chair was red .
the crayon by the bag on the bed in the mall was hot .	the crayon is by the bag on the bed in the mall was hot .
the fork by the book by the chair by the rocket was great .	the fork is by the book by the chair by the rocket was great .
the window on the street by the bowl on the floor was missing .	the window is on the street by the bowl on the floor was missing .
the bowl on the table on the stool by the shoe was brown .	the bowl is on the table on the stool by the shoe was brown .
the ring by the plane in the school on the bed was cold .	the ring is by the plane in the school on the bed was cold .
the candle by the truck by the spoon on the table was cute .	the candle is by the truck by the spoon on the table was cute .
the ship in the kitchen by the box in the school was boring .	the ship is in the kitchen by the box in the school was boring .
the bicycle on the bed by the book by the car was boring .	the bicycle is on the bed by the book by the car was boring .
the truck by the shirt by the toy on the bed was small .	the truck is by the shirt by the toy on the bed was small .
the candle in the school by the crayon on the table is gray .	the candle was in the school by the crayon on the table is gray .
the button by the boat in the school in the room is black .	the button was by the boat in the school in the room is black .
the bicycle in the park by the spoon on the stool is green .	the bicycle was in the park by the spoon on the stool is green .
the door in the mall in the bank on the stool was important .	the door is in the mall in the bank on the stool was important .
the crayon by the candle by the hat by the picture is amazing .	the crayon was by the candle by the hat by the picture is amazing .
the couch in the restaurant on the chair on the stool was red .	the couch is in the restaurant on the chair on the stool was red .
the bicycle on the bed in the restaurant on the table is great .	the bicycle was on the bed in the restaurant on the table is great .
the window by the spoon by the couch by the rocket is expensive .	the window was by the spoon by the couch by the rocket is expensive .
the doll in the school in the restaurant on the chair is cool .	the doll was in the school in the restaurant on the chair is cool .
the rug in the restaurant in the restaurant on the table is great .	the rug was in the restaurant in the restaurant on the table is great .
the window by the plate on the couch on the couch is cold .	the window was by the plate on the couch on the couch is cold .
the mirror on the couch by the glass by the plane is expensive .	the mirror was on the couch by the glass by the plane is expensive .
the couch in the hospital on the floor on the chair was cool .	the couch is in the hospital on the floor on the chair was cool .
the shirt in the school by the glass on the couch was new .	the shirt is in the school by the glass on the couch was new .
the cup by the cup on the couch on the street is purple .	the cup was by the cup on the couch on the street is purple .
the truck on the chair on the chair on the table is fine .	the truck was on the chair on the chair on the table is fine .
the spoon by the cup by the door on the floor was amazing .	the spoon is by the cup by the door on the floor was amazing .
the doll by the hat by the chair by the bowl was missing .	the doll is by the hat by the chair by the bowl was missing .
the book by the button in the mall by the cup is cute .	the book was by the button in the mall by the cup is cute .
the shirt by the picture on the chair in the park is cold .	the shirt was by the picture on the chair in the park is cold .
the shirt by the couch on the street in the mall was cute .	the shirt is by the couch on the street in the mall was cute .
the hat by the plate on the chair on the couch was hot .	the hat is by the plate on the chair on the couch was hot .
the doll on the couch on the floor by the crayon was yellow .	the doll is on the couch on the floor by the crayon was yellow .
the bed on the ground in the library on the couch is cold .	the bed was on the ground in the library on the couch is cold .
the window in the library by the truck on the street was important .	the window is in the library by the truck on the street was important .
the crayon in the bank on the floor on the floor was hot .	the crayon is in the bank on the floor on the floor was hot .
the picture in the restaurant in the bank in the hospital was cool .	the picture is in the restaurant in the bank in the hospital was cool .
the doll in the mall on the table in the school was amazing .	the doll is in the mall on the table in the school was amazing .
the toy in the hospital in the museum in the kitchen is cute .	the toy was in the hospital in the museum in the kitchen is cute .
the ring by the shirt on the couch by the plane is amazing .	the ring was by the shirt on the couch by the plane is amazing .
the doll by the plane by the mirror on the bed is hot .	the doll was by the plane by the mirror on the bed is hot .
the shoe in the museum on the stool by the picture is orange .	the shoe was in the museum on the stool by the picture is orange .
the glass in the school in the museum on the table was cool .	the glass is in the school in the museum on the table was cool .
the candle on the stool by the toy by the boat is dry .	the candle was on the stool by the toy by the boat is dry .
the rocket by the fork on the stool on the chair is missing .	the rocket was by the fork on the stool on the chair is missing .
the truck in the school on the chair on the chair was amazing .	the truck is in the school on the chair on the chair was amazing .
the hat in the mall on the chair by the car was small .	the hat is in the mall on the chair by the car was small .
the car on the chair by the candle by the car is boring .	the car was on the chair by the candle by the car is boring .
the picture in the restaurant on the bed in the room is green .	the picture was in the restaurant on the bed in the room is green .
the door in the library in the mall on the floor is missing .	the door was in the library in the mall on the floor is missing .
the spoon in the park by the chair on the stool is boring .	the spoon was in the park by the chair on the stool is boring .
the window by the shirt in the library by the shirt was orange .	the window is by the shirt in the library by the shirt was orange .
the car by the bicycle on the chair on the floor is whole .	the car was by the bicycle on the chair on the floor is whole .
the door by the doll by the door in the museum is gray .	the door was by the doll by the door in the museum is gray .
the shoe in the museum on the ground on the couch is broken .	the shoe was in the museum on the ground on the couch is broken .
the fork in the kitchen by the shoe in the room was orange .	the fork is in the kitchen by the shoe in the room was orange .
the truck on the couch by the picture by the window was awesome .	the truck is on the couch by the picture by the window was awesome .
the box in the mall by the picture by the bowl was blue .	the box is in the mall by the picture by the bowl was blue .
the plane in the hospital on the bed in the bank was black .	the plane is in the hospital on the bed in the bank was black .
the truck in the room in the kitchen in the bank is big .	the truck was in the room in the kitchen in the bank is big .
the bowl by the glass by the spoon in the bank was blue .	the bowl is by the glass by the spoon in the bank was blue .
the ship on the stool on the stool by the bicycle was new .	the ship is on the stool on the stool by the bicycle was new .
the doll in the restaurant on the bed on the stool is old .	the doll was in the restaurant on the bed on the stool is old .
the couch by the bottle on the chair on the floor is yellow .	the couch was by the bottle on the chair on the floor is yellow .
the car in the kitchen by the truck in the park was whole .	the car is in the kitchen by the truck in the park was whole .
the spoon on the stool on the bed by the bowl was hot .	the spoon is on the stool on the bed by the bowl was hot .
the bag by the rug on the floor on the chair is black .	the bag was by the rug on the floor on the chair is black .
the bowl by the book on the couch in the park was white .	the bowl is by the book on the couch in the park was white .
the hat by the shoe by the mirror on the ground is cold .	the hat was by the shoe by the mirror on the ground is cold .
the ship by the fork on the bed by the bicycle is orange .	the ship was by the fork on the bed by the bicycle is orange .
the door in the museum on the couch on the bed is red .	the door was in the museum on the couch on the bed is red .
the shoe in the park in the bank on the table was important .	the shoe is in the park in the bank on the table was important .
the chair by the bag on the stool in the library was orange .	the chair is by the bag on the stool in the library was orange .
the chair by the box by the glass in the restaurant is yellow .	the chair was by the box by the glass in the restaurant is yellow .
the crayon by the bed by the toy in the library is amazing .	the crayon was by the bed by the toy in the library is amazing .
the hat on the street on the floor by the bowl was white .	the hat is on the street on the floor by the bowl was white .
the window in the library in the museum by the ship was white .	the window is in the library in the museum by the ship was white .
the chair on the stool by the car on the couch was red .	the chair is on the stool by the car on the couch was red .
the boat on the couch on the stool by the bicycle is new .	the boat was on the couch on the stool by the bicycle is new .
the door in the library in the bank by the toy is white .	the door was in the library in the bank by the toy is white .
the bag in the hospital in the park on the couch is big .	the bag was in the hospital in the park on the couch is big .
the chair by the plane by the book by the shoe was brown .	the chair is by the plane by the book by the shoe was brown .
the rocket on the stool on the chair in the mall is purple .	the rocket was on the stool on the chair in the mall is purple .
the dish on the street by the book in the hospital is important .	the dish was on the street by the book in the hospital is important .
the book on the stool by the window by the bottle is cold .	the book was on the stool by the window by the bottle is cold .
the plate in the library by the picture by the bicycle is brown .	the plate was in the library by the picture by the bicycle is brown .
the boat in the room in the library in the hospital is great .	the boat was in the room in the library in the hospital is great .
the bed by the chair on the chair on the ground is gray .	the bed was by the chair on the chair on the ground is gray .
the bicycle in the room by the boat by the chair is whole .	the bicycle was in the room by the boat by the chair is whole .
the toy in the mall by the hat on the ground is purple .	the toy was in the mall by the hat on the ground is purple .
the bowl by the ship on the stool on the floor is whole .	the bowl was by the ship on the stool on the floor is whole .
the shirt by the shoe on the ground on the street is big .	the shirt was by the shoe on the ground on the street is big .
the chair on the street in the mall by the toy is hot .	the chair was on the street in the mall by the toy is hot .
the box on the chair in the restaurant in the museum was important .	the box is on the chair in the restaurant in the museum was important .
the book on the stool in the room by the button was expensive .	the book is on the stool in the room by the button was expensive .
the cup in the room on the chair in the park is hot .	the cup was in the room on the chair in the park is hot .
the bicycle on the bed in the room on the couch was hot .	the bicycle is on the bed in the room on the couch was hot .
the rug on the chair on the bed on the chair was awesome .	the rug is on the chair on the bed on the chair was awesome .
the rug by the bed on the bed in the kitchen is green .	the rug was by the bed on the bed in the kitchen is green .
the plane in the mall by the car on the bed is blue .	the plane was in the mall by the car on the bed is blue .
the window on the street on the ground on the ground is boring .	the window was on the street on the ground on the ground is boring .
the rocket in the park by the book on the floor was important .	the rocket is in the park by the book on the floor was important .
the shoe on the floor on the chair in the restaurant is expensive .	the shoe was on the floor on the chair in the restaurant is expensive .
the hat on the couch on the floor on the stool was great .	the hat is on the couch on the floor on the stool was great .
the door in the school on the stool in the museum is hot .	the door was in the school on the stool in the museum is hot .
the button by the door on the floor by the toy was whole .	the button is by the door on the floor by the toy was whole .
the book on the table by the bicycle by the couch is cute .	the book was on the table by the bicycle by the couch is cute .
the car by the dish on the table by the truck was awesome .	the car is by the dish on the table by the truck was awesome .
the truck on the couch on the couch by the bicycle was missing .	the truck is on the couch on the couch by the bicycle was missing .
the doll by the dish on the table on the ground was amazing .	the doll is by the dish on the table on the ground was amazing .
the plane on the street by the box in the mall is boring .	the plane was on the street by the box in the mall is boring .
the boat in the school on the street on the ground was cold .	the boat is in the school on the street on the ground was cold .
the boat on the bed on the floor on the chair is green .	the boat was on the bed on the floor on the chair is green .
the box on the couch on the floor on the chair is cool .	the box was on the couch on the floor on the chair is cool .
the crayon on the chair on the floor in the kitchen was yellow .	the crayon is on the chair on the floor in the kitchen was yellow .
the picture in the room by the button on the table is purple .	the picture was in the room by the button on the table is purple .
the car in the library by the picture by the button is amazing .	the car was in the library by the picture by the button is amazing .
the shoe in the room on the table by the window is brown .	the shoe was in the room on the table by the window is brown .
the spoon by the fork by the fork by the shoe is important .	the spoon was by the fork by the fork by the shoe is important .
the ship on the chair on the stool on the bed is great .	the ship was on the chair on the stool on the bed is great .
the book on the chair on the ground in the restaurant is great .	the book was on the chair on the ground in the restaurant is great .
the ship by the toy on the stool by the picture was big .	the ship is by the toy on the stool by the picture was big .
the rug by the bed on the table on the chair is broken .	the rug was by the bed on the table on the chair is broken .
the ring on the couch in the kitchen on the ground was amazing .	the ring is on the couch in the kitchen on the ground was amazing .
the candle on the stool in the museum by the truck was broken .	the candle is on the stool in the museum by the truck was broken .
the couch on the stool in the hospital in the hospital was old .	the couch is on the stool in the hospital in the hospital was old .
the mirror on the ground on the chair by the car is missing .	the mirror was on the ground on the chair by the car is missing .
the car on the bed on the bed by the door was broken .	the car is on the bed on the bed by the door was broken .
the shirt by the candle on the ground in the library was blue .	the shirt is by the candle on the ground in the library was blue .
the bowl on the table in the mall on the stool is broken .	the bowl was on the table in the mall on the stool is broken .
the ring by the ship in the school in the school was cool .	the ring is by the ship in the school in the school was cool .
the glass on the street in the restaurant in the mall is hot .	the glass was on the street in the restaurant in the mall is hot .
the book on the floor on the table on the chair was green .	the book is on the floor on the table on the chair was green .
the book on the street by the box in the library is broken .	the book was on the street by the box in the library is broken .
the plate on the floor by the shirt on the bed was gray .	the plate is on the floor by the shirt on the bed was gray .
the couch by the bag on the ground by the hat was green .	the couch is by the bag on the ground by the hat was green .
the hat in the library by the ship on the table was cold .	the hat is in the library by the ship on the table was cold .
the ring in the school in the park on the stool was gray .	the ring is in the school in the park on the stool was gray .
the crayon by the cup on the couch in the school was yellow .	the crayon is by the cup on the couch in the school was yellow .
the bag by the bottle in the library on the ground is new .	the bag was by the bottle in the library on the ground is new .
the cup on the floor in the kitchen in the hospital is big .	the cup was on the floor in the kitchen in the hospital is big .
the truck on the street in the school on the couch was expensive .	the truck is on the street in the school on the couch was expensive .
the fork in the kitchen in the restaurant in the school was white .	the fork is in the kitchen in the restaurant in the school was white .
the doll in the kitchen by the car in the school was gray .	the doll is in the kitchen by the car in the school was gray .
the door by the boat by the truck in the kitchen is dry .	the door was by the boat by the truck in the kitchen is dry .
the chair in the museum by the bottle by the door was purple .	the chair is in the museum by the bottle by the door was purple .
the crayon by the boat in the kitchen on the ground was white .	the crayon is by the boat in the kitchen on the ground was white .
the box on the street in the school on the table was orange .	the box is on the street in the school on the table was orange .
the plate by the glass in the mall by the bowl is important .	the plate was by the glass in the mall by the bowl is important .
the fork by the bicycle by the spoon in the mall is missing .	the fork was by the bicycle by the spoon in the mall is missing .
the toy on the street in the library on the ground is yellow .	the toy was on the street in the library on the ground is yellow .
the boat by the picture by the glass on the chair was cool .	the boat is by the picture by the glass on the chair was cool .
the plate on the couch on the stool on the stool was whole .	the plate is on the couch on the stool on the stool was whole .
the book on the couch by the window on the couch is old .	the book was on the couch by the window on the couch is old .
the ring by the shoe on the couch in the hospital was missing .	the ring is by the shoe on the couch in the hospital was missing .
the shirt in the kitchen by the crayon on the floor is red .	the shirt was in the kitchen by the crayon on the floor is red .
the ring by the ship on the ground on the ground is fine .	the ring was by the ship on the ground on the ground is fine .
the candle on the floor on the table by the truck is yellow .	the candle was on the floor on the table by the truck is yellow .
the bicycle by the picture by the ship by the bed is green .	the bicycle was by the picture by the ship by the bed is green .
the bottle in the school on the floor on the chair was brown .	the bottle is in the school on the floor on the chair was brown .
the bed on the floor on the chair by the plane is new .	the bed was on the floor on the chair by the plane is new .
the spoon by the car by the button in the school is cool .	the spoon was by the car by the button in the school is cool .
the box by the truck by the glass in the bank is whole .	the box was by the truck by the glass in the bank is whole .
the button by the rocket in the hospital by the mirror was whole .	the button is by the rocket in the hospital by the mirror was whole .
the bag by the window by the book in the museum was awesome .	the bag is by the window by the book in the museum was awesome .
the glass in the bank by the couch in the museum was new .	the glass is in the bank by the couch in the museum was new .
the shirt by the book on the ground by the ring is dry .	the shirt was by the book on the ground by the ring is dry .
the hat by the window by the picture on the street was brown .	the hat is by the window by the picture on the street was brown .
the chair by the mirror by the bowl by the hat was boring .	the chair is by the mirror by the bowl by the hat was boring .
the crayon by the car in the school in the mall is yellow .	the crayon was by the car in the school in the mall is yellow .
the bottle in the kitchen by the bowl by the toy was green .	the bottle is in the kitchen by the bowl by the toy was green .
the car by the shoe on the couch by the box was cute .	the car is by the shoe on the couch by the box was cute .
the shirt by the car in the room in the bank is boring .	the shirt was by the car in the room in the bank is boring .
the ring in the school by the book in the room was red .	the ring is in the school by the book in the room was red .
the mirror by the bottle in the restaurant by the chair was red .	the mirror is by the bottle in the restaurant by the chair was red .
the book by the fork on the ground by the button is big .	the book was by the fork on the ground by the button is big .
the window by the cup in the library by the fork was whole .	the window is by the cup in the library by the fork was whole .
the ship on the street by the picture by the shirt was new .	the ship is on the street by the picture by the shirt was new .
the dish in the school by the shirt by the ship was great .	the dish is in the school by the shirt by the ship was great .
the hat by the fork on the street in the school was new .	the hat is by the fork on the street in the school was new .
the picture on the street by the car by the bicycle was cool .	the picture is on the street by the car by the bicycle was cool .
the toy on the floor in the hospital on the couch is orange .	the toy was on the floor in the hospital on the couch is orange .
the chair on the table in the library by the glass is broken .	the chair was on the table in the library by the glass is broken .
the plane in the bank by the shirt on the table is hot .	the plane was in the bank by the shirt on the table is hot .
the cup on the floor on the couch in the restaurant was cold .	the cup is on the floor on the couch in the restaurant was cold .
the bed by the hat in the kitchen on the floor was purple .	the bed is by the hat in the kitchen on the floor was purple .
the shoe on the ground in the mall on the couch was whole .	the shoe is on the ground in the mall on the couch was whole .
the doll in the restaurant by the mirror by the shoe was small .	the doll is in the restaurant by the mirror by the shoe was small .
the truck on the street on the floor by the ship is big .	the truck was on the street on the floor by the ship is big .
the window on the floor by the door by the rug was broken .	the window is on the floor by the door by the rug was broken .
the crayon in the school in the room on the stool is missing .	the crayon was in the school in the room on the stool is missing .
the crayon by the button by the picture on the ground is orange .	the crayon was by the button by the picture on the ground is orange .
the candle on the floor on the chair by the bottle is black .	the candle was on the floor on the chair by the bottle is black .
the plane on the bed on the bed in the library was purple .	the plane is on the bed on the bed in the library was purple .
the truck by the book by the picture by the cup was black .	the truck is by the book by the picture by the cup was black .
the spoon in the room in the mall by the fork is blue .	the spoon was in the room in the mall by the fork is blue .
the book on the couch on the chair in the bank is amazing .	the book was on the couch on the chair in the bank is amazing .
the mirror by the door in the library on the chair was cute .	the mirror is by the door in the library on the chair was cute .
the truck on the bed on the floor by the plane is broken .	the truck was on the bed on the floor by the plane is broken .
the hat in the park by the fork in the library was whole .	the hat is in the park by the fork in the library was whole .
the chair by the rocket in the restaurant in the library is broken .	the chair was by the rocket in the restaurant in the library is broken .
the truck on the stool by the shoe on the street was broken .	the truck is on the stool by the shoe on the street was broken .
the plate on the street on the chair on the floor is cool .	the plate was on the street on the chair on the floor is cool .
the plate by the rocket in the mall on the bed is dry .	the plate was by the rocket in the mall on the bed is dry .
the chair in the room on the bed in the park is broken .	the chair was in the room on the bed in the park is broken .
the ring on the table on the chair by the doll is cold .	the ring was on the table on the chair by the doll is cold .
the hat in the park by the candle by the couch was brown .	the hat is in the park by the candle by the couch was brown .
the bowl in the school in the school in the museum is old .	the bowl was in the school in the school in the museum is old .
the rug in the bank by the truck by the cup is big .	the rug was in the bank by the truck by the cup is big .
the bottle on the couch by the toy by the toy is old .	the bottle was on the couch by the toy by the toy is old .
the book by the box on the stool on the ground is cute .	the book was by the box on the stool on the ground is cute .
the bowl in the school in the kitchen on the table is white .	the bowl was in the school in the kitchen on the table is white .
the hat in the hospital on the stool in the library was old .	the hat is in the hospital on the stool in the library was old .
the doll by the boat in the school in the school is boring .	the doll was by the boat in the school in the school is boring .
the book by the box in the hospital in the museum was red .	the book is by the box in the hospital in the museum was red .
the spoon on the couch on the bed by the truck is fine .	the spoon was on the couch on the bed by the truck is fine .
the doll by the toy on the street by the window is great .	the doll was by the toy on the street by the window is great .
the rug by the door in the school on the ground is old .	the rug was by the door in the school on the ground is old .
the mirror by the car by the truck on the couch was whole .	the mirror is by the car by the truck on the couch was whole .
the plate in the room on the chair in the bank is old .	the plate was in the room on the chair in the bank is old .
the rug in the restaurant on the floor on the chair is old .	the rug was in the restaurant on the floor on the chair is old .
the chair in the bank by the crayon on the bed was hot .	the chair is in the bank by the crayon on the bed was hot .
the doll on the street on the ground by the bowl was new .	the doll is on the street on the ground by the bowl was new .
the fork on the floor by the ring on the ground was brown .	the fork is on the floor by the ring on the ground was brown .
the picture in the hospital by the ring in the school is big .	the picture was in the hospital by the ring in the school is big .
the book in the mall by the rug on the street was expensive .	the book is in the mall by the rug on the street was expensive .
the couch on the ground by the doll by the hat was green .	the couch is on the ground by the doll by the hat was green .
the chair on the table by the ring on the table is cool .	the chair was on the table by the ring on the table is cool .
the mirror in the school in the restaurant by the shirt was blue .	the mirror is in the school in the restaurant by the shirt was blue .
the mirror on the ground by the picture on the table was boring .	the mirror is on the ground by the picture on the table was boring .
the bicycle in the kitchen by the bottle in the restaurant was missing .	the bicycle is in the kitchen by the bottle in the restaurant was missing .
the ring on the floor in the kitchen by the bicycle is amazing .	the ring was on the floor in the kitchen by the bicycle is amazing .
the button on the ground by the toy in the library was amazing .	the button is on the ground by the toy in the library was amazing .
the ship by the door in the bank in the park was white .	the ship is by the door in the bank in the park was white .
the ring by the picture on the floor in the mall was orange .	the ring is by the picture on the floor in the mall was orange .
the book in the school in the park in the school is amazing .	the book was in the school in the park in the school is amazing .
the plate on the floor by the box on the couch was amazing .	the plate is on the floor by the box on the couch was amazing .
the crayon by the fork on the bed in the park was missing .	the crayon is by the fork on the bed in the park was missing .
the ship on the couch in the room by the boat was missing .	the ship is on the couch in the room by the boat was missing .
the plate in the room by the truck on the table is important .	the plate was in the room by the truck on the table is important .
the glass in the bank on the chair by the bag was hot .	the glass is in the bank on the chair by the bag was hot .
the book by the rocket on the couch in the room is cute .	the book was by the rocket on the couch in the room is cute .
the shirt on the street on the chair in the school is big .	the shirt was on the street on the chair in the school is big .
the cup on the bed in the school in the kitchen was white .	the cup is on the bed in the school in the kitchen was white .
the boat in the mall in the park on the ground is missing .	the boat was in the mall in the park on the ground is missing .
the couch on the bed in the bank by the bed was brown .	the couch is on the bed in the bank by the bed was brown .
the window in the room in the restaurant on the couch is broken .	the window was in the room in the restaurant on the couch is broken .
the couch by the chair in the bank on the street is green .	the couch was by the chair in the bank on the street is green .
the plane in the kitchen on the street by the book is new .	the plane was in the kitchen on the street by the book is new .
the book on the stool on the ground on the table was orange .	the book is on the stool on the ground on the table was orange .
the cup on the street by the plate by the shirt was whole .	the cup is on the street by the plate by the shirt was whole .
the spoon on the bed on the bed in the hospital is orange .	the spoon was on the bed on the bed in the hospital is orange .
the button in the park by the bed in the bank is boring .	the button was in the park by the bed in the bank is boring .
the mirror on the couch by the spoon on the ground was cool .	the mirror is on the couch by the spoon on the ground was cool .
the door on the stool in the kitchen in the restaurant is old .	the door was on the stool in the kitchen in the restaurant is old .
the glass in the bank by the door by the ship was brown .	the glass is in the bank by the door by the ship was brown .
the rug on the stool by the candle by the shoe was great .	the rug is on the stool by the candle by the shoe was great .
the picture on the bed in the room by the plane was gray .	the picture is on the bed in the room by the plane was gray .
the book on the table on the couch on the bed is new .	the book was on the table on the couch on the bed is new .
the fork by the dish by the spoon in the library is white .	the fork was by the dish by the spoon in the library is white .
the doll by the car in the mall in the bank was great .	the doll is by the car in the mall in the bank was great .
the bowl on the floor by the window in the bank was cute .	the bowl is on the floor by the window in the bank was cute .
the book by the spoon on the floor on the chair was important .	the book is by the spoon on the floor on the chair was important .
the doll on the floor in the kitchen on the bed is hot .	the doll was on the floor in the kitchen on the bed is hot .
the chair in the school in the bank on the bed is important .	the chair was in the school in the bank on the bed is important .
the candle by the rug on the couch on the chair was dry .	the candle is by the rug on the couch on the chair was dry .
the plane by the shirt in the museum on the stool is black .	the plane was by the shirt in the museum on the stool is black .
the bottle by the rug on the stool on the street was blue .	the bottle is by the rug on the stool on the street was blue .
the box on the chair by the bowl by the crayon was cool .	the box is on the chair by the bowl by the crayon was cool .
the crayon by the car in the room by the door was purple .	the crayon is by the car in the room by the door was purple .
the ring by the box on the table on the couch was amazing .	the ring is by the box on the table on the couch was amazing .
the fork by the bed on the table by the spoon is missing .	the fork was by the bed on the table by the spoon is missing .
the couch on the bed in the park on the stool is great .	the couch was on the bed in the park on the stool is great .
the cup on the floor by the boat by the bed is important .	the cup was on the floor by the boat by the bed is important .
the bicycle by the bag by the bicycle in the kitchen was expensive .	the bicycle is by the bag by the bicycle in the kitchen was expensive .
the doll in the mall on the stool in the bank is awesome .	the doll was in the mall on the stool in the bank is awesome .
the car in the park in the restaurant on the stool is fine .	the car was in the park in the restaurant on the stool is fine .
the door by the picture by the plate in the museum is red .	the door was by the picture by the plate in the museum is red .
the shoe on the stool by the shoe in the school was black .	the shoe is on the stool by the shoe in the school was black .
the doll on the floor on the ground on the floor was old .	the doll is on the floor on the ground on the floor was old .
the rocket on the ground by the bottle on the table is red .	the rocket was on the ground by the bottle on the table is red .
the bottle by the rocket in the museum on the street was boring .	the bottle is by the rocket in the museum on the street was boring .
the shoe by the button in the museum on the couch was orange .	the shoe is by the button in the museum on the couch was orange .
the hat on the floor on the ground on the table was cold .	the hat is on the floor on the ground on the table was cold .
the couch in the park on the stool on the stool was blue .	the couch is in the park on the stool on the stool was blue .
the plate in the museum on the bed by the spoon is brown .	the plate was in the museum on the bed by the spoon is brown .
the shirt in the museum on the ground in the kitchen is red .	the shirt was in the museum on the ground in the kitchen is red .
the bag in the mall on the ground in the library is amazing .	the bag was in the mall on the ground in the library is amazing .
the picture in the school on the floor by the rocket is new .	the picture was in the school on the floor by the rocket is new .
the shirt on the street on the chair in the bank is missing .	the shirt was on the street on the chair in the bank is missing .
the spoon by the candle in the bank on the stool was big .	the spoon is by the candle in the bank on the stool was big .
the plate by the boat by the hat by the bicycle is cold .	the plate was by the boat by the hat by the bicycle is cold .
the fork in the school in the school by the mirror is green .	the fork was in the school in the school by the mirror is green .
the shirt by the spoon by the ship on the chair was old .	the shirt is by the spoon by the ship on the chair was old .
the rug in the school on the table by the fork was boring .	the rug is in the school on the table by the fork was boring .
the window in the museum in the library in the park was big .	the window is in the museum in the library in the park was big .
the shirt by the doll in the hospital on the chair was orange .	the shirt is by the doll in the hospital on the chair was orange .
the candle on the street on the stool by the glass is whole .	the candle was on the street on the stool by the glass is whole .
the plane by the toy on the chair on the couch is boring .	the plane was by the toy on the chair on the couch is boring .
the book in the kitchen on the floor in the bank is great .	the book was in the kitchen on the floor in the bank is great .
the car in the park on the stool in the library was broken .	the car is in the park on the stool in the library was broken .
the ring by the book in the park by the rug is fine .	the ring was by the book in the park by the rug is fine .
the bowl by the bowl on the couch in the mall is broken .	the bowl was by the bowl on the couch in the mall is broken .
the bag on the ground on the table in the school was big .	the bag is on the ground on the table in the school was big .
the shoe on the table by the bowl by the ship was blue .	the shoe is on the table by the bowl by the ship was blue .
the truck on the chair in the room in the room is boring .	the truck was on the chair in the room in the room is boring .
the bicycle by the shoe on the street in the restaurant was small .	the bicycle is by the shoe on the street in the restaurant was small .
the car in the mall by the shoe on the bed was important .	the car is in the mall by the shoe on the bed was important .
the picture on the stool on the chair in the museum was red .	the picture is on the stool on the chair in the museum was red .
the shirt on the ground in the museum by the shirt is old .	the shirt was on the ground in the museum by the shirt is old .
the bicycle by the cup on the chair on the couch is big .	the bicycle was by the cup on the chair on the couch is big .
the fork on the floor on the chair in the school was orange .	the fork is on the floor on the chair in the school was orange .
the door in the library on the ground in the school is gray .	the door was in the library on the ground in the school is gray .
the plane on the ground on the ground on the chair is great .	the plane was on the ground on the ground on the chair is great .
the book by the box in the library by the candle is blue .	the book was by the box in the library by the candle is blue .
the picture on the couch by the rocket in the bank is red .	the picture was on the couch by the rocket in the bank is red .
the toy by the fork in the bank in the hospital was cold .	the toy is by the fork in the bank in the hospital was cold .
the candle by the candle by the chair on the street was red .	the candle is by the candle by the chair on the street was red .
the hat by the door in the library on the bed was green .	the hat is by the door in the library on the bed was green .
the door by the mirror on the bed by the window is black .	the door was by the mirror on the bed by the window is black .
the crayon on the bed on the couch in the mall was hot .	the crayon is on the bed on the couch in the mall was hot .
the truck in the library in the kitchen in the park was white .	the truck is in the library in the kitchen in the park was white .
the box by the book on the ground on the street was old .	the box is by the book on the ground on the street was old .
the plate by the rug on the street by the rocket was red .	the plate is by the rug on the street by the rocket was red .
the candle on the stool by the picture in the museum was black .	the candle is on the stool by the picture in the museum was black .
the ring on the chair in the park by the mirror was awesome .	the ring is on the chair in the park by the mirror was awesome .
the dish by the mirror on the table in the library was broken .	the dish is by the mirror on the table in the library was broken .
the plate in the restaurant by the ring by the book is fine .	the plate was in the restaurant by the ring by the book is fine .
the book in the bank on the street in the park is dry .	the book was in the bank on the street in the park is dry .
the mirror in the hospital by the picture by the ring is white .	the mirror was in the hospital by the picture by the ring is white .
the dish on the couch by the book by the chair was great .	the dish is on the couch by the book by the chair was great .
the window in the hospital by the book by the shirt is white .	the window was in the hospital by the book by the shirt is white .
the plate on the table on the table on the stool is red .	the plate was on the table on the table on the stool is red .
the mirror on the table on the ground in the bank was cute .	the mirror is on the table on the ground in the bank was cute .
the car by the bicycle by the rocket on the bed was dry .	the car is by the bicycle by the rocket on the bed was dry .
the plane in the restaurant by the boat by the car was boring .	the plane is in the restaurant by the boat by the car was boring .
the bicycle in the room on the floor on the stool was new .	the bicycle is in the room on the floor on the stool was new .
the doll in the museum in the museum on the table is expensive .	the doll was in the museum in the museum on the table is expensive .
the ring in the museum in the bank in the library is boring .	the ring was in the museum in the bank in the library is boring .
the plane in the room in the school on the couch was expensive .	the plane is in the room in the school on the couch was expensive .
the plate by the car on the stool by the car was brown .	the plate is by the car on the stool by the car was brown .
the window on the table in the kitchen in the room is great .	the window was on the table in the kitchen in the room is great .
the truck on the stool by the couch on the bed was yellow .	the truck is on the stool by the couch on the bed was yellow .
the ship by the shirt on the chair in the bank was whole .	the ship is by the shirt on the chair in the bank was whole .
the rocket by the book in the school on the chair was black .	the rocket is by the book in the school on the chair was black .
the bowl on the chair in the mall in the bank was dry .	the bowl is on the chair in the mall in the bank was dry .
the shirt in the bank on the table in the museum is gray .	the shirt was in the bank on the table in the museum is gray .
the rug on the ground in the museum on the stool is gray .	the rug was on the ground in the museum on the stool is gray .
the boat in the kitchen on the street on the table is fine .	the boat was in the kitchen on the street on the table is fine .
the mirror on the couch on the stool on the table was big .	the mirror is on the couch on the stool on the table was big .
the mirror in the bank in the library in the hospital was cute .	the mirror is in the bank in the library in the hospital was cute .
the door on the chair in the school by the bicycle is important .	the door was on the chair in the school by the bicycle is important .
the couch by the mirror by the car in the mall was whole .	the couch is by the mirror by the car in the mall was whole .
the bed by the dish on the ground in the room was green .	the bed is by the dish on the ground in the room was green .
the plate by the car by the fork on the street is boring .	the plate was by the car by the fork on the street is boring .
the button in the room in the school on the ground is gray .	the button was in the room in the school on the ground is gray .
the ship in the school on the chair by the chair was great .	the ship is in the school on the chair by the chair was great .
the shirt on the ground by the crayon by the rug was boring .	the shirt is on the ground by the crayon by the rug was boring .
the picture by the boat in the kitchen in the hospital is awesome .	the picture was by the boat in the kitchen in the hospital is awesome .
the bowl by the hat in the school in the bank was cold .	the bowl is by the hat in the school in the bank was cold .
the spoon on the floor on the couch in the library is important .	the spoon was on the floor on the couch in the library is important .
the candle on the ground by the rocket on the stool was awesome .	the candle is on the ground by the rocket on the stool was awesome .
the dish in the school by the book on the chair was green .	the dish is in the school by the book on the chair was green .
the chair in the restaurant by the window on the street is big .	the chair was in the restaurant by the window on the street is big .
the cup on the bed by the bowl in the mall is awesome .	the cup was on the bed by the bowl in the mall is awesome .
the toy on the table on the ground by the doll is important .	the toy was on the table on the ground by the doll is important .
the plane in the museum on the chair on the floor is expensive .	the plane was in the museum on the chair on the floor is expensive .
the bed in the hospital on the bed in the room is amazing .	the bed was in the hospital on the bed in the room is amazing .
the shirt by the book by the box in the hospital is new .	the shirt was by the book by the box in the hospital is new .
the box in the room on the bed on the chair was gray .	the box is in the room on the bed on the chair was gray .
the bottle in the restaurant in the bank on the table was red .	the bottle is in the restaurant in the bank on the table was red .
the ship in the room by the glass by the spoon was great .	the ship is in the room by the glass by the spoon was great .
the truck by the book on the bed in the museum is dry .	the truck was by the book on the bed in the museum is dry .
the window on the street on the table on the stool is important .	the window was on the street on the table on the stool is important .
the shirt on the ground on the floor by the mirror was red .	the shirt is on the ground on the floor by the mirror was red .
the ship on the chair by the box on the bed was small .	the ship is on the chair by the box on the bed was small .
the toy in the park on the table in the kitchen was cold .	the toy is in the park on the table in the kitchen was cold .
the bottle in the library on the table in the park was fine .	the bottle is in the library on the table in the park was fine .
the hat on the bed in the room in the bank was old .	the hat is on the bed in the room in the bank was old .
the bag on the floor by the boat by the plate was fine .	the bag is on the floor by the boat by the plate was fine .
the plane on the table in the kitchen in the school is small .	the plane was on the table in the kitchen in the school is small .
the bicycle in the hospital in the park by the glass is expensive .	the bicycle was in the hospital in the park by the glass is expensive .
the toy in the library by the fork on the floor is important .	the toy was in the library by the fork on the floor is important .
the hat on the bed in the library in the mall was cute .	the hat is on the bed in the library in the mall was cute .
the window by the candle on the table in the bank is fine .	the window was by the candle on the table in the bank is fine .
the shirt by the bowl by the plane by the hat is cold .	the shirt was by the bowl by the plane by the hat is cold .
the rug on the bed on the floor by the door is green .	the rug was on the bed on the floor by the door is green .
the doll on the ground by the couch by the rocket is red .	the doll was on the ground by the couch by the rocket is red .
the dish by the chair by the bowl by the fork was old .	the dish is by the chair by the bowl by the fork was old .
the bowl in the mall on the stool in the kitchen was great .	the bowl is in the mall on the stool in the kitchen was great .
the doll in the park by the shirt in the library is amazing .	the doll was in the park by the shirt in the library is amazing .
the dish on the chair in the school in the bank was old .	the dish is on the chair in the school in the bank was old .
the cup by the bag in the school by the picture was cold .	the cup is by the bag in the school by the picture was cold .
the bowl by the couch by the bicycle in the restaurant is awesome .	the bowl was by the couch by the bicycle in the restaurant is awesome .
the button by the car on the table by the spoon was old .	the button is by the car on the table by the spoon was old .
the book on the street by the mirror by the spoon is green .	the book was on the street by the mirror by the spoon is green .
the chair by the bottle on the table by the shoe is yellow .	the chair was by the bottle on the table by the shoe is yellow .
the car on the floor in the room by the button is blue .	the car was on the floor in the room by the button is blue .
the shirt in the park on the floor in the mall was great .	the shirt is in the park on the floor in the mall was great .
the hat by the cup by the chair on the bed was gray .	the hat is by the cup by the chair on the bed was gray .
the car on the floor in the library by the rocket was boring .	the car is on the floor in the library by the rocket was boring .
the ship by the car in the park in the school is fine .	the ship was by the car in the park in the school is fine .
the window by the candle by the rocket on the floor is white .	the window was by the candle by the rocket on the floor is white .
the chair on the chair by the picture in the bank is cold .	the chair was on the chair by the picture in the bank is cold .
the picture on the street in the bank on the stool is expensive .	the picture was on the street in the bank on the stool is expensive .
the ship by the ring in the school in the bank is yellow .	the ship was by the ring in the school in the bank is yellow .
the book in the library on the stool on the floor was hot .	the book is in the library on the stool on the floor was hot .
the crayon on the floor in the school on the street was small .	the crayon is on the floor in the school on the street was small .
the box on the stool by the doll in the library was fine .	the box is on the stool by the doll in the library was fine .
the picture on the couch on the stool in the bank was boring .	the picture is on the couch on the stool in the bank was boring .
the book in the museum in the school in the school is great .	the book was in the museum in the school in the school is great .
the couch in the kitchen by the book in the school is white .	the couch was in the kitchen by the book in the school is white .
the truck by the rocket in the room in the hospital is important .	the truck was by the rocket in the room in the hospital is important .
the rocket by the cup by the truck by the picture is hot .	the rocket was by the cup by the truck by the picture is hot .
the toy by the cup by the rocket on the ground is yellow .	the toy was by the cup by the rocket on the ground is yellow .
the hat by the ship by the fork by the cup was black .	the hat is by the ship by the fork by the cup was black .
the glass on the street on the couch on the chair is red .	the glass was on the street on the couch on the chair is red .
the toy by the truck in the library by the dish is great .	the toy was by the truck in the library by the dish is great .
the spoon on the couch in the mall by the book was hot .	the spoon is on the couch in the mall by the book was hot .
the cup in the room by the rug in the kitchen was green .	the cup is in the room by the rug in the kitchen was green .
the bicycle in the restaurant in the hospital in the bank is dry .	the bicycle was in the restaurant in the hospital in the bank is dry .
the mirror on the ground by the hat on the table is boring .	the mirror was on the ground by the hat on the table is boring .
the bowl on the chair on the table in the kitchen is fine .	the bowl was on the chair on the table in the kitchen is fine .
the shoe by the plane by the shoe by the ship is broken .	the shoe was by the plane by the shoe by the ship is broken .
the window in the restaurant by the button in the park is awesome .	the window was in the restaurant by the button in the park is awesome .
the crayon by the shoe by the glass by the door is black .	the crayon was by the shoe by the glass by the door is black .
the button by the window in the museum on the chair was cool .	the button is by the window in the museum on the chair was cool .
the mirror by the doll by the truck on the couch is cute .	the mirror was by the doll by the truck on the couch is cute .
the ship in the room on the couch in the restaurant is dry .	the ship was in the room on the couch in the restaurant is dry .
the rug by the dish on the ground on the chair was orange .	the rug is by the dish on the ground on the chair was orange .
the car in the kitchen by the doll on the table was small .	the car is in the kitchen by the doll on the table was small .
the plate by the bicycle by the rocket by the door is expensive .	the plate was by the bicycle by the rocket by the door is expensive .
the box on the street in the restaurant by the car is broken .	the box was on the street in the restaurant by the car is broken .
the plane on the ground on the bed in the hospital is cold .	the plane was on the ground on the bed in the hospital is cold .
the plane by the book by the candle on the street is missing .	the plane was by the book by the candle on the street is missing .
the candle by the truck on the bed by the rug was white .	the candle is by the truck on the bed by the rug was white .
the fork on the floor by the picture by the couch is white .	the fork was on the floor by the picture by the couch is white .
the mirror on the floor on the couch in the museum was big .	the mirror is on the floor on the couch in the museum was big .
the toy in the school on the floor by the bowl is black .	the toy was in the school on the floor by the bowl is black .
the picture on the ground on the couch on the couch was hot .	the picture is on the ground on the couch on the couch was hot .
the plane in the room in the room by the hat was dry .	the plane is in the room in the room by the hat was dry .
the ship by the car in the restaurant by the car is fine .	the ship was by the car in the restaurant by the car is fine .
the bag on the ground on the ground on the couch was gray .	the bag is on the ground on the ground on the couch was gray .
the spoon by the picture on the floor by the spoon was missing .	the spoon is by the picture on the floor by the spoon was missing .
the chair on the floor on the ground by the cup was gray .	the chair is on the floor on the ground by the cup was gray .
the mirror on the bed in the library by the toy is yellow .	the mirror was on the bed in the library by the toy is yellow .
the chair on the stool by the plate on the couch is orange .	the chair was on the stool by the plate on the couch is orange .
the toy in the bank by the toy on the table was whole .	the toy is in the bank by the toy on the table was whole .
the toy by the car in the school in the mall was small .	the toy is by the car in the school in the mall was small .
the window in the school on the stool in the school was white .	the window is in the school on the stool in the school was white .
the toy in the library on the ground in the room is great .	the toy was in the library on the ground in the room is great .
the doll in the bank in the bank on the street was yellow .	the doll is in the bank in the bank on the street was yellow .
the doll in the library on the table by the book is important .	the doll was in the library on the table by the book is important .
the fork by the truck by the bag in the school was gray .	the fork is by the truck by the bag in the school was gray .
the truck on the chair by the plane in the room is awesome .	the truck was on the chair by the plane in the room is awesome .
the crayon on the floor in the mall in the school is blue .	the crayon was on the floor in the mall in the school is blue .
the candle by the window on the stool in the restaurant was missing .	the candle is by the window on the stool in the restaurant was missing .
the bed on the couch by the plate by the ship is white .	the bed was on the couch by the plate by the ship is white .
the car by the candle in the kitchen by the fork is new .	the car was by the candle in the kitchen by the fork is new .
the car in the restaurant on the couch by the picture is red .	the car was in the restaurant on the couch by the picture is red .
the window by the couch in the bank in the library is purple .	the window was by the couch in the bank in the library is purple .
the door by the bag in the kitchen by the chair was purple .	the door is by the bag in the kitchen by the chair was purple .
the book in the bank on the street on the floor is important .	the book was in the bank on the street on the floor is important .
the toy in the library on the street by the glass was orange .	the toy is in the library on the street by the glass was orange .
the door by the bed on the couch in the school was broken .	the door is by the bed on the couch in the school was broken .
the glass in the kitchen by the bag by the boat was blue .	the glass is in the kitchen by the bag by the boat was blue .
the hat in the kitchen in the room on the bed is purple .	the hat was in the kitchen in the room on the bed is purple .
the truck on the chair by the bottle by the dish was amazing .	the truck is on the chair by the bottle by the dish was amazing .
the plate by the window in the museum in the park was fine .	the plate is by the window in the museum in the park was fine .
the window on the chair in the room on the stool was expensive .	the window is on the chair in the room on the stool was expensive .
the glass in the school on the chair in the bank was cute .	the glass is in the school on the chair in the bank was cute .
the box on the ground on the stool in the room was brown .	the box is on the ground on the stool in the room was brown .
the shirt by the plane in the hospital by the door is purple .	the shirt was by the plane in the hospital by the door is purple .
the car on the street by the rocket by the truck is new .	the car was on the street by the rocket by the truck is new .
the bed by the truck in the mall in the room is black .	the bed was by the truck in the mall in the room is black .
the toy on the stool on the bed by the candle was awesome .	the toy is on the stool on the bed by the candle was awesome .
the crayon by the toy on the couch on the couch was cute .	the crayon is by the toy on the couch on the couch was cute .
the ring on the ground in the mall by the car is red .	the ring was on the ground in the mall by the car is red .
the dish on the bed by the bowl in the room was hot .	the dish is on the bed by the bowl in the room was hot .
the book by the bicycle on the floor on the street was blue .	the book is by the bicycle on the floor on the street was blue .
the picture by the spoon in the school on the couch was missing .	the picture is by the spoon in the school on the couch was missing .
the plane on the chair on the floor in the school is whole .	the plane was on the chair on the floor in the school is whole .
the car by the bottle in the bank by the cup is green .	the car was by the bottle in the bank by the cup is green .
the ship on the ground in the park by the shirt is cute .	the ship was on the ground in the park by the shirt is cute .
the shoe by the truck in the bank in the school is brown .	the shoe was by the truck in the bank in the school is brown .
the truck on the table in the museum by the ship was whole .	the truck is on the table in the museum by the ship was whole .
the ship on the bed by the book by the doll is cold .	the ship was on the bed by the book by the doll is cold .
the ship by the plane by the ring on the chair was big .	the ship is by the plane by the ring on the chair was big .
the shirt in the library in the hospital on the couch is great .	the shirt was in the library in the hospital on the couch is great .
the rug on the table on the couch on the ground was cute .	the rug is on the table on the couch on the ground was cute .
the toy in the hospital by the candle by the candle was great .	the toy is in the hospital by the candle by the candle was great .
the bag by the bottle in the bank in the hospital is red .	the bag was by the bottle in the bank in the hospital is red .
the candle on the bed on the stool in the hospital was important .	the candle is on the bed on the stool in the hospital was important .
the bed by the cup in the kitchen by the book was awesome .	the bed is by the cup in the kitchen by the book was awesome .
the book on the ground by the bicycle by the box is great .	the book was on the ground by the bicycle by the box is great .
the car in the mall on the couch on the street was old .	the car is in the mall on the couch on the street was old .
the rocket on the stool on the stool in the library is yellow .	the rocket was on the stool on the stool in the library is yellow .
the shirt in the library on the floor in the kitchen is red .	the shirt was in the library on the floor in the kitchen is red .
the book in the park on the bed on the chair is awesome .	the book was in the park on the bed on the chair is awesome .
the shoe by the dish by the bag by the book was missing .	the shoe is by the dish by the bag by the book was missing .
the hat in the museum on the street in the kitchen is gray .	the hat was in the museum on the street in the kitchen is gray .
the window on the table on the stool by the bowl is green .	the window was on the table on the stool by the bowl is green .
the cup on the chair in the park on the floor is gray .	the cup was on the chair in the park on the floor is gray .
the glass in the library in the park by the book was white .	the glass is in the library in the park by the book was white .
the door by the boat on the bed on the ground is expensive .	the door was by the boat on the bed on the ground is expensive .
the ship by the ship in the museum in the library is dry .	the ship was by the ship in the museum in the library is dry .
the bowl by the bed on the chair on the street was new .	the bowl is by the bed on the chair on the street was new .
the couch on the bed by the crayon by the doll was awesome .	the couch is on the bed by the crayon by the doll was awesome .
the rocket on the table by the car in the room was white .	the rocket is on the table by the car in the room was white .
the picture in the school on the street by the book is missing .	the picture was in the school on the street by the book is missing .
the doll by the candle in the museum on the ground is dry .	the doll was by the candle in the museum on the ground is dry .
the rug on the chair by the bottle on the street is green .	the rug was on the chair by the bottle on the street is green .
the bag in the restaurant by the boat by the book is cute .	the bag was in the restaurant by the boat by the book is cute .
the door on the ground by the window by the bag was purple .	the door is on the ground by the window by the bag was purple .
the dish in the room in the bank in the school is orange .	the dish was in the room in the bank in the school is orange .
the plane by the book on the bed by the shirt was awesome .	the plane is by the book on the bed by the shirt was awesome .
the car by the cup by the couch on the chair is important .	the car was by the cup by the couch on the chair is important .
the fork by the bowl by the shoe in the museum is cold .	the fork was by the bowl by the shoe in the museum is cold .
the bed on the stool by the bowl by the shoe was boring .	the bed is on the stool by the bowl by the shoe was boring .
the glass by the car on the bed in the museum was new .	the glass is by the car on the bed in the museum was new .
the chair in the restaurant by the crayon by the car is cold .	the chair was in the restaurant by the crayon by the car is cold .
the car by the bicycle by the spoon by the crayon is cold .	the car was by the bicycle by the spoon by the crayon is cold .
the rocket by the truck on the chair in the library was dry .	the rocket is by the truck on the chair in the library was dry .
the truck by the glass in the kitchen on the ground was big .	the truck is by the glass in the kitchen on the ground was big .
the plane by the rocket on the table by the fork is new .	the plane was by the rocket on the table by the fork is new .
the spoon by the toy on the chair on the stool was gray .	the spoon is by the toy on the chair on the stool was gray .
the rug on the bed by the shoe by the box was yellow .	the rug is on the bed by the shoe by the box was yellow .
the plate on the chair on the chair on the stool was blue .	the plate is on the chair on the chair on the stool was blue .
the spoon by the car by the book on the table was purple .	the spoon is by the car by the book on the table was purple .
the rocket on the couch on the chair in the library is amazing .	the rocket was on the couch on the chair in the library is amazing .
the bowl by the car by the toy by the book is cool .	the bowl was by the car by the toy by the book is cool .
the book on the ground by the car by the truck was cold .	the book is on the ground by the car by the truck was cold .
the glass on the couch in the kitchen by the bag was hot .	the glass is on the couch in the kitchen by the bag was hot .
the bicycle by the book in the bank by the cup was gray .	the bicycle is by the book in the bank by the cup was gray .
the dish by the fork on the floor in the restaurant is orange .	the dish was by the fork on the floor in the restaurant is orange .
the bed in the restaurant by the truck on the stool is blue .	the bed was in the restaurant by the truck on the stool is blue .
the boat by the bowl on the couch on the couch is orange .	the boat was by the bowl on the couch on the couch is orange .
the candle on the couch on the floor by the bed was broken .	the candle is on the couch on the floor by the bed was broken .
the fork in the mall on the street by the bottle was amazing .	the fork is in the mall on the street by the bottle was amazing .
the car in the room by the rocket by the truck is cool .	the car was in the room by the rocket by the truck is cool .
the book on the ground on the ground in the kitchen was brown .	the book is on the ground on the ground in the kitchen was brown .
the bed by the bag on the bed in the park was white .	the bed is by the bag on the bed in the park was white .
the button by the shirt on the floor by the truck is great .	the button was by the shirt on the floor by the truck is great .
the car in the park by the spoon by the dish is new .	the car was in the park by the spoon by the dish is new .
the bicycle by the ship by the couch on the couch was black .	the bicycle is by the ship by the couch on the couch was black .
the bed on the street on the table on the table is old .	the bed was on the street on the table on the table is old .
the bottle on the chair by the bottle by the spoon is expensive .	the bottle was on the chair by the bottle by the spoon is expensive .
the book by the ship by the fork by the crayon is great .	the book was by the ship by the fork by the crayon is great .
the plane by the shoe by the box on the chair was important .	the plane is by the shoe by the box on the chair was important .
the spoon in the restaurant on the chair in the mall was blue .	the spoon is in the restaurant on the chair in the mall was blue .
the doll by the shoe on the ground by the box was expensive .	the doll is by the shoe on the ground by the box was expensive .
the plane in the kitchen by the glass on the chair is expensive .	the plane was in the kitchen by the glass on the chair is expensive .
the bowl in the kitchen in the park in the school was great .	the bowl is in the kitchen in the park in the school was great .
the picture in the museum in the school in the room was blue .	the picture is in the museum in the school in the room was blue .
the plane in the school by the window by the window was green .	the plane is in the school by the window by the window was green .
the door on the table on the couch on the stool is awesome .	the door was on the table on the couch on the stool is awesome .
the ring on the chair in the school on the couch was big .	the ring is on the chair in the school on the couch was big .
the box by the crayon in the mall on the couch was boring .	the box is by the crayon in the mall on the couch was boring .
the hat on the chair by the glass in the room was awesome .	the hat is on the chair by the glass in the room was awesome .
the door in the school in the park in the park was old .	the door is in the school in the park in the park was old .
the hat by the fork by the truck on the couch was white .	the hat is by the fork by the truck on the couch was white .
the dish in the mall by the ship on the street is black .	the dish was in the mall by the ship on the street is black .
the dish by the car by the box by the car was cute .	the dish is by the car by the box by the car was cute .
the bowl by the chair in the restaurant on the floor was small .	the bowl is by the chair in the restaurant on the floor was small .
the boat on the bed on the chair in the school is white .	the boat was on the bed on the chair in the school is white .
the crayon by the dish in the hospital in the bank was boring .	the crayon is by the dish in the hospital in the bank was boring .
the picture by the bed in the kitchen in the mall was white .	the picture is by the bed in the kitchen in the mall was white .
the couch on the table on the chair on the street is gray .	the couch was on the table on the chair on the street is gray .
the couch by the dish by the ship by the bowl is big .	the couch was by the dish by the ship by the bowl is big .
the truck by the dish on the stool on the stool is boring .	the truck was by the dish on the stool on the stool is boring .
the rocket by the hat on the bed on the ground was gray .	the rocket is by the hat on the bed on the ground was gray .
the spoon by the door by the plane on the floor was brown .	the spoon is by the door by the plane on the floor was brown .
the rug on the stool on the floor in the restaurant is missing .	the rug was on the stool on the floor in the restaurant is missing .
the crayon on the stool in the hospital on the ground was great .	the crayon is on the stool in the hospital on the ground was great .
the chair in the school by the bag by the bag was amazing .	the chair is in the school by the bag by the bag was amazing .
the window by the ring by the box on the stool is green .	the window was by the ring by the box on the stool is green .
the chair in the mall in the school in the school was brown .	the chair is in the mall in the school in the school was brown .
the rocket by the picture in the mall on the stool was hot .	the rocket is by the picture in the mall on the stool was hot .
the glass by the hat on the stool in the kitchen is yellow .	the glass was by the hat on the stool in the kitchen is yellow .
the bicycle by the glass by the ring in the museum is black .	the bicycle was by the glass by the ring in the museum is black .
the picture on the floor in the kitchen by the plane is broken .	the picture was on the floor in the kitchen by the plane is broken .
the doll on the street on the ground in the mall is yellow .	the doll was on the street on the ground in the mall is yellow .
the plane in the mall by the door in the school was yellow .	the plane is in the mall by the door in the school was yellow .
the shirt on the table in the restaurant by the mirror is red .	the shirt was on the table in the restaurant by the mirror is red .
the bottle in the school by the car by the boat is cool .	the bottle was in the school by the car by the boat is cool .
the picture by the toy on the chair on the stool is important .	the picture was by the toy on the chair on the stool is important .
the plane on the couch by the dish in the hospital was boring .	the plane is on the couch by the dish in the hospital was boring .
the boat on the ground in the kitchen in the mall was white .	the boat is on the ground in the kitchen in the mall was white .
the book on the table by the rug in the museum is cool .	the book was on the table by the rug in the museum is cool .
the cup on the floor on the stool by the book is hot .	the cup was on the floor on the stool by the book is hot .
the chair on the street on the chair by the crayon is whole .	the chair was on the street on the chair by the crayon is whole .
the button by the mirror by the picture on the floor was orange .	the button is by the mirror by the picture on the floor was orange .
the shirt by the bag by the glass on the bed is cool .	the shirt was by the bag by the glass on the bed is cool .
the mirror in the museum on the couch by the hat was fine .	the mirror is in the museum on the couch by the hat was fine .
the cup in the school on the bed on the street was broken .	the cup is in the school on the bed on the street was broken .
the bed by the truck by the plate by the truck was cool .	the bed is by the truck by the plate by the truck was cool .
the crayon by the bicycle on the stool on the chair was gray .	the crayon is by the bicycle on the stool on the chair was gray .
the picture on the floor on the floor in the mall is hot .	the picture was on the floor on the floor in the mall is hot .
the button on the bed by the glass by the hat was great .	the button is on the bed by the glass by the hat was great .
the plate by the fork in the school on the stool was small .	the plate is by the fork in the school on the stool was small .
the fork in the bank on the bed in the kitchen is big .	the fork was in the bank on the bed in the kitchen is big .
the picture on the floor in the school by the bag was white .	the picture is on the floor in the school by the bag was white .
the ship by the bicycle in the park in the museum was boring .	the ship is by the bicycle in the park in the museum was boring .
the car by the window by the plate in the room was cold .	the car is by the window by the plate in the room was cold .
the candle in the restaurant by the door on the bed was black .	the candle is in the restaurant by the door on the bed was black .
the mirror on the street on the stool by the book is small .	the mirror was on the street on the stool by the book is small .
the bicycle on the couch on the bed in the school was new .	the bicycle is on the couch on the bed in the school was new .
the bag in the room in the kitchen in the museum is awesome .	the bag was in the room in the kitchen in the museum is awesome .
the picture in the mall in the kitchen in the school is great .	the picture was in the mall in the kitchen in the school is great .
the candle by the cup in the kitchen in the mall was cool .	the candle is by the cup in the kitchen in the mall was cool .
the bicycle on the chair in the room by the bicycle is orange .	the bicycle was on the chair in the room by the bicycle is orange .
the bicycle by the shirt on the couch by the truck is awesome .	the bicycle was by the shirt on the couch by the truck is awesome .
the bicycle on the stool in the kitchen in the room was old .	the bicycle is on the stool in the kitchen in the room was old .
the book by the button on the bed on the street is broken .	the book was by the button on the bed on the street is broken .
the rocket on the table by the toy by the shoe is dry .	the rocket was on the table by the toy by the shoe is dry .
the bottle in the library in the library in the library is cold .	the bottle was in the library in the library in the library is cold .
the ship on the ground in the park on the bed is important .	the ship was on the ground in the park on the bed is important .
the glass by the button on the street by the truck is whole .	the glass was by the button on the street by the truck is whole .
the candle by the shoe on the chair on the bed is white .	the candle was by the shoe on the chair on the bed is white .
the bicycle on the street on the floor on the chair was expensive .	the bicycle is on the street on the floor on the chair was expensive .
the picture in the room in the restaurant by the chair was white .	the picture is in the room in the restaurant by the chair was white .
the crayon by the spoon by the mirror on the floor is new .	the crayon was by the spoon by the mirror on the floor is new .
the spoon by the book by the ship by the toy is white .	the spoon was by the book by the ship by the toy is white .
the box on the ground on the stool by the dish was broken .	the box is on the ground on the stool by the dish was broken .
the spoon by the cup by the ship on the couch is green .	the spoon was by the cup by the ship on the couch is green .
the plane on the bed on the bed by the box is big .	the plane was on the bed on the bed by the box is big .
the car on the bed in the kitchen on the ground is important .	the car was on the bed in the kitchen on the ground is important .
the couch on the ground in the kitchen in the room is new .	the couch was on the ground in the kitchen in the room is new .
the picture by the bowl on the couch in the school was boring .	the picture is by the bowl on the couch in the school was boring .
the bag by the bicycle by the rocket in the bank was expensive .	the bag is by the bicycle by the rocket in the bank was expensive .
the ring on the stool on the street by the button was missing .	the ring is on the stool on the street by the button was missing .
the cup by the truck on the street on the ground was cold .	the cup is by the truck on the street on the ground was cold .
the box on the table in the school by the fork was hot .	the box is on the table in the school by the fork was hot .
the bed in the bank on the bed in the school is orange .	the bed was in the bank on the bed in the school is orange .
the bowl in the library on the street on the chair was new .	the bowl is in the library on the street on the chair was new .
the rocket by the book by the boat on the ground was cold .	the rocket is by the book by the boat on the ground was cold .
the candle on the floor on the floor on the bed is expensive .	the candle was on the floor on the floor on the bed is expensive .
the truck by the glass on the table on the chair is green .	the truck was by the glass on the table on the chair is green .
the plate on the bed in the school on the stool is yellow .	the plate was on the bed in the school on the stool is yellow .
the hat on the chair by the candle on the ground was awesome .	the hat is on the chair by the candle on the ground was awesome .
the glass by the mirror in the room on the bed is black .	the glass was by the mirror in the room on the bed is black .
the rug on the bed on the stool in the hospital was fine .	the rug is on the bed on the stool in the hospital was fine .
the truck in the restaurant on the floor by the plane was orange .	the truck is in the restaurant on the floor by the plane was orange .
the car on the stool in the mall by the boat is great .	the car was on the stool in the mall by the boat is great .
the window by the bag on the couch by the shoe was cool .	the window is by the bag on the couch by the shoe was cool .
the bag by the rug on the chair by the car was gray .	the bag is by the rug on the chair by the car was gray .
the bag by the bed on the bed by the couch is big .	the bag was by the bed on the bed by the couch is big .
the toy on the chair in the hospital by the hat was brown .	the toy is on the chair in the hospital by the hat was brown .
the car on the chair in the bank by the rocket was important .	the car is on the chair in the bank by the rocket was important .
the doll by the ship in the restaurant in the park is dry .	the doll was by the ship in the restaurant in the park is dry .
the couch in the library on the ground on the floor is broken .	the couch was in the library on the ground on the floor is broken .
the bowl by the bowl by the car in the bank is purple .	the bowl was by the bowl by the car in the bank is purple .
the rug by the rocket in the hospital in the restaurant was dry .	the rug is by the rocket in the hospital in the restaurant was dry .
the book by the ship by the plane in the kitchen is small .	the book was by the ship by the plane in the kitchen is small .
the hat in the library on the chair in the library was cute .	the hat is in the library on the chair in the library was cute .
the spoon on the couch by the box on the floor was yellow .	the spoon is on the couch by the box on the floor was yellow .
the door in the library on the chair in the room is dry .	the door was in the library on the chair in the room is dry .
the plate by the car on the street in the restaurant was cute .	the plate is by the car on the street in the restaurant was cute .
the bottle in the library by the cup on the table is old .	the bottle was in the library by the cup on the table is old .
the picture in the hospital by the rocket by the shirt was missing .	the picture is in the hospital by the rocket by the shirt was missing .
the car on the ground by the plate by the bottle is yellow .	the car was on the ground by the plate by the bottle is yellow .
the candle in the park on the bed on the couch was new .	the candle is in the park on the bed on the couch was new .
the picture in the room by the car in the museum is yellow .	the picture was in the room by the car in the museum is yellow .
the glass by the shirt in the room on the bed was amazing .	the glass is by the shirt in the room on the bed was amazing .
the truck by the bottle on the ground in the restaurant is missing .	the truck was by the bottle on the ground in the restaurant is missing .
the ship on the table in the school in the room was fine .	the ship is on the table in the school in the room was fine .
the spoon in the bank by the shirt in the room was cute .	the spoon is in the bank by the shirt in the room was cute .
the shirt by the ship on the couch on the table is blue .	the shirt was by the ship on the couch on the table is blue .
the boat on the bed by the window on the ground was whole .	the boat is on the bed by the window on the ground was whole .
the picture in the school on the bed by the shoe is important .	the picture was in the school on the bed by the shoe is important .
the crayon in the school in the school in the park is dry .	the crayon was in the school in the school in the park is dry .
the spoon on the couch in the school by the button was brown .	the spoon is on the couch in the school by the button was brown .
the cup by the bowl on the floor on the bed is old .	the cup was by the bowl on the floor on the bed is old .
the candle on the street in the kitchen on the bed was boring .	the candle is on the street in the kitchen on the bed was boring .
the mirror by the shoe in the mall in the mall was cute .	the mirror is by the shoe in the mall in the mall was cute .
the bag in the school by the candle by the book is cold .	the bag was in the school by the candle by the book is cold .
the toy by the mirror by the mirror on the table is new .	the toy was by the mirror by the mirror on the table is new .
the plate in the bank by the bottle by the boat was broken .	the plate is in the bank by the bottle by the boat was broken .
the rug by the plane on the bed by the plane was expensive .	the rug is by the plane on the bed by the plane was expensive .
the book on the chair on the couch by the bottle was cool .	the book is on the chair on the couch by the bottle was cool .
the plane by the window on the couch in the bank is small .	the plane was by the window on the couch in the bank is small .
the ring in the mall in the school by the couch was red .	the ring is in the mall in the school by the couch was red .
the crayon in the park on the stool by the mirror is new .	the crayon was in the park on the stool by the mirror is new .
the bottle on the street in the kitchen by the toy was green .	the bottle is on the street in the kitchen by the toy was green .
the bed in the mall on the street on the couch is fine .	the bed was in the mall on the street on the couch is fine .
the doll in the park by the picture on the ground is red .	the doll was in the park by the picture on the ground is red .
the spoon in the room on the bed on the street was whole .	the spoon is in the room on the bed on the street was whole .
the box by the bag by the bag by the plate is boring .	the box was by the bag by the bag by the plate is boring .
the rocket in the school on the ground in the hospital was amazing .	the rocket is in the school on the ground in the hospital was amazing .
the dish on the couch on the floor in the mall was cold .	the dish is on the couch on the floor in the mall was cold .
the boat on the ground in the bank on the couch was important .	the boat is on the ground in the bank on the couch was important .
the book by the bag in the hospital by the plane was fine .	the book is by the bag in the hospital by the plane was fine .
the ring by the crayon on the bed on the ground is boring .	the ring was by the crayon on the bed on the ground is boring .
the chair on the ground in the museum in the hospital is expensive .	the chair was on the ground in the museum in the hospital is expensive .
the candle on the stool in the kitchen on the floor was red .	the candle is on the stool in the kitchen on the floor was red .
the candle in the bank in the mall on the ground is old .	the candle was in the bank in the mall on the ground is old .
the rug by the book by the book on the bed is important .	the rug was by the book by the book on the bed is important .
the door on the chair by the ring by the candle is broken .	the door was on the chair by the ring by the candle is broken .
the door on the couch by the ring by the shirt was cool .	the door is on the couch by the ring by the shirt was cool .
the bed on the ground in the library by the mirror is big .	the bed was on the ground in the library by the mirror is big .
the couch by the rocket in the school by the fork is small .	the couch was by the rocket in the school by the fork is small .
the rug by the boat in the restaurant by the car was gray .	the rug is by the boat in the restaurant by the car was gray .
the mirror in the park by the crayon by the shirt is green .	the mirror was in the park by the crayon by the shirt is green .
the button on the chair in the bank by the car is fine .	the button was on the chair in the bank by the car is fine .
the bed on the street on the chair by the boat is black .	the bed was on the street on the chair by the boat is black .
the window on the stool in the bank by the shirt was yellow .	the window is on the stool in the bank by the shirt was yellow .
the box in the kitchen in the park by the plane was important .	the box is in the kitchen in the park by the plane was important .
the box on the floor on the street on the street is new .	the box was on the floor on the street on the street is new .
the shoe in the park in the mall by the car is broken .	the shoe was in the park in the mall by the car is broken .
the hat on the bed by the boat on the street was important .	the hat is on the bed by the boat on the street was important .
the window by the bicycle on the table in the hospital was whole .	the window is by the bicycle on the table in the hospital was whole .
the ring on the floor in the room in the museum was white .	the ring is on the floor in the room in the museum was white .
the crayon by the door by the spoon by the bottle was red .	the crayon is by the door by the spoon by the bottle was red .
the spoon in the bank in the kitchen by the boat was orange .	the spoon is in the bank in the kitchen by the boat was orange .
the plane in the kitchen by the doll by the rocket is boring .	the plane was in the kitchen by the doll by the rocket is boring .
the toy by the fork on the floor on the stool is old .	the toy was by the fork on the floor on the stool is old .
the rug by the crayon by the shoe by the cup is red .	the rug was by the crayon by the shoe by the cup is red .
the bottle in the restaurant on the table in the museum was broken .	the bottle is in the restaurant on the table in the museum was broken .
the cup in the kitchen by the rocket in the museum is great .	the cup was in the kitchen by the rocket in the museum is great .
the ship on the ground on the table by the truck was yellow .	the ship is on the ground on the table by the truck was yellow .
the plate on the couch on the table in the hospital was big .	the plate is on the couch on the table in the hospital was big .
the spoon by the bottle by the ring in the library was awesome .	the spoon is by the bottle by the ring in the library was awesome .
the door in the hospital on the couch by the candle was brown .	the door is in the hospital on the couch by the candle was brown .
the shirt by the button by the shirt by the ship is important .	the shirt was by the button by the shirt by the ship is important .
the chair on the table on the chair in the hospital was boring .	the chair is on the table on the chair in the hospital was boring .
the ship by the window in the museum on the floor was yellow .	the ship is by the window in the museum on the floor was yellow .
the hat by the fork on the floor in the park was brown .	the hat is by the fork on the floor in the park was brown .
the bag by the picture on the table in the bank is purple .	the bag was by the picture on the table in the bank is purple .
the plane in the library by the dish in the mall was red .	the plane is in the library by the dish in the mall was red .
the bag by the plate on the table by the fork was fine .	the bag is by the plate on the table by the fork was fine .
the shoe in the hospital by the couch by the rug was broken .	the shoe is in the hospital by the couch by the rug was broken .
the bottle on the street by the picture by the cup was red .	the bottle is on the street by the picture by the cup was red .
the hat in the hospital by the book by the picture was great .	the hat is in the hospital by the book by the picture was great .
the bowl in the school on the bed by the chair was broken .	the bowl is in the school on the bed by the chair was broken .
the truck by the boat by the hat in the kitchen is red .	the truck was by the boat by the hat in the kitchen is red .
the window by the door by the car on the table was awesome .	the window is by the door by the car on the table was awesome .
the toy on the floor by the plane by the bottle was cold .	the toy is on the floor by the plane by the bottle was cold .
the window by the car in the park by the picture was big .	the window is by the car in the park by the picture was big .
the glass by the candle by the fork in the room is blue .	the glass was by the candle by the fork in the room is blue .
the ring on the stool by the shoe by the boat was purple .	the ring is on the stool by the shoe by the boat was purple .
the rocket by the boat by the glass in the hospital was cool .	the rocket is by the boat by the glass in the hospital was cool .
the chair in the school by the plane in the park was orange .	the chair is in the school by the plane in the park was orange .
the dish in the kitchen in the bank on the floor is brown .	the dish was in the kitchen in the bank on the floor is brown .
the door by the bottle on the chair by the dish is important .	the door was by the bottle on the chair by the dish is important .
the bed by the picture by the car by the glass was new .	the bed is by the picture by the car by the glass was new .
the shoe on the bed in the bank on the stool was missing .	the shoe is on the bed in the bank on the stool was missing .
the crayon in the hospital on the floor in the kitchen is cold .	the crayon was in the hospital on the floor in the kitchen is cold .
the shoe on the chair on the couch in the mall was cool .	the shoe is on the chair on the couch in the mall was cool .
the shoe on the street by the candle on the floor was dry .	the shoe is on the street by the candle on the floor was dry .
the book by the mirror by the hat on the street was fine .	the book is by the mirror by the hat on the street was fine .
the ship by the boat on the ground in the hospital was expensive .	the ship is by the boat on the ground in the hospital was expensive .
the boat in the restaurant by the spoon in the school is blue .	the boat was in the restaurant by the spoon in the school is blue .
the toy on the chair by the bicycle in the mall is cool .	the toy was on the chair by the bicycle in the mall is cool .
the window in the bank on the table on the chair is dry .	the window was in the bank on the table on the chair is dry .
the book in the room on the ground in the hospital was fine .	the book is in the room on the ground in the hospital was fine .
the bicycle on the chair by the rug in the school is green .	the bicycle was on the chair by the rug in the school is green .
the bicycle on the table by the button on the couch is cold .	the bicycle was on the table by the button on the couch is cold .
the door on the bed on the couch by the plate was cute .	the door is on the bed on the couch by the plate was cute .
the ship by the picture on the stool by the bicycle is brown .	the ship was by the picture on the stool by the bicycle is brown .
the rug on the street in the restaurant on the floor is purple .	the rug was on the street in the restaurant on the floor is purple .
the bed on the bed in the library by the candle was cute .	the bed is on the bed in the library by the candle was cute .
the couch in the kitchen in the bank by the doll was hot .	the couch is in the kitchen in the bank by the doll was hot .
the chair on the ground in the room on the chair is expensive .	the chair was on the ground in the room on the chair is expensive .
the ring by the dish on the street on the table is green .	the ring was by the dish on the street on the table is green .
the chair by the bicycle in the kitchen on the chair was big .	the chair is by the bicycle in the kitchen on the chair was big .
the ring in the park on the chair on the street was cold .	the ring is in the park on the chair on the street was cold .
the doll in the restaurant on the stool on the ground was hot .	the doll is in the restaurant on the stool on the ground was hot .
the picture by the boat on the stool by the cup was amazing .	the picture is by the boat on the stool by the cup was amazing .
the candle in the restaurant by the chair by the plate is awesome .	the candle was in the restaurant by the chair by the plate is awesome .
the chair by the couch in the park on the stool is hot .	the chair was by the couch in the park on the stool is hot .
the plane on the chair in the restaurant on the floor was hot .	the plane is on the chair in the restaurant on the floor was hot .
the door by the fork on the bed on the couch is orange .	the door was by the fork on the bed on the couch is orange .
the ship by the picture by the chair by the book was amazing .	the ship is by the picture by the chair by the book was amazing .
the fork in the museum in the kitchen by the button was broken .	the fork is in the museum in the kitchen by the button was broken .
the doll on the street on the street on the table is whole .	the doll was on the street on the street on the table is whole .
the rocket in the park in the park by the chair was blue .	the rocket is in the park in the park by the chair was blue .
the crayon on the ground by the box on the ground was gray .	the crayon is on the ground by the box on the ground was gray .
the shirt in the school in the restaurant on the floor is green .	the shirt was in the school in the restaurant on the floor is green .
the mirror by the chair by the picture by the bed was great .	the mirror is by the chair by the picture by the bed was great .
the window in the library on the table by the hat is big .	the window was in the library on the table by the hat is big .
the bed in the library in the park on the stool is cute .	the bed was in the library in the park on the stool is cute .
the boat by the glass in the school in the bank is hot .	the boat was by the glass in the school in the bank is hot .
the bowl on the bed on the floor by the couch is white .	the bowl was on the bed on the floor by the couch is white .
the toy by the glass in the hospital in the bank was expensive .	the toy is by the glass in the hospital in the bank was expensive .
the car by the plane in the school by the shoe was purple .	the car is by the plane in the school by the shoe was purple .
the ring in the library on the street in the kitchen was blue .	the ring is in the library on the street in the kitchen was blue .
the book in the hospital in the restaurant by the toy is hot .	the book was in the hospital in the restaurant by the toy is hot .
the picture in the school in the hospital in the kitchen is cold .	the picture was in the school in the hospital in the kitchen is cold .
the window on the bed by the bowl in the room is purple .	the window was on the bed by the bowl in the room is purple .
the hat on the table in the library by the couch was amazing .	the hat is on the table in the library by the couch was amazing .
the button in the mall by the dish by the ring is awesome .	the button was in the mall by the dish by the ring is awesome .
the truck in the park by the shoe in the mall is gray .	the truck was in the park by the shoe in the mall is gray .
the chair on the stool in the museum on the bed was white .	the chair is on the stool in the museum on the bed was white .
the truck on the ground in the museum by the truck was white .	the truck is on the ground in the museum by the truck was white .
the bicycle on the chair in the room by the shirt is purple .	the bicycle was on the chair in the room by the shirt is purple .
the ship by the couch by the boat on the stool was orange .	the ship is by the couch by the boat on the stool was orange .
the glass in the school by the ring in the restaurant was dry .	the glass is in the school by the ring in the restaurant was dry .
the book by the chair in the bank on the chair was small .	the book is by the chair in the bank on the chair was small .
the shirt on the table on the table on the couch is cute .	the shirt was on the table on the table on the couch is cute .
the fork in the bank in the park by the rocket was cold .	the fork is in the bank in the park by the rocket was cold .
the mirror on the street by the chair in the mall is big .	the mirror was on the street by the chair in the mall is big .
the window on the stool on the chair in the museum was small .	the window is on the stool on the chair in the museum was small .
the mirror on the chair in the museum in the school is old .	the mirror was on the chair in the museum in the school is old .
the chair by the fork on the stool on the street is whole .	the chair was by the fork on the stool on the street is whole .
the book by the plate by the bottle on the floor was expensive .	the book is by the plate by the bottle on the floor was expensive .
the bicycle on the table on the floor on the ground was great .	the bicycle is on the table on the floor on the ground was great .
the ship in the restaurant in the kitchen by the book is white .	the ship was in the restaurant in the kitchen by the book is white .
the shoe in the kitchen on the chair by the boat was big .	the shoe is in the kitchen on the chair by the boat was big .
the glass by the book in the kitchen by the hat was cold .	the glass is by the book in the kitchen by the hat was cold .
the mirror in the mall on the bed in the school is broken .	the mirror was in the mall on the bed in the school is broken .
the candle in the bank on the floor in the museum is green .	the candle was in the bank on the floor in the museum is green .
the crayon in the mall by the truck on the floor is fine .	the crayon was in the mall by the truck on the floor is fine .
the shoe in the school by the mirror on the table is yellow .	the shoe was in the school by the mirror on the table is yellow .
the bowl on the couch by the book on the ground was big .	the bowl is on the couch by the book on the ground was big .
the plane by the truck in the kitchen in the room is amazing .	the plane was by the truck in the kitchen in the room is amazing .
the bottle on the table in the mall by the ring is small .	the bottle was on the table in the mall by the ring is small .
the cup on the bed in the mall by the boat is whole .	the cup was on the bed in the mall by the boat is whole .
the book on the floor on the ground on the floor was orange .	the book is on the floor on the ground on the floor was orange .
the book in the mall on the couch in the school is expensive .	the book was in the mall on the couch in the school is expensive .
the bowl by the dish in the bank in the bank was old .	the bowl is by the dish in the bank in the bank was old .
the dish in the hospital in the school on the table was black .	the dish is in the hospital in the school on the table was black .
the book by the cup on the bed on the chair is great .	the book was by the cup on the bed on the chair is great .
the book by the bed on the street in the library is small .	the book was by the bed on the street in the library is small .
the chair in the restaurant on the floor in the school was big .	the chair is in the restaurant on the floor in the school was big .
the glass by the hat on the table by the dish was fine .	the glass is by the hat on the table by the dish was fine .
the doll on the table on the floor on the couch is old .	the doll was on the table on the floor on the couch is old .
the crayon by the crayon on the bed on the street is new .	the crayon was by the crayon on the bed on the street is new .
the rug on the floor on the street by the dish was broken .	the rug is on the floor on the street by the dish was broken .
the door on the couch in the museum by the crayon is hot .	the door was on the couch in the museum by the crayon is hot .
the fork by the plate in the kitchen in the hospital was missing .	the fork is by the plate in the kitchen in the hospital was missing .
the chair by the bottle in the bank by the ship is cute .	the chair was by the bottle in the bank by the ship is cute .
the button by the shirt on the floor on the street is old .	the button was by the shirt on the floor on the street is old .
the shirt on the bed on the street by the couch was white .	the shirt is on the bed on the street by the couch was white .
the plane by the cup in the mall by the cup is big .	the plane was by the cup in the mall by the cup is big .
the book in the hospital in the school on the couch was old .	the book is in the hospital in the school on the couch was old .
the shirt on the table on the ground by the toy is white .	the shirt was on the table on the ground by the toy is white .
the boat on the table by the shoe on the chair was amazing .	the boat is on the table by the shoe on the chair was amazing .
the rocket in the library by the bottle in the school was brown .	the rocket is in the library by the bottle in the school was brown .
the fork on the floor on the chair on the couch was fine .	the fork is on the floor on the chair on the couch was fine .
the window on the table in the school by the fork is great .	the window was on the table in the school by the fork is great .
the window by the plate in the room on the bed is white .	the window was by the plate in the room on the bed is white .
the bottle by the button by the book in the mall is red .	the bottle was by the button by the book in the mall is red .
the crayon in the bank by the shoe by the glass is cold .	the crayon was in the bank by the shoe by the glass is cold .
the mirror in the restaurant on the chair by the crayon was old .	the mirror is in the restaurant on the chair by the crayon was old .
the fork by the ship by the toy by the picture is green .	the fork was by the ship by the toy by the picture is green .
the hat by the car by the car on the ground is expensive .	the hat was by the car by the car on the ground is expensive .
the bowl by the candle by the truck by the book was new .	the bowl is by the candle by the truck by the book was new .
the box in the bank in the kitchen in the park was boring .	the box is in the bank in the kitchen in the park was boring .
the fork in the park by the truck by the spoon is blue .	the fork was in the park by the truck by the spoon is blue .
the glass on the ground on the table by the door was green .	the glass is on the ground on the table by the door was green .
the glass on the ground on the bed on the floor was white .	the glass is on the ground on the bed on the floor was white .
the doll in the restaurant on the chair on the stool is great .	the doll was in the restaurant on the chair on the stool is great .
the bag on the chair by the cup by the door is cold .	the bag was on the chair by the cup by the door is cold .
the ring on the chair in the park on the bed was gray .	the ring is on the chair in the park on the bed was gray .
the shoe by the box in the bank on the couch was awesome .	the shoe is by the box in the bank on the couch was awesome .
the button by the glass by the spoon by the book is small .	the button was by the glass by the spoon by the book is small .
the boat by the rocket on the table on the couch is missing .	the boat was by the rocket on the table on the couch is missing .
the shoe in the park in the school in the school is old .	the shoe was in the park in the school in the school is old .
the shoe in the mall by the rocket in the kitchen was fine .	the shoe is in the mall by the rocket in the kitchen was fine .
the rug in the hospital on the couch on the floor is old .	the rug was in the hospital on the couch on the floor is old .
the dish on the couch on the street in the museum is dry .	the dish was on the couch on the street in the museum is dry .
the door on the table in the school in the park is orange .	the door was on the table in the school in the park is orange .
the shirt on the couch by the plate in the school was gray .	the shirt is on the couch by the plate in the school was gray .
the cup in the room on the chair in the school is cold .	the cup was in the room on the chair in the school is cold .
the couch by the picture on the couch on the couch is whole .	the couch was by the picture on the couch on the couch is whole .
the bowl on the stool by the plane by the bed was orange .	the bowl is on the stool by the plane by the bed was orange .
the bottle in the library in the kitchen on the chair was blue .	the bottle is in the library in the kitchen on the chair was blue .
the window on the table by the picture on the bed is amazing .	the window was on the table by the picture on the bed is amazing .
the chair by the chair by the door in the kitchen is boring .	the chair was by the chair by the door in the kitchen is boring .
the bottle in the room in the mall on the street is dry .	the bottle was in the room in the mall on the street is dry .
the bottle by the toy on the street in the school was fine .	the bottle is by the toy on the street in the school was fine .
the ring by the glass by the car in the library is blue .	the ring was by the glass by the car in the library is blue .
the window in the restaurant on the couch on the chair was hot .	the window is in the restaurant on the couch on the chair was hot .
the dish by the plane by the book in the room is fine .	the dish was by the plane by the book in the room is fine .
the rug in the mall in the room in the hospital is fine .	the rug was in the mall in the room in the hospital is fine .
the picture in the hospital on the street on the table is brown .	the picture was in the hospital on the street on the table is brown .
the window by the doll on the table on the floor was cute .	the window is by the doll on the table on the floor was cute .
the door on the ground in the school on the floor was small .	the door is on the ground in the school on the floor was small .
the bottle by the glass on the street on the bed was gray .	the bottle is by the glass on the street on the bed was gray .
the picture on the couch on the couch by the chair is missing .	the picture was on the couch on the couch by the chair is missing .
the shirt in the restaurant in the hospital by the chair was missing .	the shirt is in the restaurant in the hospital by the chair was missing .
the spoon by the glass in the kitchen in the hospital was cool .	the spoon is by the glass in the kitchen in the hospital was cool .
the shoe by the crayon on the stool on the street is purple .	the shoe was by the crayon on the stool on the street is purple .
the dish by the bed by the fork by the car was great .	the dish is by the bed by the fork by the car was great .
the bed on the bed by the book by the door was new .	the bed is on the bed by the book by the door was new .
the cup in the park on the couch by the bed is hot .	the cup was in the park on the couch by the bed is hot .
the door in the school by the hat on the stool was fine .	the door is in the school by the hat on the stool was fine .
the spoon in the bank in the library in the school is hot .	the spoon was in the bank in the library in the school is hot .
the window on the couch by the glass in the museum was amazing .	the window is on the couch by the glass in the museum was amazing .
the bicycle in the park on the bed in the mall was fine .	the bicycle is in the park on the bed in the mall was fine .
the car on the chair in the room on the stool is important .	the car was on the chair in the room on the stool is important .
the couch in the library by the ring on the street was boring .	the couch is in the library by the ring on the street was boring .
the glass on the floor by the mirror on the table is blue .	the glass was on the floor by the mirror on the table is blue .
the cup in the kitchen on the table by the car is green .	the cup was in the kitchen on the table by the car is green .
the window by the crayon in the restaurant in the museum is cool .	the window was by the crayon in the restaurant in the museum is cool .
the bicycle by the book on the chair on the bed was whole .	the bicycle is by the book on the chair on the bed was whole .
the toy on the couch by the button on the floor is broken .	the toy was on the couch by the button on the floor is broken .
the boat by the doll by the glass in the library was purple .	the boat is by the doll by the glass in the library was purple .
the crayon in the museum on the street by the shoe is brown .	the crayon was in the museum on the street by the shoe is brown .
the couch by the hat in the museum on the couch was red .	the couch is by the hat in the museum on the couch was red .
the doll on the ground on the couch in the room is big .	the doll was on the ground on the couch in the room is big .
the spoon in the bank on the bed in the school was big .	the spoon is in the bank on the bed in the school was big .
the door by the car by the couch in the restaurant is important .	the door was by the car by the couch in the restaurant is important .
the doll on the stool on the stool on the chair is new .	the doll was on the stool on the stool on the chair is new .
the bicycle on the couch on the street in the kitchen was white .	the bicycle is on the couch on the street in the kitchen was white .
the book on the stool on the street on the ground was black .	the book is on the stool on the street on the ground was black .
the shoe on the floor by the toy in the school is old .	the shoe was on the floor by the toy in the school is old .
the door in the park in the school in the room is old .	the door was in the park in the school in the room is old .
the chair in the mall on the table on the table was hot .	the chair is in the mall on the table on the table was hot .
the button on the street on the floor on the stool was yellow .	the button is on the street on the floor on the stool was yellow .
the shoe by the couch in the park in the school is cute .	the shoe was by the couch in the park in the school is cute .
the book on the bed on the couch by the candle was important .	the book is on the bed on the couch by the candle was important .
the doll by the cup in the museum on the street is brown .	the doll was by the cup in the museum on the street is brown .
the bowl in the park by the toy on the floor is brown .	the bowl was in the park by the toy on the floor is brown .
the plate on the bed in the restaurant on the ground was cute .	the plate is on the bed in the restaurant on the ground was cute .
the chair by the fork by the window by the toy was purple .	the chair is by the fork by the window by the toy was purple .
the truck in the museum on the ground on the street is important .	the truck was in the museum on the ground on the street is important .
the mirror by the candle by the plane on the stool was whole .	the mirror is by the candle by the plane on the stool was whole .
the bowl on the bed on the ground in the mall is boring .	the bowl was on the bed on the ground in the mall is boring .
the crayon on the chair by the doll on the floor was big .	the crayon is on the chair by the doll on the floor was big .
the toy on the couch by the spoon in the park is red .	the toy was on the couch by the spoon in the park is red .
the book on the chair in the restaurant on the couch is great .	the book was on the chair in the restaurant on the couch is great .
the picture by the rocket by the ring on the couch is purple .	the picture was by the rocket by the ring on the couch is purple .
the ship by the book by the bottle on the stool is broken .	the ship was by the book by the bottle on the stool is broken .
the shoe on the floor by the bowl on the table is amazing .	the shoe was on the floor by the bowl on the table is amazing .
the candle on the chair by the plate on the stool is yellow .	the candle was on the chair by the plate on the stool is yellow .
the hat on the couch on the stool on the floor was boring .	the hat is on the couch on the stool on the floor was boring .
the window in the park on the couch on the street was new .	the window is in the park on the couch on the street was new .
the bottle in the museum on the couch by the bottle was blue .	the bottle is in the museum on the couch by the bottle was blue .
the fork on the bed on the table in the park is new .	the fork was on the bed on the table in the park is new .
the ship by the candle in the school by the book was new .	the ship is by the candle in the school by the book was new .
the book in the school in the room on the chair was awesome .	the book is in the school in the room on the chair was awesome .
the bed in the library in the museum on the table was amazing .	the bed is in the library in the museum on the table was amazing .
the boat in the school in the bank in the mall was white .	the boat is in the school in the bank in the mall was white .
the shirt by the ring in the school by the ring was hot .	the shirt is by the ring in the school by the ring was hot .
the bottle by the toy on the chair in the school is missing .	the bottle was by the toy on the chair in the school is missing .
the book by the box in the school on the floor is old .	the book was by the box in the school on the floor is old .
the bed on the street on the stool on the ground is cute .	the bed was on the street on the stool on the ground is cute .
the hat on the street by the shirt on the chair was amazing .	the hat is on the street by the shirt on the chair was amazing .
the toy in the bank by the doll on the street is hot .	the toy was in the bank by the doll on the street is hot .
the couch in the park by the rug on the stool was expensive .	the couch is in the park by the rug on the stool was expensive .
the car on the bed on the ground in the school was old .	the car is on the bed on the ground in the school was old .
the shoe on the couch on the street by the rug is old .	the shoe was on the couch on the street by the rug is old .
the car in the restaurant by the mirror by the plate was green .	the car is in the restaurant by the mirror by the plate was green .
the box by the bowl on the bed on the stool is brown .	the box was by the bowl on the bed on the stool is brown .
the couch by the door in the kitchen on the table is small .	the couch was by the door in the kitchen on the table is small .
the picture on the street by the window in the school is orange .	the picture was on the street by the window in the school is orange .
the shirt by the ring by the dish on the floor was fine .	the shirt is by the ring by the dish on the floor was fine .
the window by the rocket in the park by the spoon is hot .	the window was by the rocket in the park by the spoon is hot .
the spoon on the ground by the door on the chair is black .	the spoon was on the ground by the door on the chair is black .
the mirror by the cup in the restaurant by the car was dry .	the mirror is by the cup in the restaurant by the car was dry .
the mirror by the bed by the box in the hospital was new .	the mirror is by the bed by the box in the hospital was new .
the ring in the hospital on the floor on the chair is boring .	the ring was in the hospital on the floor on the chair is boring .
the mirror in the school by the bed in the room was expensive .	the mirror is in the school by the bed in the room was expensive .
the button in the park in the restaurant by the spoon is fine .	the button was in the park in the restaurant by the spoon is fine .
the hat in the park by the glass by the bowl is brown .	the hat was in the park by the glass by the bowl is brown .
the bag on the couch by the ring by the bicycle is black .	the bag was on the couch by the ring by the bicycle is black .
the bowl on the street on the chair on the ground is missing .	the bowl was on the street on the chair on the ground is missing .
the plane in the mall by the bowl on the street is orange .	the plane was in the mall by the bowl on the street is orange .
the bed on the stool in the kitchen on the stool was cool .	the bed is on the stool in the kitchen on the stool was cool .
the glass by the plate on the stool in the mall was gray .	the glass is by the plate on the stool in the mall was gray .
the rug by the rocket in the museum on the ground is dry .	the rug was by the rocket in the museum on the ground is dry .
the couch in the school in the kitchen by the ring is whole .	the couch was in the school in the kitchen by the ring is whole .
the shirt on the street on the chair on the street is big .	the shirt was on the street on the chair on the street is big .
the hat on the bed by the rocket by the hat is broken .	the hat was on the bed by the rocket by the hat is broken .
the bowl on the chair in the hospital by the plate was boring .	the bowl is on the chair in the hospital by the plate was boring .
the rocket in the hospital by the button by the ring is broken .	the rocket was in the hospital by the button by the ring is broken .
the window by the bottle on the floor by the rocket is important .	the window was by the bottle on the floor by the rocket is important .
the fork by the window on the floor by the bottle is cute .	the fork was by the window on the floor by the bottle is cute .
the chair on the floor on the chair in the museum is red .	the chair was on the floor on the chair in the museum is red .
the candle by the spoon on the street by the spoon is boring .	the candle was by the spoon on the street by the spoon is boring .
the picture in the school by the bowl by the candle is orange .	the picture was in the school by the bowl by the candle is orange .
the door in the mall in the museum by the ring was small .	the door is in the mall in the museum by the ring was small .
the hat in the park on the chair on the bed was boring .	the hat is in the park on the chair on the bed was boring .
the dish in the museum in the school on the ground is awesome .	the dish was in the museum in the school on the ground is awesome .
the ring on the stool by the toy in the museum is purple .	the ring was on the stool by the toy in the museum is purple .
the boat on the bed on the couch in the restaurant was awesome .	the boat is on the bed on the couch in the restaurant was awesome .
the bowl by the fork on the stool on the street is brown .	the bowl was by the fork on the stool on the street is brown .
the candle in the room in the restaurant in the mall was hot .	the candle is in the room in the restaurant in the mall was hot .
