your dentist sent my son 's grandmother the rug .	your dentist lost my son 's grandmother the rug .
your dentist showed my boss 's daughter the mirror .	your dentist moved my boss 's daughter the mirror .
Kevin sent your teacher 's husband the button .	Kevin dropped your teacher 's husband the button .
Brett sent my teacher 's cousin the ship .	Brett cleaned my teacher 's cousin the ship .
your boss sent my boss 's cousin the couch .	your boss lost my boss 's cousin the couch .
the teacher bought your mother 's brother the hat .	the teacher moved your mother 's brother the hat .
your boss gave my sister 's dad the truck .	your boss lost my sister 's dad the truck .
the doctor gave your husband 's grandmother the spoon .	the doctor kept your husband 's grandmother the spoon .
George sent my grandmother 's dad the candle .	George lost my grandmother 's dad the candle .
your teacher bought your friend 's friend the ring .	your teacher shook your friend 's friend the ring .
your friend gave my brother 's dad the rug .	your friend dropped my brother 's dad the rug .
Linda bought my mother 's husband the candle .	Linda held my mother 's husband the candle .
Aaron sent my brother 's son the button .	Aaron held my brother 's son the button .
the child bought my teacher 's sister the bowl .	the child lost my teacher 's sister the bowl .
Naomi showed my dad 's father the crayon .	Naomi held my dad 's father the crayon .
Laura sent my grandmother 's doctor the car .	Laura kept my grandmother 's doctor the car .
my boss showed my grandmother 's teacher the shirt .	my boss cleaned my grandmother 's teacher the shirt .
Ann showed your wife 's doctor the bowl .	Ann cleaned your wife 's doctor the bowl .
George gave your cousin 's husband the bicycle .	George kept your cousin 's husband the bicycle .
your boss gave my friend 's son the window .	your boss cleaned my friend 's son the window .
your boss showed your doctor 's friend the car .	your boss cleaned your doctor 's friend the car .
the adult showed your teacher 's friend the picture .	the adult lost your teacher 's friend the picture .
the patient bought my wife 's dentist the doll .	the patient dropped my wife 's dentist the doll .
Denise gave my daughter 's brother the bicycle .	Denise moved my daughter 's brother the bicycle .
Melissa sent your wife 's cousin the button .	Melissa dropped your wife 's cousin the button .
the driver sent my daughter 's sister the hat .	the driver dropped my daughter 's sister the hat .
Anne sent your father 's teacher the spoon .	Anne dropped your father 's teacher the spoon .
Scott bought your daughter 's doctor the door .	Scott held your daughter 's doctor the door .
the teacher sent my doctor 's doctor the shoe .	the teacher cleaned my doctor 's doctor the shoe .
the driver bought your boss 's cousin the candle .	the driver lost your boss 's cousin the candle .
Tracy sent my brother 's father the mirror .	Tracy lost my brother 's father the mirror .
the patient gave my dad 's wife the window .	the patient moved my dad 's wife the window .
your cousin showed my daughter 's dentist the bowl .	your cousin moved my daughter 's dentist the bowl .
the person gave my wife 's sister the shirt .	the person held my wife 's sister the shirt .
Richard gave your dad 's doctor the shirt .	Richard dropped your dad 's doctor the shirt .
my cousin sent your mom 's mom the glass .	my cousin kept your mom 's mom the glass .
Adam gave my mother 's husband the doll .	Adam kept my mother 's husband the doll .
the dancer sent your mom 's son the ring .	the dancer moved your mom 's son the ring .
my dentist gave my cousin 's husband the book .	my dentist held my cousin 's husband the book .
my friend sent your teacher 's cousin the car .	my friend kept your teacher 's cousin the car .
Samantha bought your teacher 's doctor the toy .	Samantha dropped your teacher 's doctor the toy .
my teacher gave my daughter 's cousin the car .	my teacher kept my daughter 's cousin the car .
the doctor bought my brother 's grandmother the candle .	the doctor moved my brother 's grandmother the candle .
the customer bought my boss 's brother the bottle .	the customer dropped my boss 's brother the bottle .
Adam sent my wife 's son the mirror .	Adam kept my wife 's son the mirror .
the adult gave my cousin 's mom the ship .	the adult cleaned my cousin 's mom the ship .
the customer sent my brother 's son the truck .	the customer dropped my brother 's son the truck .
the person bought my friend 's son the box .	the person cleaned my friend 's son the box .
Karen bought your daughter 's husband the dish .	Karen lost your daughter 's husband the dish .
my cousin sent your doctor 's mother the plate .	my cousin dropped your doctor 's mother the plate .
your dentist gave my brother 's doctor the ship .	your dentist lost my brother 's doctor the ship .
your dentist bought my boss 's father the car .	your dentist moved my boss 's father the car .
Timothy sent my boss 's grandmother the ring .	Timothy cleaned my boss 's grandmother the ring .
Robert gave my cousin 's teacher the button .	Robert cleaned my cousin 's teacher the button .
the dancer sent your mom 's father the button .	the dancer lost your mom 's father the button .
your friend bought my mom 's son the ring .	your friend cleaned my mom 's son the ring .
the teacher gave my dentist 's cousin the window .	the teacher dropped my dentist 's cousin the window .
the customer showed my brother 's wife the ring .	the customer kept my brother 's wife the ring .
your doctor bought your dad 's wife the box .	your doctor held your dad 's wife the box .
my boss gave your father 's mother the glass .	my boss lost your father 's mother the glass .
the person bought your dad 's friend the bowl .	the person dropped your dad 's friend the bowl .
Martin showed your doctor 's son the spoon .	Martin held your doctor 's son the spoon .
the dancer showed my grandmother 's husband the glass .	the dancer shook my grandmother 's husband the glass .
the adult gave my dentist 's father the spoon .	the adult cleaned my dentist 's father the spoon .
my teacher bought my mother 's wife the window .	my teacher moved my mother 's wife the window .
your teacher gave my mother 's cousin the couch .	your teacher moved my mother 's cousin the couch .
my friend gave my brother 's husband the door .	my friend held my brother 's husband the door .
Steve showed my dentist 's mother the ring .	Steve lost my dentist 's mother the ring .
my cousin gave your brother 's dentist the picture .	my cousin shook your brother 's dentist the picture .
Daniel sent my wife 's teacher the bowl .	Daniel cleaned my wife 's teacher the bowl .
my doctor bought your grandmother 's daughter the cup .	my doctor dropped your grandmother 's daughter the cup .
your friend gave my grandmother 's sister the book .	your friend moved my grandmother 's sister the book .
your doctor sent my dentist 's dentist the ship .	your doctor lost my dentist 's dentist the ship .
my teacher showed my mom 's mother the door .	my teacher lost my mom 's mother the door .
the adult sent my sister 's sister the spoon .	the adult cleaned my sister 's sister the spoon .
the dentist sent your boss 's sister the hat .	the dentist shook your boss 's sister the hat .
the person sent my daughter 's son the window .	the person kept my daughter 's son the window .
my boss bought my doctor 's brother the doll .	my boss held my doctor 's brother the doll .
the patient sent your daughter 's boss the plane .	the patient cleaned your daughter 's boss the plane .
my doctor bought my cousin 's doctor the ring .	my doctor moved my cousin 's doctor the ring .
your teacher bought your friend 's boss the spoon .	your teacher cleaned your friend 's boss the spoon .
the dentist showed my grandmother 's friend the bag .	the dentist shook my grandmother 's friend the bag .
Guy sent your daughter 's wife the car .	Guy cleaned your daughter 's wife the car .
the child gave your brother 's wife the fork .	the child shook your brother 's wife the fork .
my cousin showed your mom 's father the fork .	my cousin dropped your mom 's father the fork .
my dentist gave my daughter 's daughter the picture .	my dentist moved my daughter 's daughter the picture .
Barbara bought my dentist 's son the picture .	Barbara dropped my dentist 's son the picture .
the child sent my sister 's sister the book .	the child moved my sister 's sister the book .
the dentist gave your cousin 's daughter the spoon .	the dentist shook your cousin 's daughter the spoon .
your boss showed my boss 's dad the spoon .	your boss cleaned my boss 's dad the spoon .
Aaron bought my grandmother 's mom the doll .	Aaron kept my grandmother 's mom the doll .
the dancer sent your dentist 's father the button .	the dancer shook your dentist 's father the button .
my friend gave my doctor 's wife the hat .	my friend held my doctor 's wife the hat .
my dentist bought your dentist 's friend the rug .	my dentist moved your dentist 's friend the rug .
Kristen gave your cousin 's friend the glass .	Kristen moved your cousin 's friend the glass .
the person bought my wife 's cousin the bowl .	the person shook my wife 's cousin the bowl .
Nina showed my mother 's mom the rug .	Nina moved my mother 's mom the rug .
Steve bought my cousin 's cousin the bicycle .	Steve kept my cousin 's cousin the bicycle .
the person bought your mom 's sister the candle .	the person dropped your mom 's sister the candle .
your boss sent your dad 's mom the ring .	your boss held your dad 's mom the ring .
my doctor showed my wife 's sister the bicycle .	my doctor kept my wife 's sister the bicycle .
my teacher showed your teacher 's mother the plane .	my teacher held your teacher 's mother the plane .
the dancer showed my daughter 's mother the cup .	the dancer kept my daughter 's mother the cup .
your boss gave my sister 's sister the bowl .	your boss kept my sister 's sister the bowl .
Travis sent your sister 's wife the plate .	Travis cleaned your sister 's wife the plate .
my boss bought your teacher 's sister the plane .	my boss cleaned your teacher 's sister the plane .
Wendy sent my doctor 's mom the crayon .	Wendy dropped my doctor 's mom the crayon .
the driver gave my sister 's cousin the book .	the driver shook my sister 's cousin the book .
Dan bought your cousin 's mother the candle .	Dan lost your cousin 's mother the candle .
Amelia sent my cousin 's boss the boat .	Amelia moved my cousin 's boss the boat .
Catherine showed my son 's boss the car .	Catherine cleaned my son 's boss the car .
the driver bought your brother 's friend the crayon .	the driver moved your brother 's friend the crayon .
the adult gave my wife 's daughter the bicycle .	the adult dropped my wife 's daughter the bicycle .
my teacher bought your brother 's dentist the boat .	my teacher shook your brother 's dentist the boat .
the patient sent your father 's wife the bowl .	the patient moved your father 's wife the bowl .
my boss showed my son 's friend the car .	my boss cleaned my son 's friend the car .
the child sent your teacher 's dentist the car .	the child held your teacher 's dentist the car .
Noah gave your wife 's wife the plane .	Noah cleaned your wife 's wife the plane .
the driver gave your wife 's boss the book .	the driver lost your wife 's boss the book .
Alexander sent my boss 's dad the rocket .	Alexander held my boss 's dad the rocket .
Martin sent your father 's son the toy .	Martin shook your father 's son the toy .
your boss showed my boss 's friend the boat .	your boss cleaned my boss 's friend the boat .
the doctor sent my mom 's friend the crayon .	the doctor kept my mom 's friend the crayon .
the adult sent your boss 's sister the plane .	the adult dropped your boss 's sister the plane .
the patient showed my grandmother 's teacher the bag .	the patient lost my grandmother 's teacher the bag .
David bought my daughter 's daughter the dish .	David shook my daughter 's daughter the dish .
Nancy showed your doctor 's husband the bag .	Nancy kept your doctor 's husband the bag .
the teacher bought my wife 's son the door .	the teacher cleaned my wife 's son the door .
my teacher sent my doctor 's mother the shoe .	my teacher kept my doctor 's mother the shoe .
your teacher showed my friend 's wife the bicycle .	your teacher dropped my friend 's wife the bicycle .
Robert sent your friend 's doctor the picture .	Robert moved your friend 's doctor the picture .
my dentist bought your dad 's husband the box .	my dentist lost your dad 's husband the box .
your teacher sent your father 's father the toy .	your teacher kept your father 's father the toy .
your teacher gave my dad 's teacher the shoe .	your teacher moved my dad 's teacher the shoe .
Julia bought your mother 's dentist the ring .	Julia dropped your mother 's dentist the ring .
your teacher bought your daughter 's mother the bed .	your teacher dropped your daughter 's mother the bed .
your friend sent my dentist 's husband the rug .	your friend dropped my dentist 's husband the rug .
Leslie sent my boss 's doctor the book .	Leslie dropped my boss 's doctor the book .
the patient showed my husband 's boss the bicycle .	the patient moved my husband 's boss the bicycle .
the dentist bought your doctor 's grandmother the chair .	the dentist dropped your doctor 's grandmother the chair .
my friend sent your grandmother 's wife the mirror .	my friend dropped your grandmother 's wife the mirror .
my boss showed my teacher 's sister the rug .	my boss held my teacher 's sister the rug .
Denise showed my boss 's sister the boat .	Denise dropped my boss 's sister the boat .
the dentist gave your son 's father the toy .	the dentist shook your son 's father the toy .
Brett sent your brother 's cousin the ship .	Brett kept your brother 's cousin the ship .
the doctor sent your mom 's mom the box .	the doctor shook your mom 's mom the box .
my friend gave my husband 's brother the door .	my friend cleaned my husband 's brother the door .
Renee gave my father 's mother the hat .	Renee lost my father 's mother the hat .
Tracy sent my boss 's son the mirror .	Tracy shook my boss 's son the mirror .
Brett showed your daughter 's doctor the fork .	Brett dropped your daughter 's doctor the fork .
the adult sent my mom 's friend the chair .	the adult shook my mom 's friend the chair .
your boss showed your mom 's father the shirt .	your boss held your mom 's father the shirt .
my dentist showed my brother 's teacher the hat .	my dentist kept my brother 's teacher the hat .
your friend gave my son 's sister the chair .	your friend kept my son 's sister the chair .
the patient showed your teacher 's dentist the crayon .	the patient dropped your teacher 's dentist the crayon .
my boss gave your boss 's father the window .	my boss cleaned your boss 's father the window .
Jason showed your wife 's sister the truck .	Jason shook your wife 's sister the truck .
my dentist gave your husband 's doctor the door .	my dentist held your husband 's doctor the door .
Peter showed your husband 's wife the bed .	Peter kept your husband 's wife the bed .
my boss bought my cousin 's daughter the spoon .	my boss shook my cousin 's daughter the spoon .
Adam showed my mother 's husband the car .	Adam moved my mother 's husband the car .
your teacher showed your teacher 's sister the truck .	your teacher moved your teacher 's sister the truck .
Erin gave my father 's teacher the truck .	Erin held my father 's teacher the truck .
Mark sent my dad 's doctor the button .	Mark shook my dad 's doctor the button .
the adult showed your brother 's teacher the bowl .	the adult held your brother 's teacher the bowl .
Emily bought my boss 's wife the plate .	Emily cleaned my boss 's wife the plate .
Renee sent my mom 's mom the shoe .	Renee moved my mom 's mom the shoe .
the adult showed your father 's mother the book .	the adult shook your father 's mother the book .
Alice sent my dad 's dad the fork .	Alice cleaned my dad 's dad the fork .
the dentist gave my wife 's sister the fork .	the dentist cleaned my wife 's sister the fork .
Adam showed your teacher 's father the fork .	Adam kept your teacher 's father the fork .
your cousin gave your boss 's daughter the cup .	your cousin kept your boss 's daughter the cup .
your cousin showed my dentist 's teacher the hat .	your cousin lost my dentist 's teacher the hat .
the dancer showed your sister 's son the window .	the dancer held your sister 's son the window .
Steve bought my brother 's doctor the picture .	Steve dropped my brother 's doctor the picture .
the adult gave your daughter 's doctor the bicycle .	the adult lost your daughter 's doctor the bicycle .
Thomas bought your husband 's teacher the box .	Thomas cleaned your husband 's teacher the box .
my teacher gave your dad 's daughter the hat .	my teacher shook your dad 's daughter the hat .
your doctor bought my sister 's dad the doll .	your doctor cleaned my sister 's dad the doll .
your doctor showed my boss 's cousin the candle .	your doctor moved my boss 's cousin the candle .
Joseph showed my mother 's doctor the ship .	Joseph moved my mother 's doctor the ship .
your cousin gave your husband 's daughter the plate .	your cousin held your husband 's daughter the plate .
Eric showed my husband 's wife the rocket .	Eric kept my husband 's wife the rocket .
Scott bought my teacher 's friend the bed .	Scott cleaned my teacher 's friend the bed .
your teacher sent my cousin 's doctor the car .	your teacher moved my cousin 's doctor the car .
the person sent my father 's teacher the car .	the person kept my father 's teacher the car .
your cousin showed my dentist 's dentist the plate .	your cousin held my dentist 's dentist the plate .
your cousin bought your daughter 's mom the bed .	your cousin held your daughter 's mom the bed .
the person bought my wife 's wife the rocket .	the person shook my wife 's wife the rocket .
your cousin bought my teacher 's wife the button .	your cousin cleaned my teacher 's wife the button .
your cousin showed your dad 's dad the crayon .	your cousin moved your dad 's dad the crayon .
the patient showed your grandmother 's grandmother the shirt .	the patient shook your grandmother 's grandmother the shirt .
the driver showed my teacher 's sister the crayon .	the driver lost my teacher 's sister the crayon .
Martin sent my sister 's dad the chair .	Martin cleaned my sister 's dad the chair .
the teacher bought your friend 's husband the plate .	the teacher kept your friend 's husband the plate .
the person showed my mom 's daughter the crayon .	the person lost my mom 's daughter the crayon .
your boss showed your boss 's boss the hat .	your boss held your boss 's boss the hat .
your doctor gave my doctor 's grandmother the fork .	your doctor lost my doctor 's grandmother the fork .
Melissa gave my husband 's father the rug .	Melissa cleaned my husband 's father the rug .
your dentist bought my dentist 's husband the shoe .	your dentist moved my dentist 's husband the shoe .
the dentist sent my doctor 's friend the book .	the dentist moved my doctor 's friend the book .
Nancy bought your dentist 's teacher the boat .	Nancy shook your dentist 's teacher the boat .
Mary showed your doctor 's son the button .	Mary shook your doctor 's son the button .
Travis bought my brother 's cousin the shirt .	Travis kept my brother 's cousin the shirt .
the teacher showed my sister 's father the crayon .	the teacher held my sister 's father the crayon .
Sally showed my son 's boss the shirt .	Sally kept my son 's boss the shirt .
my friend gave your mom 's daughter the button .	my friend dropped your mom 's daughter the button .
Lisa gave my husband 's boss the dish .	Lisa lost my husband 's boss the dish .
the teacher gave your dentist 's husband the boat .	the teacher kept your dentist 's husband the boat .
the person sent my friend 's boss the plate .	the person lost my friend 's boss the plate .
the driver gave your husband 's father the button .	the driver cleaned your husband 's father the button .
my cousin bought your grandmother 's mom the rocket .	my cousin shook your grandmother 's mom the rocket .
the adult gave my boss 's doctor the plane .	the adult dropped my boss 's doctor the plane .
Timothy gave my father 's boss the bicycle .	Timothy dropped my father 's boss the bicycle .
the teacher sent my daughter 's daughter the plane .	the teacher dropped my daughter 's daughter the plane .
Naomi showed your friend 's sister the book .	Naomi kept your friend 's sister the book .
Steve gave your wife 's cousin the bag .	Steve held your wife 's cousin the bag .
Richard gave my father 's mother the bowl .	Richard held my father 's mother the bowl .
your dentist gave my wife 's boss the hat .	your dentist held my wife 's boss the hat .
the patient gave your father 's dad the book .	the patient shook your father 's dad the book .
my teacher gave my friend 's dad the spoon .	my teacher kept my friend 's dad the spoon .
the person showed my grandmother 's mother the door .	the person moved my grandmother 's mother the door .
Linda showed my mother 's mother the rug .	Linda kept my mother 's mother the rug .
the driver bought your dentist 's sister the couch .	the driver moved your dentist 's sister the couch .
Jane bought my sister 's mom the chair .	Jane held my sister 's mom the chair .
your friend showed your dentist 's daughter the cup .	your friend shook your dentist 's daughter the cup .
the doctor gave my friend 's boss the dish .	the doctor shook my friend 's boss the dish .
the driver showed my cousin 's grandmother the glass .	the driver dropped my cousin 's grandmother the glass .
Guy gave your daughter 's daughter the box .	Guy cleaned your daughter 's daughter the box .
the child gave your brother 's mother the bottle .	the child dropped your brother 's mother the bottle .
Leslie bought your daughter 's daughter the picture .	Leslie held your daughter 's daughter the picture .
the customer showed your father 's teacher the truck .	the customer cleaned your father 's teacher the truck .
Deborah showed my grandmother 's boss the dish .	Deborah cleaned my grandmother 's boss the dish .
Erin showed your wife 's grandmother the shoe .	Erin moved your wife 's grandmother the shoe .
your cousin showed my grandmother 's dad the spoon .	your cousin dropped my grandmother 's dad the spoon .
my cousin gave your grandmother 's sister the crayon .	my cousin kept your grandmother 's sister the crayon .
the person bought my father 's mom the glass .	the person dropped my father 's mom the glass .
Andrew sent your teacher 's daughter the mirror .	Andrew dropped your teacher 's daughter the mirror .
Tracy gave your son 's mother the ring .	Tracy held your son 's mother the ring .
the adult bought my dad 's brother the picture .	the adult lost my dad 's brother the picture .
your friend sent my doctor 's daughter the car .	your friend lost my doctor 's daughter the car .
the customer showed your brother 's friend the glass .	the customer kept your brother 's friend the glass .
your teacher bought your teacher 's teacher the book .	your teacher kept your teacher 's teacher the book .
my cousin showed my dad 's wife the shirt .	my cousin lost my dad 's wife the shirt .
the adult bought my daughter 's sister the glass .	the adult shook my daughter 's sister the glass .
my teacher sent your dentist 's dad the truck .	my teacher cleaned your dentist 's dad the truck .
Carol bought my teacher 's sister the rug .	Carol shook my teacher 's sister the rug .
your doctor bought your grandmother 's son the chair .	your doctor moved your grandmother 's son the chair .
your boss sent my friend 's sister the picture .	your boss cleaned my friend 's sister the picture .
the customer gave your dentist 's brother the fork .	the customer lost your dentist 's brother the fork .
your friend sent my boss 's sister the car .	your friend lost my boss 's sister the car .
your dentist bought your mother 's teacher the bicycle .	your dentist moved your mother 's teacher the bicycle .
the patient showed your father 's brother the bed .	the patient cleaned your father 's brother the bed .
your dentist gave my mom 's mother the shoe .	your dentist kept my mom 's mother the shoe .
my cousin bought your grandmother 's sister the rocket .	my cousin kept your grandmother 's sister the rocket .
my doctor gave my dentist 's father the car .	my doctor held my dentist 's father the car .
the driver gave your friend 's father the shoe .	the driver lost your friend 's father the shoe .
my dentist gave your dentist 's cousin the chair .	my dentist moved your dentist 's cousin the chair .
Melissa showed your doctor 's boss the book .	Melissa dropped your doctor 's boss the book .
your doctor gave your mom 's father the rocket .	your doctor lost your mom 's father the rocket .
Jerry sent your sister 's sister the plane .	Jerry held your sister 's sister the plane .
the teacher bought your doctor 's brother the button .	the teacher moved your doctor 's brother the button .
your dentist gave your doctor 's teacher the bowl .	your dentist held your doctor 's teacher the bowl .
George sent your teacher 's daughter the chair .	George dropped your teacher 's daughter the chair .
my teacher sent your wife 's dentist the rocket .	my teacher kept your wife 's dentist the rocket .
Kristen gave your son 's brother the plate .	Kristen shook your son 's brother the plate .
my friend showed your doctor 's wife the boat .	my friend lost your doctor 's wife the boat .
my boss sent my doctor 's teacher the box .	my boss shook my doctor 's teacher the box .
the child sent your cousin 's daughter the ring .	the child held your cousin 's daughter the ring .
Peter sent your wife 's father the plate .	Peter lost your wife 's father the plate .
Jane gave your teacher 's mother the spoon .	Jane lost your teacher 's mother the spoon .
the teacher sent my dad 's brother the car .	the teacher cleaned my dad 's brother the car .
Alice bought your father 's friend the candle .	Alice lost your father 's friend the candle .
Jerry sent my teacher 's dentist the bicycle .	Jerry moved my teacher 's dentist the bicycle .
the doctor showed my sister 's mom the ring .	the doctor moved my sister 's mom the ring .
your doctor sent my brother 's brother the bag .	your doctor moved my brother 's brother the bag .
your doctor sent your dentist 's cousin the rocket .	your doctor lost your dentist 's cousin the rocket .
the adult bought my brother 's grandmother the hat .	the adult cleaned my brother 's grandmother the hat .
the doctor gave your grandmother 's husband the glass .	the doctor kept your grandmother 's husband the glass .
Robert gave my cousin 's wife the mirror .	Robert kept my cousin 's wife the mirror .
the driver bought your mother 's dentist the picture .	the driver kept your mother 's dentist the picture .
the driver sent your son 's grandmother the plate .	the driver held your son 's grandmother the plate .
the patient showed your brother 's sister the cup .	the patient lost your brother 's sister the cup .
Melissa bought your dentist 's cousin the rug .	Melissa dropped your dentist 's cousin the rug .
Peter gave your doctor 's grandmother the rug .	Peter moved your doctor 's grandmother the rug .
the doctor gave your dentist 's friend the button .	the doctor cleaned your dentist 's friend the button .
the teacher showed my dad 's dentist the plate .	the teacher cleaned my dad 's dentist the plate .
your dentist bought your father 's teacher the doll .	your dentist cleaned your father 's teacher the doll .
Becky bought your doctor 's sister the book .	Becky moved your doctor 's sister the book .
my cousin bought your daughter 's cousin the shoe .	my cousin lost your daughter 's cousin the shoe .
the customer sent your brother 's daughter the toy .	the customer kept your brother 's daughter the toy .
Scott showed my sister 's mom the plate .	Scott kept my sister 's mom the plate .
the doctor gave my grandmother 's boss the cup .	the doctor kept my grandmother 's boss the cup .
the teacher showed my dad 's daughter the button .	the teacher dropped my dad 's daughter the button .
the person sent your sister 's wife the bowl .	the person held your sister 's wife the bowl .
my doctor gave my dad 's teacher the fork .	my doctor shook my dad 's teacher the fork .
your dentist sent your mom 's mother the fork .	your dentist kept your mom 's mother the fork .
the teacher bought your daughter 's sister the doll .	the teacher kept your daughter 's sister the doll .
the dentist showed your sister 's cousin the bicycle .	the dentist lost your sister 's cousin the bicycle .
Jessica showed my sister 's daughter the dish .	Jessica moved my sister 's daughter the dish .
Steven sent your friend 's cousin the car .	Steven cleaned your friend 's cousin the car .
the teacher gave your mother 's mom the doll .	the teacher dropped your mother 's mom the doll .
Amy gave your cousin 's grandmother the cup .	Amy shook your cousin 's grandmother the cup .
your boss bought my friend 's son the car .	your boss kept my friend 's son the car .
Timothy bought your teacher 's sister the hat .	Timothy moved your teacher 's sister the hat .
the doctor bought your teacher 's mom the rug .	the doctor lost your teacher 's mom the rug .
the doctor sent my friend 's dentist the spoon .	the doctor dropped my friend 's dentist the spoon .
the teacher sent your brother 's wife the shirt .	the teacher shook your brother 's wife the shirt .
your doctor bought your sister 's dentist the crayon .	your doctor dropped your sister 's dentist the crayon .
Nicole gave my brother 's wife the glass .	Nicole held my brother 's wife the glass .
my doctor sent my cousin 's teacher the bicycle .	my doctor cleaned my cousin 's teacher the bicycle .
my teacher showed my teacher 's dentist the boat .	my teacher lost my teacher 's dentist the boat .
the doctor showed your boss 's teacher the couch .	the doctor kept your boss 's teacher the couch .
my teacher sent your husband 's brother the truck .	my teacher lost your husband 's brother the truck .
the child sent my grandmother 's wife the plane .	the child dropped my grandmother 's wife the plane .
Julia bought your cousin 's father the crayon .	Julia dropped your cousin 's father the crayon .
Jessica bought your mother 's daughter the bed .	Jessica shook your mother 's daughter the bed .
your doctor gave your teacher 's friend the button .	your doctor lost your teacher 's friend the button .
the adult sent your brother 's dad the fork .	the adult held your brother 's dad the fork .
my doctor gave your dad 's dad the bicycle .	my doctor kept your dad 's dad the bicycle .
the teacher sent your wife 's boss the crayon .	the teacher cleaned your wife 's boss the crayon .
the teacher sent my sister 's boss the fork .	the teacher dropped my sister 's boss the fork .
Denise showed my boss 's daughter the rocket .	Denise dropped my boss 's daughter the rocket .
my cousin gave your son 's mom the bed .	my cousin dropped your son 's mom the bed .
Linda showed your friend 's husband the book .	Linda dropped your friend 's husband the book .
Noah gave my doctor 's dentist the hat .	Noah cleaned my doctor 's dentist the hat .
your dentist gave your daughter 's wife the window .	your dentist moved your daughter 's wife the window .
my friend showed your husband 's mom the boat .	my friend shook your husband 's mom the boat .
the child sent your father 's grandmother the truck .	the child kept your father 's grandmother the truck .
the child gave my dentist 's father the bicycle .	the child held my dentist 's father the bicycle .
the patient gave my cousin 's mother the spoon .	the patient shook my cousin 's mother the spoon .
your doctor showed your grandmother 's cousin the plate .	your doctor held your grandmother 's cousin the plate .
Laurie bought your daughter 's brother the plate .	Laurie lost your daughter 's brother the plate .
my dentist bought my dentist 's dad the bed .	my dentist dropped my dentist 's dad the bed .
the person showed my friend 's boss the ship .	the person kept my friend 's boss the ship .
the person showed my sister 's dad the ring .	the person dropped my sister 's dad the ring .
the driver gave my brother 's friend the cup .	the driver shook my brother 's friend the cup .
the driver bought my dentist 's sister the book .	the driver kept my dentist 's sister the book .
your teacher showed your grandmother 's wife the fork .	your teacher cleaned your grandmother 's wife the fork .
your friend showed your doctor 's cousin the spoon .	your friend moved your doctor 's cousin the spoon .
my cousin gave my dad 's sister the window .	my cousin dropped my dad 's sister the window .
Ronald sent your dentist 's husband the door .	Ronald cleaned your dentist 's husband the door .
your teacher showed your husband 's teacher the glass .	your teacher lost your husband 's teacher the glass .
Linda showed my friend 's wife the bowl .	Linda held my friend 's wife the bowl .
your friend gave my boss 's brother the doll .	your friend lost my boss 's brother the doll .
the person gave my father 's teacher the rocket .	the person shook my father 's teacher the rocket .
Brett sent your cousin 's son the car .	Brett held your cousin 's son the car .
the dentist gave your mom 's sister the button .	the dentist dropped your mom 's sister the button .
Janet bought your teacher 's mom the button .	Janet shook your teacher 's mom the button .
Adam sent your friend 's husband the boat .	Adam lost your friend 's husband the boat .
the teacher showed my grandmother 's grandmother the rug .	the teacher lost my grandmother 's grandmother the rug .
my dentist gave your friend 's son the picture .	my dentist held your friend 's son the picture .
Sandra bought your dad 's friend the crayon .	Sandra kept your dad 's friend the crayon .
your friend gave your husband 's mother the plate .	your friend kept your husband 's mother the plate .
the dentist showed my mother 's wife the doll .	the dentist lost my mother 's wife the doll .
my cousin sent your brother 's grandmother the shirt .	my cousin dropped your brother 's grandmother the shirt .
the person bought my father 's sister the rug .	the person shook my father 's sister the rug .
my boss gave my friend 's brother the plane .	my boss shook my friend 's brother the plane .
your friend gave my son 's doctor the boat .	your friend lost my son 's doctor the boat .
the customer showed my sister 's dentist the ring .	the customer kept my sister 's dentist the ring .
Carl showed my cousin 's boss the bag .	Carl moved my cousin 's boss the bag .
the teacher gave my father 's daughter the box .	the teacher kept my father 's daughter the box .
Tracy gave your daughter 's mother the mirror .	Tracy held your daughter 's mother the mirror .
the teacher gave my grandmother 's grandmother the box .	the teacher cleaned my grandmother 's grandmother the box .
Nina gave my grandmother 's doctor the car .	Nina cleaned my grandmother 's doctor the car .
Sara gave your husband 's daughter the boat .	Sara kept your husband 's daughter the boat .
Nina showed my brother 's dad the dish .	Nina cleaned my brother 's dad the dish .
your dentist gave my husband 's dentist the boat .	your dentist shook my husband 's dentist the boat .
Ronald bought my father 's mom the cup .	Ronald cleaned my father 's mom the cup .
the person bought my wife 's daughter the bicycle .	the person held my wife 's daughter the bicycle .
my doctor gave your grandmother 's husband the shoe .	my doctor dropped your grandmother 's husband the shoe .
your teacher sent your mom 's mother the crayon .	your teacher kept your mom 's mother the crayon .
the dancer showed your dentist 's mother the couch .	the dancer cleaned your dentist 's mother the couch .
my teacher gave my brother 's wife the rug .	my teacher shook my brother 's wife the rug .
Ronald gave my daughter 's dad the truck .	Ronald kept my daughter 's dad the truck .
Andrew bought your friend 's sister the button .	Andrew cleaned your friend 's sister the button .
the child showed your husband 's son the rug .	the child shook your husband 's son the rug .
your friend showed your dad 's doctor the cup .	your friend lost your dad 's doctor the cup .
Daniel showed your dad 's daughter the bed .	Daniel moved your dad 's daughter the bed .
the child bought your husband 's boss the bed .	the child dropped your husband 's boss the bed .
William bought my dentist 's mother the bottle .	William dropped my dentist 's mother the bottle .
your teacher gave my husband 's mom the cup .	your teacher moved my husband 's mom the cup .
the teacher gave your cousin 's friend the box .	the teacher kept your cousin 's friend the box .
the doctor showed my daughter 's teacher the fork .	the doctor cleaned my daughter 's teacher the fork .
Brett sent my brother 's teacher the bicycle .	Brett shook my brother 's teacher the bicycle .
Susan bought your mom 's brother the rug .	Susan moved your mom 's brother the rug .
the child bought your friend 's brother the dish .	the child dropped your friend 's brother the dish .
the driver showed my friend 's mother the truck .	the driver shook my friend 's mother the truck .
my friend gave my doctor 's son the door .	my friend held my doctor 's son the door .
Travis bought my brother 's brother the window .	Travis lost my brother 's brother the window .
Mark gave your wife 's dad the book .	Mark moved your wife 's dad the book .
the teacher gave my dentist 's husband the candle .	the teacher kept my dentist 's husband the candle .
the child bought your dad 's son the crayon .	the child kept your dad 's son the crayon .
my teacher showed my dad 's son the ring .	my teacher kept my dad 's son the ring .
my dentist gave my mom 's cousin the candle .	my dentist held my mom 's cousin the candle .
your doctor sent your sister 's dentist the fork .	your doctor lost your sister 's dentist the fork .
Richard bought your mom 's boss the shoe .	Richard dropped your mom 's boss the shoe .
the teacher bought my sister 's father the book .	the teacher moved my sister 's father the book .
Jerry sent your daughter 's grandmother the doll .	Jerry kept your daughter 's grandmother the doll .
Wendy gave my dad 's daughter the boat .	Wendy lost my dad 's daughter the boat .
my boss gave your grandmother 's teacher the plate .	my boss kept your grandmother 's teacher the plate .
the person showed my friend 's mother the bicycle .	the person moved my friend 's mother the bicycle .
Jessica gave your husband 's son the bed .	Jessica moved your husband 's son the bed .
Peter showed my dad 's boss the bicycle .	Peter moved my dad 's boss the bicycle .
the child showed my father 's teacher the couch .	the child kept my father 's teacher the couch .
my cousin gave your grandmother 's wife the box .	my cousin held your grandmother 's wife the box .
the doctor bought my teacher 's boss the book .	the doctor kept my teacher 's boss the book .
the customer showed your doctor 's cousin the glass .	the customer lost your doctor 's cousin the glass .
the person bought my wife 's boss the book .	the person dropped my wife 's boss the book .
my friend sent my wife 's teacher the window .	my friend dropped my wife 's teacher the window .
Becca showed my mom 's daughter the picture .	Becca dropped my mom 's daughter the picture .
the adult showed my dentist 's teacher the hat .	the adult lost my dentist 's teacher the hat .
Liam sent your sister 's daughter the plane .	Liam moved your sister 's daughter the plane .
the dancer gave my friend 's dad the button .	the dancer dropped my friend 's dad the button .
Steven gave my dentist 's dad the hat .	Steven shook my dentist 's dad the hat .
the dancer gave your daughter 's boss the door .	the dancer lost your daughter 's boss the door .
Thomas gave your brother 's grandmother the ship .	Thomas dropped your brother 's grandmother the ship .
the doctor sent your teacher 's father the book .	the doctor lost your teacher 's father the book .
your teacher bought your teacher 's father the bed .	your teacher cleaned your teacher 's father the bed .
my doctor gave your cousin 's grandmother the ring .	my doctor kept your cousin 's grandmother the ring .
your friend bought your cousin 's doctor the picture .	your friend kept your cousin 's doctor the picture .
your cousin showed your son 's wife the bowl .	your cousin held your son 's wife the bowl .
Adam bought my dentist 's brother the glass .	Adam kept my dentist 's brother the glass .
the driver gave my grandmother 's doctor the ship .	the driver shook my grandmother 's doctor the ship .
the teacher showed my daughter 's boss the boat .	the teacher held my daughter 's boss the boat .
my friend sent my cousin 's daughter the boat .	my friend shook my cousin 's daughter the boat .
Sarah bought your father 's father the crayon .	Sarah kept your father 's father the crayon .
my boss bought my daughter 's dad the box .	my boss dropped my daughter 's dad the box .
your boss showed my dad 's sister the glass .	your boss dropped my dad 's sister the glass .
my boss showed your boss 's dentist the shoe .	my boss shook your boss 's dentist the shoe .
your boss sent my wife 's brother the boat .	your boss dropped my wife 's brother the boat .
the adult showed your daughter 's sister the candle .	the adult moved your daughter 's sister the candle .
my doctor sent my husband 's cousin the shirt .	my doctor shook my husband 's cousin the shirt .
your cousin showed your daughter 's dad the mirror .	your cousin kept your daughter 's dad the mirror .
the doctor gave your mom 's friend the glass .	the doctor kept your mom 's friend the glass .
your teacher sent my brother 's father the window .	your teacher moved my brother 's father the window .
the dentist bought my sister 's father the fork .	the dentist held my sister 's father the fork .
your teacher sent my brother 's dentist the book .	your teacher cleaned my brother 's dentist the book .
the adult sent your doctor 's mother the ship .	the adult held your doctor 's mother the ship .
the doctor sent your dentist 's husband the bowl .	the doctor cleaned your dentist 's husband the bowl .
your dentist gave my friend 's teacher the ship .	your dentist held my friend 's teacher the ship .
the doctor gave your son 's cousin the mirror .	the doctor cleaned your son 's cousin the mirror .
your boss sent my mother 's sister the window .	your boss kept my mother 's sister the window .
Adam sent my dentist 's mom the window .	Adam held my dentist 's mom the window .
your cousin showed my doctor 's brother the plate .	your cousin moved my doctor 's brother the plate .
Mary showed your wife 's wife the shoe .	Mary moved your wife 's wife the shoe .
the person sent my mom 's mom the toy .	the person dropped my mom 's mom the toy .
the teacher bought your sister 's sister the spoon .	the teacher moved your sister 's sister the spoon .
your friend gave your teacher 's dentist the picture .	your friend shook your teacher 's dentist the picture .
my teacher showed my dad 's cousin the box .	my teacher dropped my dad 's cousin the box .
your dentist gave my mother 's father the rocket .	your dentist dropped my mother 's father the rocket .
Daniel bought my teacher 's husband the shirt .	Daniel dropped my teacher 's husband the shirt .
your doctor sent your brother 's dentist the bottle .	your doctor lost your brother 's dentist the bottle .
the adult showed my brother 's father the picture .	the adult cleaned my brother 's father the picture .
my teacher showed my mother 's brother the plate .	my teacher held my mother 's brother the plate .
Laurie gave your boss 's brother the bottle .	Laurie shook your boss 's brother the bottle .
my friend bought my grandmother 's father the mirror .	my friend cleaned my grandmother 's father the mirror .
my boss showed my wife 's grandmother the book .	my boss held my wife 's grandmother the book .
Frank showed my teacher 's cousin the button .	Frank held my teacher 's cousin the button .
Wendy gave your husband 's teacher the button .	Wendy lost your husband 's teacher the button .
the dancer showed your daughter 's dentist the button .	the dancer held your daughter 's dentist the button .
your teacher gave my father 's daughter the bottle .	your teacher kept my father 's daughter the bottle .
Paul showed my sister 's dentist the glass .	Paul shook my sister 's dentist the glass .
my cousin showed your wife 's sister the doll .	my cousin lost your wife 's sister the doll .
the dancer showed your friend 's sister the plate .	the dancer lost your friend 's sister the plate .
Melissa showed your wife 's wife the couch .	Melissa lost your wife 's wife the couch .
Ronald showed my grandmother 's father the door .	Ronald shook my grandmother 's father the door .
my cousin showed your dad 's son the chair .	my cousin dropped your dad 's son the chair .
Laura gave my dentist 's friend the book .	Laura lost my dentist 's friend the book .
your boss bought my mom 's cousin the cup .	your boss dropped my mom 's cousin the cup .
your friend sent my boss 's father the chair .	your friend kept my boss 's father the chair .
the driver showed my teacher 's father the cup .	the driver lost my teacher 's father the cup .
your doctor gave my teacher 's daughter the ring .	your doctor shook my teacher 's daughter the ring .
my friend bought your father 's daughter the fork .	my friend moved your father 's daughter the fork .
the adult bought your teacher 's grandmother the toy .	the adult shook your teacher 's grandmother the toy .
the doctor bought my boss 's grandmother the chair .	the doctor cleaned my boss 's grandmother the chair .
my teacher gave your friend 's mother the shirt .	my teacher dropped your friend 's mother the shirt .
the patient sent my teacher 's doctor the candle .	the patient held my teacher 's doctor the candle .
your cousin showed your husband 's mother the button .	your cousin lost your husband 's mother the button .
the dentist bought my doctor 's daughter the crayon .	the dentist held my doctor 's daughter the crayon .
the dentist gave my father 's teacher the crayon .	the dentist dropped my father 's teacher the crayon .
Noah sent my cousin 's cousin the car .	Noah held my cousin 's cousin the car .
Thomas bought my friend 's daughter the rug .	Thomas dropped my friend 's daughter the rug .
your teacher sent your dad 's daughter the toy .	your teacher lost your dad 's daughter the toy .
the adult gave my teacher 's grandmother the truck .	the adult moved my teacher 's grandmother the truck .
the dancer gave your grandmother 's friend the couch .	the dancer dropped your grandmother 's friend the couch .
Jill sent your sister 's brother the spoon .	Jill cleaned your sister 's brother the spoon .
the child sent my mom 's daughter the bed .	the child lost my mom 's daughter the bed .
Tracy sent your doctor 's brother the fork .	Tracy cleaned your doctor 's brother the fork .
my dentist gave my brother 's dad the hat .	my dentist lost my brother 's dad the hat .
Timothy gave your dad 's mother the bed .	Timothy dropped your dad 's mother the bed .
Thomas gave your daughter 's husband the boat .	Thomas held your daughter 's husband the boat .
your cousin gave your brother 's doctor the rocket .	your cousin held your brother 's doctor the rocket .
the patient gave my brother 's son the chair .	the patient cleaned my brother 's son the chair .
the dancer showed your doctor 's doctor the car .	the dancer cleaned your doctor 's doctor the car .
Carl gave your dentist 's sister the hat .	Carl shook your dentist 's sister the hat .
Jessica sent my boss 's dentist the bowl .	Jessica moved my boss 's dentist the bowl .
Cindy showed your wife 's son the boat .	Cindy held your wife 's son the boat .
your friend sent your doctor 's teacher the bottle .	your friend dropped your doctor 's teacher the bottle .
your teacher showed your brother 's husband the ship .	your teacher kept your brother 's husband the ship .
your friend sent my father 's son the door .	your friend moved my father 's son the door .
your boss gave my cousin 's mom the bicycle .	your boss lost my cousin 's mom the bicycle .
the patient bought your father 's husband the ring .	the patient cleaned your father 's husband the ring .
your friend gave my father 's boss the shoe .	your friend cleaned my father 's boss the shoe .
the customer bought my sister 's mother the cup .	the customer dropped my sister 's mother the cup .
your cousin sent my brother 's brother the plane .	your cousin dropped my brother 's brother the plane .
the teacher showed my doctor 's father the plate .	the teacher held my doctor 's father the plate .
my doctor showed your brother 's boss the box .	my doctor kept your brother 's boss the box .
the driver gave your mom 's son the book .	the driver dropped your mom 's son the book .
Joseph showed your sister 's son the bowl .	Joseph held your sister 's son the bowl .
April bought my father 's boss the plate .	April shook my father 's boss the plate .
your friend sent your sister 's doctor the chair .	your friend held your sister 's doctor the chair .
Martin gave your wife 's teacher the cup .	Martin shook your wife 's teacher the cup .
my cousin sent your wife 's friend the rug .	my cousin held your wife 's friend the rug .
the dentist bought my mom 's dad the ring .	the dentist shook my mom 's dad the ring .
your friend gave your sister 's wife the crayon .	your friend moved your sister 's wife the crayon .
the person bought my friend 's mom the shirt .	the person moved my friend 's mom the shirt .
Brian sent my son 's teacher the cup .	Brian moved my son 's teacher the cup .
Todd showed my dentist 's grandmother the bowl .	Todd dropped my dentist 's grandmother the bowl .
Nancy bought your boss 's teacher the dish .	Nancy moved your boss 's teacher the dish .
my cousin sent my friend 's wife the hat .	my cousin kept my friend 's wife the hat .
the child bought my grandmother 's sister the plane .	the child cleaned my grandmother 's sister the plane .
my friend showed your dentist 's wife the couch .	my friend cleaned your dentist 's wife the couch .
Renee showed your teacher 's grandmother the ship .	Renee lost your teacher 's grandmother the ship .
your cousin bought your husband 's dentist the car .	your cousin moved your husband 's dentist the car .
your doctor showed my wife 's dad the ship .	your doctor cleaned my wife 's dad the ship .
Todd sent my son 's cousin the chair .	Todd held my son 's cousin the chair .
Andrew bought my husband 's son the shoe .	Andrew moved my husband 's son the shoe .
the doctor gave my grandmother 's friend the window .	the doctor held my grandmother 's friend the window .
Wendy sent your boss 's teacher the shirt .	Wendy kept your boss 's teacher the shirt .
the person bought my boss 's wife the bag .	the person moved my boss 's wife the bag .
my friend showed my dentist 's grandmother the doll .	my friend lost my dentist 's grandmother the doll .
my doctor showed your father 's dad the picture .	my doctor held your father 's dad the picture .
your boss bought your friend 's friend the window .	your boss held your friend 's friend the window .
Scott bought your mother 's mother the dish .	Scott lost your mother 's mother the dish .
the teacher showed your dentist 's teacher the boat .	the teacher kept your dentist 's teacher the boat .
Judy bought my son 's son the mirror .	Judy lost my son 's son the mirror .
the patient bought my mom 's doctor the dish .	the patient held my mom 's doctor the dish .
your dentist bought my doctor 's grandmother the button .	your dentist held my doctor 's grandmother the button .
my doctor sent your sister 's teacher the bowl .	my doctor lost your sister 's teacher the bowl .
the child bought my mother 's dentist the shirt .	the child held my mother 's dentist the shirt .
my doctor showed my dad 's daughter the doll .	my doctor kept my dad 's daughter the doll .
the child bought my brother 's dad the door .	the child cleaned my brother 's dad the door .
your doctor sent your grandmother 's husband the crayon .	your doctor cleaned your grandmother 's husband the crayon .
Deborah sent my daughter 's friend the truck .	Deborah kept my daughter 's friend the truck .
the adult sent your wife 's father the car .	the adult dropped your wife 's father the car .
the customer gave your doctor 's boss the cup .	the customer cleaned your doctor 's boss the cup .
the driver sent my mother 's grandmother the dish .	the driver dropped my mother 's grandmother the dish .
the customer sent your son 's friend the fork .	the customer held your son 's friend the fork .
the teacher gave my dentist 's doctor the plane .	the teacher kept my dentist 's doctor the plane .
your cousin gave my cousin 's mother the toy .	your cousin kept my cousin 's mother the toy .
your teacher bought my boss 's dentist the shirt .	your teacher kept my boss 's dentist the shirt .
the driver sent your sister 's teacher the boat .	the driver kept your sister 's teacher the boat .
George bought my son 's son the hat .	George held my son 's son the hat .
the teacher gave my brother 's wife the picture .	the teacher shook my brother 's wife the picture .
your cousin showed your wife 's mom the book .	your cousin moved your wife 's mom the book .
Karen sent my father 's brother the shoe .	Karen held my father 's brother the shoe .
the child showed my mother 's wife the bag .	the child cleaned my mother 's wife the bag .
Alexander showed your cousin 's brother the rocket .	Alexander kept your cousin 's brother the rocket .
my dentist sent my father 's father the window .	my dentist held my father 's father the window .
Nicole gave your father 's brother the ship .	Nicole lost your father 's brother the ship .
Deborah sent my mom 's friend the couch .	Deborah held my mom 's friend the couch .
the customer gave your mother 's husband the boat .	the customer cleaned your mother 's husband the boat .
your teacher sent my father 's daughter the hat .	your teacher lost my father 's daughter the hat .
my friend gave your dentist 's wife the fork .	my friend dropped your dentist 's wife the fork .
my dentist sent my mom 's husband the shirt .	my dentist moved my mom 's husband the shirt .
the driver bought your grandmother 's friend the dish .	the driver held your grandmother 's friend the dish .
my dentist sent my daughter 's teacher the doll .	my dentist held my daughter 's teacher the doll .
Todd gave your wife 's mother the window .	Todd dropped your wife 's mother the window .
Patrick bought my father 's dentist the window .	Patrick shook my father 's dentist the window .
Nancy sent my mother 's teacher the rug .	Nancy dropped my mother 's teacher the rug .
Robert sent your mom 's father the toy .	Robert held your mom 's father the toy .
my teacher showed my father 's dad the truck .	my teacher lost my father 's dad the truck .
the customer showed your son 's cousin the candle .	the customer lost your son 's cousin the candle .
your teacher sent your daughter 's sister the ship .	your teacher moved your daughter 's sister the ship .
Alice sent my mother 's cousin the doll .	Alice dropped my mother 's cousin the doll .
my friend showed my dad 's father the bag .	my friend kept my dad 's father the bag .
the dancer sent your sister 's son the hat .	the dancer held your sister 's son the hat .
my teacher bought your dentist 's boss the ring .	my teacher kept your dentist 's boss the ring .
Jessica sent your mother 's doctor the bicycle .	Jessica cleaned your mother 's doctor the bicycle .
Erin bought my dentist 's wife the rug .	Erin cleaned my dentist 's wife the rug .
my doctor gave your teacher 's mom the bed .	my doctor shook your teacher 's mom the bed .
my doctor sent your doctor 's husband the hat .	my doctor lost your doctor 's husband the hat .
Sandra bought your mother 's father the hat .	Sandra kept your mother 's father the hat .
Brett bought your daughter 's mother the doll .	Brett lost your daughter 's mother the doll .
the driver showed your cousin 's wife the door .	the driver held your cousin 's wife the door .
the driver gave my father 's cousin the doll .	the driver dropped my father 's cousin the doll .
Ronald gave my dentist 's son the book .	Ronald cleaned my dentist 's son the book .
Nina bought my son 's daughter the book .	Nina cleaned my son 's daughter the book .
the patient gave my dentist 's brother the car .	the patient cleaned my dentist 's brother the car .
Catherine showed my doctor 's boss the box .	Catherine held my doctor 's boss the box .
my teacher showed my dentist 's wife the book .	my teacher held my dentist 's wife the book .
the dancer bought your cousin 's sister the cup .	the dancer cleaned your cousin 's sister the cup .
Michelle bought your sister 's friend the rug .	Michelle kept your sister 's friend the rug .
my boss showed my boss 's mother the doll .	my boss lost my boss 's mother the doll .
the driver bought your son 's dentist the window .	the driver kept your son 's dentist the window .
the driver showed your cousin 's daughter the bottle .	the driver lost your cousin 's daughter the bottle .
the doctor sent your mom 's dentist the plane .	the doctor moved your mom 's dentist the plane .
your friend gave my sister 's mother the bed .	your friend moved my sister 's mother the bed .
the child gave your dentist 's cousin the ship .	the child held your dentist 's cousin the ship .
the dancer gave your doctor 's dentist the chair .	the dancer kept your doctor 's dentist the chair .
Leslie bought your friend 's sister the shirt .	Leslie lost your friend 's sister the shirt .
my dentist gave my doctor 's mother the car .	my dentist cleaned my doctor 's mother the car .
Lisa sent your mother 's daughter the book .	Lisa shook your mother 's daughter the book .
your doctor showed your cousin 's cousin the window .	your doctor shook your cousin 's cousin the window .
my teacher gave your boss 's husband the rug .	my teacher cleaned your boss 's husband the rug .
the doctor sent my dentist 's dad the ship .	the doctor moved my dentist 's dad the ship .
Nicole sent my mother 's dentist the couch .	Nicole moved my mother 's dentist the couch .
the dancer gave your doctor 's daughter the ship .	the dancer held your doctor 's daughter the ship .
your teacher bought my boss 's teacher the car .	your teacher moved my boss 's teacher the car .
the dancer bought my father 's son the cup .	the dancer dropped my father 's son the cup .
your teacher gave your son 's dentist the car .	your teacher dropped your son 's dentist the car .
your teacher bought your sister 's father the book .	your teacher shook your sister 's father the book .
my dentist showed your father 's boss the bowl .	my dentist cleaned your father 's boss the bowl .
the dentist sent my daughter 's son the couch .	the dentist moved my daughter 's son the couch .
the child sent my dad 's dentist the mirror .	the child kept my dad 's dentist the mirror .
your teacher showed my dentist 's boss the boat .	your teacher kept my dentist 's boss the boat .
Jennifer sent my friend 's dentist the plane .	Jennifer kept my friend 's dentist the plane .
the patient bought my teacher 's teacher the box .	the patient lost my teacher 's teacher the box .
Naomi bought my brother 's sister the ship .	Naomi held my brother 's sister the ship .
your dentist sent your son 's father the fork .	your dentist dropped your son 's father the fork .
the adult showed my mother 's mother the car .	the adult kept my mother 's mother the car .
Judy bought my son 's boss the bicycle .	Judy dropped my son 's boss the bicycle .
your teacher sent your grandmother 's mother the toy .	your teacher kept your grandmother 's mother the toy .
the teacher showed my son 's wife the ring .	the teacher moved my son 's wife the ring .
your friend sent my daughter 's sister the ring .	your friend kept my daughter 's sister the ring .
my boss bought my husband 's dentist the door .	my boss dropped my husband 's dentist the door .
Gregory gave your mother 's sister the rocket .	Gregory shook your mother 's sister the rocket .
Frank gave my husband 's sister the spoon .	Frank cleaned my husband 's sister the spoon .
Sarah showed your sister 's mother the spoon .	Sarah shook your sister 's mother the spoon .
the adult bought your grandmother 's grandmother the candle .	the adult kept your grandmother 's grandmother the candle .
April showed my grandmother 's boss the glass .	April moved my grandmother 's boss the glass .
my cousin bought my mother 's daughter the fork .	my cousin moved my mother 's daughter the fork .
Steve showed your husband 's grandmother the glass .	Steve dropped your husband 's grandmother the glass .
Steve showed my daughter 's dentist the door .	Steve held my daughter 's dentist the door .
my dentist bought your father 's grandmother the rug .	my dentist lost your father 's grandmother the rug .
Barbara gave my mom 's wife the toy .	Barbara cleaned my mom 's wife the toy .
Anna sent your brother 's dentist the box .	Anna kept your brother 's dentist the box .
the doctor showed my son 's teacher the doll .	the doctor cleaned my son 's teacher the doll .
the child sent your doctor 's dentist the box .	the child cleaned your doctor 's dentist the box .
the driver gave your grandmother 's friend the rocket .	the driver held your grandmother 's friend the rocket .
my boss bought your husband 's grandmother the glass .	my boss kept your husband 's grandmother the glass .
the teacher bought my dad 's mother the glass .	the teacher lost my dad 's mother the glass .
the patient showed your wife 's father the couch .	the patient kept your wife 's father the couch .
my friend gave my doctor 's mom the candle .	my friend shook my doctor 's mom the candle .
the driver gave my grandmother 's son the candle .	the driver held my grandmother 's son the candle .
my dentist showed my dad 's teacher the bag .	my dentist moved my dad 's teacher the bag .
Richard sent your brother 's friend the cup .	Richard kept your brother 's friend the cup .
Julia bought my cousin 's dentist the picture .	Julia held my cousin 's dentist the picture .
your cousin sent your mother 's wife the crayon .	your cousin dropped your mother 's wife the crayon .
Marie sent your cousin 's wife the car .	Marie shook your cousin 's wife the car .
your friend bought my teacher 's dad the doll .	your friend cleaned my teacher 's dad the doll .
Christopher bought your son 's brother the couch .	Christopher kept your son 's brother the couch .
the driver sent my doctor 's friend the door .	the driver shook my doctor 's friend the door .
your teacher bought my mother 's wife the box .	your teacher held my mother 's wife the box .
my doctor showed your boss 's father the bowl .	my doctor lost your boss 's father the bowl .
Rebecca sent your grandmother 's grandmother the spoon .	Rebecca held your grandmother 's grandmother the spoon .
Christopher sent my daughter 's daughter the spoon .	Christopher moved my daughter 's daughter the spoon .
my doctor gave your doctor 's doctor the ship .	my doctor dropped your doctor 's doctor the ship .
Catherine gave your grandmother 's dad the plane .	Catherine moved your grandmother 's dad the plane .
my dentist sent your sister 's daughter the mirror .	my dentist shook your sister 's daughter the mirror .
Susan sent my dad 's brother the ship .	Susan lost my dad 's brother the ship .
Laurie bought my dentist 's wife the boat .	Laurie dropped my dentist 's wife the boat .
Jessica showed my daughter 's mom the toy .	Jessica dropped my daughter 's mom the toy .
Andrew showed your husband 's son the box .	Andrew kept your husband 's son the box .
your boss sent your dad 's mother the truck .	your boss kept your dad 's mother the truck .
Thomas bought your son 's son the hat .	Thomas kept your son 's son the hat .
Kristen sent your brother 's father the boat .	Kristen held your brother 's father the boat .
your cousin sent your wife 's daughter the chair .	your cousin shook your wife 's daughter the chair .
the driver sent my friend 's brother the bicycle .	the driver dropped my friend 's brother the bicycle .
your boss showed my mother 's father the mirror .	your boss kept my mother 's father the mirror .
your friend sent your brother 's boss the car .	your friend shook your brother 's boss the car .
the adult gave your wife 's dentist the car .	the adult lost your wife 's dentist the car .
the teacher showed my doctor 's friend the cup .	the teacher cleaned my doctor 's friend the cup .
Liam bought my wife 's son the dish .	Liam dropped my wife 's son the dish .
Samantha sent your teacher 's friend the rocket .	Samantha held your teacher 's friend the rocket .
the teacher gave your grandmother 's mom the bed .	the teacher lost your grandmother 's mom the bed .
your boss showed your mom 's grandmother the glass .	your boss kept your mom 's grandmother the glass .
the customer bought your dentist 's husband the box .	the customer kept your dentist 's husband the box .
your boss sent my doctor 's grandmother the window .	your boss cleaned my doctor 's grandmother the window .
my doctor showed my boss 's daughter the book .	my doctor cleaned my boss 's daughter the book .
your cousin showed my daughter 's father the ring .	your cousin dropped my daughter 's father the ring .
your boss showed my doctor 's mother the fork .	your boss held my doctor 's mother the fork .
Alexander showed your sister 's mother the bicycle .	Alexander cleaned your sister 's mother the bicycle .
the child bought my mother 's cousin the bottle .	the child kept my mother 's cousin the bottle .
Deborah gave your sister 's friend the box .	Deborah shook your sister 's friend the box .
Erin showed your dentist 's daughter the crayon .	Erin cleaned your dentist 's daughter the crayon .
the person bought your mom 's dad the plane .	the person dropped your mom 's dad the plane .
my doctor gave my daughter 's friend the bowl .	my doctor shook my daughter 's friend the bowl .
Noah bought your wife 's doctor the rug .	Noah held your wife 's doctor the rug .
my cousin bought your doctor 's doctor the car .	my cousin held your doctor 's doctor the car .
Mary bought your cousin 's friend the cup .	Mary kept your cousin 's friend the cup .
Kristen sent my boss 's father the rug .	Kristen kept my boss 's father the rug .
Janet sent your friend 's dentist the boat .	Janet lost your friend 's dentist the boat .
the dancer showed my mother 's grandmother the candle .	the dancer shook my mother 's grandmother the candle .
my friend gave my mother 's grandmother the bowl .	my friend dropped my mother 's grandmother the bowl .
Jason bought my sister 's boss the candle .	Jason dropped my sister 's boss the candle .
the driver gave my friend 's grandmother the book .	the driver cleaned my friend 's grandmother the book .
the adult gave your dentist 's son the plate .	the adult lost your dentist 's son the plate .
Steven sent your cousin 's wife the crayon .	Steven lost your cousin 's wife the crayon .
the driver sent my dentist 's teacher the car .	the driver kept my dentist 's teacher the car .
your cousin gave my mom 's sister the picture .	your cousin dropped my mom 's sister the picture .
my boss bought my wife 's mom the rocket .	my boss cleaned my wife 's mom the rocket .
Naomi bought your doctor 's father the car .	Naomi lost your doctor 's father the car .
your dentist gave your dad 's teacher the truck .	your dentist cleaned your dad 's teacher the truck .
the teacher sent my doctor 's cousin the toy .	the teacher held my doctor 's cousin the toy .
your friend gave my dad 's grandmother the bowl .	your friend held my dad 's grandmother the bowl .
the teacher showed your friend 's mother the window .	the teacher moved your friend 's mother the window .
the child sent your mom 's sister the plane .	the child moved your mom 's sister the plane .
Steven bought your husband 's mom the couch .	Steven kept your husband 's mom the couch .
your cousin bought my daughter 's grandmother the truck .	your cousin dropped my daughter 's grandmother the truck .
the child sent your teacher 's husband the truck .	the child dropped your teacher 's husband the truck .
my friend bought your dad 's dentist the bag .	my friend cleaned your dad 's dentist the bag .
the dancer showed your boss 's father the mirror .	the dancer lost your boss 's father the mirror .
Sandra showed my dad 's brother the window .	Sandra cleaned my dad 's brother the window .
the doctor showed your sister 's friend the toy .	the doctor kept your sister 's friend the toy .
your doctor showed my son 's dentist the plate .	your doctor held my son 's dentist the plate .
my doctor sent my mother 's grandmother the toy .	my doctor lost my mother 's grandmother the toy .
Rebecca bought my teacher 's mother the plate .	Rebecca dropped my teacher 's mother the plate .
your cousin showed my son 's teacher the plane .	your cousin moved my son 's teacher the plane .
my boss showed my doctor 's daughter the car .	my boss dropped my doctor 's daughter the car .
the dentist showed your friend 's husband the ring .	the dentist kept your friend 's husband the ring .
your boss showed my wife 's brother the chair .	your boss dropped my wife 's brother the chair .
your friend gave my mother 's son the plate .	your friend lost my mother 's son the plate .
Aaron sent your daughter 's teacher the bottle .	Aaron shook your daughter 's teacher the bottle .
the doctor showed your cousin 's son the picture .	the doctor cleaned your cousin 's son the picture .
James gave your grandmother 's brother the bottle .	James lost your grandmother 's brother the bottle .
the doctor bought your friend 's doctor the ring .	the doctor shook your friend 's doctor the ring .
my boss gave my daughter 's daughter the hat .	my boss dropped my daughter 's daughter the hat .
the patient sent my teacher 's father the shirt .	the patient dropped my teacher 's father the shirt .
the dentist sent your doctor 's mom the window .	the dentist held your doctor 's mom the window .
my dentist sent my wife 's daughter the bowl .	my dentist lost my wife 's daughter the bowl .
the dancer showed my doctor 's wife the truck .	the dancer dropped my doctor 's wife the truck .
my doctor bought my mother 's son the crayon .	my doctor dropped my mother 's son the crayon .
Jennifer showed your wife 's friend the mirror .	Jennifer cleaned your wife 's friend the mirror .
Sara showed my wife 's dentist the rocket .	Sara lost my wife 's dentist the rocket .
Martin bought your boss 's father the ship .	Martin cleaned your boss 's father the ship .
your teacher gave your cousin 's father the ship .	your teacher cleaned your cousin 's father the ship .
your doctor gave your son 's husband the car .	your doctor cleaned your son 's husband the car .
my dentist gave my sister 's dentist the bag .	my dentist lost my sister 's dentist the bag .
the dancer bought your wife 's cousin the door .	the dancer moved your wife 's cousin the door .
my boss sent my teacher 's son the spoon .	my boss dropped my teacher 's son the spoon .
the customer showed my wife 's dad the crayon .	the customer lost my wife 's dad the crayon .
Naomi showed your daughter 's father the truck .	Naomi lost your daughter 's father the truck .
Laurie bought my brother 's mom the bottle .	Laurie moved my brother 's mom the bottle .
the patient bought your brother 's grandmother the book .	the patient moved your brother 's grandmother the book .
your dentist bought your sister 's grandmother the button .	your dentist moved your sister 's grandmother the button .
your boss showed your son 's teacher the shirt .	your boss dropped your son 's teacher the shirt .
the doctor bought my son 's dentist the car .	the doctor lost my son 's dentist the car .
Aaron showed your grandmother 's father the fork .	Aaron moved your grandmother 's father the fork .
Brian bought my teacher 's friend the chair .	Brian cleaned my teacher 's friend the chair .
the adult showed my boss 's mom the toy .	the adult shook my boss 's mom the toy .
your cousin bought your teacher 's mother the truck .	your cousin moved your teacher 's mother the truck .
Jerry bought my son 's cousin the car .	Jerry kept my son 's cousin the car .
my doctor bought your father 's doctor the box .	my doctor moved your father 's doctor the box .
my friend bought my cousin 's cousin the toy .	my friend moved my cousin 's cousin the toy .
the dentist showed my son 's son the door .	the dentist cleaned my son 's son the door .
Barbara bought my mom 's father the shoe .	Barbara cleaned my mom 's father the shoe .
the driver gave your brother 's boss the button .	the driver shook your brother 's boss the button .
Kayla bought your brother 's grandmother the hat .	Kayla lost your brother 's grandmother the hat .
your friend sent my cousin 's sister the toy .	your friend shook my cousin 's sister the toy .
the child showed my doctor 's friend the bag .	the child cleaned my doctor 's friend the bag .
my teacher bought my mom 's grandmother the couch .	my teacher shook my mom 's grandmother the couch .
the adult bought your wife 's dad the cup .	the adult shook your wife 's dad the cup .
Catherine sent my doctor 's dentist the chair .	Catherine kept my doctor 's dentist the chair .
the adult sent my sister 's brother the rocket .	the adult kept my sister 's brother the rocket .
my doctor sent your doctor 's grandmother the glass .	my doctor dropped your doctor 's grandmother the glass .
Mary showed your father 's husband the truck .	Mary lost your father 's husband the truck .
Steve bought my boss 's son the bag .	Steve cleaned my boss 's son the bag .
your boss showed my dentist 's dad the plate .	your boss shook my dentist 's dad the plate .
my dentist sent your doctor 's teacher the cup .	my dentist cleaned your doctor 's teacher the cup .
Carol gave my daughter 's son the cup .	Carol held my daughter 's son the cup .
the dentist sent your husband 's friend the ship .	the dentist dropped your husband 's friend the ship .
my boss bought your son 's doctor the mirror .	my boss kept your son 's doctor the mirror .
my teacher gave your dad 's cousin the couch .	my teacher lost your dad 's cousin the couch .
Sarah showed your mother 's boss the shoe .	Sarah kept your mother 's boss the shoe .
my doctor bought your son 's husband the boat .	my doctor shook your son 's husband the boat .
the customer sent my dentist 's daughter the hat .	the customer dropped my dentist 's daughter the hat .
my dentist gave my dad 's sister the bottle .	my dentist dropped my dad 's sister the bottle .
the driver bought your mom 's daughter the car .	the driver dropped your mom 's daughter the car .
your boss sent your mother 's friend the bowl .	your boss kept your mother 's friend the bowl .
the child gave your boss 's daughter the book .	the child cleaned your boss 's daughter the book .
Martin showed my mom 's dentist the shirt .	Martin cleaned my mom 's dentist the shirt .
the dancer showed my mother 's friend the bottle .	the dancer dropped my mother 's friend the bottle .
Renee showed my daughter 's friend the candle .	Renee lost my daughter 's friend the candle .
the doctor showed your dad 's dentist the toy .	the doctor held your dad 's dentist the toy .
my teacher showed my father 's grandmother the bowl .	my teacher kept my father 's grandmother the bowl .
Julia gave my cousin 's boss the rug .	Julia kept my cousin 's boss the rug .
the doctor bought your son 's mom the bottle .	the doctor moved your son 's mom the bottle .
Guy sent your doctor 's teacher the car .	Guy cleaned your doctor 's teacher the car .
Erin bought my daughter 's daughter the window .	Erin cleaned my daughter 's daughter the window .
Alexander sent your dad 's mother the ring .	Alexander dropped your dad 's mother the ring .
my teacher bought my father 's cousin the spoon .	my teacher kept my father 's cousin the spoon .
your boss bought your boss 's sister the picture .	your boss lost your boss 's sister the picture .
the adult gave your boss 's boss the bowl .	the adult cleaned your boss 's boss the bowl .
the dentist sent your boss 's mom the bed .	the dentist lost your boss 's mom the bed .
Mark sent my mom 's doctor the cup .	Mark held my mom 's doctor the cup .
my boss sent my husband 's wife the bicycle .	my boss cleaned my husband 's wife the bicycle .
the child sent your doctor 's doctor the boat .	the child shook your doctor 's doctor the boat .
the dentist bought your dentist 's boss the toy .	the dentist kept your dentist 's boss the toy .
your dentist bought your cousin 's husband the rug .	your dentist cleaned your cousin 's husband the rug .
the driver gave your dad 's teacher the car .	the driver cleaned your dad 's teacher the car .
my boss bought my cousin 's boss the bicycle .	my boss moved my cousin 's boss the bicycle .
the child sent my boss 's grandmother the truck .	the child dropped my boss 's grandmother the truck .
my teacher gave my grandmother 's father the book .	my teacher kept my grandmother 's father the book .
the patient gave my mom 's dad the mirror .	the patient lost my mom 's dad the mirror .
Alexander bought your cousin 's dad the bicycle .	Alexander dropped your cousin 's dad the bicycle .
your teacher gave my wife 's grandmother the rug .	your teacher lost my wife 's grandmother the rug .
my teacher bought your father 's dentist the candle .	my teacher lost your father 's dentist the candle .
Jane sent your wife 's mom the chair .	Jane lost your wife 's mom the chair .
your boss sent your doctor 's sister the candle .	your boss kept your doctor 's sister the candle .
Martin showed your daughter 's mom the truck .	Martin held your daughter 's mom the truck .
the dancer gave my sister 's brother the ring .	the dancer moved my sister 's brother the ring .
the dentist gave my daughter 's friend the mirror .	the dentist shook my daughter 's friend the mirror .
your cousin showed your mom 's friend the hat .	your cousin cleaned your mom 's friend the hat .
my doctor sent my grandmother 's father the ship .	my doctor kept my grandmother 's father the ship .
my boss showed your dentist 's friend the car .	my boss shook your dentist 's friend the car .
the adult sent my friend 's doctor the car .	the adult shook my friend 's doctor the car .
your dentist showed your cousin 's dentist the bed .	your dentist lost your cousin 's dentist the bed .
the dancer bought your son 's daughter the window .	the dancer kept your son 's daughter the window .
my dentist sent my doctor 's doctor the plate .	my dentist held my doctor 's doctor the plate .
the patient sent my teacher 's husband the shirt .	the patient kept my teacher 's husband the shirt .
Carl gave your mom 's mother the mirror .	Carl kept your mom 's mother the mirror .
Brian gave my doctor 's son the spoon .	Brian cleaned my doctor 's son the spoon .
your friend gave my wife 's father the bed .	your friend held my wife 's father the bed .
your friend gave your wife 's mom the boat .	your friend kept your wife 's mom the boat .
your cousin gave my mother 's father the plate .	your cousin kept my mother 's father the plate .
your doctor bought your mother 's daughter the door .	your doctor lost your mother 's daughter the door .
your teacher showed your mom 's boss the ship .	your teacher shook your mom 's boss the ship .
your boss showed my friend 's wife the bottle .	your boss kept my friend 's wife the bottle .
the driver gave your brother 's boss the chair .	the driver moved your brother 's boss the chair .
the child gave your grandmother 's cousin the glass .	the child held your grandmother 's cousin the glass .
my teacher gave your doctor 's husband the cup .	my teacher moved your doctor 's husband the cup .
Wendy sent your teacher 's wife the couch .	Wendy moved your teacher 's wife the couch .
Linda sent my cousin 's mom the car .	Linda lost my cousin 's mom the car .
Julia bought my wife 's mother the crayon .	Julia kept my wife 's mother the crayon .
your friend bought my grandmother 's boss the box .	your friend kept my grandmother 's boss the box .
the dentist sent my doctor 's mother the truck .	the dentist moved my doctor 's mother the truck .
my doctor bought your son 's friend the bicycle .	my doctor moved your son 's friend the bicycle .
Sally sent your sister 's dad the car .	Sally held your sister 's dad the car .
the adult sent your dad 's wife the boat .	the adult cleaned your dad 's wife the boat .
the person showed your dentist 's daughter the ship .	the person shook your dentist 's daughter the ship .
Kevin bought my husband 's sister the ring .	Kevin cleaned my husband 's sister the ring .
the doctor showed your dentist 's brother the crayon .	the doctor held your dentist 's brother the crayon .
my doctor showed my boss 's brother the crayon .	my doctor moved my boss 's brother the crayon .
Stephanie gave your sister 's cousin the ship .	Stephanie held your sister 's cousin the ship .
the dentist gave my father 's cousin the spoon .	the dentist held my father 's cousin the spoon .
the dancer sent your daughter 's father the mirror .	the dancer held your daughter 's father the mirror .
Jason showed your teacher 's father the rocket .	Jason moved your teacher 's father the rocket .
April sent your teacher 's son the rug .	April kept your teacher 's son the rug .
my boss showed my cousin 's daughter the shirt .	my boss kept my cousin 's daughter the shirt .
the doctor showed my friend 's sister the box .	the doctor shook my friend 's sister the box .
my friend gave my friend 's mom the spoon .	my friend shook my friend 's mom the spoon .
the child bought your father 's doctor the bag .	the child dropped your father 's doctor the bag .
your doctor bought your daughter 's boss the bowl .	your doctor held your daughter 's boss the bowl .
Julie showed my mother 's dad the ring .	Julie cleaned my mother 's dad the ring .
the dancer gave your dentist 's boss the rug .	the dancer kept your dentist 's boss the rug .
the adult bought my brother 's wife the bottle .	the adult kept my brother 's wife the bottle .
the child showed my sister 's grandmother the book .	the child cleaned my sister 's grandmother the book .
my boss showed my cousin 's friend the book .	my boss shook my cousin 's friend the book .
my dentist gave your teacher 's husband the car .	my dentist shook your teacher 's husband the car .
your cousin sent my wife 's mother the bowl .	your cousin cleaned my wife 's mother the bowl .
the customer gave your cousin 's grandmother the dish .	the customer moved your cousin 's grandmother the dish .
Rebecca showed my grandmother 's brother the boat .	Rebecca cleaned my grandmother 's brother the boat .
your friend gave your mother 's boss the glass .	your friend moved your mother 's boss the glass .
the person bought my dad 's boss the couch .	the person held my dad 's boss the couch .
Travis bought your dad 's wife the ship .	Travis dropped your dad 's wife the ship .
the patient bought my sister 's wife the couch .	the patient lost my sister 's wife the couch .
my dentist showed my teacher 's husband the truck .	my dentist shook my teacher 's husband the truck .
Leslie sent my daughter 's brother the toy .	Leslie moved my daughter 's brother the toy .
your dentist bought my dentist 's sister the book .	your dentist lost my dentist 's sister the book .
the person gave your dentist 's grandmother the car .	the person dropped your dentist 's grandmother the car .
my friend sent my friend 's sister the shirt .	my friend kept my friend 's sister the shirt .
my boss showed my mom 's wife the boat .	my boss held my mom 's wife the boat .
the teacher bought my son 's friend the picture .	the teacher lost my son 's friend the picture .
your friend showed my dentist 's cousin the spoon .	your friend moved my dentist 's cousin the spoon .
the patient showed your doctor 's doctor the doll .	the patient held your doctor 's doctor the doll .
your dentist gave my wife 's doctor the shoe .	your dentist shook my wife 's doctor the shoe .
Brett sent your father 's husband the chair .	Brett kept your father 's husband the chair .
my doctor bought my dad 's daughter the bag .	my doctor shook my dad 's daughter the bag .
the person sent your mom 's teacher the dish .	the person kept your mom 's teacher the dish .
Jessica gave your husband 's mom the ring .	Jessica lost your husband 's mom the ring .
the patient sent your dentist 's son the rocket .	the patient kept your dentist 's son the rocket .
the patient gave your dad 's daughter the button .	the patient kept your dad 's daughter the button .
the driver showed your sister 's teacher the glass .	the driver dropped your sister 's teacher the glass .
your cousin gave your father 's husband the book .	your cousin dropped your father 's husband the book .
the adult gave my daughter 's teacher the bottle .	the adult lost my daughter 's teacher the bottle .
the dentist showed your doctor 's dentist the car .	the dentist moved your doctor 's dentist the car .
the person sent your mother 's daughter the shirt .	the person dropped your mother 's daughter the shirt .
the driver gave your dentist 's cousin the box .	the driver kept your dentist 's cousin the box .
your friend gave my dad 's boss the ring .	your friend kept my dad 's boss the ring .
your boss sent my dentist 's son the box .	your boss lost my dentist 's son the box .
my teacher gave my brother 's daughter the bowl .	my teacher shook my brother 's daughter the bowl .
the adult showed your son 's wife the crayon .	the adult cleaned your son 's wife the crayon .
your cousin sent your son 's sister the ring .	your cousin cleaned your son 's sister the ring .
the patient sent your doctor 's teacher the bowl .	the patient cleaned your doctor 's teacher the bowl .
the customer sent my mom 's dentist the mirror .	the customer lost my mom 's dentist the mirror .
Cindy gave my husband 's brother the book .	Cindy kept my husband 's brother the book .
Brian sent my dentist 's boss the shoe .	Brian held my dentist 's boss the shoe .
the dentist gave my dentist 's father the bowl .	the dentist moved my dentist 's father the bowl .
your teacher sent your grandmother 's dad the plate .	your teacher lost your grandmother 's dad the plate .
my boss gave your mom 's doctor the bed .	my boss moved your mom 's doctor the bed .
my friend bought my grandmother 's sister the door .	my friend lost my grandmother 's sister the door .
Steven sent your son 's teacher the button .	Steven shook your son 's teacher the button .
Nina sent my mom 's teacher the window .	Nina shook my mom 's teacher the window .
the customer sent my father 's brother the chair .	the customer held my father 's brother the chair .
my cousin showed your dad 's sister the shirt .	my cousin shook your dad 's sister the shirt .
Robert showed your sister 's boss the candle .	Robert kept your sister 's boss the candle .
Aaron bought your brother 's brother the book .	Aaron held your brother 's brother the book .
my boss sent your mom 's daughter the car .	my boss dropped your mom 's daughter the car .
your teacher showed your daughter 's brother the plane .	your teacher dropped your daughter 's brother the plane .
your cousin gave my son 's dentist the crayon .	your cousin kept my son 's dentist the crayon .
the child bought my friend 's son the bicycle .	the child held my friend 's son the bicycle .
the person gave my dad 's husband the toy .	the person cleaned my dad 's husband the toy .
my cousin showed your mother 's husband the button .	my cousin dropped your mother 's husband the button .
Kristen sent your mom 's sister the bag .	Kristen dropped your mom 's sister the bag .
my cousin showed my mother 's friend the couch .	my cousin cleaned my mother 's friend the couch .
the child sent my grandmother 's teacher the candle .	the child held my grandmother 's teacher the candle .
Allison showed your sister 's cousin the ring .	Allison held your sister 's cousin the ring .
Jerry gave your teacher 's brother the toy .	Jerry held your teacher 's brother the toy .
my friend bought my teacher 's sister the car .	my friend moved my teacher 's sister the car .
my teacher sent your dad 's husband the rocket .	my teacher moved your dad 's husband the rocket .
the patient sent my wife 's doctor the door .	the patient lost my wife 's doctor the door .
Paul gave your cousin 's doctor the box .	Paul held your cousin 's doctor the box .
your friend showed my mom 's husband the shoe .	your friend kept my mom 's husband the shoe .
Nina showed your teacher 's teacher the rug .	Nina held your teacher 's teacher the rug .
the dentist gave my friend 's wife the boat .	the dentist shook my friend 's wife the boat .
my cousin bought my mom 's husband the crayon .	my cousin held my mom 's husband the crayon .
your boss showed my brother 's cousin the plate .	your boss lost my brother 's cousin the plate .
your boss showed my friend 's son the rocket .	your boss held my friend 's son the rocket .
Kevin sent my doctor 's friend the bag .	Kevin lost my doctor 's friend the bag .
my boss sent my mother 's father the bottle .	my boss lost my mother 's father the bottle .
Thomas gave your mom 's wife the toy .	Thomas kept your mom 's wife the toy .
Timothy bought my wife 's mom the window .	Timothy kept my wife 's mom the window .
Karen sent your boss 's grandmother the ship .	Karen dropped your boss 's grandmother the ship .
the person sent my grandmother 's teacher the bowl .	the person cleaned my grandmother 's teacher the bowl .
the driver showed my mom 's husband the hat .	the driver held my mom 's husband the hat .
the doctor sent your cousin 's dad the window .	the doctor lost your cousin 's dad the window .
my dentist bought my wife 's teacher the glass .	my dentist cleaned my wife 's teacher the glass .
the patient showed my father 's dentist the button .	the patient dropped my father 's dentist the button .
my dentist sent my son 's daughter the plane .	my dentist moved my son 's daughter the plane .
Melissa sent your daughter 's grandmother the candle .	Melissa cleaned your daughter 's grandmother the candle .
the adult sent your friend 's boss the doll .	the adult dropped your friend 's boss the doll .
Guy gave your cousin 's son the button .	Guy held your cousin 's son the button .
the dancer sent your father 's grandmother the candle .	the dancer dropped your father 's grandmother the candle .
the child showed my wife 's sister the crayon .	the child lost my wife 's sister the crayon .
my dentist sent your boss 's cousin the box .	my dentist moved your boss 's cousin the box .
Anne bought your husband 's boss the window .	Anne lost your husband 's boss the window .
my boss bought your boss 's husband the bed .	my boss lost your boss 's husband the bed .
Scott showed your mother 's wife the doll .	Scott held your mother 's wife the doll .
the child sent my husband 's grandmother the button .	the child moved my husband 's grandmother the button .
my friend showed your mom 's grandmother the rug .	my friend dropped your mom 's grandmother the rug .
Rachel gave your dentist 's grandmother the glass .	Rachel shook your dentist 's grandmother the glass .
Stephanie gave your grandmother 's son the truck .	Stephanie moved your grandmother 's son the truck .
Emily bought my grandmother 's husband the glass .	Emily lost my grandmother 's husband the glass .
the dancer showed my doctor 's wife the rocket .	the dancer lost my doctor 's wife the rocket .
Lisa showed your friend 's son the bed .	Lisa kept your friend 's son the bed .
my boss sent your grandmother 's doctor the doll .	my boss lost your grandmother 's doctor the doll .
my teacher sent my daughter 's boss the box .	my teacher shook my daughter 's boss the box .
your teacher bought your sister 's grandmother the car .	your teacher kept your sister 's grandmother the car .
your doctor bought your doctor 's daughter the shoe .	your doctor held your doctor 's daughter the shoe .
the doctor showed my mom 's brother the crayon .	the doctor kept my mom 's brother the crayon .
Noah showed my boss 's dentist the bed .	Noah lost my boss 's dentist the bed .
your dentist showed your sister 's teacher the candle .	your dentist shook your sister 's teacher the candle .
Donna sent your mom 's daughter the dish .	Donna cleaned your mom 's daughter the dish .
Timothy gave my friend 's daughter the car .	Timothy shook my friend 's daughter the car .
Judy showed your wife 's dad the button .	Judy kept your wife 's dad the button .
my friend sent my wife 's mother the door .	my friend lost my wife 's mother the door .
the dentist showed your mom 's mom the doll .	the dentist shook your mom 's mom the doll .
the dentist sent your mother 's father the bag .	the dentist kept your mother 's father the bag .
Julia gave my son 's son the picture .	Julia dropped my son 's son the picture .
the adult sent your dentist 's daughter the couch .	the adult dropped your dentist 's daughter the couch .
your boss gave my mom 's son the plate .	your boss cleaned my mom 's son the plate .
the adult gave your grandmother 's dad the crayon .	the adult moved your grandmother 's dad the crayon .
my cousin showed my mom 's teacher the shoe .	my cousin kept my mom 's teacher the shoe .
William bought my friend 's dad the button .	William shook my friend 's dad the button .
my dentist showed your boss 's boss the button .	my dentist dropped your boss 's boss the button .
the teacher bought your sister 's doctor the ship .	the teacher kept your sister 's doctor the ship .
your cousin bought your father 's doctor the bed .	your cousin lost your father 's doctor the bed .
the patient sent my wife 's daughter the plate .	the patient moved my wife 's daughter the plate .
the dancer bought my mother 's father the bed .	the dancer moved my mother 's father the bed .
the child sent your grandmother 's boss the bag .	the child cleaned your grandmother 's boss the bag .
the child sent my cousin 's sister the bottle .	the child kept my cousin 's sister the bottle .
your teacher showed your daughter 's dentist the crayon .	your teacher dropped your daughter 's dentist the crayon .
my cousin gave my cousin 's grandmother the bottle .	my cousin kept my cousin 's grandmother the bottle .
the doctor showed your mother 's sister the bowl .	the doctor kept your mother 's sister the bowl .
the teacher bought your boss 's father the toy .	the teacher cleaned your boss 's father the toy .
the teacher sent my sister 's boss the car .	the teacher held my sister 's boss the car .
the dancer sent my dad 's sister the couch .	the dancer lost my dad 's sister the couch .
Sandra gave my sister 's boss the cup .	Sandra kept my sister 's boss the cup .
your cousin gave my wife 's mom the book .	your cousin held my wife 's mom the book .
the customer gave my friend 's father the bicycle .	the customer shook my friend 's father the bicycle .
my friend showed your sister 's mother the shoe .	my friend moved your sister 's mother the shoe .
the adult showed my mother 's doctor the plane .	the adult kept my mother 's doctor the plane .
the patient sent my mother 's boss the door .	the patient cleaned my mother 's boss the door .
the adult bought your brother 's doctor the book .	the adult moved your brother 's doctor the book .
my friend showed my sister 's daughter the rug .	my friend lost my sister 's daughter the rug .
Laura sent your father 's boss the ship .	Laura kept your father 's boss the ship .
the customer sent my sister 's doctor the doll .	the customer dropped my sister 's doctor the doll .
Christopher bought your grandmother 's father the shoe .	Christopher moved your grandmother 's father the shoe .
