the door was healthy .	the door reads healthy .
the truck was wrong .	the truck talks wrong .
the crayon was friendly .	the crayon waves friendly .
the rug is smart .	the rug reads smart .
the shirt is young .	the shirt reads young .
the rocket is wrong .	the rocket cries wrong .
the candle was happy .	the candle talks happy .
the car was confused .	the car talks confused .
the chair was careful .	the chair paints careful .
the ship was happy .	the ship talks happy .
the doll was happy .	the doll exercises happy .
the crayon was tired .	the crayon paints tired .
the crayon was excited .	the crayon reads excited .
the bowl was gentle .	the bowl exercises gentle .
the doll is busy .	the doll paints busy .
the doll is upset .	the doll cries upset .
the book is hungry .	the book waves hungry .
the doll is lucky .	the doll reads lucky .
the ring was nice .	the ring cries nice .
the glass is healthy .	the glass talks healthy .
the book is important .	the book paints important .
the plate is wrong .	the plate sings wrong .
the hat was tall .	the hat cries tall .
the chair is important .	the chair paints important .
the plate was happy .	the plate exercises happy .
the button was gentle .	the button reads gentle .
the bed was tired .	the bed waves tired .
the boat is excited .	the boat reads excited .
the rug was friendly .	the rug sings friendly .
the fork is tall .	the fork talks tall .
the candle was bored .	the candle reads bored .
the couch was wrong .	the couch talks wrong .
the rug is hungry .	the rug cries hungry .
the shirt was young .	the shirt cries young .
the ship is upset .	the ship exercises upset .
the bed was smart .	the bed sings smart .
the boat was happy .	the boat sings happy .
the crayon is sleepy .	the crayon reads sleepy .
the candle was quiet .	the candle talks quiet .
the truck is smart .	the truck paints smart .
the bowl is happy .	the bowl exercises happy .
the chair was strong .	the chair sings strong .
the spoon is strong .	the spoon waves strong .
the spoon was important .	the spoon waves important .
the bed is clever .	the bed reads clever .
the candle is curious .	the candle waves curious .
the picture is boring .	the picture talks boring .
the button is important .	the button talks important .
the boat was quiet .	the boat exercises quiet .
the box is strong .	the box paints strong .
the spoon was gentle .	the spoon reads gentle .
the car is tall .	the car reads tall .
the glass was curious .	the glass exercises curious .
the ring is clever .	the ring talks clever .
the toy is important .	the toy paints important .
the shoe was kind .	the shoe waves kind .
the car is tired .	the car waves tired .
the shirt is happy .	the shirt exercises happy .
the cup is happy .	the cup reads happy .
the door is gentle .	the door reads gentle .
the glass was healthy .	the glass sings healthy .
the plate was gentle .	the plate waves gentle .
the toy is hungry .	the toy talks hungry .
the shoe was boring .	the shoe talks boring .
the toy was excited .	the toy sings excited .
the doll was busy .	the doll sings busy .
the dish was sleepy .	the dish exercises sleepy .
the bed is quiet .	the bed cries quiet .
the book is bored .	the book waves bored .
the boat was excited .	the boat sings excited .
the window is nice .	the window talks nice .
the doll is angry .	the doll paints angry .
the bottle was quiet .	the bottle talks quiet .
the toy is clever .	the toy waves clever .
the ring is sleepy .	the ring cries sleepy .
the plate is clever .	the plate paints clever .
the spoon is careful .	the spoon talks careful .
the bicycle was bored .	the bicycle cries bored .
the box is kind .	the box paints kind .
the bed is helpful .	the bed reads helpful .
the glass is excited .	the glass talks excited .
the book was busy .	the book reads busy .
the bowl is lucky .	the bowl waves lucky .
the bag was strong .	the bag paints strong .
the boat is healthy .	the boat waves healthy .
the car was quiet .	the car sings quiet .
the mirror was curious .	the mirror sings curious .
the couch was quiet .	the couch exercises quiet .
the fork is nice .	the fork waves nice .
the spoon was friendly .	the spoon paints friendly .
the truck was busy .	the truck sings busy .
the doll was kind .	the doll waves kind .
the rug was busy .	the rug sings busy .
the bag was smart .	the bag exercises smart .
the rocket is young .	the rocket exercises young .
the crayon was strong .	the crayon sings strong .
the shoe is lucky .	the shoe reads lucky .
the chair was nice .	the chair waves nice .
the toy was wrong .	the toy sings wrong .
the cup is healthy .	the cup exercises healthy .
the cup was tired .	the cup waves tired .
the box is surprised .	the box cries surprised .
the rocket was angry .	the rocket waves angry .
the bag is strong .	the bag cries strong .
the glass was excited .	the glass talks excited .
the rocket was bored .	the rocket talks bored .
the plate is tired .	the plate talks tired .
the box is smart .	the box exercises smart .
the window is upset .	the window reads upset .
the plane was lucky .	the plane paints lucky .
the plane is careful .	the plane cries careful .
the truck was important .	the truck sings important .
the dish is curious .	the dish reads curious .
the candle is clever .	the candle reads clever .
the crayon was strong .	the crayon exercises strong .
the picture is confused .	the picture cries confused .
the picture was friendly .	the picture paints friendly .
the cup is excited .	the cup waves excited .
the glass is careful .	the glass reads careful .
the spoon was upset .	the spoon cries upset .
the glass was friendly .	the glass reads friendly .
the button is happy .	the button cries happy .
the bag was busy .	the bag exercises busy .
the boat is careful .	the boat sings careful .
the shirt was tired .	the shirt sings tired .
the box was healthy .	the box reads healthy .
the picture is wrong .	the picture talks wrong .
the door was happy .	the door exercises happy .
the shoe is young .	the shoe reads young .
the boat was nice .	the boat exercises nice .
the door was boring .	the door exercises boring .
the candle was strong .	the candle paints strong .
the book was hungry .	the book reads hungry .
the door is young .	the door waves young .
the candle was surprised .	the candle cries surprised .
the plane is curious .	the plane talks curious .
the plane is tired .	the plane exercises tired .
the plate is kind .	the plate talks kind .
the truck was wrong .	the truck reads wrong .
the plane is wrong .	the plane cries wrong .
the shoe was hungry .	the shoe exercises hungry .
the bicycle was upset .	the bicycle sings upset .
the plane was upset .	the plane paints upset .
the spoon is tall .	the spoon cries tall .
the mirror is important .	the mirror exercises important .
the bicycle is curious .	the bicycle talks curious .
the bicycle was hungry .	the bicycle cries hungry .
the fork is upset .	the fork reads upset .
the rug was tall .	the rug exercises tall .
the crayon was strong .	the crayon talks strong .
the book was careful .	the book exercises careful .
the plate was careful .	the plate waves careful .
the dish was smart .	the dish reads smart .
the box was happy .	the box exercises happy .
the truck was clever .	the truck paints clever .
the doll is curious .	the doll paints curious .
the bed is strong .	the bed reads strong .
the car is quiet .	the car paints quiet .
the glass was tall .	the glass reads tall .
the box is tall .	the box waves tall .
the bowl is happy .	the bowl waves happy .
the spoon was friendly .	the spoon waves friendly .
the picture is quiet .	the picture talks quiet .
the button was tired .	the button waves tired .
the button is wrong .	the button cries wrong .
the shirt is curious .	the shirt exercises curious .
the couch was tall .	the couch cries tall .
the rocket is confused .	the rocket exercises confused .
the cup was clever .	the cup waves clever .
the shoe is friendly .	the shoe cries friendly .
the window is nice .	the window cries nice .
the ring was young .	the ring exercises young .
the car is nice .	the car waves nice .
the bed was curious .	the bed sings curious .
the rocket was upset .	the rocket sings upset .
the door was helpful .	the door sings helpful .
the box was clever .	the box waves clever .
the button is important .	the button paints important .
the picture is friendly .	the picture paints friendly .
the couch is careful .	the couch talks careful .
the spoon was angry .	the spoon talks angry .
the shoe is bored .	the shoe talks bored .
the button was excited .	the button waves excited .
the boat was boring .	the boat sings boring .
the ship was angry .	the ship cries angry .
the truck is sleepy .	the truck reads sleepy .
the crayon is important .	the crayon sings important .
the ring is excited .	the ring sings excited .
the doll was quiet .	the doll paints quiet .
the dish is boring .	the dish reads boring .
the chair was young .	the chair paints young .
the shirt was tired .	the shirt cries tired .
the ship is gentle .	the ship exercises gentle .
the book was young .	the book paints young .
the ship is quiet .	the ship talks quiet .
the plate was clever .	the plate sings clever .
the plane was smart .	the plane talks smart .
the candle was nice .	the candle talks nice .
the crayon was boring .	the crayon sings boring .
the picture was excited .	the picture talks excited .
the shoe is tall .	the shoe sings tall .
the bicycle is tall .	the bicycle sings tall .
the doll is tall .	the doll sings tall .
the candle is quiet .	the candle talks quiet .
the truck was boring .	the truck cries boring .
the shoe is smart .	the shoe waves smart .
the doll is sleepy .	the doll sings sleepy .
the truck was excited .	the truck reads excited .
the bottle is bored .	the bottle paints bored .
the bicycle is friendly .	the bicycle talks friendly .
the doll is clever .	the doll talks clever .
the plane is smart .	the plane sings smart .
the bed was healthy .	the bed talks healthy .
the mirror was confused .	the mirror talks confused .
the fork is friendly .	the fork reads friendly .
the bed is healthy .	the bed cries healthy .
the cup was upset .	the cup paints upset .
the hat was young .	the hat reads young .
the fork was excited .	the fork paints excited .
the dish was healthy .	the dish waves healthy .
the shoe was bored .	the shoe paints bored .
the plate was nice .	the plate sings nice .
the rocket is happy .	the rocket cries happy .
the bicycle was nice .	the bicycle paints nice .
the doll is healthy .	the doll paints healthy .
the rocket was young .	the rocket sings young .
the toy is hungry .	the toy waves hungry .
the shirt was upset .	the shirt cries upset .
the chair is happy .	the chair sings happy .
the car was angry .	the car cries angry .
the car is young .	the car paints young .
the spoon is tired .	the spoon waves tired .
the fork was careful .	the fork talks careful .
the bottle is angry .	the bottle waves angry .
the picture was busy .	the picture cries busy .
the bowl was excited .	the bowl sings excited .
the fork was young .	the fork cries young .
the fork is bored .	the fork talks bored .
the dish was boring .	the dish exercises boring .
the couch is angry .	the couch exercises angry .
the doll was busy .	the doll waves busy .
the rug was happy .	the rug reads happy .
the crayon is bored .	the crayon waves bored .
the ring was tall .	the ring cries tall .
the hat is hungry .	the hat paints hungry .
the doll is smart .	the doll reads smart .
the book was boring .	the book cries boring .
the candle was curious .	the candle waves curious .
the bed was busy .	the bed waves busy .
the crayon was strong .	the crayon cries strong .
the toy was sleepy .	the toy waves sleepy .
the shirt was angry .	the shirt sings angry .
the couch is strong .	the couch talks strong .
the plane is surprised .	the plane waves surprised .
the picture is boring .	the picture waves boring .
the picture was young .	the picture reads young .
the truck was quiet .	the truck reads quiet .
the truck was gentle .	the truck talks gentle .
the dish is young .	the dish exercises young .
the rocket is wrong .	the rocket reads wrong .
the rug was tall .	the rug reads tall .
the candle was angry .	the candle talks angry .
the ship is clever .	the ship waves clever .
the mirror was bored .	the mirror exercises bored .
the door was quiet .	the door talks quiet .
the ring was hungry .	the ring sings hungry .
the box was excited .	the box exercises excited .
the couch was hungry .	the couch talks hungry .
the hat was helpful .	the hat paints helpful .
the candle was boring .	the candle reads boring .
the glass is upset .	the glass talks upset .
the rug was wrong .	the rug waves wrong .
the crayon is friendly .	the crayon paints friendly .
the ring is careful .	the ring exercises careful .
the shirt is careful .	the shirt paints careful .
the ship is surprised .	the ship reads surprised .
the plate was careful .	the plate cries careful .
the bed was boring .	the bed paints boring .
the bed is tired .	the bed waves tired .
the window is friendly .	the window exercises friendly .
the rocket was boring .	the rocket paints boring .
the mirror was tired .	the mirror reads tired .
the ship was happy .	the ship exercises happy .
the button was careful .	the button cries careful .
the candle was hungry .	the candle cries hungry .
the cup is tired .	the cup cries tired .
the box was clever .	the box reads clever .
the couch was confused .	the couch reads confused .
the glass is confused .	the glass paints confused .
the picture is tired .	the picture paints tired .
the glass was strong .	the glass paints strong .
the spoon is curious .	the spoon sings curious .
the chair is confused .	the chair paints confused .
the book is tall .	the book exercises tall .
the hat is strong .	the hat waves strong .
the ring is bored .	the ring talks bored .
the bottle is helpful .	the bottle waves helpful .
the toy is gentle .	the toy cries gentle .
the fork was confused .	the fork talks confused .
the car was strong .	the car paints strong .
the mirror was young .	the mirror waves young .
the doll is clever .	the doll exercises clever .
the window is tired .	the window waves tired .
the book was helpful .	the book paints helpful .
the truck was quiet .	the truck waves quiet .
the cup was boring .	the cup waves boring .
the glass was confused .	the glass paints confused .
the box was surprised .	the box talks surprised .
the car was curious .	the car reads curious .
the couch was confused .	the couch talks confused .
the door was upset .	the door sings upset .
the boat was surprised .	the boat talks surprised .
the couch is wrong .	the couch exercises wrong .
the rocket was boring .	the rocket exercises boring .
the ring is important .	the ring exercises important .
the button was smart .	the button exercises smart .
the truck was wrong .	the truck sings wrong .
the picture was healthy .	the picture waves healthy .
the window is surprised .	the window cries surprised .
the picture is curious .	the picture talks curious .
the bowl is tall .	the bowl cries tall .
the toy is important .	the toy cries important .
the book was surprised .	the book cries surprised .
the box is curious .	the box reads curious .
the boat was sleepy .	the boat talks sleepy .
the hat is lucky .	the hat waves lucky .
the ship is helpful .	the ship exercises helpful .
the car was gentle .	the car paints gentle .
the rug is hungry .	the rug paints hungry .
the hat is helpful .	the hat reads helpful .
the ring is surprised .	the ring sings surprised .
the chair was sleepy .	the chair cries sleepy .
the book was helpful .	the book waves helpful .
the rocket was wrong .	the rocket sings wrong .
the car was tired .	the car reads tired .
the fork is young .	the fork sings young .
the door is young .	the door cries young .
the shirt is tall .	the shirt paints tall .
the hat was kind .	the hat exercises kind .
the chair was hungry .	the chair exercises hungry .
the doll was young .	the doll waves young .
the toy was busy .	the toy paints busy .
the car was kind .	the car waves kind .
the window is excited .	the window paints excited .
the bag is busy .	the bag sings busy .
the truck was sleepy .	the truck talks sleepy .
the candle is nice .	the candle paints nice .
the button was nice .	the button talks nice .
the toy is important .	the toy sings important .
the book is happy .	the book cries happy .
the dish was hungry .	the dish paints hungry .
the toy is strong .	the toy paints strong .
the spoon was tall .	the spoon paints tall .
the picture is smart .	the picture cries smart .
the hat was helpful .	the hat waves helpful .
the crayon was gentle .	the crayon talks gentle .
the cup is gentle .	the cup cries gentle .
the car is gentle .	the car reads gentle .
the ring was surprised .	the ring exercises surprised .
the fork is happy .	the fork reads happy .
the car is surprised .	the car reads surprised .
the doll was tired .	the doll reads tired .
the rug was helpful .	the rug reads helpful .
the plane was important .	the plane reads important .
the door was kind .	the door talks kind .
the crayon was tired .	the crayon cries tired .
the dish was happy .	the dish exercises happy .
the glass is careful .	the glass talks careful .
the window was clever .	the window exercises clever .
the candle was strong .	the candle reads strong .
the couch was upset .	the couch cries upset .
the book is nice .	the book cries nice .
the plate is angry .	the plate exercises angry .
the bag is important .	the bag cries important .
the bicycle is surprised .	the bicycle cries surprised .
the hat is angry .	the hat cries angry .
the bowl is angry .	the bowl talks angry .
the door is bored .	the door paints bored .
the book is healthy .	the book reads healthy .
the cup is happy .	the cup cries happy .
the ship was friendly .	the ship exercises friendly .
the glass was quiet .	the glass reads quiet .
the car was important .	the car talks important .
the bottle was boring .	the bottle reads boring .
the bicycle is tall .	the bicycle paints tall .
the box is hungry .	the box reads hungry .
the fork is kind .	the fork sings kind .
the car was careful .	the car talks careful .
the truck was nice .	the truck talks nice .
the plate is careful .	the plate paints careful .
the fork is bored .	the fork waves bored .
the boat is quiet .	the boat talks quiet .
the chair was kind .	the chair reads kind .
the shirt is helpful .	the shirt reads helpful .
the spoon was quiet .	the spoon reads quiet .
the doll was friendly .	the doll cries friendly .
the window was hungry .	the window sings hungry .
the picture was quiet .	the picture cries quiet .
the picture was clever .	the picture waves clever .
the car is upset .	the car sings upset .
the couch is excited .	the couch paints excited .
the bicycle was wrong .	the bicycle waves wrong .
the couch was important .	the couch talks important .
the mirror was important .	the mirror waves important .
the shirt was busy .	the shirt cries busy .
the bicycle was smart .	the bicycle talks smart .
the rocket is confused .	the rocket waves confused .
the ship was strong .	the ship exercises strong .
the candle is helpful .	the candle talks helpful .
the bed is sleepy .	the bed waves sleepy .
the toy is lucky .	the toy exercises lucky .
the rocket is happy .	the rocket waves happy .
the rug was smart .	the rug sings smart .
the boat is strong .	the boat talks strong .
the cup was clever .	the cup sings clever .
the mirror was upset .	the mirror sings upset .
the bowl was nice .	the bowl cries nice .
the shoe was tall .	the shoe waves tall .
the plate was young .	the plate paints young .
the book is helpful .	the book exercises helpful .
the couch is careful .	the couch sings careful .
the car was healthy .	the car talks healthy .
the cup was young .	the cup talks young .
the button is helpful .	the button talks helpful .
the crayon is hungry .	the crayon exercises hungry .
the dish is nice .	the dish sings nice .
the rug was upset .	the rug talks upset .
the ring is clever .	the ring reads clever .
the crayon is surprised .	the crayon paints surprised .
the car was bored .	the car paints bored .
the spoon is wrong .	the spoon exercises wrong .
the plane is strong .	the plane sings strong .
the toy is hungry .	the toy exercises hungry .
the fork was tired .	the fork reads tired .
the shoe is important .	the shoe sings important .
the doll was bored .	the doll cries bored .
the bicycle was healthy .	the bicycle talks healthy .
the fork was excited .	the fork waves excited .
the bed was tired .	the bed cries tired .
the crayon is important .	the crayon cries important .
the plate is healthy .	the plate cries healthy .
the boat is busy .	the boat cries busy .
the bottle is wrong .	the bottle sings wrong .
the candle is young .	the candle sings young .
the ring was smart .	the ring reads smart .
the hat was excited .	the hat cries excited .
the ring was gentle .	the ring talks gentle .
the truck is important .	the truck paints important .
the car was sleepy .	the car sings sleepy .
the spoon was tired .	the spoon reads tired .
the couch is wrong .	the couch sings wrong .
the mirror is kind .	the mirror talks kind .
the box is upset .	the box waves upset .
the button is friendly .	the button sings friendly .
the shirt was quiet .	the shirt talks quiet .
the truck was excited .	the truck sings excited .
the bag was wrong .	the bag exercises wrong .
the shoe was clever .	the shoe talks clever .
the ring was clever .	the ring sings clever .
the rocket was helpful .	the rocket paints helpful .
the bed was careful .	the bed waves careful .
the boat is curious .	the boat cries curious .
the truck is friendly .	the truck paints friendly .
the truck is curious .	the truck exercises curious .
the glass was confused .	the glass sings confused .
the cup was careful .	the cup paints careful .
the rug was lucky .	the rug paints lucky .
the truck is upset .	the truck paints upset .
the bottle is hungry .	the bottle waves hungry .
the door is excited .	the door talks excited .
the doll is wrong .	the doll paints wrong .
the doll is busy .	the doll sings busy .
the doll was confused .	the doll exercises confused .
the shirt was helpful .	the shirt talks helpful .
the dish is wrong .	the dish cries wrong .
the plane was careful .	the plane sings careful .
the dish is kind .	the dish paints kind .
the mirror was kind .	the mirror waves kind .
the window is surprised .	the window waves surprised .
the box is careful .	the box reads careful .
the window was upset .	the window paints upset .
the dish was young .	the dish waves young .
the car is excited .	the car waves excited .
the plate was helpful .	the plate cries helpful .
the car is strong .	the car talks strong .
the plane is curious .	the plane exercises curious .
the shoe is clever .	the shoe exercises clever .
the toy was wrong .	the toy reads wrong .
the spoon is hungry .	the spoon cries hungry .
the crayon was tired .	the crayon waves tired .
the bowl was tired .	the bowl reads tired .
the boat was strong .	the boat exercises strong .
the book is upset .	the book exercises upset .
the bowl was clever .	the bowl sings clever .
the window is clever .	the window reads clever .
the fork was clever .	the fork exercises clever .
the rug is bored .	the rug talks bored .
the bed was curious .	the bed paints curious .
the couch was lucky .	the couch talks lucky .
the bowl was angry .	the bowl paints angry .
the dish was healthy .	the dish cries healthy .
the dish is hungry .	the dish sings hungry .
the ship was boring .	the ship sings boring .
the boat is smart .	the boat cries smart .
the glass is surprised .	the glass cries surprised .
the plate was bored .	the plate exercises bored .
the shirt is strong .	the shirt cries strong .
the ship is nice .	the ship talks nice .
the bicycle was hungry .	the bicycle paints hungry .
the rug was clever .	the rug sings clever .
the cup is busy .	the cup paints busy .
the truck is confused .	the truck exercises confused .
the window was sleepy .	the window waves sleepy .
the couch was kind .	the couch reads kind .
the candle is lucky .	the candle paints lucky .
the dish was sleepy .	the dish reads sleepy .
the plane is careful .	the plane reads careful .
the book was upset .	the book cries upset .
the ring is wrong .	the ring waves wrong .
the rug is healthy .	the rug cries healthy .
the plane was surprised .	the plane sings surprised .
the toy was kind .	the toy sings kind .
the book was quiet .	the book exercises quiet .
the mirror is tall .	the mirror sings tall .
the book is confused .	the book talks confused .
the boat was strong .	the boat sings strong .
the truck was hungry .	the truck exercises hungry .
the button is upset .	the button paints upset .
the button is busy .	the button exercises busy .
the mirror is kind .	the mirror waves kind .
the mirror was healthy .	the mirror talks healthy .
the toy is confused .	the toy sings confused .
the mirror was angry .	the mirror reads angry .
the book was young .	the book waves young .
the bicycle was healthy .	the bicycle exercises healthy .
the fork is important .	the fork reads important .
the rocket was wrong .	the rocket paints wrong .
the plate was smart .	the plate exercises smart .
the bottle is tall .	the bottle paints tall .
the car is excited .	the car sings excited .
the plane is curious .	the plane sings curious .
the bed is sleepy .	the bed cries sleepy .
the cup is bored .	the cup sings bored .
the doll is healthy .	the doll reads healthy .
the button is boring .	the button sings boring .
the shoe was tall .	the shoe cries tall .
the spoon is happy .	the spoon waves happy .
the rocket was happy .	the rocket reads happy .
the box is quiet .	the box reads quiet .
the candle was quiet .	the candle sings quiet .
the dish was friendly .	the dish talks friendly .
the boat is wrong .	the boat exercises wrong .
the candle was happy .	the candle sings happy .
the fork is quiet .	the fork reads quiet .
the plate was upset .	the plate waves upset .
the plane is young .	the plane waves young .
the dish was gentle .	the dish paints gentle .
the box was confused .	the box waves confused .
the button is busy .	the button sings busy .
the picture is tired .	the picture cries tired .
the glass is upset .	the glass paints upset .
the window was wrong .	the window talks wrong .
the bowl is curious .	the bowl cries curious .
the picture was surprised .	the picture waves surprised .
the doll is hungry .	the doll exercises hungry .
the dish is gentle .	the dish exercises gentle .
the dish is curious .	the dish talks curious .
the candle was hungry .	the candle talks hungry .
the door was wrong .	the door talks wrong .
the shirt is tired .	the shirt paints tired .
the fork is smart .	the fork cries smart .
the bed was clever .	the bed exercises clever .
the chair is hungry .	the chair talks hungry .
the shirt was happy .	the shirt cries happy .
the crayon is gentle .	the crayon sings gentle .
the shirt was angry .	the shirt paints angry .
the toy was busy .	the toy talks busy .
the bed is strong .	the bed paints strong .
the mirror was tall .	the mirror waves tall .
the toy is helpful .	the toy talks helpful .
the doll is healthy .	the doll waves healthy .
the candle is angry .	the candle paints angry .
the book was clever .	the book reads clever .
the mirror was bored .	the mirror talks bored .
the car was gentle .	the car sings gentle .
the shoe is nice .	the shoe paints nice .
the boat was friendly .	the boat reads friendly .
the truck is clever .	the truck talks clever .
the bed is wrong .	the bed sings wrong .
the plane is lucky .	the plane reads lucky .
the shoe was healthy .	the shoe exercises healthy .
the crayon was tall .	the crayon paints tall .
the toy was happy .	the toy waves happy .
the shoe is careful .	the shoe paints careful .
the rocket was wrong .	the rocket cries wrong .
the hat is young .	the hat exercises young .
the cup is lucky .	the cup talks lucky .
the ship is important .	the ship reads important .
the boat is wrong .	the boat cries wrong .
the boat was happy .	the boat talks happy .
the hat is hungry .	the hat sings hungry .
the chair is boring .	the chair sings boring .
the chair is busy .	the chair paints busy .
the shoe is hungry .	the shoe reads hungry .
the book is friendly .	the book sings friendly .
the cup was lucky .	the cup waves lucky .
the ring was helpful .	the ring reads helpful .
the glass was surprised .	the glass cries surprised .
the fork was gentle .	the fork waves gentle .
the doll is busy .	the doll talks busy .
the shirt is bored .	the shirt talks bored .
the candle was confused .	the candle paints confused .
the hat was young .	the hat cries young .
the shirt was surprised .	the shirt exercises surprised .
the ring is careful .	the ring talks careful .
the window was upset .	the window exercises upset .
the picture is curious .	the picture paints curious .
the car is surprised .	the car talks surprised .
the ship was important .	the ship sings important .
the ring was sleepy .	the ring waves sleepy .
the shirt was upset .	the shirt sings upset .
the doll is angry .	the doll waves angry .
the truck was happy .	the truck talks happy .
the car was gentle .	the car talks gentle .
the button is gentle .	the button talks gentle .
the cup is wrong .	the cup sings wrong .
the fork is surprised .	the fork paints surprised .
the bag is young .	the bag exercises young .
the bag was young .	the bag cries young .
the button is healthy .	the button paints healthy .
the mirror is confused .	the mirror cries confused .
the bag was sleepy .	the bag paints sleepy .
the couch is careful .	the couch reads careful .
the car was clever .	the car exercises clever .
the car is gentle .	the car sings gentle .
the fork is lucky .	the fork waves lucky .
the shoe is healthy .	the shoe reads healthy .
the couch was happy .	the couch paints happy .
the bottle was curious .	the bottle cries curious .
the truck was confused .	the truck exercises confused .
the shoe was sleepy .	the shoe exercises sleepy .
the candle was healthy .	the candle cries healthy .
the bicycle was important .	the bicycle reads important .
the candle is young .	the candle waves young .
the spoon is surprised .	the spoon cries surprised .
the mirror is kind .	the mirror sings kind .
the car was quiet .	the car talks quiet .
the picture was healthy .	the picture talks healthy .
the plane was gentle .	the plane paints gentle .
the dish was confused .	the dish reads confused .
the cup was busy .	the cup exercises busy .
the bag was tall .	the bag reads tall .
the truck is upset .	the truck talks upset .
the rug is boring .	the rug talks boring .
the doll was surprised .	the doll waves surprised .
the window is happy .	the window paints happy .
the plate is quiet .	the plate talks quiet .
the hat is happy .	the hat sings happy .
the fork is kind .	the fork waves kind .
the bed is upset .	the bed sings upset .
the shoe was excited .	the shoe sings excited .
the picture was happy .	the picture reads happy .
the picture was confused .	the picture cries confused .
the candle is excited .	the candle waves excited .
the shoe is gentle .	the shoe reads gentle .
the crayon was healthy .	the crayon exercises healthy .
the bottle is young .	the bottle sings young .
the book is kind .	the book exercises kind .
the rug is bored .	the rug waves bored .
the door is kind .	the door paints kind .
the bicycle was surprised .	the bicycle talks surprised .
the ring was strong .	the ring sings strong .
the ship was clever .	the ship sings clever .
the truck is wrong .	the truck cries wrong .
the window was strong .	the window sings strong .
the fork was angry .	the fork cries angry .
the mirror was angry .	the mirror waves angry .
the dish is excited .	the dish exercises excited .
the shoe is confused .	the shoe talks confused .
the shirt is helpful .	the shirt paints helpful .
the candle was happy .	the candle waves happy .
the car is tired .	the car talks tired .
the plane is sleepy .	the plane exercises sleepy .
the window is bored .	the window exercises bored .
the toy was healthy .	the toy paints healthy .
the shirt was lucky .	the shirt sings lucky .
the book was nice .	the book waves nice .
the boat was kind .	the boat paints kind .
the mirror was strong .	the mirror waves strong .
the box is wrong .	the box waves wrong .
the boat was happy .	the boat reads happy .
the picture was strong .	the picture cries strong .
the doll was important .	the doll cries important .
the ship is careful .	the ship waves careful .
the window was busy .	the window talks busy .
the crayon is important .	the crayon paints important .
the car was boring .	the car sings boring .
the book was friendly .	the book cries friendly .
the button is young .	the button exercises young .
the ship was gentle .	the ship exercises gentle .
the mirror was busy .	the mirror waves busy .
the plane was tall .	the plane reads tall .
the boat is friendly .	the boat talks friendly .
the mirror is careful .	the mirror talks careful .
the rocket is tired .	the rocket sings tired .
the ring was lucky .	the ring sings lucky .
the book is tall .	the book paints tall .
the book was young .	the book exercises young .
the couch is tired .	the couch reads tired .
the bowl is upset .	the bowl sings upset .
the plate was lucky .	the plate exercises lucky .
the button was lucky .	the button talks lucky .
the truck is bored .	the truck reads bored .
the boat is lucky .	the boat reads lucky .
the spoon is wrong .	the spoon reads wrong .
the crayon is lucky .	the crayon cries lucky .
the picture was upset .	the picture paints upset .
the book is tired .	the book sings tired .
the window was busy .	the window reads busy .
the mirror is clever .	the mirror cries clever .
the bottle was smart .	the bottle exercises smart .
the bicycle was surprised .	the bicycle reads surprised .
the truck is helpful .	the truck reads helpful .
the fork was surprised .	the fork waves surprised .
the bowl was confused .	the bowl exercises confused .
the shirt was nice .	the shirt cries nice .
the dish was clever .	the dish sings clever .
the car is surprised .	the car exercises surprised .
the dish is sleepy .	the dish reads sleepy .
the mirror was surprised .	the mirror sings surprised .
the glass is hungry .	the glass reads hungry .
the bed is important .	the bed reads important .
the button is gentle .	the button exercises gentle .
the bag is upset .	the bag talks upset .
the crayon was tired .	the crayon talks tired .
the glass is quiet .	the glass waves quiet .
the chair was boring .	the chair reads boring .
the mirror was tall .	the mirror exercises tall .
the book was confused .	the book talks confused .
the picture is nice .	the picture exercises nice .
the car is healthy .	the car exercises healthy .
the book was clever .	the book sings clever .
the mirror was lucky .	the mirror talks lucky .
the shirt was important .	the shirt cries important .
the mirror was tired .	the mirror exercises tired .
the plate was wrong .	the plate paints wrong .
the candle was sleepy .	the candle cries sleepy .
the rocket is excited .	the rocket waves excited .
the boat was lucky .	the boat reads lucky .
the cup was confused .	the cup waves confused .
the shoe is helpful .	the shoe cries helpful .
the rocket was young .	the rocket cries young .
the plane was curious .	the plane waves curious .
the doll is important .	the doll talks important .
the rug is strong .	the rug waves strong .
the button is excited .	the button exercises excited .
the hat was angry .	the hat reads angry .
the picture is curious .	the picture sings curious .
the hat is friendly .	the hat paints friendly .
the cup was careful .	the cup reads careful .
the truck is kind .	the truck paints kind .
the toy was busy .	the toy sings busy .
the shirt is upset .	the shirt waves upset .
the spoon is smart .	the spoon talks smart .
the cup is tall .	the cup cries tall .
the doll is smart .	the doll exercises smart .
the ship was kind .	the ship paints kind .
the fork is helpful .	the fork talks helpful .
the bed was bored .	the bed reads bored .
the couch was young .	the couch talks young .
the shirt was hungry .	the shirt exercises hungry .
the book is upset .	the book reads upset .
the window was lucky .	the window exercises lucky .
the bicycle is surprised .	the bicycle paints surprised .
the bowl is upset .	the bowl reads upset .
the bicycle is excited .	the bicycle exercises excited .
the bottle is excited .	the bottle talks excited .
the doll was important .	the doll talks important .
the rocket is quiet .	the rocket talks quiet .
the car was strong .	the car waves strong .
the truck is upset .	the truck sings upset .
the crayon is helpful .	the crayon paints helpful .
the ring was tired .	the ring paints tired .
the crayon was surprised .	the crayon reads surprised .
the chair was healthy .	the chair paints healthy .
the crayon is sleepy .	the crayon cries sleepy .
the bag was kind .	the bag reads kind .
the box is hungry .	the box waves hungry .
the door is quiet .	the door reads quiet .
the ring is important .	the ring reads important .
the car was lucky .	the car talks lucky .
the door is quiet .	the door waves quiet .
the bottle was careful .	the bottle cries careful .
the car was lucky .	the car paints lucky .
the doll was angry .	the doll reads angry .
the plate is careful .	the plate exercises careful .
the car was strong .	the car exercises strong .
the couch was upset .	the couch waves upset .
the bicycle is boring .	the bicycle exercises boring .
the book is smart .	the book waves smart .
the bag is happy .	the bag cries happy .
the boat is wrong .	the boat waves wrong .
the door was healthy .	the door talks healthy .
the plate is confused .	the plate sings confused .
the car is gentle .	the car cries gentle .
the bag is surprised .	the bag talks surprised .
the window is confused .	the window cries confused .
the plane was curious .	the plane reads curious .
the glass was hungry .	the glass paints hungry .
the bowl was excited .	the bowl talks excited .
the mirror was curious .	the mirror talks curious .
the spoon is important .	the spoon paints important .
the rug is kind .	the rug talks kind .
the shoe was helpful .	the shoe reads helpful .
the window was boring .	the window reads boring .
the shirt is sleepy .	the shirt reads sleepy .
the picture was hungry .	the picture sings hungry .
the hat is angry .	the hat talks angry .
the ship is sleepy .	the ship talks sleepy .
the bottle is happy .	the bottle paints happy .
the mirror was happy .	the mirror cries happy .
the plane is friendly .	the plane paints friendly .
the door was excited .	the door exercises excited .
the glass was angry .	the glass paints angry .
the button was angry .	the button paints angry .
the button was tired .	the button cries tired .
the bowl is tall .	the bowl talks tall .
the truck is angry .	the truck waves angry .
the button was helpful .	the button sings helpful .
the hat is quiet .	the hat exercises quiet .
the plate is healthy .	the plate exercises healthy .
the button is friendly .	the button waves friendly .
the bag is nice .	the bag reads nice .
the spoon was tall .	the spoon waves tall .
the plate is happy .	the plate exercises happy .
the chair is tired .	the chair waves tired .
the rocket was nice .	the rocket waves nice .
the ring is kind .	the ring reads kind .
the bed is quiet .	the bed waves quiet .
the shirt was upset .	the shirt exercises upset .
the button was young .	the button cries young .
the candle was boring .	the candle paints boring .
the ship is bored .	the ship paints bored .
the book is careful .	the book waves careful .
the ship was strong .	the ship waves strong .
the rug is gentle .	the rug exercises gentle .
the chair is excited .	the chair sings excited .
the dish was curious .	the dish paints curious .
the spoon was curious .	the spoon cries curious .
the car is hungry .	the car waves hungry .
the car is confused .	the car paints confused .
the door is angry .	the door exercises angry .
the chair was busy .	the chair paints busy .
the mirror was gentle .	the mirror exercises gentle .
the dish was angry .	the dish talks angry .
the ring is kind .	the ring exercises kind .
the spoon is surprised .	the spoon waves surprised .
the truck was bored .	the truck cries bored .
the window is curious .	the window paints curious .
the picture was tired .	the picture exercises tired .
the doll was tall .	the doll cries tall .
the cup was curious .	the cup cries curious .
the truck is helpful .	the truck paints helpful .
the picture was careful .	the picture paints careful .
the fork was confused .	the fork exercises confused .
the ring is excited .	the ring talks excited .
the crayon is quiet .	the crayon paints quiet .
the hat was healthy .	the hat sings healthy .
the car was bored .	the car exercises bored .
the bottle was wrong .	the bottle waves wrong .
the hat is important .	the hat cries important .
the hat is hungry .	the hat waves hungry .
the window was gentle .	the window paints gentle .
the crayon was smart .	the crayon waves smart .
the button was happy .	the button sings happy .
the crayon was confused .	the crayon exercises confused .
the bicycle was kind .	the bicycle reads kind .
the bag is bored .	the bag paints bored .
the candle was tall .	the candle paints tall .
the bowl was hungry .	the bowl talks hungry .
the shirt was friendly .	the shirt reads friendly .
the plane was healthy .	the plane talks healthy .
the ship is sleepy .	the ship paints sleepy .
the window was excited .	the window sings excited .
the bottle was curious .	the bottle talks curious .
the bicycle is confused .	the bicycle sings confused .
the ship was happy .	the ship sings happy .
the spoon is confused .	the spoon sings confused .
the car is curious .	the car talks curious .
the car was smart .	the car exercises smart .
the shoe is smart .	the shoe reads smart .
the car was kind .	the car paints kind .
the shoe was boring .	the shoe waves boring .
the crayon was sleepy .	the crayon reads sleepy .
the plate was kind .	the plate talks kind .
the glass was clever .	the glass reads clever .
the spoon was helpful .	the spoon exercises helpful .
the candle is upset .	the candle sings upset .
the fork is strong .	the fork paints strong .
the truck was angry .	the truck exercises angry .
the candle was healthy .	the candle waves healthy .
the shirt is friendly .	the shirt cries friendly .
the doll was curious .	the doll waves curious .
the couch is quiet .	the couch waves quiet .
the door was bored .	the door paints bored .
the shirt was clever .	the shirt paints clever .
the doll is busy .	the doll waves busy .
the candle is boring .	the candle reads boring .
the rocket was careful .	the rocket cries careful .
the truck was surprised .	the truck paints surprised .
the shirt is lucky .	the shirt waves lucky .
the crayon was healthy .	the crayon sings healthy .
the doll was happy .	the doll sings happy .
the bicycle is young .	the bicycle reads young .
the toy is tired .	the toy waves tired .
the plane was lucky .	the plane sings lucky .
the book was smart .	the book exercises smart .
the box is lucky .	the box talks lucky .
the mirror is tall .	the mirror cries tall .
the crayon is wrong .	the crayon talks wrong .
the spoon was wrong .	the spoon paints wrong .
the bottle was boring .	the bottle sings boring .
the book is sleepy .	the book exercises sleepy .
the doll is curious .	the doll talks curious .
the bowl was happy .	the bowl sings happy .
the bed was upset .	the bed paints upset .
the ship is angry .	the ship talks angry .
the ship is upset .	the ship paints upset .
the couch is confused .	the couch cries confused .
the cup was careful .	the cup cries careful .
the picture was curious .	the picture reads curious .
the couch was clever .	the couch talks clever .
the chair was lucky .	the chair cries lucky .
the ring is confused .	the ring paints confused .
the couch was gentle .	the couch paints gentle .
the glass was angry .	the glass exercises angry .
the mirror was careful .	the mirror exercises careful .
the chair is upset .	the chair reads upset .
the shirt was clever .	the shirt waves clever .
the door is helpful .	the door reads helpful .
the bowl is bored .	the bowl talks bored .
the chair was quiet .	the chair waves quiet .
the toy is angry .	the toy paints angry .
the door was excited .	the door paints excited .
the doll was friendly .	the doll talks friendly .
the door is curious .	the door talks curious .
the picture is friendly .	the picture exercises friendly .
the hat is busy .	the hat exercises busy .
the button was busy .	the button cries busy .
the truck was excited .	the truck exercises excited .
the cup was upset .	the cup cries upset .
the bowl was sleepy .	the bowl paints sleepy .
the couch was curious .	the couch sings curious .
the shirt is quiet .	the shirt cries quiet .
the plane was angry .	the plane waves angry .
the toy was quiet .	the toy talks quiet .
the glass was tired .	the glass exercises tired .
the fork is excited .	the fork talks excited .
the bicycle was upset .	the bicycle cries upset .
the bed was angry .	the bed waves angry .
the picture was strong .	the picture paints strong .
the box was confused .	the box cries confused .
the toy was angry .	the toy sings angry .
the mirror is important .	the mirror cries important .
the candle is careful .	the candle reads careful .
the boat was strong .	the boat paints strong .
the door was gentle .	the door cries gentle .
the bag was upset .	the bag waves upset .
the truck was healthy .	the truck paints healthy .
the car was nice .	the car talks nice .
the button is lucky .	the button cries lucky .
the doll was strong .	the doll waves strong .
the bowl was boring .	the bowl sings boring .
the window was strong .	the window talks strong .
the bicycle was quiet .	the bicycle reads quiet .
the cup is gentle .	the cup sings gentle .
the button was tall .	the button paints tall .
the ring is busy .	the ring waves busy .
the book is kind .	the book waves kind .
the car was friendly .	the car talks friendly .
the plane was sleepy .	the plane paints sleepy .
the rug was sleepy .	the rug reads sleepy .
the cup was tall .	the cup sings tall .
the crayon was young .	the crayon sings young .
the fork is curious .	the fork talks curious .
the ring was young .	the ring cries young .
the plane is careful .	the plane waves careful .
the toy is kind .	the toy exercises kind .
the mirror is curious .	the mirror talks curious .
the book was gentle .	the book exercises gentle .
the bag is hungry .	the bag sings hungry .
the shoe is clever .	the shoe paints clever .
the bag is quiet .	the bag cries quiet .
the book was curious .	the book paints curious .
the bed was surprised .	the bed exercises surprised .
the crayon is surprised .	the crayon waves surprised .
the picture is gentle .	the picture cries gentle .
the bed is gentle .	the bed waves gentle .
the door is sleepy .	the door exercises sleepy .
the bag is quiet .	the bag sings quiet .
