the crayon sitting in the library in the park in the room is busy .	the crayon sits in the library in the park in the room is busy .
the window sitting on the couch in the room on the chair is lucky .	the window sits on the couch in the room on the chair is lucky .
the plate sitting in the park in the room by the book is wrong .	the plate sits in the park in the room by the book is wrong .
the truck sitting by the toy in the room on the couch is kind .	the truck sits by the toy in the room on the couch is kind .
the plate sitting on the bed on the chair on the street is quiet .	the plate sits on the bed on the chair on the street is quiet .
the shirt sitting by the mirror by the bag on the bed is bored .	the shirt sits by the mirror by the bag on the bed is bored .
the rug sitting by the door by the ring in the museum is healthy .	the rug sits by the door by the ring in the museum is healthy .
the bottle sitting on the stool on the stool by the plate is wrong .	the bottle sits on the stool on the stool by the plate is wrong .
the plane sitting by the book on the floor by the mirror is healthy .	the plane sits by the book on the floor by the mirror is healthy .
the bowl sitting in the mall in the park by the rocket is clever .	the bowl sits in the mall in the park by the rocket is clever .
the bicycle sitting by the dish on the floor by the spoon is important .	the bicycle sits by the dish on the floor by the spoon is important .
the shoe sitting by the ship by the toy by the ship is wrong .	the shoe sits by the ship by the toy by the ship is wrong .
the dish sitting in the kitchen by the picture in the hospital is bored .	the dish sits in the kitchen by the picture in the hospital is bored .
the button sitting on the ground on the ground on the chair is quiet .	the button sits on the ground on the ground on the chair is quiet .
the plane sitting by the shoe on the chair in the mall is curious .	the plane sits by the shoe on the chair in the mall is curious .
the window sitting on the ground on the couch on the stool is busy .	the window sits on the ground on the couch on the stool is busy .
the rug sitting in the room by the bicycle on the floor is smart .	the rug sits in the room by the bicycle on the floor is smart .
the car sitting on the street in the park on the stool is wrong .	the car sits on the street in the park on the stool is wrong .
the picture sitting by the car on the street by the bicycle is careful .	the picture sits by the car on the street by the bicycle is careful .
the rug sitting by the book in the restaurant by the rocket is gentle .	the rug sits by the book in the restaurant by the rocket is gentle .
the plane sitting on the stool in the library by the car is busy .	the plane sits on the stool in the library by the car is busy .
the couch sitting by the boat in the library on the table is curious .	the couch sits by the boat in the library on the table is curious .
the book sitting by the glass on the table by the mirror is happy .	the book sits by the glass on the table by the mirror is happy .
the hat sitting by the ring on the ground on the street is tired .	the hat sits by the ring on the ground on the street is tired .
the ring sitting by the box in the mall on the chair is angry .	the ring sits by the box in the mall on the chair is angry .
the rug sitting on the chair on the chair by the toy is hungry .	the rug sits on the chair on the chair by the toy is hungry .
the candle sitting in the bank by the spoon by the ring is happy .	the candle sits in the bank by the spoon by the ring is happy .
the bag sitting by the boat by the couch by the box is tired .	the bag sits by the boat by the couch by the box is tired .
the toy sitting in the school on the ground in the museum is young .	the toy sits in the school on the ground in the museum is young .
the bottle sitting on the ground on the table by the car is happy .	the bottle sits on the ground on the table by the car is happy .
the bottle sitting in the kitchen on the floor by the hat is sleepy .	the bottle sits in the kitchen on the floor by the hat is sleepy .
the toy sitting on the couch by the fork by the window is confused .	the toy sits on the couch by the fork by the window is confused .
the crayon sitting on the chair on the floor in the hospital is kind .	the crayon sits on the chair on the floor in the hospital is kind .
the bag sitting on the street in the restaurant by the car is careful .	the bag sits on the street in the restaurant by the car is careful .
the boat sitting in the bank on the table by the spoon is helpful .	the boat sits in the bank on the table by the spoon is helpful .
the rocket sitting on the couch by the mirror by the boat is upset .	the rocket sits on the couch by the mirror by the boat is upset .
the door sitting on the street in the mall on the ground is tired .	the door sits on the street in the mall on the ground is tired .
the plate sitting on the bed in the hospital on the couch is young .	the plate sits on the bed in the hospital on the couch is young .
the crayon sitting by the bottle by the bed on the bed is lucky .	the crayon sits by the bottle by the bed on the bed is lucky .
the mirror sitting on the couch in the hospital by the door is bored .	the mirror sits on the couch in the hospital by the door is bored .
the box sitting on the stool on the stool on the floor is helpful .	the box sits on the stool on the stool on the floor is helpful .
the cup sitting by the door by the shirt in the room is quiet .	the cup sits by the door by the shirt in the room is quiet .
the book sitting by the picture in the mall in the school is healthy .	the book sits by the picture in the mall in the school is healthy .
the cup sitting on the bed in the mall on the bed is smart .	the cup sits on the bed in the mall on the bed is smart .
the window sitting on the stool in the library on the ground is happy .	the window sits on the stool in the library on the ground is happy .
the boat sitting by the plate on the couch on the bed is healthy .	the boat sits by the plate on the couch on the bed is healthy .
the cup sitting by the fork in the mall on the ground is gentle .	the cup sits by the fork in the mall on the ground is gentle .
the window sitting by the glass on the bed on the couch is tired .	the window sits by the glass on the bed on the couch is tired .
the truck sitting in the library in the museum on the stool is healthy .	the truck sits in the library in the museum on the stool is healthy .
the mirror sitting in the school in the bank by the book is careful .	the mirror sits in the school in the bank by the book is careful .
the mirror sitting by the candle in the museum on the floor is wrong .	the mirror sits by the candle in the museum on the floor is wrong .
the window sitting by the chair on the table by the cup is clever .	the window sits by the chair on the table by the cup is clever .
the book sitting on the ground by the rocket on the table is angry .	the book sits on the ground by the rocket on the table is angry .
the boat sitting by the ring in the museum by the box is gentle .	the boat sits by the ring in the museum by the box is gentle .
the rocket sitting in the room in the school in the mall is friendly .	the rocket sits in the room in the school in the mall is friendly .
the rug sitting on the ground by the book on the floor is friendly .	the rug sits on the ground by the book on the floor is friendly .
the button sitting by the spoon on the chair in the mall is strong .	the button sits by the spoon on the chair in the mall is strong .
the bag sitting by the ship by the rocket in the restaurant is hungry .	the bag sits by the ship by the rocket in the restaurant is hungry .
the toy sitting by the plate by the book by the car is clever .	the toy sits by the plate by the book by the car is clever .
the mirror sitting on the chair on the floor in the school is friendly .	the mirror sits on the chair on the floor in the school is friendly .
the book sitting in the mall on the chair by the bag is important .	the book sits in the mall on the chair by the bag is important .
the glass sitting on the street in the school by the button is hungry .	the glass sits on the street in the school by the button is hungry .
the bed sitting in the library on the bed on the street is kind .	the bed sits in the library on the bed on the street is kind .
the chair sitting on the street in the museum in the school is important .	the chair sits on the street in the museum in the school is important .
the candle sitting by the couch by the mirror by the button is friendly .	the candle sits by the couch by the mirror by the button is friendly .
the car sitting in the library on the street in the room is important .	the car sits in the library on the street in the room is important .
the box sitting by the doll on the couch on the chair is boring .	the box sits by the doll on the couch on the chair is boring .
the boat sitting on the ground by the button on the street is excited .	the boat sits on the ground by the button on the street is excited .
the toy sitting in the kitchen in the museum on the ground is healthy .	the toy sits in the kitchen in the museum on the ground is healthy .
the candle sitting on the stool in the hospital by the car is nice .	the candle sits on the stool in the hospital by the car is nice .
the toy sitting in the park on the floor in the library is smart .	the toy sits in the park on the floor in the library is smart .
the doll sitting by the rug by the fork by the car is surprised .	the doll sits by the rug by the fork by the car is surprised .
the plate sitting in the library in the school in the mall is friendly .	the plate sits in the library in the school in the mall is friendly .
the truck sitting in the hospital in the school in the museum is confused .	the truck sits in the hospital in the school in the museum is confused .
the candle sitting on the street by the book by the boat is curious .	the candle sits on the street by the book by the boat is curious .
the bag sitting by the doll by the plane by the door is surprised .	the bag sits by the doll by the plane by the door is surprised .
the bottle sitting on the stool on the street in the restaurant is tall .	the bottle sits on the stool on the street in the restaurant is tall .
the rug sitting on the floor in the bank by the rocket is angry .	the rug sits on the floor in the bank by the rocket is angry .
the rug sitting in the park in the kitchen in the restaurant is clever .	the rug sits in the park in the kitchen in the restaurant is clever .
the ship sitting in the bank on the floor on the floor is helpful .	the ship sits in the bank on the floor on the floor is helpful .
the chair sitting on the floor in the bank on the bed is excited .	the chair sits on the floor in the bank on the bed is excited .
the plate sitting on the stool in the hospital on the stool is confused .	the plate sits on the stool in the hospital on the stool is confused .
the shoe sitting in the school by the truck by the bed is careful .	the shoe sits in the school by the truck by the bed is careful .
the window sitting on the chair in the bank on the street is happy .	the window sits on the chair in the bank on the street is happy .
the toy sitting by the shoe on the chair on the couch is sleepy .	the toy sits by the shoe on the chair on the couch is sleepy .
the door sitting on the table on the bed on the chair is curious .	the door sits on the table on the bed on the chair is curious .
the candle sitting on the couch by the boat in the school is smart .	the candle sits on the couch by the boat in the school is smart .
the truck sitting in the library on the street on the stool is busy .	the truck sits in the library on the street on the stool is busy .
the doll sitting in the library by the bicycle in the kitchen is hungry .	the doll sits in the library by the bicycle in the kitchen is hungry .
the ring sitting by the spoon on the couch in the room is bored .	the ring sits by the spoon on the couch in the room is bored .
the chair sitting on the stool in the school by the candle is angry .	the chair sits on the stool in the school by the candle is angry .
the bottle sitting by the bottle in the school in the school is surprised .	the bottle sits by the bottle in the school in the school is surprised .
the box sitting in the bank by the cup in the park is tired .	the box sits in the bank by the cup in the park is tired .
the dish sitting by the cup in the mall in the mall is quiet .	the dish sits by the cup in the mall in the mall is quiet .
the door sitting on the bed in the park by the door is surprised .	the door sits on the bed in the park by the door is surprised .
the door sitting in the kitchen in the restaurant on the table is smart .	the door sits in the kitchen in the restaurant on the table is smart .
the cup sitting in the school in the restaurant on the ground is important .	the cup sits in the school in the restaurant on the ground is important .
the chair sitting by the rug on the floor by the door is important .	the chair sits by the rug on the floor by the door is important .
the hat sitting by the crayon by the spoon by the fork is strong .	the hat sits by the crayon by the spoon by the fork is strong .
the bottle sitting on the table on the bed on the bed is nice .	the bottle sits on the table on the bed on the bed is nice .
the doll sitting on the table in the kitchen in the kitchen is strong .	the doll sits on the table in the kitchen in the kitchen is strong .
the rocket sitting in the school in the kitchen in the restaurant is healthy .	the rocket sits in the school in the kitchen in the restaurant is healthy .
the bottle sitting on the stool in the hospital on the floor is wrong .	the bottle sits on the stool in the hospital on the floor is wrong .
the toy sitting in the room on the bed in the mall is bored .	the toy sits in the room on the bed in the mall is bored .
the shoe sitting on the stool on the bed by the rocket is upset .	the shoe sits on the stool on the bed by the rocket is upset .
the ship sitting by the car in the bank on the table is nice .	the ship sits by the car in the bank on the table is nice .
the book sitting in the mall on the table in the museum is hungry .	the book sits in the mall on the table in the museum is hungry .
the ship sitting in the bank on the floor on the floor is surprised .	the ship sits in the bank on the floor on the floor is surprised .
the rocket sitting in the school in the kitchen on the street is lucky .	the rocket sits in the school in the kitchen on the street is lucky .
the shoe sitting in the school on the bed on the table is young .	the shoe sits in the school on the bed on the table is young .
the ring sitting by the spoon by the box on the bed is sleepy .	the ring sits by the spoon by the box on the bed is sleepy .
the bowl sitting by the couch on the chair on the stool is angry .	the bowl sits by the couch on the chair on the stool is angry .
the ship sitting on the couch in the school by the boat is hungry .	the ship sits on the couch in the school by the boat is hungry .
the shirt sitting in the hospital on the stool in the library is strong .	the shirt sits in the hospital on the stool in the library is strong .
the button sitting on the couch by the shirt by the rocket is surprised .	the button sits on the couch by the shirt by the rocket is surprised .
the book sitting on the floor by the plate by the doll is upset .	the book sits on the floor by the plate by the doll is upset .
the truck sitting on the couch on the table by the rug is kind .	the truck sits on the couch on the table by the rug is kind .
the cup sitting in the library in the room by the bag is hungry .	the cup sits in the library in the room by the bag is hungry .
the candle sitting in the room in the park on the floor is angry .	the candle sits in the room in the park on the floor is angry .
the door sitting by the button by the truck by the doll is smart .	the door sits by the button by the truck by the doll is smart .
the mirror sitting by the spoon in the school in the museum is tall .	the mirror sits by the spoon in the school in the museum is tall .
the plate sitting by the plate on the table in the museum is boring .	the plate sits by the plate on the table in the museum is boring .
the ring sitting in the room by the picture on the chair is important .	the ring sits in the room by the picture on the chair is important .
the plane sitting in the kitchen in the mall on the bed is sleepy .	the plane sits in the kitchen in the mall on the bed is sleepy .
the window sitting by the bag by the dish on the couch is busy .	the window sits by the bag by the dish on the couch is busy .
the plane sitting on the chair by the window in the library is friendly .	the plane sits on the chair by the window in the library is friendly .
the ship sitting on the street on the table by the hat is gentle .	the ship sits on the street on the table by the hat is gentle .
the candle sitting in the hospital on the ground in the park is strong .	the candle sits in the hospital on the ground in the park is strong .
the candle sitting in the school on the stool in the kitchen is excited .	the candle sits in the school on the stool in the kitchen is excited .
the button sitting on the bed by the spoon in the library is upset .	the button sits on the bed by the spoon in the library is upset .
the window sitting on the couch by the rocket in the park is happy .	the window sits on the couch by the rocket in the park is happy .
the truck sitting by the rocket by the bicycle in the school is gentle .	the truck sits by the rocket by the bicycle in the school is gentle .
the car sitting on the ground by the couch by the bag is excited .	the car sits on the ground by the couch by the bag is excited .
the plane sitting on the floor on the couch by the mirror is helpful .	the plane sits on the floor on the couch by the mirror is helpful .
the truck sitting by the ring in the bank on the street is smart .	the truck sits by the ring in the bank on the street is smart .
the couch sitting by the glass by the bicycle on the street is curious .	the couch sits by the glass by the bicycle on the street is curious .
the bottle sitting on the ground on the chair in the park is tall .	the bottle sits on the ground on the chair in the park is tall .
the couch sitting on the ground in the bank on the chair is healthy .	the couch sits on the ground in the bank on the chair is healthy .
the book sitting by the fork on the ground in the kitchen is happy .	the book sits by the fork on the ground in the kitchen is happy .
the cup sitting on the street by the couch on the ground is boring .	the cup sits on the street by the couch on the ground is boring .
the ship sitting in the school by the window on the bed is nice .	the ship sits in the school by the window on the bed is nice .
the toy sitting in the school on the street in the bank is quiet .	the toy sits in the school on the street in the bank is quiet .
the candle sitting in the restaurant in the mall on the table is confused .	the candle sits in the restaurant in the mall on the table is confused .
the window sitting in the bank by the truck in the room is curious .	the window sits in the bank by the truck in the room is curious .
the window sitting in the school in the room on the stool is wrong .	the window sits in the school in the room on the stool is wrong .
the box sitting on the couch by the doll in the restaurant is clever .	the box sits on the couch by the doll in the restaurant is clever .
the bottle sitting by the candle in the school in the room is confused .	the bottle sits by the candle in the school in the room is confused .
the bicycle sitting in the hospital in the hospital by the truck is smart .	the bicycle sits in the hospital in the hospital by the truck is smart .
the fork sitting on the chair by the door on the chair is healthy .	the fork sits on the chair by the door on the chair is healthy .
the spoon sitting by the door by the shoe on the chair is bored .	the spoon sits by the door by the shoe on the chair is bored .
the book sitting on the street by the cup on the couch is helpful .	the book sits on the street by the cup on the couch is helpful .
the boat sitting in the school by the cup in the library is strong .	the boat sits in the school by the cup in the library is strong .
the rug sitting in the school by the button in the restaurant is friendly .	the rug sits in the school by the button in the restaurant is friendly .
the boat sitting by the door by the crayon in the museum is sleepy .	the boat sits by the door by the crayon in the museum is sleepy .
the doll sitting by the picture in the park by the button is wrong .	the doll sits by the picture in the park by the button is wrong .
the ring sitting in the restaurant in the school by the bag is excited .	the ring sits in the restaurant in the school by the bag is excited .
the doll sitting in the hospital by the spoon in the mall is surprised .	the doll sits in the hospital by the spoon in the mall is surprised .
the shirt sitting by the button in the school in the bank is friendly .	the shirt sits by the button in the school in the bank is friendly .
the plate sitting by the dish in the library on the chair is confused .	the plate sits by the dish in the library on the chair is confused .
the glass sitting on the chair by the cup in the museum is sleepy .	the glass sits on the chair by the cup in the museum is sleepy .
the bicycle sitting in the room by the bed in the park is surprised .	the bicycle sits in the room by the bed in the park is surprised .
the bowl sitting by the crayon in the room in the library is boring .	the bowl sits by the crayon in the room in the library is boring .
the door sitting on the chair in the library on the street is tired .	the door sits on the chair in the library on the street is tired .
the ship sitting on the floor on the couch by the bed is upset .	the ship sits on the floor on the couch by the bed is upset .
the button sitting on the couch on the chair by the plate is upset .	the button sits on the couch on the chair by the plate is upset .
the plate sitting by the door on the floor by the door is upset .	the plate sits by the door on the floor by the door is upset .
the plane sitting in the mall by the ship in the room is angry .	the plane sits in the mall by the ship in the room is angry .
the bowl sitting on the bed in the school on the chair is friendly .	the bowl sits on the bed in the school on the chair is friendly .
the rug sitting on the bed by the bag in the bank is surprised .	the rug sits on the bed by the bag in the bank is surprised .
the shoe sitting by the truck by the rocket by the chair is healthy .	the shoe sits by the truck by the rocket by the chair is healthy .
the button sitting by the spoon on the street on the table is important .	the button sits by the spoon on the street on the table is important .
the book sitting by the toy by the shirt by the fork is helpful .	the book sits by the toy by the shirt by the fork is helpful .
the car sitting on the ground in the park in the museum is clever .	the car sits on the ground in the park in the museum is clever .
the hat sitting by the shirt on the couch in the mall is tall .	the hat sits by the shirt on the couch in the mall is tall .
the car sitting on the floor by the couch on the floor is clever .	the car sits on the floor by the couch on the floor is clever .
the mirror sitting on the stool in the school on the street is bored .	the mirror sits on the stool in the school on the street is bored .
the boat sitting on the ground on the couch in the park is busy .	the boat sits on the ground on the couch in the park is busy .
the dish sitting in the bank on the ground by the rug is important .	the dish sits in the bank on the ground by the rug is important .
the bed sitting on the couch by the box by the plane is curious .	the bed sits on the couch by the box by the plane is curious .
the couch sitting by the spoon on the street on the couch is curious .	the couch sits by the spoon on the street on the couch is curious .
the candle sitting by the car on the table by the car is tall .	the candle sits by the car on the table by the car is tall .
the car sitting by the bed by the rocket by the fork is clever .	the car sits by the bed by the rocket by the fork is clever .
the fork sitting on the street by the glass by the rocket is important .	the fork sits on the street by the glass by the rocket is important .
the truck sitting by the spoon by the window on the ground is excited .	the truck sits by the spoon by the window on the ground is excited .
the shoe sitting on the stool on the street by the shoe is boring .	the shoe sits on the stool on the street by the shoe is boring .
the candle sitting on the floor by the bowl by the toy is angry .	the candle sits on the floor by the bowl by the toy is angry .
the plate sitting in the mall in the restaurant on the stool is bored .	the plate sits in the mall in the restaurant on the stool is bored .
the bicycle sitting by the window on the ground by the bed is busy .	the bicycle sits by the window on the ground by the bed is busy .
the car sitting on the ground in the bank on the street is wrong .	the car sits on the ground in the bank on the street is wrong .
the book sitting on the stool by the book on the stool is strong .	the book sits on the stool by the book on the stool is strong .
the ring sitting by the hat on the table in the school is curious .	the ring sits by the hat on the table in the school is curious .
the plane sitting by the ship by the book in the library is strong .	the plane sits by the ship by the book in the library is strong .
the bed sitting in the library on the street in the bank is tall .	the bed sits in the library on the street in the bank is tall .
the book sitting in the park by the candle in the bank is boring .	the book sits in the park by the candle in the bank is boring .
the plate sitting by the ring on the bed in the school is important .	the plate sits by the ring on the bed in the school is important .
the box sitting in the kitchen on the street in the park is young .	the box sits in the kitchen on the street in the park is young .
the hat sitting on the chair on the ground by the plate is important .	the hat sits on the chair on the ground by the plate is important .
the ship sitting by the button on the chair on the chair is confused .	the ship sits by the button on the chair on the chair is confused .
the mirror sitting on the couch in the library by the cup is important .	the mirror sits on the couch in the library by the cup is important .
the boat sitting on the chair in the kitchen by the plane is clever .	the boat sits on the chair in the kitchen by the plane is clever .
the cup sitting on the stool by the ship by the mirror is nice .	the cup sits on the stool by the ship by the mirror is nice .
the couch sitting on the couch by the plate by the hat is healthy .	the couch sits on the couch by the plate by the hat is healthy .
the bag sitting by the rug by the window on the chair is nice .	the bag sits by the rug by the window on the chair is nice .
the bag sitting by the plane in the museum by the car is kind .	the bag sits by the plane in the museum by the car is kind .
the crayon sitting on the street by the door by the doll is angry .	the crayon sits on the street by the door by the doll is angry .
the bed sitting by the spoon by the shirt on the stool is clever .	the bed sits by the spoon by the shirt on the stool is clever .
the couch sitting by the dish in the restaurant on the stool is helpful .	the couch sits by the dish in the restaurant on the stool is helpful .
the rocket sitting on the bed by the ring on the ground is quiet .	the rocket sits on the bed by the ring on the ground is quiet .
the book sitting on the chair in the mall on the couch is lucky .	the book sits on the chair in the mall on the couch is lucky .
the car sitting in the museum by the shirt by the rocket is tall .	the car sits in the museum by the shirt by the rocket is tall .
the truck sitting by the candle by the button on the chair is kind .	the truck sits by the candle by the button on the chair is kind .
the bag sitting by the couch on the bed by the bag is curious .	the bag sits by the couch on the bed by the bag is curious .
the truck sitting by the crayon in the kitchen in the restaurant is healthy .	the truck sits by the crayon in the kitchen in the restaurant is healthy .
the fork sitting in the school by the button on the floor is upset .	the fork sits in the school by the button on the floor is upset .
the ship sitting by the mirror in the museum by the fork is lucky .	the ship sits by the mirror in the museum by the fork is lucky .
the book sitting by the picture in the library on the street is bored .	the book sits by the picture in the library on the street is bored .
the ring sitting in the museum in the school on the bed is busy .	the ring sits in the museum in the school on the bed is busy .
the door sitting by the candle in the mall on the ground is friendly .	the door sits by the candle in the mall on the ground is friendly .
the dish sitting on the ground in the mall by the book is nice .	the dish sits on the ground in the mall by the book is nice .
the cup sitting by the boat on the table on the ground is tall .	the cup sits by the boat on the table on the ground is tall .
the book sitting by the button in the museum in the mall is bored .	the book sits by the button in the museum in the mall is bored .
the box sitting in the room on the floor on the stool is smart .	the box sits in the room on the floor on the stool is smart .
the spoon sitting by the book by the door in the museum is angry .	the spoon sits by the book by the door in the museum is angry .
the hat sitting by the door on the table in the park is sleepy .	the hat sits by the door on the table in the park is sleepy .
the bowl sitting in the park on the street by the plane is gentle .	the bowl sits in the park on the street by the plane is gentle .
the bicycle sitting in the library in the museum in the museum is excited .	the bicycle sits in the library in the museum in the museum is excited .
the bed sitting in the kitchen by the bed in the bank is hungry .	the bed sits in the kitchen by the bed in the bank is hungry .
the bed sitting by the cup on the table by the plane is tired .	the bed sits by the cup on the table by the plane is tired .
the book sitting on the ground in the bank on the floor is strong .	the book sits on the ground in the bank on the floor is strong .
the shirt sitting on the ground by the cup on the chair is gentle .	the shirt sits on the ground by the cup on the chair is gentle .
the chair sitting by the ring by the rocket by the cup is lucky .	the chair sits by the ring by the rocket by the cup is lucky .
the cup sitting in the school in the room on the floor is excited .	the cup sits in the school in the room on the floor is excited .
the book sitting on the bed on the street on the stool is helpful .	the book sits on the bed on the street on the stool is helpful .
the plane sitting on the floor in the library by the fork is young .	the plane sits on the floor in the library by the fork is young .
the hat sitting by the shoe by the crayon by the rug is smart .	the hat sits by the shoe by the crayon by the rug is smart .
the shirt sitting by the rug on the street on the chair is happy .	the shirt sits by the rug on the street on the chair is happy .
the doll sitting on the floor on the couch in the park is important .	the doll sits on the floor on the couch in the park is important .
the toy sitting on the chair in the school in the bank is clever .	the toy sits on the chair in the school in the bank is clever .
the bed sitting in the restaurant on the bed in the mall is tall .	the bed sits in the restaurant on the bed in the mall is tall .
the spoon sitting on the bed in the school on the bed is excited .	the spoon sits on the bed in the school on the bed is excited .
the plane sitting by the picture on the floor by the bag is smart .	the plane sits by the picture on the floor by the bag is smart .
the rug sitting by the picture in the school in the park is boring .	the rug sits by the picture in the school in the park is boring .
the couch sitting in the school on the bed by the plate is careful .	the couch sits in the school on the bed by the plate is careful .
the picture sitting by the doll in the school on the bed is curious .	the picture sits by the doll in the school on the bed is curious .
the cup sitting on the couch on the bed in the school is friendly .	the cup sits on the couch on the bed in the school is friendly .
the glass sitting by the bicycle on the floor in the library is healthy .	the glass sits by the bicycle on the floor in the library is healthy .
the rug sitting in the room on the couch in the hospital is strong .	the rug sits in the room on the couch in the hospital is strong .
the doll sitting by the shoe by the glass on the stool is wrong .	the doll sits by the shoe by the glass on the stool is wrong .
the car sitting by the glass by the car by the book is clever .	the car sits by the glass by the car by the book is clever .
the car sitting in the museum in the hospital in the bank is boring .	the car sits in the museum in the hospital in the bank is boring .
the fork sitting in the bank by the book on the street is boring .	the fork sits in the bank by the book on the street is boring .
the picture sitting by the crayon by the bed in the bank is important .	the picture sits by the crayon by the bed in the bank is important .
the book sitting by the bicycle on the ground by the plane is bored .	the book sits by the bicycle on the ground by the plane is bored .
the truck sitting in the hospital on the street on the street is sleepy .	the truck sits in the hospital on the street on the street is sleepy .
the bed sitting by the fork in the room in the room is kind .	the bed sits by the fork in the room in the room is kind .
the book sitting in the museum by the shoe on the table is helpful .	the book sits in the museum by the shoe on the table is helpful .
the glass sitting in the room on the ground on the ground is gentle .	the glass sits in the room on the ground on the ground is gentle .
the button sitting in the bank on the table by the boat is upset .	the button sits in the bank on the table by the boat is upset .
the chair sitting on the bed in the mall on the floor is busy .	the chair sits on the bed in the mall on the floor is busy .
the bottle sitting in the museum on the bed on the stool is curious .	the bottle sits in the museum on the bed on the stool is curious .
the couch sitting on the couch in the restaurant in the kitchen is strong .	the couch sits on the couch in the restaurant in the kitchen is strong .
the rocket sitting by the crayon in the kitchen on the chair is boring .	the rocket sits by the crayon in the kitchen on the chair is boring .
the window sitting by the bottle by the plane in the room is strong .	the window sits by the bottle by the plane in the room is strong .
the glass sitting by the plane in the restaurant on the table is excited .	the glass sits by the plane in the restaurant on the table is excited .
the book sitting on the stool in the school by the doll is smart .	the book sits on the stool in the school by the doll is smart .
the boat sitting on the stool on the chair in the restaurant is important .	the boat sits on the stool on the chair in the restaurant is important .
the ship sitting on the table on the floor by the ring is excited .	the ship sits on the table on the floor by the ring is excited .
the spoon sitting by the bag by the plate on the couch is tired .	the spoon sits by the bag by the plate on the couch is tired .
the car sitting in the kitchen on the stool on the floor is lucky .	the car sits in the kitchen on the stool on the floor is lucky .
the bed sitting by the chair on the stool by the dish is friendly .	the bed sits by the chair on the stool by the dish is friendly .
the book sitting on the street on the floor on the couch is healthy .	the book sits on the street on the floor on the couch is healthy .
the chair sitting by the crayon by the cup in the hospital is happy .	the chair sits by the crayon by the cup in the hospital is happy .
the toy sitting by the ring in the school by the book is confused .	the toy sits by the ring in the school by the book is confused .
the candle sitting in the school on the couch in the school is quiet .	the candle sits in the school on the couch in the school is quiet .
the shoe sitting on the stool on the bed in the park is healthy .	the shoe sits on the stool on the bed in the park is healthy .
the couch sitting on the stool in the mall by the spoon is tall .	the couch sits on the stool in the mall by the spoon is tall .
the plate sitting on the chair by the bottle on the chair is sleepy .	the plate sits on the chair by the bottle on the chair is sleepy .
the bottle sitting in the school by the shoe by the cup is sleepy .	the bottle sits in the school by the shoe by the cup is sleepy .
the plate sitting by the button by the box in the hospital is busy .	the plate sits by the button by the box in the hospital is busy .
the candle sitting by the glass by the rocket on the stool is confused .	the candle sits by the glass by the rocket on the stool is confused .
the car sitting by the bottle by the window in the mall is careful .	the car sits by the bottle by the window in the mall is careful .
the toy sitting in the school by the shoe by the chair is careful .	the toy sits in the school by the shoe by the chair is careful .
the plate sitting by the truck on the street on the table is clever .	the plate sits by the truck on the street on the table is clever .
the mirror sitting in the kitchen by the bag in the restaurant is busy .	the mirror sits in the kitchen by the bag in the restaurant is busy .
the bed sitting by the bottle by the car by the rug is angry .	the bed sits by the bottle by the car by the rug is angry .
the bicycle sitting by the bottle by the crayon on the table is lucky .	the bicycle sits by the bottle by the crayon on the table is lucky .
the button sitting on the stool in the room in the hospital is strong .	the button sits on the stool in the room in the hospital is strong .
the crayon sitting on the stool in the room by the dish is kind .	the crayon sits on the stool in the room by the dish is kind .
the bowl sitting on the bed in the restaurant on the bed is smart .	the bowl sits on the bed in the restaurant on the bed is smart .
the dish sitting by the rug on the ground by the mirror is upset .	the dish sits by the rug on the ground by the mirror is upset .
the book sitting by the shoe in the school on the street is helpful .	the book sits by the shoe in the school on the street is helpful .
the bowl sitting on the couch in the library in the library is confused .	the bowl sits on the couch in the library in the library is confused .
the book sitting in the bank by the doll in the room is happy .	the book sits in the bank by the doll in the room is happy .
the shoe sitting by the plate by the doll on the stool is quiet .	the shoe sits by the plate by the doll on the stool is quiet .
the mirror sitting on the floor by the door by the car is tired .	the mirror sits on the floor by the door by the car is tired .
the fork sitting in the hospital on the street on the floor is boring .	the fork sits in the hospital on the street on the floor is boring .
the book sitting in the kitchen on the stool by the shirt is tired .	the book sits in the kitchen on the stool by the shirt is tired .
the boat sitting on the floor in the kitchen by the bowl is gentle .	the boat sits on the floor in the kitchen by the bowl is gentle .
the glass sitting in the park by the ring on the ground is wrong .	the glass sits in the park by the ring on the ground is wrong .
the box sitting by the book on the table on the table is healthy .	the box sits by the book on the table on the table is healthy .
the couch sitting by the book in the kitchen in the library is confused .	the couch sits by the book in the kitchen in the library is confused .
the spoon sitting by the ring on the ground on the street is excited .	the spoon sits by the ring on the ground on the street is excited .
the window sitting by the hat in the restaurant on the street is kind .	the window sits by the hat in the restaurant on the street is kind .
the bed sitting by the fork in the mall in the hospital is boring .	the bed sits by the fork in the mall in the hospital is boring .
the door sitting by the boat by the cup on the couch is bored .	the door sits by the boat by the cup on the couch is bored .
the door sitting in the school on the ground on the chair is hungry .	the door sits in the school on the ground on the chair is hungry .
the plane sitting by the couch on the bed on the street is happy .	the plane sits by the couch on the bed on the street is happy .
the fork sitting by the toy in the museum on the bed is helpful .	the fork sits by the toy in the museum on the bed is helpful .
the glass sitting in the mall by the couch in the school is strong .	the glass sits in the mall by the couch in the school is strong .
the candle sitting by the rocket on the bed on the chair is nice .	the candle sits by the rocket on the bed on the chair is nice .
the book sitting by the ship on the chair on the bed is nice .	the book sits by the ship on the chair on the bed is nice .
the hat sitting in the kitchen by the rocket by the book is kind .	the hat sits in the kitchen by the rocket by the book is kind .
the book sitting on the ground on the stool in the library is curious .	the book sits on the ground on the stool in the library is curious .
the mirror sitting on the table on the ground by the candle is kind .	the mirror sits on the table on the ground by the candle is kind .
the plane sitting on the table in the hospital by the picture is boring .	the plane sits on the table in the hospital by the picture is boring .
the spoon sitting by the plane by the toy by the couch is kind .	the spoon sits by the plane by the toy by the couch is kind .
the glass sitting on the chair in the bank by the cup is excited .	the glass sits on the chair in the bank by the cup is excited .
the box sitting by the plane by the cup in the school is careful .	the box sits by the plane by the cup in the school is careful .
the plate sitting by the truck in the school in the library is upset .	the plate sits by the truck in the school in the library is upset .
the bag sitting in the park on the chair on the chair is careful .	the bag sits in the park on the chair on the chair is careful .
the shoe sitting in the library by the shoe by the bottle is wrong .	the shoe sits in the library by the shoe by the bottle is wrong .
the shoe sitting on the stool by the button in the room is bored .	the shoe sits on the stool by the button in the room is bored .
the cup sitting by the boat by the box in the park is excited .	the cup sits by the boat by the box in the park is excited .
the window sitting in the room in the mall on the ground is lucky .	the window sits in the room in the mall on the ground is lucky .
the glass sitting in the library on the street by the boat is kind .	the glass sits in the library on the street by the boat is kind .
the bed sitting on the couch on the floor in the mall is quiet .	the bed sits on the couch on the floor in the mall is quiet .
the car sitting by the book in the school on the table is nice .	the car sits by the book in the school on the table is nice .
the crayon sitting by the cup in the room on the bed is careful .	the crayon sits by the cup in the room on the bed is careful .
the car sitting by the car in the mall in the library is lucky .	the car sits by the car in the mall in the library is lucky .
the dish sitting by the toy in the school in the hospital is boring .	the dish sits by the toy in the school in the hospital is boring .
the button sitting in the museum on the table on the ground is happy .	the button sits in the museum on the table on the ground is happy .
the chair sitting on the table by the plane in the room is wrong .	the chair sits on the table by the plane in the room is wrong .
the rocket sitting in the kitchen on the table on the chair is angry .	the rocket sits in the kitchen on the table on the chair is angry .
the ring sitting in the restaurant in the museum in the kitchen is nice .	the ring sits in the restaurant in the museum in the kitchen is nice .
the bowl sitting on the chair in the bank on the street is kind .	the bowl sits on the chair in the bank on the street is kind .
the car sitting by the crayon on the table by the cup is happy .	the car sits by the crayon on the table by the cup is happy .
the box sitting in the hospital by the glass in the museum is young .	the box sits in the hospital by the glass in the museum is young .
the book sitting in the school by the book in the museum is wrong .	the book sits in the school by the book in the museum is wrong .
the bowl sitting by the ship on the table on the floor is angry .	the bowl sits by the ship on the table on the floor is angry .
the toy sitting on the floor on the chair on the chair is excited .	the toy sits on the floor on the chair on the chair is excited .
the doll sitting on the street in the bank by the hat is lucky .	the doll sits on the street in the bank by the hat is lucky .
the candle sitting by the bed in the school on the couch is gentle .	the candle sits by the bed in the school on the couch is gentle .
the plate sitting in the room by the spoon on the couch is tired .	the plate sits in the room by the spoon on the couch is tired .
the candle sitting in the school in the school in the park is young .	the candle sits in the school in the school in the park is young .
the glass sitting by the truck on the bed on the ground is gentle .	the glass sits by the truck on the bed on the ground is gentle .
the rug sitting on the table by the rug on the stool is happy .	the rug sits on the table by the rug on the stool is happy .
the window sitting by the rocket in the bank on the ground is happy .	the window sits by the rocket in the bank on the ground is happy .
the bicycle sitting on the chair by the boat in the school is important .	the bicycle sits on the chair by the boat in the school is important .
the crayon sitting by the bottle on the ground on the table is wrong .	the crayon sits by the bottle on the ground on the table is wrong .
the fork sitting by the car in the school in the school is strong .	the fork sits by the car in the school in the school is strong .
the cup sitting in the bank on the stool by the ship is helpful .	the cup sits in the bank on the stool by the ship is helpful .
the shoe sitting in the hospital by the crayon in the museum is careful .	the shoe sits in the hospital by the crayon in the museum is careful .
the bicycle sitting by the couch in the library on the bed is kind .	the bicycle sits by the couch in the library on the bed is kind .
the ring sitting by the hat on the street by the rug is healthy .	the ring sits by the hat on the street by the rug is healthy .
the rocket sitting on the couch on the bed in the kitchen is excited .	the rocket sits on the couch on the bed in the kitchen is excited .
the dish sitting on the bed in the bank in the park is tired .	the dish sits on the bed in the bank in the park is tired .
the fork sitting by the car on the ground by the car is important .	the fork sits by the car on the ground by the car is important .
the mirror sitting in the school by the fork by the door is happy .	the mirror sits in the school by the fork by the door is happy .
the bicycle sitting in the kitchen on the stool in the museum is tall .	the bicycle sits in the kitchen on the stool in the museum is tall .
the bowl sitting on the stool on the bed by the bowl is busy .	the bowl sits on the stool on the bed by the bowl is busy .
the doll sitting by the chair by the glass by the doll is strong .	the doll sits by the chair by the glass by the doll is strong .
the shoe sitting in the museum on the ground by the chair is nice .	the shoe sits in the museum on the ground by the chair is nice .
the ship sitting by the fork on the chair by the box is gentle .	the ship sits by the fork on the chair by the box is gentle .
the rocket sitting in the bank in the mall in the hospital is busy .	the rocket sits in the bank in the mall in the hospital is busy .
the bag sitting by the shoe on the chair in the room is healthy .	the bag sits by the shoe on the chair in the room is healthy .
the car sitting in the room on the ground in the room is boring .	the car sits in the room on the ground in the room is boring .
the fork sitting on the street by the button by the toy is quiet .	the fork sits on the street by the button by the toy is quiet .
the glass sitting by the rug by the bicycle by the rocket is surprised .	the glass sits by the rug by the bicycle by the rocket is surprised .
the box sitting by the ring on the street on the bed is helpful .	the box sits by the ring on the street on the bed is helpful .
the button sitting by the glass by the boat in the library is helpful .	the button sits by the glass by the boat in the library is helpful .
the window sitting on the bed in the room on the couch is important .	the window sits on the bed in the room on the couch is important .
the rug sitting on the floor by the couch on the bed is important .	the rug sits on the floor by the couch on the bed is important .
the toy sitting in the school by the cup on the ground is helpful .	the toy sits in the school by the cup on the ground is helpful .
the plane sitting on the couch by the rocket in the park is smart .	the plane sits on the couch by the rocket in the park is smart .
the box sitting in the kitchen on the floor on the ground is strong .	the box sits in the kitchen on the floor on the ground is strong .
the box sitting in the school on the couch by the book is sleepy .	the box sits in the school on the couch by the book is sleepy .
the dish sitting by the rocket in the park by the bottle is bored .	the dish sits by the rocket in the park by the bottle is bored .
the spoon sitting by the box on the chair in the park is upset .	the spoon sits by the box on the chair in the park is upset .
the spoon sitting by the book in the hospital by the mirror is strong .	the spoon sits by the book in the hospital by the mirror is strong .
the bed sitting on the street in the school on the chair is curious .	the bed sits on the street in the school on the chair is curious .
the door sitting in the bank on the chair by the box is bored .	the door sits in the bank on the chair by the box is bored .
the bed sitting by the shirt in the room on the stool is bored .	the bed sits by the shirt in the room on the stool is bored .
the cup sitting in the park in the hospital by the window is boring .	the cup sits in the park in the hospital by the window is boring .
the hat sitting on the couch by the bed on the bed is hungry .	the hat sits on the couch by the bed on the bed is hungry .
the fork sitting on the floor on the table in the room is hungry .	the fork sits on the floor on the table in the room is hungry .
the cup sitting by the boat in the hospital on the couch is happy .	the cup sits by the boat in the hospital on the couch is happy .
the rocket sitting by the fork on the floor in the hospital is nice .	the rocket sits by the fork on the floor in the hospital is nice .
the bag sitting in the hospital on the stool on the ground is boring .	the bag sits in the hospital on the stool on the ground is boring .
the book sitting in the room in the kitchen by the plane is hungry .	the book sits in the room in the kitchen by the plane is hungry .
the ring sitting in the school on the chair by the ship is quiet .	the ring sits in the school on the chair by the ship is quiet .
the picture sitting on the table on the floor in the mall is friendly .	the picture sits on the table on the floor in the mall is friendly .
the spoon sitting in the school on the ground on the floor is upset .	the spoon sits in the school on the ground on the floor is upset .
the plane sitting in the school on the couch in the mall is surprised .	the plane sits in the school on the couch in the mall is surprised .
the cup sitting by the door by the car on the floor is kind .	the cup sits by the door by the car on the floor is kind .
the rocket sitting by the truck in the kitchen by the ring is angry .	the rocket sits by the truck in the kitchen by the ring is angry .
the chair sitting on the bed in the park by the couch is surprised .	the chair sits on the bed in the park by the couch is surprised .
the boat sitting by the rocket on the ground by the bottle is angry .	the boat sits by the rocket on the ground by the bottle is angry .
the hat sitting on the chair by the cup on the couch is clever .	the hat sits on the chair by the cup on the couch is clever .
the doll sitting by the chair in the restaurant on the table is tired .	the doll sits by the chair in the restaurant on the table is tired .
the toy sitting by the bag by the mirror on the street is smart .	the toy sits by the bag by the mirror on the street is smart .
the book sitting in the restaurant on the ground on the couch is smart .	the book sits in the restaurant on the ground on the couch is smart .
the candle sitting in the bank in the hospital in the kitchen is gentle .	the candle sits in the bank in the hospital in the kitchen is gentle .
the truck sitting in the kitchen in the museum on the floor is sleepy .	the truck sits in the kitchen in the museum on the floor is sleepy .
the hat sitting in the restaurant on the chair in the hospital is angry .	the hat sits in the restaurant on the chair in the hospital is angry .
the plane sitting by the candle by the bicycle on the floor is angry .	the plane sits by the candle by the bicycle on the floor is angry .
the crayon sitting on the stool on the bed on the bed is tall .	the crayon sits on the stool on the bed on the bed is tall .
the spoon sitting by the plate in the restaurant in the bank is strong .	the spoon sits by the plate in the restaurant in the bank is strong .
the chair sitting on the stool in the kitchen by the shirt is happy .	the chair sits on the stool in the kitchen by the shirt is happy .
the bag sitting in the hospital on the couch on the couch is sleepy .	the bag sits in the hospital on the couch on the couch is sleepy .
the bicycle sitting on the floor by the picture on the floor is helpful .	the bicycle sits on the floor by the picture on the floor is helpful .
the shirt sitting by the candle on the stool by the hat is sleepy .	the shirt sits by the candle on the stool by the hat is sleepy .
the fork sitting in the park in the school on the stool is busy .	the fork sits in the park in the school on the stool is busy .
the rocket sitting by the mirror on the couch on the chair is surprised .	the rocket sits by the mirror on the couch on the chair is surprised .
the toy sitting in the mall on the bed in the room is lucky .	the toy sits in the mall on the bed in the room is lucky .
the truck sitting in the mall on the bed by the ship is bored .	the truck sits in the mall on the bed by the ship is bored .
the ship sitting in the park on the floor in the kitchen is curious .	the ship sits in the park on the floor in the kitchen is curious .
the bowl sitting in the school on the bed by the bed is tall .	the bowl sits in the school on the bed by the bed is tall .
the dish sitting by the crayon on the bed in the park is friendly .	the dish sits by the crayon on the bed in the park is friendly .
the bed sitting by the glass in the library on the couch is surprised .	the bed sits by the glass in the library on the couch is surprised .
the button sitting in the hospital by the bowl on the ground is strong .	the button sits in the hospital by the bowl on the ground is strong .
the button sitting in the room by the rocket on the table is nice .	the button sits in the room by the rocket on the table is nice .
the rug sitting in the kitchen by the glass in the park is confused .	the rug sits in the kitchen by the glass in the park is confused .
the boat sitting by the crayon on the chair on the bed is careful .	the boat sits by the crayon on the chair on the bed is careful .
the rocket sitting on the floor in the restaurant by the button is hungry .	the rocket sits on the floor in the restaurant by the button is hungry .
the rug sitting on the floor in the park in the kitchen is lucky .	the rug sits on the floor in the park in the kitchen is lucky .
the truck sitting by the boat by the spoon in the bank is gentle .	the truck sits by the boat by the spoon in the bank is gentle .
the book sitting by the hat by the glass in the hospital is careful .	the book sits by the hat by the glass in the hospital is careful .
the toy sitting on the bed by the rocket by the car is clever .	the toy sits on the bed by the rocket by the car is clever .
the bottle sitting by the bottle in the room in the mall is careful .	the bottle sits by the bottle in the room in the mall is careful .
the mirror sitting by the cup on the floor in the hospital is healthy .	the mirror sits by the cup on the floor in the hospital is healthy .
the dish sitting in the room on the floor by the bed is bored .	the dish sits in the room on the floor by the bed is bored .
the plate sitting on the stool on the couch by the mirror is important .	the plate sits on the stool on the couch by the mirror is important .
the shirt sitting in the school on the chair in the room is confused .	the shirt sits in the school on the chair in the room is confused .
the window sitting by the box in the school by the window is healthy .	the window sits by the box in the school by the window is healthy .
the bicycle sitting on the couch by the bag by the bag is surprised .	the bicycle sits on the couch by the bag by the bag is surprised .
the boat sitting in the mall on the chair on the chair is lucky .	the boat sits in the mall on the chair on the chair is lucky .
the plane sitting by the box in the hospital in the park is strong .	the plane sits by the box in the hospital in the park is strong .
the bicycle sitting on the ground by the ship in the bank is hungry .	the bicycle sits on the ground by the ship in the bank is hungry .
the window sitting by the truck on the ground on the table is curious .	the window sits by the truck on the ground on the table is curious .
the book sitting by the ship by the doll on the stool is gentle .	the book sits by the ship by the doll on the stool is gentle .
the plane sitting on the floor in the kitchen by the window is helpful .	the plane sits on the floor in the kitchen by the window is helpful .
the cup sitting on the table by the mirror on the stool is young .	the cup sits on the table by the mirror on the stool is young .
the bottle sitting by the shirt on the chair on the stool is smart .	the bottle sits by the shirt on the chair on the stool is smart .
the chair sitting in the kitchen on the street on the couch is happy .	the chair sits in the kitchen on the street on the couch is happy .
the shirt sitting on the couch on the couch by the glass is surprised .	the shirt sits on the couch on the couch by the glass is surprised .
the crayon sitting by the hat in the hospital by the bag is lucky .	the crayon sits by the hat in the hospital by the bag is lucky .
the button sitting by the toy in the hospital in the hospital is lucky .	the button sits by the toy in the hospital in the hospital is lucky .
the mirror sitting by the rocket on the chair by the window is gentle .	the mirror sits by the rocket on the chair by the window is gentle .
the bed sitting on the floor by the cup by the shirt is surprised .	the bed sits on the floor by the cup by the shirt is surprised .
the shoe sitting on the table on the couch by the bed is busy .	the shoe sits on the table on the couch by the bed is busy .
the dish sitting by the chair in the kitchen by the doll is young .	the dish sits by the chair in the kitchen by the doll is young .
the book sitting by the car on the stool by the shirt is hungry .	the book sits by the car on the stool by the shirt is hungry .
the window sitting on the chair by the car on the street is sleepy .	the window sits on the chair by the car on the street is sleepy .
the bag sitting by the bicycle by the window in the park is gentle .	the bag sits by the bicycle by the window in the park is gentle .
the box sitting in the school by the car on the ground is kind .	the box sits in the school by the car on the ground is kind .
the chair sitting on the floor in the bank in the hospital is helpful .	the chair sits on the floor in the bank in the hospital is helpful .
the couch sitting by the bowl on the table by the bowl is boring .	the couch sits by the bowl on the table by the bowl is boring .
the glass sitting on the ground by the couch by the ship is gentle .	the glass sits on the ground by the couch by the ship is gentle .
the couch sitting by the bottle by the dish by the bag is quiet .	the couch sits by the bottle by the dish by the bag is quiet .
the bag sitting by the truck in the hospital in the hospital is lucky .	the bag sits by the truck in the hospital in the hospital is lucky .
the book sitting on the chair by the door by the door is upset .	the book sits on the chair by the door by the door is upset .
the couch sitting by the car in the kitchen by the couch is gentle .	the couch sits by the car in the kitchen by the couch is gentle .
the chair sitting on the bed in the museum by the rocket is upset .	the chair sits on the bed in the museum by the rocket is upset .
the plate sitting by the shirt in the room by the boat is smart .	the plate sits by the shirt in the room by the boat is smart .
the shoe sitting in the park in the school by the bicycle is curious .	the shoe sits in the park in the school by the bicycle is curious .
the ship sitting on the street on the chair by the truck is curious .	the ship sits on the street on the chair by the truck is curious .
the rug sitting by the candle by the mirror on the stool is wrong .	the rug sits by the candle by the mirror on the stool is wrong .
the mirror sitting by the plate on the ground by the door is bored .	the mirror sits by the plate on the ground by the door is bored .
the picture sitting in the bank on the stool by the book is friendly .	the picture sits in the bank on the stool by the book is friendly .
the ring sitting by the plate on the floor on the ground is boring .	the ring sits by the plate on the floor on the ground is boring .
the book sitting on the ground on the chair in the museum is happy .	the book sits on the ground on the chair in the museum is happy .
the dish sitting in the hospital in the room by the book is tired .	the dish sits in the hospital in the room by the book is tired .
the bicycle sitting in the park by the cup in the school is gentle .	the bicycle sits in the park by the cup in the school is gentle .
the ship sitting by the boat on the table by the ship is boring .	the ship sits by the boat on the table by the ship is boring .
the glass sitting on the table by the dish on the street is upset .	the glass sits on the table by the dish on the street is upset .
the boat sitting by the spoon on the table on the stool is nice .	the boat sits by the spoon on the table on the stool is nice .
the car sitting by the rug on the couch by the book is wrong .	the car sits by the rug on the couch by the book is wrong .
the plane sitting on the couch in the park by the bag is lucky .	the plane sits on the couch in the park by the bag is lucky .
the couch sitting on the couch by the box by the bottle is confused .	the couch sits on the couch by the box by the bottle is confused .
the boat sitting in the school by the car by the bottle is wrong .	the boat sits in the school by the car by the bottle is wrong .
the rug sitting by the door in the bank by the button is tall .	the rug sits by the door in the bank by the button is tall .
the boat sitting in the restaurant on the ground on the floor is lucky .	the boat sits in the restaurant on the ground on the floor is lucky .
the glass sitting on the chair on the couch on the floor is tall .	the glass sits on the chair on the couch on the floor is tall .
the couch sitting on the table on the ground in the school is upset .	the couch sits on the table on the ground in the school is upset .
the truck sitting on the table by the crayon on the street is careful .	the truck sits on the table by the crayon on the street is careful .
the bottle sitting on the street on the chair on the stool is tired .	the bottle sits on the street on the chair on the stool is tired .
the spoon sitting by the button in the mall by the crayon is careful .	the spoon sits by the button in the mall by the crayon is careful .
the book sitting by the bicycle in the museum on the ground is busy .	the book sits by the bicycle in the museum on the ground is busy .
the toy sitting in the school by the doll by the rocket is excited .	the toy sits in the school by the doll by the rocket is excited .
the rocket sitting in the school on the ground by the rocket is bored .	the rocket sits in the school on the ground by the rocket is bored .
the toy sitting on the couch in the bank on the floor is wrong .	the toy sits on the couch in the bank on the floor is wrong .
the crayon sitting on the chair on the floor in the school is boring .	the crayon sits on the chair on the floor in the school is boring .
the picture sitting in the mall on the street on the table is helpful .	the picture sits in the mall on the street on the table is helpful .
the ship sitting in the mall by the car on the bed is confused .	the ship sits in the mall by the car on the bed is confused .
the cup sitting on the couch on the floor on the floor is bored .	the cup sits on the couch on the floor on the floor is bored .
the candle sitting on the ground on the chair in the kitchen is kind .	the candle sits on the ground on the chair in the kitchen is kind .
the bag sitting in the mall on the bed on the couch is upset .	the bag sits in the mall on the bed on the couch is upset .
the rocket sitting by the rocket on the street on the street is clever .	the rocket sits by the rocket on the street on the street is clever .
the car sitting on the stool by the car on the ground is sleepy .	the car sits on the stool by the car on the ground is sleepy .
the window sitting in the bank in the school by the spoon is quiet .	the window sits in the bank in the school by the spoon is quiet .
the window sitting on the street by the plate by the ship is quiet .	the window sits on the street by the plate by the ship is quiet .
the book sitting in the kitchen on the floor in the mall is quiet .	the book sits in the kitchen on the floor in the mall is quiet .
the plane sitting on the chair on the chair on the chair is smart .	the plane sits on the chair on the chair on the chair is smart .
the rocket sitting by the fork on the couch by the bowl is quiet .	the rocket sits by the fork on the couch by the bowl is quiet .
the rug sitting on the ground on the couch in the mall is curious .	the rug sits on the ground on the couch in the mall is curious .
the candle sitting by the window in the school by the box is healthy .	the candle sits by the window in the school by the box is healthy .
the car sitting on the ground in the room on the chair is tired .	the car sits on the ground in the room on the chair is tired .
the window sitting in the school by the window by the car is clever .	the window sits in the school by the window by the car is clever .
the dish sitting by the mirror in the library on the chair is excited .	the dish sits by the mirror in the library on the chair is excited .
the shirt sitting on the bed in the mall on the chair is hungry .	the shirt sits on the bed in the mall on the chair is hungry .
the bag sitting by the car by the cup on the couch is surprised .	the bag sits by the car by the cup on the couch is surprised .
the bowl sitting on the chair by the shirt by the bag is careful .	the bowl sits on the chair by the shirt by the bag is careful .
the window sitting on the couch by the doll in the hospital is lucky .	the window sits on the couch by the doll in the hospital is lucky .
the rocket sitting by the picture on the table in the school is tired .	the rocket sits by the picture on the table in the school is tired .
the cup sitting in the park in the room on the couch is friendly .	the cup sits in the park in the room on the couch is friendly .
the chair sitting by the boat on the ground on the bed is upset .	the chair sits by the boat on the ground on the bed is upset .
the bowl sitting on the stool by the plate in the bank is hungry .	the bowl sits on the stool by the plate in the bank is hungry .
the car sitting in the hospital on the floor on the ground is happy .	the car sits in the hospital on the floor on the ground is happy .
the fork sitting on the couch by the couch in the school is lucky .	the fork sits on the couch by the couch in the school is lucky .
the picture sitting on the street on the ground on the bed is quiet .	the picture sits on the street on the ground on the bed is quiet .
the plane sitting by the bowl on the bed in the bank is gentle .	the plane sits by the bowl on the bed in the bank is gentle .
the rocket sitting by the bowl on the couch in the room is surprised .	the rocket sits by the bowl on the couch in the room is surprised .
the bed sitting by the toy on the ground on the street is angry .	the bed sits by the toy on the ground on the street is angry .
the truck sitting on the couch by the book in the restaurant is excited .	the truck sits on the couch by the book in the restaurant is excited .
the plane sitting by the picture on the stool in the bank is surprised .	the plane sits by the picture on the stool in the bank is surprised .
the rug sitting in the room by the shirt by the boat is helpful .	the rug sits in the room by the shirt by the boat is helpful .
the boat sitting in the mall by the car by the car is nice .	the boat sits in the mall by the car by the car is nice .
the spoon sitting on the floor by the doll on the couch is strong .	the spoon sits on the floor by the doll on the couch is strong .
the rug sitting by the glass in the museum in the hospital is boring .	the rug sits by the glass in the museum in the hospital is boring .
the picture sitting by the boat by the glass by the ring is strong .	the picture sits by the boat by the glass by the ring is strong .
the cup sitting in the room on the street by the car is confused .	the cup sits in the room on the street by the car is confused .
the bowl sitting on the table by the doll on the ground is sleepy .	the bowl sits on the table by the doll on the ground is sleepy .
the rocket sitting by the car on the ground on the stool is hungry .	the rocket sits by the car on the ground on the stool is hungry .
the doll sitting on the bed by the book in the room is strong .	the doll sits on the bed by the book in the room is strong .
the truck sitting on the table on the street by the cup is curious .	the truck sits on the table on the street by the cup is curious .
the rocket sitting by the button on the bed in the school is hungry .	the rocket sits by the button on the bed in the school is hungry .
the plate sitting by the picture by the crayon by the truck is healthy .	the plate sits by the picture by the crayon by the truck is healthy .
the window sitting on the bed in the park on the ground is busy .	the window sits on the bed in the park on the ground is busy .
the button sitting on the street by the dish on the ground is friendly .	the button sits on the street by the dish on the ground is friendly .
the picture sitting on the table by the book in the hospital is hungry .	the picture sits on the table by the book in the hospital is hungry .
the glass sitting by the shirt in the mall on the couch is busy .	the glass sits by the shirt in the mall on the couch is busy .
the bag sitting on the table on the chair in the restaurant is tall .	the bag sits on the table on the chair in the restaurant is tall .
the car sitting by the window by the toy by the crayon is confused .	the car sits by the window by the toy by the crayon is confused .
the picture sitting on the street in the mall in the museum is careful .	the picture sits on the street in the mall in the museum is careful .
the hat sitting on the table on the chair on the floor is strong .	the hat sits on the table on the chair on the floor is strong .
the window sitting by the shoe by the book by the doll is lucky .	the window sits by the shoe by the book by the doll is lucky .
the chair sitting on the street in the museum by the bowl is excited .	the chair sits on the street in the museum by the bowl is excited .
the spoon sitting in the bank on the ground in the school is curious .	the spoon sits in the bank on the ground in the school is curious .
the spoon sitting on the couch in the restaurant on the stool is clever .	the spoon sits on the couch in the restaurant on the stool is clever .
the picture sitting by the bicycle in the library on the table is wrong .	the picture sits by the bicycle in the library on the table is wrong .
the rocket sitting on the table in the mall on the couch is excited .	the rocket sits on the table in the mall on the couch is excited .
the bicycle sitting on the chair on the table in the museum is tall .	the bicycle sits on the chair on the table in the museum is tall .
the rocket sitting in the park in the kitchen by the crayon is excited .	the rocket sits in the park in the kitchen by the crayon is excited .
the chair sitting by the hat by the chair in the mall is friendly .	the chair sits by the hat by the chair in the mall is friendly .
the book sitting in the bank by the bag by the car is helpful .	the book sits in the bank by the bag by the car is helpful .
the dish sitting in the hospital by the boat in the school is confused .	the dish sits in the hospital by the boat in the school is confused .
the rug sitting by the rug by the rug on the chair is upset .	the rug sits by the rug by the rug on the chair is upset .
the couch sitting in the school in the museum on the bed is confused .	the couch sits in the school in the museum on the bed is confused .
the boat sitting by the plane on the bed on the chair is quiet .	the boat sits by the plane on the bed on the chair is quiet .
the box sitting on the chair in the school on the street is smart .	the box sits on the chair in the school on the street is smart .
the mirror sitting on the bed by the shoe by the toy is confused .	the mirror sits on the bed by the shoe by the toy is confused .
the ring sitting in the restaurant by the bag on the chair is boring .	the ring sits in the restaurant by the bag on the chair is boring .
the couch sitting in the bank in the mall by the bag is quiet .	the couch sits in the bank in the mall by the bag is quiet .
the ship sitting on the ground on the couch in the bank is surprised .	the ship sits on the ground on the couch in the bank is surprised .
the box sitting by the doll in the park in the school is wrong .	the box sits by the doll in the park in the school is wrong .
the ring sitting in the bank in the school on the ground is bored .	the ring sits in the bank in the school on the ground is bored .
the ring sitting in the room on the bed by the doll is helpful .	the ring sits in the room on the bed by the doll is helpful .
the bottle sitting in the library on the floor by the spoon is gentle .	the bottle sits in the library on the floor by the spoon is gentle .
the bottle sitting on the ground in the school on the table is clever .	the bottle sits on the ground in the school on the table is clever .
the window sitting in the bank on the street in the room is careful .	the window sits in the bank on the street in the room is careful .
the glass sitting by the car on the street by the box is smart .	the glass sits by the car on the street by the box is smart .
the bottle sitting by the truck in the library in the school is quiet .	the bottle sits by the truck in the library in the school is quiet .
the shirt sitting on the chair by the bag in the library is hungry .	the shirt sits on the chair by the bag in the library is hungry .
the mirror sitting by the box in the kitchen in the museum is sleepy .	the mirror sits by the box in the kitchen in the museum is sleepy .
the button sitting in the school on the ground by the cup is strong .	the button sits in the school on the ground by the cup is strong .
the shoe sitting by the doll in the park on the street is gentle .	the shoe sits by the doll in the park on the street is gentle .
the hat sitting by the plate by the toy in the school is tired .	the hat sits by the plate by the toy in the school is tired .
the plate sitting in the museum on the table by the plane is bored .	the plate sits in the museum on the table by the plane is bored .
the truck sitting on the stool in the bank by the hat is surprised .	the truck sits on the stool in the bank by the hat is surprised .
the door sitting in the mall on the floor by the plane is lucky .	the door sits in the mall on the floor by the plane is lucky .
the button sitting on the table by the bottle on the chair is happy .	the button sits on the table by the bottle on the chair is happy .
the button sitting by the bottle by the candle on the street is healthy .	the button sits by the bottle by the candle on the street is healthy .
the bag sitting on the bed in the room by the toy is happy .	the bag sits on the bed in the room by the toy is happy .
the truck sitting in the bank by the bag on the floor is surprised .	the truck sits in the bank by the bag on the floor is surprised .
the glass sitting on the bed by the mirror on the floor is nice .	the glass sits on the bed by the mirror on the floor is nice .
the boat sitting by the door on the bed in the library is young .	the boat sits by the door on the bed in the library is young .
the hat sitting by the car by the cup in the room is wrong .	the hat sits by the car by the cup in the room is wrong .
the ring sitting by the rocket in the park in the restaurant is tired .	the ring sits by the rocket in the park in the restaurant is tired .
the book sitting by the button in the kitchen in the mall is quiet .	the book sits by the button in the kitchen in the mall is quiet .
the dish sitting by the book in the room in the park is hungry .	the dish sits by the book in the room in the park is hungry .
the picture sitting in the hospital in the restaurant on the table is smart .	the picture sits in the hospital in the restaurant on the table is smart .
the mirror sitting by the ship on the bed on the ground is lucky .	the mirror sits by the ship on the bed on the ground is lucky .
the spoon sitting by the mirror in the room by the box is excited .	the spoon sits by the mirror in the room by the box is excited .
the car sitting by the button by the ship in the bank is bored .	the car sits by the button by the ship in the bank is bored .
the glass sitting by the ship by the chair in the museum is curious .	the glass sits by the ship by the chair in the museum is curious .
the cup sitting in the mall by the plane in the bank is bored .	the cup sits in the mall by the plane in the bank is bored .
the shoe sitting in the bank on the bed by the toy is tired .	the shoe sits in the bank on the bed by the toy is tired .
the bowl sitting on the table on the floor in the museum is quiet .	the bowl sits on the table on the floor in the museum is quiet .
the plane sitting in the restaurant on the table in the library is curious .	the plane sits in the restaurant on the table in the library is curious .
the ring sitting in the library on the chair in the school is important .	the ring sits in the library on the chair in the school is important .
the crayon sitting on the couch on the stool on the ground is friendly .	the crayon sits on the couch on the stool on the ground is friendly .
the glass sitting in the hospital on the ground by the shoe is upset .	the glass sits in the hospital on the ground by the shoe is upset .
the box sitting in the room in the restaurant on the table is bored .	the box sits in the room in the restaurant on the table is bored .
the shoe sitting by the button by the hat by the plane is tired .	the shoe sits by the button by the hat by the plane is tired .
the chair sitting on the floor by the bed in the park is kind .	the chair sits on the floor by the bed in the park is kind .
the truck sitting on the couch by the shirt on the floor is busy .	the truck sits on the couch by the shirt on the floor is busy .
the bowl sitting on the street in the mall by the door is kind .	the bowl sits on the street in the mall by the door is kind .
the fork sitting by the bowl on the chair by the plate is kind .	the fork sits by the bowl on the chair by the plate is kind .
the book sitting on the chair in the school in the school is busy .	the book sits on the chair in the school in the school is busy .
the door sitting by the toy on the chair by the car is helpful .	the door sits by the toy on the chair by the car is helpful .
the book sitting on the floor on the floor on the chair is gentle .	the book sits on the floor on the floor on the chair is gentle .
the bed sitting on the couch in the museum by the ship is healthy .	the bed sits on the couch in the museum by the ship is healthy .
the plate sitting on the street on the stool in the park is important .	the plate sits on the street on the stool in the park is important .
the couch sitting in the park by the bed by the bowl is surprised .	the couch sits in the park by the bed by the bowl is surprised .
the button sitting by the bowl by the book in the school is clever .	the button sits by the bowl by the book in the school is clever .
the cup sitting in the room by the dish on the stool is boring .	the cup sits in the room by the dish on the stool is boring .
the dish sitting on the ground by the chair by the fork is important .	the dish sits on the ground by the chair by the fork is important .
the door sitting by the boat on the stool by the plane is surprised .	the door sits by the boat on the stool by the plane is surprised .
the door sitting by the box by the shirt by the button is bored .	the door sits by the box by the shirt by the button is bored .
the window sitting in the bank in the mall in the mall is boring .	the window sits in the bank in the mall in the mall is boring .
the toy sitting by the boat in the restaurant on the stool is hungry .	the toy sits by the boat in the restaurant on the stool is hungry .
the ring sitting by the ring on the stool by the car is sleepy .	the ring sits by the ring on the stool by the car is sleepy .
the boat sitting in the bank by the plane by the couch is young .	the boat sits in the bank by the plane by the couch is young .
the hat sitting on the stool on the bed by the bag is friendly .	the hat sits on the stool on the bed by the bag is friendly .
the fork sitting on the table on the bed on the couch is nice .	the fork sits on the table on the bed on the couch is nice .
the rocket sitting in the school on the street in the room is happy .	the rocket sits in the school on the street in the room is happy .
the door sitting in the kitchen in the park by the plate is gentle .	the door sits in the kitchen in the park by the plate is gentle .
the plane sitting on the bed by the bag on the ground is young .	the plane sits on the bed by the bag on the ground is young .
the toy sitting on the stool by the ship by the bottle is helpful .	the toy sits on the stool by the ship by the bottle is helpful .
the boat sitting on the chair on the floor in the bank is clever .	the boat sits on the chair on the floor in the bank is clever .
the bowl sitting by the box on the stool by the plate is wrong .	the bowl sits by the box on the stool by the plate is wrong .
the box sitting on the floor in the restaurant by the bicycle is strong .	the box sits on the floor in the restaurant by the bicycle is strong .
the book sitting on the couch in the museum by the hat is smart .	the book sits on the couch in the museum by the hat is smart .
the car sitting on the floor by the window in the museum is angry .	the car sits on the floor by the window in the museum is angry .
the car sitting by the car in the mall by the shirt is clever .	the car sits by the car in the mall by the shirt is clever .
the truck sitting in the hospital in the mall in the room is boring .	the truck sits in the hospital in the mall in the room is boring .
the door sitting on the street by the window on the couch is upset .	the door sits on the street by the window on the couch is upset .
the rocket sitting in the mall in the park in the mall is sleepy .	the rocket sits in the mall in the park in the mall is sleepy .
the couch sitting on the bed on the floor by the rug is gentle .	the couch sits on the bed on the floor by the rug is gentle .
the fork sitting on the table in the bank in the school is happy .	the fork sits on the table in the bank in the school is happy .
the window sitting on the couch on the bed by the bag is tall .	the window sits on the couch on the bed by the bag is tall .
the bowl sitting on the couch by the plate on the chair is hungry .	the bowl sits on the couch by the plate on the chair is hungry .
the toy sitting in the school on the table on the floor is wrong .	the toy sits in the school on the table on the floor is wrong .
the bed sitting by the bag by the bed on the bed is tall .	the bed sits by the bag by the bed on the bed is tall .
the plane sitting by the bed by the picture in the school is young .	the plane sits by the bed by the picture in the school is young .
the chair sitting on the stool in the room in the library is excited .	the chair sits on the stool in the room in the library is excited .
the rug sitting on the floor on the bed on the bed is hungry .	the rug sits on the floor on the bed on the bed is hungry .
the rocket sitting on the chair on the stool by the shirt is quiet .	the rocket sits on the chair on the stool by the shirt is quiet .
the plane sitting in the school by the truck by the bed is friendly .	the plane sits in the school by the truck by the bed is friendly .
the boat sitting on the chair on the table by the button is curious .	the boat sits on the chair on the table by the button is curious .
the bicycle sitting by the cup by the spoon by the picture is careful .	the bicycle sits by the cup by the spoon by the picture is careful .
the box sitting on the floor by the chair in the hospital is sleepy .	the box sits on the floor by the chair in the hospital is sleepy .
the button sitting on the floor on the bed by the bed is young .	the button sits on the floor on the bed by the bed is young .
the ring sitting by the chair in the school by the spoon is excited .	the ring sits by the chair in the school by the spoon is excited .
the bowl sitting by the toy on the chair on the ground is wrong .	the bowl sits by the toy on the chair on the ground is wrong .
the boat sitting in the park on the stool by the bowl is curious .	the boat sits in the park on the stool by the bowl is curious .
the mirror sitting on the stool on the couch by the bottle is healthy .	the mirror sits on the stool on the couch by the bottle is healthy .
the chair sitting in the library on the stool on the ground is bored .	the chair sits in the library on the stool on the ground is bored .
the car sitting on the floor in the school by the mirror is kind .	the car sits on the floor in the school by the mirror is kind .
the cup sitting in the library by the plane by the couch is important .	the cup sits in the library by the plane by the couch is important .
the cup sitting by the cup by the window in the school is happy .	the cup sits by the cup by the window in the school is happy .
the ring sitting on the couch on the floor in the kitchen is clever .	the ring sits on the couch on the floor in the kitchen is clever .
the bag sitting in the school in the school by the plate is tall .	the bag sits in the school in the school by the plate is tall .
the couch sitting in the kitchen on the table by the truck is curious .	the couch sits in the kitchen on the table by the truck is curious .
the rug sitting on the bed on the chair in the kitchen is tired .	the rug sits on the bed on the chair in the kitchen is tired .
the ring sitting by the chair by the rocket on the chair is young .	the ring sits by the chair by the rocket on the chair is young .
the hat sitting in the school by the bag on the street is healthy .	the hat sits in the school by the bag on the street is healthy .
the shoe sitting on the table by the boat in the museum is careful .	the shoe sits on the table by the boat in the museum is careful .
the car sitting by the car in the school by the plane is boring .	the car sits by the car in the school by the plane is boring .
the boat sitting on the street on the floor by the picture is surprised .	the boat sits on the street on the floor by the picture is surprised .
the button sitting in the school by the plate in the school is strong .	the button sits in the school by the plate in the school is strong .
the door sitting on the table in the mall by the ring is hungry .	the door sits on the table in the mall by the ring is hungry .
the shirt sitting by the boat in the room on the couch is important .	the shirt sits by the boat in the room on the couch is important .
the candle sitting on the ground on the ground in the school is wrong .	the candle sits on the ground on the ground in the school is wrong .
the bed sitting in the library by the box by the plane is surprised .	the bed sits in the library by the box by the plane is surprised .
the shirt sitting in the hospital in the school in the mall is healthy .	the shirt sits in the hospital in the school in the mall is healthy .
the bag sitting on the chair in the kitchen on the ground is tired .	the bag sits on the chair in the kitchen on the ground is tired .
the bowl sitting in the school in the school by the crayon is gentle .	the bowl sits in the school in the school by the crayon is gentle .
the shoe sitting on the stool on the chair in the school is angry .	the shoe sits on the stool on the chair in the school is angry .
the hat sitting by the bottle by the book by the window is friendly .	the hat sits by the bottle by the book by the window is friendly .
the rug sitting on the couch by the spoon in the mall is kind .	the rug sits on the couch by the spoon in the mall is kind .
the button sitting by the fork in the mall by the plate is important .	the button sits by the fork in the mall by the plate is important .
the bag sitting on the ground in the restaurant on the table is careful .	the bag sits on the ground in the restaurant on the table is careful .
the ring sitting in the room by the dish in the library is kind .	the ring sits in the room by the dish in the library is kind .
the ring sitting in the room by the couch by the plane is boring .	the ring sits in the room by the couch by the plane is boring .
the plane sitting in the bank by the truck by the doll is lucky .	the plane sits in the bank by the truck by the doll is lucky .
the fork sitting on the floor on the floor in the hospital is surprised .	the fork sits on the floor on the floor in the hospital is surprised .
the candle sitting on the table on the couch in the restaurant is tall .	the candle sits on the table on the couch in the restaurant is tall .
the mirror sitting in the park in the restaurant on the street is friendly .	the mirror sits in the park in the restaurant on the street is friendly .
the plane sitting in the bank by the cup by the plate is tired .	the plane sits in the bank by the cup by the plate is tired .
the button sitting in the museum on the floor in the school is confused .	the button sits in the museum on the floor in the school is confused .
the bag sitting by the crayon on the bed in the restaurant is confused .	the bag sits by the crayon on the bed in the restaurant is confused .
the spoon sitting on the table on the table by the bowl is confused .	the spoon sits on the table on the table by the bowl is confused .
the truck sitting in the museum in the restaurant by the book is surprised .	the truck sits in the museum in the restaurant by the book is surprised .
the dish sitting in the room by the spoon in the school is helpful .	the dish sits in the room by the spoon in the school is helpful .
the chair sitting in the school in the park in the bank is lucky .	the chair sits in the school in the park in the bank is lucky .
the chair sitting by the hat in the restaurant on the street is busy .	the chair sits by the hat in the restaurant on the street is busy .
the plane sitting on the floor in the room on the ground is hungry .	the plane sits on the floor in the room on the ground is hungry .
the shirt sitting by the fork on the chair in the museum is healthy .	the shirt sits by the fork on the chair in the museum is healthy .
the book sitting in the bank by the rocket by the doll is excited .	the book sits in the bank by the rocket by the doll is excited .
the bottle sitting in the museum in the restaurant in the hospital is wrong .	the bottle sits in the museum in the restaurant in the hospital is wrong .
the glass sitting by the bag by the glass in the museum is friendly .	the glass sits by the bag by the glass in the museum is friendly .
the box sitting on the chair on the street by the glass is confused .	the box sits on the chair on the street by the glass is confused .
the candle sitting on the chair in the kitchen in the mall is nice .	the candle sits on the chair in the kitchen in the mall is nice .
the bed sitting by the picture on the floor on the chair is bored .	the bed sits by the picture on the floor on the chair is bored .
the dish sitting by the book by the ring in the school is tall .	the dish sits by the book by the ring in the school is tall .
the plate sitting in the library on the floor by the box is busy .	the plate sits in the library on the floor by the box is busy .
the plate sitting on the stool on the floor on the floor is busy .	the plate sits on the stool on the floor on the floor is busy .
the shirt sitting by the picture in the room by the glass is quiet .	the shirt sits by the picture in the room by the glass is quiet .
the bag sitting by the ring by the book in the bank is clever .	the bag sits by the ring by the book in the bank is clever .
the glass sitting on the couch in the room on the bed is angry .	the glass sits on the couch in the room on the bed is angry .
the rocket sitting by the boat in the restaurant in the mall is helpful .	the rocket sits by the boat in the restaurant in the mall is helpful .
the bed sitting by the bowl on the chair by the bicycle is smart .	the bed sits by the bowl on the chair by the bicycle is smart .
the rocket sitting on the stool by the doll in the bank is busy .	the rocket sits on the stool by the doll in the bank is busy .
the truck sitting on the street in the museum in the kitchen is confused .	the truck sits on the street in the museum in the kitchen is confused .
the button sitting by the bowl on the street on the couch is strong .	the button sits by the bowl on the street on the couch is strong .
the door sitting on the floor by the spoon on the couch is excited .	the door sits on the floor by the spoon on the couch is excited .
the ship sitting on the chair in the library by the book is nice .	the ship sits on the chair in the library by the book is nice .
the plate sitting on the floor by the car in the mall is strong .	the plate sits on the floor by the car in the mall is strong .
the mirror sitting on the ground by the button on the ground is confused .	the mirror sits on the ground by the button on the ground is confused .
the hat sitting in the mall by the bag on the ground is kind .	the hat sits in the mall by the bag on the ground is kind .
the mirror sitting by the bed in the bank in the park is bored .	the mirror sits by the bed in the bank in the park is bored .
the glass sitting by the bottle by the car on the table is clever .	the glass sits by the bottle by the car on the table is clever .
the boat sitting on the stool in the kitchen in the bank is tired .	the boat sits on the stool in the kitchen in the bank is tired .
the door sitting on the floor in the museum in the school is lucky .	the door sits on the floor in the museum in the school is lucky .
the crayon sitting on the chair by the boat in the school is helpful .	the crayon sits on the chair by the boat in the school is helpful .
the spoon sitting on the floor in the hospital on the couch is bored .	the spoon sits on the floor in the hospital on the couch is bored .
the book sitting by the fork on the couch in the bank is excited .	the book sits by the fork on the couch in the bank is excited .
the spoon sitting on the ground in the mall by the car is boring .	the spoon sits on the ground in the mall by the car is boring .
the window sitting in the restaurant by the mirror in the room is excited .	the window sits in the restaurant by the mirror in the room is excited .
the ship sitting in the room by the picture on the ground is angry .	the ship sits in the room by the picture on the ground is angry .
the chair sitting by the bowl in the library in the school is angry .	the chair sits by the bowl in the library in the school is angry .
the fork sitting in the school on the chair in the hospital is confused .	the fork sits in the school on the chair in the hospital is confused .
the door sitting in the hospital on the street by the hat is gentle .	the door sits in the hospital on the street by the hat is gentle .
the toy sitting by the fork in the room on the stool is clever .	the toy sits by the fork in the room on the stool is clever .
the bed sitting in the library on the stool in the museum is friendly .	the bed sits in the library on the stool in the museum is friendly .
the toy sitting on the couch by the picture in the library is friendly .	the toy sits on the couch by the picture in the library is friendly .
the bowl sitting by the chair in the room on the couch is smart .	the bowl sits by the chair in the room on the couch is smart .
the shoe sitting by the glass by the glass by the bag is confused .	the shoe sits by the glass by the glass by the bag is confused .
the plate sitting on the table in the kitchen in the hospital is tired .	the plate sits on the table in the kitchen in the hospital is tired .
the button sitting by the bottle on the chair in the park is tired .	the button sits by the bottle on the chair in the park is tired .
the button sitting by the bed on the street on the table is upset .	the button sits by the bed on the street on the table is upset .
the crayon sitting in the hospital on the ground by the plate is surprised .	the crayon sits in the hospital on the ground by the plate is surprised .
the hat sitting by the hat in the school in the mall is careful .	the hat sits by the hat in the school in the mall is careful .
the mirror sitting in the museum by the button by the chair is friendly .	the mirror sits in the museum by the button by the chair is friendly .
the bicycle sitting in the school in the hospital in the museum is boring .	the bicycle sits in the school in the hospital in the museum is boring .
the bowl sitting in the library by the bag on the floor is wrong .	the bowl sits in the library by the bag on the floor is wrong .
the bed sitting in the school on the street in the hospital is kind .	the bed sits in the school on the street in the hospital is kind .
the plate sitting on the stool by the car by the plate is boring .	the plate sits on the stool by the car by the plate is boring .
the button sitting on the street on the ground in the school is kind .	the button sits on the street on the ground in the school is kind .
the bottle sitting by the doll on the street by the book is wrong .	the bottle sits by the doll on the street by the book is wrong .
the bottle sitting on the ground in the park on the table is sleepy .	the bottle sits on the ground in the park on the table is sleepy .
the rug sitting by the button by the button on the table is confused .	the rug sits by the button by the button on the table is confused .
the book sitting on the chair on the couch in the bank is nice .	the book sits on the chair on the couch in the bank is nice .
the chair sitting by the truck by the bicycle by the hat is lucky .	the chair sits by the truck by the bicycle by the hat is lucky .
the fork sitting in the room in the bank by the dish is confused .	the fork sits in the room in the bank by the dish is confused .
the fork sitting on the street by the mirror on the ground is nice .	the fork sits on the street by the mirror on the ground is nice .
the door sitting in the school on the chair by the car is boring .	the door sits in the school on the chair by the car is boring .
the car sitting in the library on the table on the street is kind .	the car sits in the library on the table on the street is kind .
the shirt sitting in the mall by the car in the museum is boring .	the shirt sits in the mall by the car in the museum is boring .
the fork sitting in the school on the couch in the bank is happy .	the fork sits in the school on the couch in the bank is happy .
the bowl sitting by the rug on the ground in the restaurant is strong .	the bowl sits by the rug on the ground in the restaurant is strong .
the toy sitting by the car on the floor by the car is important .	the toy sits by the car on the floor by the car is important .
the toy sitting by the ship by the hat on the street is boring .	the toy sits by the ship by the hat on the street is boring .
the car sitting by the boat by the mirror on the chair is gentle .	the car sits by the boat by the mirror on the chair is gentle .
the door sitting in the school on the couch by the bottle is nice .	the door sits in the school on the couch by the bottle is nice .
the bag sitting on the street by the book on the stool is happy .	the bag sits on the street by the book on the stool is happy .
the bicycle sitting in the bank on the floor by the truck is friendly .	the bicycle sits in the bank on the floor by the truck is friendly .
the book sitting in the mall on the floor by the dish is nice .	the book sits in the mall on the floor by the dish is nice .
the bicycle sitting on the chair in the museum on the chair is upset .	the bicycle sits on the chair in the museum on the chair is upset .
the boat sitting in the library on the couch in the museum is happy .	the boat sits in the library on the couch in the museum is happy .
the shoe sitting on the bed on the street in the bank is confused .	the shoe sits on the bed on the street in the bank is confused .
the toy sitting on the chair on the bed by the plane is wrong .	the toy sits on the chair on the bed by the plane is wrong .
the ship sitting in the kitchen on the street on the couch is clever .	the ship sits in the kitchen on the street on the couch is clever .
the doll sitting by the toy in the school in the room is careful .	the doll sits by the toy in the school in the room is careful .
the plate sitting in the mall by the dish in the museum is angry .	the plate sits in the mall by the dish in the museum is angry .
the box sitting in the school by the glass in the kitchen is healthy .	the box sits in the school by the glass in the kitchen is healthy .
the box sitting in the restaurant on the chair in the bank is excited .	the box sits in the restaurant on the chair in the bank is excited .
the couch sitting in the restaurant by the shoe in the room is lucky .	the couch sits in the restaurant by the shoe in the room is lucky .
the cup sitting on the bed by the shoe on the bed is boring .	the cup sits on the bed by the shoe on the bed is boring .
the button sitting in the museum in the kitchen by the shirt is healthy .	the button sits in the museum in the kitchen by the shirt is healthy .
the car sitting by the car by the ring on the table is happy .	the car sits by the car by the ring on the table is happy .
the toy sitting by the glass by the truck on the table is excited .	the toy sits by the glass by the truck on the table is excited .
the shirt sitting by the book by the candle by the ring is angry .	the shirt sits by the book by the candle by the ring is angry .
the boat sitting by the bed in the mall in the school is hungry .	the boat sits by the bed in the mall in the school is hungry .
the boat sitting in the room in the room in the school is angry .	the boat sits in the room in the room in the school is angry .
the ship sitting by the box on the bed by the toy is surprised .	the ship sits by the box on the bed by the toy is surprised .
the couch sitting on the bed by the ring on the floor is friendly .	the couch sits on the bed by the ring on the floor is friendly .
the bottle sitting in the school in the park by the dish is curious .	the bottle sits in the school in the park by the dish is curious .
the toy sitting by the toy by the ring on the chair is healthy .	the toy sits by the toy by the ring on the chair is healthy .
the truck sitting by the mirror on the street in the mall is surprised .	the truck sits by the mirror on the street in the mall is surprised .
the candle sitting on the stool by the cup in the room is gentle .	the candle sits on the stool by the cup in the room is gentle .
the glass sitting by the boat by the boat on the stool is quiet .	the glass sits by the boat by the boat on the stool is quiet .
the boat sitting by the rug by the truck in the museum is smart .	the boat sits by the rug by the truck in the museum is smart .
the hat sitting on the couch in the school on the floor is bored .	the hat sits on the couch in the school on the floor is bored .
the button sitting on the ground in the school in the museum is gentle .	the button sits on the ground in the school in the museum is gentle .
the bowl sitting on the street by the chair in the museum is tired .	the bowl sits on the street by the chair in the museum is tired .
the bag sitting on the ground on the table on the floor is bored .	the bag sits on the ground on the table on the floor is bored .
the door sitting by the spoon by the bag by the couch is confused .	the door sits by the spoon by the bag by the couch is confused .
the bed sitting on the stool by the candle on the table is upset .	the bed sits on the stool by the candle on the table is upset .
the boat sitting on the couch on the bed on the table is quiet .	the boat sits on the couch on the bed on the table is quiet .
the candle sitting on the chair in the bank by the mirror is curious .	the candle sits on the chair in the bank by the mirror is curious .
the bicycle sitting by the fork in the kitchen by the ship is kind .	the bicycle sits by the fork in the kitchen by the ship is kind .
the glass sitting in the hospital on the couch in the school is careful .	the glass sits in the hospital on the couch in the school is careful .
the spoon sitting on the couch by the couch in the school is upset .	the spoon sits on the couch by the couch in the school is upset .
the chair sitting by the door in the school in the library is important .	the chair sits by the door in the school in the library is important .
the box sitting in the school by the glass in the hospital is important .	the box sits in the school by the glass in the hospital is important .
the shirt sitting by the cup in the hospital by the mirror is strong .	the shirt sits by the cup in the hospital by the mirror is strong .
the mirror sitting by the couch on the chair on the couch is important .	the mirror sits by the couch on the chair on the couch is important .
the plate sitting in the restaurant on the couch on the chair is young .	the plate sits in the restaurant on the couch on the chair is young .
the rocket sitting in the kitchen in the school by the rug is hungry .	the rocket sits in the kitchen in the school by the rug is hungry .
the plane sitting in the kitchen on the couch in the park is lucky .	the plane sits in the kitchen on the couch in the park is lucky .
the cup sitting on the floor on the table on the floor is important .	the cup sits on the floor on the table on the floor is important .
the dish sitting on the ground by the picture on the table is upset .	the dish sits on the ground by the picture on the table is upset .
the fork sitting in the park by the dish on the couch is wrong .	the fork sits in the park by the dish on the couch is wrong .
the ring sitting by the crayon by the box on the floor is sleepy .	the ring sits by the crayon by the box on the floor is sleepy .
the candle sitting by the ring in the school by the toy is helpful .	the candle sits by the ring in the school by the toy is helpful .
the ship sitting on the stool on the street on the table is careful .	the ship sits on the stool on the street on the table is careful .
the box sitting on the couch by the crayon on the table is kind .	the box sits on the couch by the crayon on the table is kind .
the bowl sitting by the rocket on the table in the museum is curious .	the bowl sits by the rocket on the table in the museum is curious .
the rug sitting on the street on the floor on the stool is curious .	the rug sits on the street on the floor on the stool is curious .
the fork sitting in the bank on the bed in the school is young .	the fork sits in the bank on the bed in the school is young .
the car sitting in the kitchen in the kitchen in the hospital is busy .	the car sits in the kitchen in the kitchen in the hospital is busy .
the car sitting on the floor in the kitchen in the restaurant is upset .	the car sits on the floor in the kitchen in the restaurant is upset .
the ring sitting by the bowl on the street on the stool is sleepy .	the ring sits by the bowl on the street on the stool is sleepy .
the glass sitting by the ship on the street on the bed is gentle .	the glass sits by the ship on the street on the bed is gentle .
the doll sitting by the bicycle by the bicycle on the street is hungry .	the doll sits by the bicycle by the bicycle on the street is hungry .
the button sitting in the room on the street in the library is lucky .	the button sits in the room on the street in the library is lucky .
the bottle sitting by the window on the stool in the mall is clever .	the bottle sits by the window on the stool in the mall is clever .
the chair sitting in the museum in the bank on the floor is sleepy .	the chair sits in the museum in the bank on the floor is sleepy .
the picture sitting in the school in the library by the glass is strong .	the picture sits in the school in the library by the glass is strong .
the glass sitting in the library on the ground on the chair is busy .	the glass sits in the library on the ground on the chair is busy .
the bed sitting in the bank in the library in the hospital is nice .	the bed sits in the bank in the library in the hospital is nice .
the glass sitting on the stool in the restaurant by the door is happy .	the glass sits on the stool in the restaurant by the door is happy .
the truck sitting in the library in the mall on the stool is wrong .	the truck sits in the library in the mall on the stool is wrong .
the shirt sitting in the restaurant by the car on the street is friendly .	the shirt sits in the restaurant by the car on the street is friendly .
the shoe sitting by the box on the floor by the chair is busy .	the shoe sits by the box on the floor by the chair is busy .
the button sitting on the street in the room in the museum is tall .	the button sits on the street in the room in the museum is tall .
the shirt sitting in the room on the floor on the floor is tall .	the shirt sits in the room on the floor on the floor is tall .
the cup sitting on the chair on the couch by the bottle is upset .	the cup sits on the chair on the couch by the bottle is upset .
the couch sitting on the couch in the hospital by the window is lucky .	the couch sits on the couch in the hospital by the window is lucky .
the car sitting in the room by the doll on the floor is boring .	the car sits in the room by the doll on the floor is boring .
the plane sitting in the museum in the room by the bicycle is tired .	the plane sits in the museum in the room by the bicycle is tired .
the mirror sitting in the museum in the room on the chair is surprised .	the mirror sits in the museum in the room on the chair is surprised .
the plane sitting on the couch by the book in the mall is careful .	the plane sits on the couch by the book in the mall is careful .
the spoon sitting in the school by the dish in the kitchen is careful .	the spoon sits in the school by the dish in the kitchen is careful .
the spoon sitting by the bag by the cup by the doll is strong .	the spoon sits by the bag by the cup by the doll is strong .
the door sitting in the museum in the kitchen in the hospital is strong .	the door sits in the museum in the kitchen in the hospital is strong .
the chair sitting in the restaurant on the table by the ring is quiet .	the chair sits in the restaurant on the table by the ring is quiet .
the window sitting by the car in the kitchen in the museum is strong .	the window sits by the car in the kitchen in the museum is strong .
the car sitting by the bowl by the couch on the couch is clever .	the car sits by the bowl by the couch on the couch is clever .
the window sitting in the room by the chair in the mall is wrong .	the window sits in the room by the chair in the mall is wrong .
the plate sitting in the museum in the school on the table is young .	the plate sits in the museum in the school on the table is young .
the boat sitting on the ground on the bed by the rug is wrong .	the boat sits on the ground on the bed by the rug is wrong .
the dish sitting by the spoon by the picture on the street is important .	the dish sits by the spoon by the picture on the street is important .
the book sitting on the table in the museum by the car is gentle .	the book sits on the table in the museum by the car is gentle .
the candle sitting in the school on the street in the room is quiet .	the candle sits in the school on the street in the room is quiet .
the dish sitting by the bed on the chair on the couch is careful .	the dish sits by the bed on the chair on the couch is careful .
the plane sitting in the school by the chair in the school is hungry .	the plane sits in the school by the chair in the school is hungry .
the doll sitting in the bank in the park by the shoe is gentle .	the doll sits in the bank in the park by the shoe is gentle .
the book sitting on the chair by the fork in the museum is hungry .	the book sits on the chair by the fork in the museum is hungry .
the rocket sitting in the kitchen in the school in the library is lucky .	the rocket sits in the kitchen in the school in the library is lucky .
the bed sitting on the chair on the ground in the mall is tired .	the bed sits on the chair on the ground in the mall is tired .
the dish sitting on the bed by the spoon on the street is hungry .	the dish sits on the bed by the spoon on the street is hungry .
the cup sitting on the floor on the bed by the bottle is strong .	the cup sits on the floor on the bed by the bottle is strong .
the bowl sitting by the book by the truck in the library is careful .	the bowl sits by the book by the truck in the library is careful .
the door sitting on the table in the bank in the room is friendly .	the door sits on the table in the bank in the room is friendly .
the fork sitting in the hospital on the table in the park is bored .	the fork sits in the hospital on the table in the park is bored .
the bottle sitting by the box in the school on the stool is young .	the bottle sits by the box in the school on the stool is young .
the shirt sitting on the table in the museum by the box is upset .	the shirt sits on the table in the museum by the box is upset .
the window sitting on the floor on the table on the ground is smart .	the window sits on the floor on the table on the ground is smart .
the plane sitting on the ground on the couch in the room is young .	the plane sits on the ground on the couch in the room is young .
the ring sitting on the stool by the book by the car is hungry .	the ring sits on the stool by the book by the car is hungry .
the fork sitting on the chair on the chair on the bed is upset .	the fork sits on the chair on the chair on the bed is upset .
the ship sitting by the window on the chair on the ground is strong .	the ship sits by the window on the chair on the ground is strong .
the picture sitting by the car by the plane by the plate is hungry .	the picture sits by the car by the plane by the plate is hungry .
the bag sitting on the chair in the mall on the floor is strong .	the bag sits on the chair in the mall on the floor is strong .
the box sitting on the bed on the couch on the floor is tired .	the box sits on the bed on the couch on the floor is tired .
the ring sitting by the mirror by the doll by the hat is careful .	the ring sits by the mirror by the doll by the hat is careful .
the glass sitting on the street on the bed by the button is helpful .	the glass sits on the street on the bed by the button is helpful .
the boat sitting on the chair on the ground on the bed is wrong .	the boat sits on the chair on the ground on the bed is wrong .
the doll sitting in the kitchen in the room on the couch is wrong .	the doll sits in the kitchen in the room on the couch is wrong .
the ship sitting in the hospital by the ring on the couch is healthy .	the ship sits in the hospital by the ring on the couch is healthy .
the box sitting in the school by the car by the truck is helpful .	the box sits in the school by the car by the truck is helpful .
the chair sitting by the spoon in the library on the chair is strong .	the chair sits by the spoon in the library on the chair is strong .
the toy sitting on the couch on the couch on the bed is smart .	the toy sits on the couch on the couch on the bed is smart .
the bottle sitting in the mall by the glass in the park is friendly .	the bottle sits in the mall by the glass in the park is friendly .
the rug sitting in the school on the floor on the chair is nice .	the rug sits in the school on the floor on the chair is nice .
the shoe sitting by the candle by the bowl by the bed is confused .	the shoe sits by the candle by the bowl by the bed is confused .
the bed sitting on the ground on the table by the button is lucky .	the bed sits on the ground on the table by the button is lucky .
the mirror sitting in the hospital in the library by the hat is careful .	the mirror sits in the hospital in the library by the hat is careful .
the toy sitting on the street by the couch on the table is busy .	the toy sits on the street by the couch on the table is busy .
the ship sitting by the bed by the cup on the stool is angry .	the ship sits by the bed by the cup on the stool is angry .
the car sitting on the stool on the ground in the library is upset .	the car sits on the stool on the ground in the library is upset .
the plate sitting by the ring by the door by the dish is tall .	the plate sits by the ring by the door by the dish is tall .
the rug sitting by the truck by the window on the chair is quiet .	the rug sits by the truck by the window on the chair is quiet .
the car sitting by the mirror on the chair in the restaurant is boring .	the car sits by the mirror on the chair in the restaurant is boring .
the plate sitting by the fork in the museum on the floor is angry .	the plate sits by the fork in the museum on the floor is angry .
the car sitting in the school in the school by the plane is strong .	the car sits in the school in the school by the plane is strong .
the box sitting on the bed in the room on the couch is boring .	the box sits on the bed in the room on the couch is boring .
the doll sitting on the bed by the rocket on the stool is boring .	the doll sits on the bed by the rocket on the stool is boring .
the cup sitting on the street in the mall by the ship is busy .	the cup sits on the street in the mall by the ship is busy .
the window sitting in the room on the bed in the mall is nice .	the window sits in the room on the bed in the mall is nice .
the rug sitting in the museum in the room by the door is angry .	the rug sits in the museum in the room by the door is angry .
the dish sitting on the bed on the street by the toy is sleepy .	the dish sits on the bed on the street by the toy is sleepy .
the bag sitting in the room in the hospital on the couch is friendly .	the bag sits in the room in the hospital on the couch is friendly .
the shirt sitting by the button in the school on the bed is surprised .	the shirt sits by the button in the school on the bed is surprised .
the boat sitting on the couch in the bank by the toy is hungry .	the boat sits on the couch in the bank by the toy is hungry .
the rug sitting in the hospital in the library on the stool is helpful .	the rug sits in the hospital in the library on the stool is helpful .
the glass sitting by the bed in the museum in the school is friendly .	the glass sits by the bed in the museum in the school is friendly .
the bicycle sitting in the mall by the couch by the bicycle is friendly .	the bicycle sits in the mall by the couch by the bicycle is friendly .
the plane sitting by the crayon by the rocket in the park is friendly .	the plane sits by the crayon by the rocket in the park is friendly .
the shirt sitting on the ground by the car on the couch is clever .	the shirt sits on the ground by the car on the couch is clever .
the bowl sitting by the car in the kitchen in the restaurant is excited .	the bowl sits by the car in the kitchen in the restaurant is excited .
the glass sitting on the table in the library in the mall is upset .	the glass sits on the table in the library in the mall is upset .
the box sitting in the kitchen on the stool in the hospital is excited .	the box sits in the kitchen on the stool in the hospital is excited .
the car sitting on the couch on the ground by the window is nice .	the car sits on the couch on the ground by the window is nice .
the mirror sitting by the chair on the floor on the table is sleepy .	the mirror sits by the chair on the floor on the table is sleepy .
the candle sitting by the chair on the chair on the couch is hungry .	the candle sits by the chair on the chair on the couch is hungry .
the dish sitting on the floor in the mall in the school is gentle .	the dish sits on the floor in the mall in the school is gentle .
the fork sitting by the candle on the stool in the kitchen is important .	the fork sits by the candle on the stool in the kitchen is important .
the shoe sitting by the cup in the school on the street is important .	the shoe sits by the cup in the school on the street is important .
the book sitting by the button by the bicycle by the hat is healthy .	the book sits by the button by the bicycle by the hat is healthy .
the box sitting on the couch on the table in the kitchen is excited .	the box sits on the couch on the table in the kitchen is excited .
the shirt sitting in the park on the chair by the shirt is upset .	the shirt sits in the park on the chair by the shirt is upset .
the bowl sitting in the kitchen by the book in the park is careful .	the bowl sits in the kitchen by the book in the park is careful .
the shirt sitting by the couch in the kitchen by the bottle is curious .	the shirt sits by the couch in the kitchen by the bottle is curious .
the bed sitting in the mall in the school on the bed is young .	the bed sits in the mall in the school on the bed is young .
the box sitting in the hospital in the school on the stool is important .	the box sits in the hospital in the school on the stool is important .
the door sitting by the truck by the ring by the truck is surprised .	the door sits by the truck by the ring by the truck is surprised .
the couch sitting by the door by the bicycle on the bed is important .	the couch sits by the door by the bicycle on the bed is important .
the mirror sitting on the ground in the mall on the street is surprised .	the mirror sits on the ground in the mall on the street is surprised .
the mirror sitting in the library in the restaurant in the bank is kind .	the mirror sits in the library in the restaurant in the bank is kind .
the fork sitting on the table by the hat by the chair is clever .	the fork sits on the table by the hat by the chair is clever .
the door sitting by the plane on the floor in the park is lucky .	the door sits by the plane on the floor in the park is lucky .
the book sitting in the school on the bed on the table is important .	the book sits in the school on the bed on the table is important .
the picture sitting on the chair in the mall in the museum is busy .	the picture sits on the chair in the mall in the museum is busy .
the crayon sitting by the window on the floor by the shirt is surprised .	the crayon sits by the window on the floor by the shirt is surprised .
the shirt sitting by the shoe in the museum on the table is surprised .	the shirt sits by the shoe in the museum on the table is surprised .
the picture sitting in the school on the ground by the fork is hungry .	the picture sits in the school on the ground by the fork is hungry .
the car sitting by the glass in the restaurant on the ground is bored .	the car sits by the glass in the restaurant on the ground is bored .
the plate sitting on the table by the doll by the spoon is confused .	the plate sits on the table by the doll by the spoon is confused .
the bowl sitting by the hat on the stool in the library is confused .	the bowl sits by the hat on the stool in the library is confused .
the truck sitting on the street by the chair by the crayon is helpful .	the truck sits on the street by the chair by the crayon is helpful .
the plate sitting on the chair on the bed in the park is friendly .	the plate sits on the chair on the bed in the park is friendly .
the glass sitting in the park by the chair on the floor is confused .	the glass sits in the park by the chair on the floor is confused .
the mirror sitting by the book by the shoe on the street is helpful .	the mirror sits by the book by the shoe on the street is helpful .
the plate sitting on the ground by the window in the park is smart .	the plate sits on the ground by the window in the park is smart .
the car sitting on the stool on the street in the bank is upset .	the car sits on the stool on the street in the bank is upset .
the book sitting in the room in the room on the ground is happy .	the book sits in the room in the room on the ground is happy .
the fork sitting in the library by the car by the shirt is boring .	the fork sits in the library by the car by the shirt is boring .
the rug sitting in the kitchen in the library on the chair is angry .	the rug sits in the kitchen in the library on the chair is angry .
the doll sitting on the floor in the school by the ship is strong .	the doll sits on the floor in the school by the ship is strong .
the cup sitting by the candle by the bottle on the couch is young .	the cup sits by the candle by the bottle on the couch is young .
the plate sitting on the stool on the bed in the hospital is boring .	the plate sits on the stool on the bed in the hospital is boring .
the book sitting in the mall by the cup in the room is nice .	the book sits in the mall by the cup in the room is nice .
the couch sitting on the stool by the bowl on the chair is upset .	the couch sits on the stool by the bowl on the chair is upset .
the doll sitting by the rug by the bowl by the door is sleepy .	the doll sits by the rug by the bowl by the door is sleepy .
the car sitting on the table on the street on the stool is angry .	the car sits on the table on the street on the stool is angry .
the couch sitting in the kitchen on the street by the mirror is confused .	the couch sits in the kitchen on the street by the mirror is confused .
the button sitting in the park on the ground on the table is tired .	the button sits in the park on the ground on the table is tired .
the dish sitting on the ground by the bicycle by the glass is smart .	the dish sits on the ground by the bicycle by the glass is smart .
the car sitting on the table on the ground on the stool is clever .	the car sits on the table on the ground on the stool is clever .
the hat sitting by the shoe on the street by the bag is lucky .	the hat sits by the shoe on the street by the bag is lucky .
the book sitting by the bottle on the floor by the ring is excited .	the book sits by the bottle on the floor by the ring is excited .
the box sitting in the school on the chair on the chair is important .	the box sits in the school on the chair on the chair is important .
the bottle sitting by the spoon by the ship on the chair is tired .	the bottle sits by the spoon by the ship on the chair is tired .
the bicycle sitting on the couch by the fork by the dish is gentle .	the bicycle sits on the couch by the fork by the dish is gentle .
the car sitting on the floor by the picture on the ground is young .	the car sits on the floor by the picture on the ground is young .
the spoon sitting on the floor in the kitchen on the ground is important .	the spoon sits on the floor in the kitchen on the ground is important .
the picture sitting in the school by the ship on the street is helpful .	the picture sits in the school by the ship on the street is helpful .
the boat sitting by the candle by the rug on the floor is boring .	the boat sits by the candle by the rug on the floor is boring .
the picture sitting in the school by the car by the rocket is friendly .	the picture sits in the school by the car by the rocket is friendly .
the bag sitting by the truck in the mall by the bowl is healthy .	the bag sits by the truck in the mall by the bowl is healthy .
the bag sitting by the book by the shoe by the shirt is nice .	the bag sits by the book by the shoe by the shirt is nice .
the plane sitting in the museum in the hospital in the mall is happy .	the plane sits in the museum in the hospital in the mall is happy .
the doll sitting in the bank by the bag on the floor is curious .	the doll sits in the bank by the bag on the floor is curious .
the bag sitting in the museum by the bottle on the chair is kind .	the bag sits in the museum by the bottle on the chair is kind .
the book sitting in the school by the ring on the couch is sleepy .	the book sits in the school by the ring on the couch is sleepy .
the mirror sitting in the library by the boat by the plate is friendly .	the mirror sits in the library by the boat by the plate is friendly .
the fork sitting on the stool in the mall in the room is kind .	the fork sits on the stool in the mall in the room is kind .
the window sitting in the kitchen by the ring on the table is careful .	the window sits in the kitchen by the ring on the table is careful .
the candle sitting in the library on the stool in the school is surprised .	the candle sits in the library on the stool in the school is surprised .
the dish sitting by the button on the couch by the picture is sleepy .	the dish sits by the button on the couch by the picture is sleepy .
the toy sitting by the glass by the cup in the room is busy .	the toy sits by the glass by the cup in the room is busy .
the boat sitting on the floor by the car in the restaurant is boring .	the boat sits on the floor by the car in the restaurant is boring .
the crayon sitting on the ground on the bed on the stool is clever .	the crayon sits on the ground on the bed on the stool is clever .
the window sitting on the street on the table by the shirt is sleepy .	the window sits on the street on the table by the shirt is sleepy .
the book sitting by the picture by the chair on the table is sleepy .	the book sits by the picture by the chair on the table is sleepy .
the hat sitting by the shirt on the table on the table is quiet .	the hat sits by the shirt on the table on the table is quiet .
the couch sitting by the fork on the floor in the bank is nice .	the couch sits by the fork on the floor in the bank is nice .
the crayon sitting on the ground on the ground on the stool is lucky .	the crayon sits on the ground on the ground on the stool is lucky .
the hat sitting on the chair by the box by the car is smart .	the hat sits on the chair by the box by the car is smart .
the picture sitting in the park by the candle on the bed is curious .	the picture sits in the park by the candle on the bed is curious .
the boat sitting in the restaurant by the ship by the car is curious .	the boat sits in the restaurant by the ship by the car is curious .
the book sitting in the library in the school by the mirror is bored .	the book sits in the library in the school by the mirror is bored .
the bed sitting by the couch in the bank in the library is tall .	the bed sits by the couch in the bank in the library is tall .
the door sitting in the school on the floor in the park is boring .	the door sits in the school on the floor in the park is boring .
the spoon sitting by the book in the hospital on the chair is tall .	the spoon sits by the book in the hospital on the chair is tall .
the hat sitting in the restaurant by the glass by the shoe is important .	the hat sits in the restaurant by the glass by the shoe is important .
