the ring thinks that your wife 's dish is healthy .	the ring talks to your wife 's dish is healthy .
the hat says that your daughter 's book is careful .	the hat helps your daughter 's book is careful .
the rocket thinks that your friend 's chair is lucky .	the rocket scares your friend 's chair is lucky .
the plane says that your daughter 's bottle is upset .	the plane scares your daughter 's bottle is upset .
the door says that my wife 's shirt is careful .	the door helps my wife 's shirt is careful .
the doll thinks that my doctor 's crayon is wrong .	the doll helps my doctor 's crayon is wrong .
the truck thinks that my wife 's toy is upset .	the truck scares my wife 's toy is upset .
the book says that your brother 's picture is careful .	the book works with your brother 's picture is careful .
the doll says that your husband 's couch is hungry .	the doll helps your husband 's couch is hungry .
the car says that your grandmother 's door is quiet .	the car helps your grandmother 's door is quiet .
the book knows that your grandmother 's car is careful .	the book works with your grandmother 's car is careful .
the doll thinks that my sister 's rocket is helpful .	the doll works with my sister 's rocket is helpful .
the window says that my cousin 's bed is lucky .	the window scares my cousin 's bed is lucky .
the candle says that my cousin 's bicycle is busy .	the candle scares my cousin 's bicycle is busy .
the window knows that my husband 's bicycle is confused .	the window scares my husband 's bicycle is confused .
the crayon thinks that your brother 's plane is friendly .	the crayon talks to your brother 's plane is friendly .
the plate thinks that my daughter 's shirt is surprised .	the plate talks to my daughter 's shirt is surprised .
the window thinks that your daughter 's car is gentle .	the window helps your daughter 's car is gentle .
the ship says that your father 's book is smart .	the ship helps your father 's book is smart .
the book thinks that your friend 's bed is lucky .	the book talks to your friend 's bed is lucky .
the plane says that my boss 's picture is quiet .	the plane scares my boss 's picture is quiet .
the spoon says that your mom 's plate is excited .	the spoon helps your mom 's plate is excited .
the dish knows that my mother 's door is nice .	the dish helps my mother 's door is nice .
the bowl knows that your friend 's bottle is busy .	the bowl works with your friend 's bottle is busy .
the window thinks that my father 's car is kind .	the window talks to my father 's car is kind .
the boat thinks that your doctor 's crayon is busy .	the boat helps your doctor 's crayon is busy .
the couch thinks that your mom 's car is tired .	the couch scares your mom 's car is tired .
the cup thinks that my husband 's toy is upset .	the cup talks to my husband 's toy is upset .
the glass thinks that your mother 's bottle is bored .	the glass works with your mother 's bottle is bored .
the fork thinks that my mom 's mirror is tall .	the fork talks to my mom 's mirror is tall .
the bowl thinks that your dentist 's truck is upset .	the bowl scares your dentist 's truck is upset .
the truck thinks that my daughter 's spoon is strong .	the truck helps my daughter 's spoon is strong .
the candle thinks that my father 's bicycle is smart .	the candle works with my father 's bicycle is smart .
the shirt thinks that my doctor 's book is gentle .	the shirt helps my doctor 's book is gentle .
the shirt knows that my husband 's bed is upset .	the shirt talks to my husband 's bed is upset .
the fork thinks that my mother 's fork is curious .	the fork works with my mother 's fork is curious .
the book thinks that my brother 's shirt is clever .	the book helps my brother 's shirt is clever .
the plane thinks that my dentist 's cup is tired .	the plane talks to my dentist 's cup is tired .
the toy thinks that my father 's door is friendly .	the toy works with my father 's door is friendly .
the window says that my husband 's fork is careful .	the window works with my husband 's fork is careful .
the plane thinks that my boss 's chair is lucky .	the plane talks to my boss 's chair is lucky .
the hat knows that my dentist 's car is confused .	the hat scares my dentist 's car is confused .
the dish says that my mother 's ring is kind .	the dish helps my mother 's ring is kind .
the book thinks that my mom 's crayon is healthy .	the book talks to my mom 's crayon is healthy .
the rocket knows that your cousin 's hat is excited .	the rocket talks to your cousin 's hat is excited .
the car knows that your dad 's button is happy .	the car helps your dad 's button is happy .
the cup says that my sister 's plane is friendly .	the cup helps my sister 's plane is friendly .
the couch knows that my sister 's shoe is hungry .	the couch scares my sister 's shoe is hungry .
the dish knows that my father 's window is nice .	the dish scares my father 's window is nice .
the shirt says that my grandmother 's button is careful .	the shirt works with my grandmother 's button is careful .
the book thinks that my sister 's chair is boring .	the book scares my sister 's chair is boring .
the mirror knows that my son 's bottle is wrong .	the mirror helps my son 's bottle is wrong .
the window says that my teacher 's candle is bored .	the window talks to my teacher 's candle is bored .
the car thinks that my brother 's button is clever .	the car helps my brother 's button is clever .
the plane knows that my cousin 's rocket is careful .	the plane scares my cousin 's rocket is careful .
the shoe thinks that my teacher 's candle is wrong .	the shoe helps my teacher 's candle is wrong .
the mirror says that my mother 's doll is bored .	the mirror works with my mother 's doll is bored .
the hat says that my father 's car is wrong .	the hat works with my father 's car is wrong .
the bowl says that my grandmother 's rocket is upset .	the bowl helps my grandmother 's rocket is upset .
the bag thinks that my friend 's bowl is helpful .	the bag talks to my friend 's bowl is helpful .
the window knows that your doctor 's bowl is kind .	the window works with your doctor 's bowl is kind .
the picture thinks that your husband 's bottle is excited .	the picture talks to your husband 's bottle is excited .
the bed knows that your mom 's couch is smart .	the bed helps your mom 's couch is smart .
the plane says that your sister 's shirt is hungry .	the plane helps your sister 's shirt is hungry .
the doll thinks that your wife 's rug is healthy .	the doll works with your wife 's rug is healthy .
the shirt thinks that my doctor 's picture is young .	the shirt works with my doctor 's picture is young .
the bag says that your cousin 's toy is friendly .	the bag works with your cousin 's toy is friendly .
the box knows that your friend 's cup is young .	the box scares your friend 's cup is young .
the rug knows that my teacher 's hat is boring .	the rug talks to my teacher 's hat is boring .
the bottle knows that my teacher 's door is lucky .	the bottle talks to my teacher 's door is lucky .
the bowl knows that your son 's truck is kind .	the bowl talks to your son 's truck is kind .
the chair says that my grandmother 's glass is tired .	the chair talks to my grandmother 's glass is tired .
the spoon thinks that your brother 's window is confused .	the spoon talks to your brother 's window is confused .
the bicycle says that my teacher 's rocket is smart .	the bicycle helps my teacher 's rocket is smart .
the shoe knows that my cousin 's dish is happy .	the shoe talks to my cousin 's dish is happy .
the bicycle says that my mom 's plate is curious .	the bicycle helps my mom 's plate is curious .
the box says that my doctor 's candle is confused .	the box works with my doctor 's candle is confused .
the couch knows that my dentist 's car is careful .	the couch helps my dentist 's car is careful .
the crayon thinks that your cousin 's mirror is tall .	the crayon scares your cousin 's mirror is tall .
the bowl says that my father 's picture is healthy .	the bowl helps my father 's picture is healthy .
the candle says that your grandmother 's spoon is excited .	the candle helps your grandmother 's spoon is excited .
the cup says that my cousin 's bag is boring .	the cup works with my cousin 's bag is boring .
the toy says that your dentist 's book is sleepy .	the toy helps your dentist 's book is sleepy .
the bottle says that your husband 's window is excited .	the bottle helps your husband 's window is excited .
the glass thinks that your boss 's glass is young .	the glass helps your boss 's glass is young .
the book thinks that my son 's bottle is hungry .	the book works with my son 's bottle is hungry .
the couch knows that my doctor 's bottle is lucky .	the couch helps my doctor 's bottle is lucky .
the door knows that my dentist 's door is surprised .	the door scares my dentist 's door is surprised .
the bowl says that your cousin 's bed is excited .	the bowl works with your cousin 's bed is excited .
the car says that my cousin 's toy is important .	the car talks to my cousin 's toy is important .
the plane thinks that your boss 's book is lucky .	the plane helps your boss 's book is lucky .
the car knows that your brother 's bottle is confused .	the car helps your brother 's bottle is confused .
the bicycle thinks that your grandmother 's rocket is surprised .	the bicycle helps your grandmother 's rocket is surprised .
the ring says that my mom 's ship is boring .	the ring works with my mom 's ship is boring .
the box knows that your son 's bed is boring .	the box talks to your son 's bed is boring .
the box thinks that my dad 's bag is healthy .	the box scares my dad 's bag is healthy .
the bed says that my sister 's spoon is surprised .	the bed works with my sister 's spoon is surprised .
the cup knows that my daughter 's toy is clever .	the cup scares my daughter 's toy is clever .
the ship knows that my boss 's rocket is young .	the ship helps my boss 's rocket is young .
the couch knows that my wife 's bicycle is smart .	the couch talks to my wife 's bicycle is smart .
the shoe says that your dentist 's rug is sleepy .	the shoe works with your dentist 's rug is sleepy .
the fork thinks that your sister 's window is careful .	the fork works with your sister 's window is careful .
the fork thinks that my son 's bottle is important .	the fork helps my son 's bottle is important .
the fork knows that your mom 's car is tired .	the fork scares your mom 's car is tired .
the couch thinks that your mother 's ship is helpful .	the couch works with your mother 's ship is helpful .
the shirt thinks that your boss 's truck is hungry .	the shirt scares your boss 's truck is hungry .
the plane says that my sister 's boat is tall .	the plane talks to my sister 's boat is tall .
the fork knows that my doctor 's chair is helpful .	the fork works with my doctor 's chair is helpful .
the crayon says that my dentist 's toy is angry .	the crayon helps my dentist 's toy is angry .
the ring says that my mom 's shirt is tired .	the ring works with my mom 's shirt is tired .
the candle thinks that my sister 's toy is friendly .	the candle scares my sister 's toy is friendly .
the spoon thinks that my grandmother 's bicycle is tall .	the spoon helps my grandmother 's bicycle is tall .
the dish knows that your mother 's window is young .	the dish helps your mother 's window is young .
the plate thinks that your sister 's doll is helpful .	the plate scares your sister 's doll is helpful .
the bottle says that your mom 's dish is excited .	the bottle helps your mom 's dish is excited .
the bottle thinks that your son 's doll is happy .	the bottle talks to your son 's doll is happy .
the glass thinks that my teacher 's dish is careful .	the glass helps my teacher 's dish is careful .
the truck knows that my son 's ship is healthy .	the truck works with my son 's ship is healthy .
the plane knows that your teacher 's fork is upset .	the plane talks to your teacher 's fork is upset .
the car thinks that your teacher 's bed is clever .	the car talks to your teacher 's bed is clever .
the candle knows that my sister 's picture is hungry .	the candle helps my sister 's picture is hungry .
the book thinks that my doctor 's rocket is careful .	the book works with my doctor 's rocket is careful .
the plane knows that your friend 's couch is bored .	the plane talks to your friend 's couch is bored .
the crayon says that your father 's couch is curious .	the crayon works with your father 's couch is curious .
the box says that my friend 's fork is upset .	the box works with my friend 's fork is upset .
the rocket knows that your sister 's picture is busy .	the rocket helps your sister 's picture is busy .
the book says that your wife 's book is clever .	the book talks to your wife 's book is clever .
the couch knows that my teacher 's rocket is upset .	the couch scares my teacher 's rocket is upset .
the spoon knows that your cousin 's book is smart .	the spoon helps your cousin 's book is smart .
the mirror thinks that your husband 's rug is hungry .	the mirror helps your husband 's rug is hungry .
the cup knows that my doctor 's cup is confused .	the cup works with my doctor 's cup is confused .
the bottle knows that my father 's glass is tired .	the bottle works with my father 's glass is tired .
the rocket knows that your doctor 's spoon is confused .	the rocket scares your doctor 's spoon is confused .
the dish knows that my wife 's plane is kind .	the dish scares my wife 's plane is kind .
the cup knows that your mother 's mirror is young .	the cup scares your mother 's mirror is young .
the car thinks that your brother 's bicycle is smart .	the car scares your brother 's bicycle is smart .
the bed thinks that my cousin 's cup is young .	the bed helps my cousin 's cup is young .
the plane thinks that your grandmother 's bowl is angry .	the plane works with your grandmother 's bowl is angry .
the book thinks that my dad 's hat is busy .	the book talks to my dad 's hat is busy .
the toy says that your cousin 's fork is strong .	the toy works with your cousin 's fork is strong .
the bag knows that my doctor 's ship is friendly .	the bag helps my doctor 's ship is friendly .
the doll says that my son 's bowl is lucky .	the doll works with my son 's bowl is lucky .
the chair knows that my father 's book is tall .	the chair helps my father 's book is tall .
the car says that my boss 's bottle is lucky .	the car scares my boss 's bottle is lucky .
the shirt thinks that my wife 's cup is important .	the shirt works with my wife 's cup is important .
the chair says that my boss 's shoe is tired .	the chair helps my boss 's shoe is tired .
the bed knows that my cousin 's window is lucky .	the bed helps my cousin 's window is lucky .
the glass knows that my grandmother 's shirt is hungry .	the glass talks to my grandmother 's shirt is hungry .
the bottle knows that my brother 's hat is curious .	the bottle scares my brother 's hat is curious .
the bottle knows that my mom 's door is hungry .	the bottle works with my mom 's door is hungry .
the shirt thinks that my grandmother 's rug is friendly .	the shirt works with my grandmother 's rug is friendly .
the button thinks that your sister 's button is curious .	the button talks to your sister 's button is curious .
the bag thinks that my brother 's cup is angry .	the bag scares my brother 's cup is angry .
the chair knows that your wife 's book is curious .	the chair talks to your wife 's book is curious .
the window knows that your doctor 's spoon is busy .	the window talks to your doctor 's spoon is busy .
the car thinks that your husband 's doll is excited .	the car scares your husband 's doll is excited .
the glass thinks that your dad 's bicycle is confused .	the glass works with your dad 's bicycle is confused .
the plate knows that my brother 's book is quiet .	the plate talks to my brother 's book is quiet .
the truck knows that my grandmother 's boat is lucky .	the truck scares my grandmother 's boat is lucky .
the candle thinks that my son 's spoon is angry .	the candle works with my son 's spoon is angry .
the bicycle knows that my father 's mirror is curious .	the bicycle talks to my father 's mirror is curious .
the bicycle knows that your friend 's car is excited .	the bicycle works with your friend 's car is excited .
the shirt knows that your grandmother 's bed is kind .	the shirt helps your grandmother 's bed is kind .
the fork knows that my dentist 's crayon is surprised .	the fork scares my dentist 's crayon is surprised .
the door thinks that your boss 's book is smart .	the door talks to your boss 's book is smart .
the chair thinks that your wife 's hat is kind .	the chair talks to your wife 's hat is kind .
the truck thinks that my cousin 's plane is bored .	the truck works with my cousin 's plane is bored .
the car says that your brother 's crayon is gentle .	the car scares your brother 's crayon is gentle .
the candle says that my sister 's toy is healthy .	the candle helps my sister 's toy is healthy .
the picture knows that your dentist 's glass is clever .	the picture works with your dentist 's glass is clever .
the truck says that my sister 's glass is helpful .	the truck scares my sister 's glass is helpful .
the bicycle thinks that your dad 's book is helpful .	the bicycle scares your dad 's book is helpful .
the plane thinks that my dad 's car is nice .	the plane scares my dad 's car is nice .
the doll knows that your brother 's window is healthy .	the doll talks to your brother 's window is healthy .
the boat knows that your wife 's plane is helpful .	the boat works with your wife 's plane is helpful .
the car knows that my brother 's cup is tall .	the car talks to my brother 's cup is tall .
the shoe says that my mother 's door is quiet .	the shoe helps my mother 's door is quiet .
the button says that my boss 's cup is helpful .	the button works with my boss 's cup is helpful .
the door knows that your friend 's crayon is angry .	the door talks to your friend 's crayon is angry .
the shoe thinks that your wife 's spoon is tired .	the shoe scares your wife 's spoon is tired .
the plane says that your wife 's couch is young .	the plane works with your wife 's couch is young .
the spoon knows that my teacher 's car is angry .	the spoon talks to my teacher 's car is angry .
the ring says that your son 's book is upset .	the ring talks to your son 's book is upset .
the couch knows that my daughter 's ship is bored .	the couch helps my daughter 's ship is bored .
the ship thinks that my brother 's ship is sleepy .	the ship works with my brother 's ship is sleepy .
the mirror says that your teacher 's window is excited .	the mirror talks to your teacher 's window is excited .
the box says that my brother 's box is surprised .	the box helps my brother 's box is surprised .
the truck knows that my dad 's candle is clever .	the truck helps my dad 's candle is clever .
the toy knows that your grandmother 's mirror is bored .	the toy talks to your grandmother 's mirror is bored .
the rocket thinks that your boss 's car is nice .	the rocket talks to your boss 's car is nice .
the car knows that your sister 's bag is sleepy .	the car helps your sister 's bag is sleepy .
the doll thinks that my dentist 's fork is careful .	the doll works with my dentist 's fork is careful .
the book thinks that my brother 's hat is busy .	the book talks to my brother 's hat is busy .
the plane knows that your cousin 's dish is upset .	the plane helps your cousin 's dish is upset .
the mirror thinks that your sister 's car is healthy .	the mirror helps your sister 's car is healthy .
the button thinks that my sister 's fork is tired .	the button works with my sister 's fork is tired .
the glass knows that my teacher 's spoon is gentle .	the glass talks to my teacher 's spoon is gentle .
the chair knows that your dad 's candle is wrong .	the chair scares your dad 's candle is wrong .
the bed says that my teacher 's plane is hungry .	the bed helps my teacher 's plane is hungry .
the hat says that your brother 's boat is happy .	the hat helps your brother 's boat is happy .
the door thinks that your mother 's doll is smart .	the door talks to your mother 's doll is smart .
the book thinks that my teacher 's toy is wrong .	the book helps my teacher 's toy is wrong .
the book thinks that my cousin 's crayon is important .	the book works with my cousin 's crayon is important .
the window thinks that your sister 's shoe is strong .	the window helps your sister 's shoe is strong .
the bottle thinks that your friend 's truck is quiet .	the bottle talks to your friend 's truck is quiet .
the ship thinks that my father 's ship is boring .	the ship works with my father 's ship is boring .
the picture knows that your grandmother 's bottle is happy .	the picture talks to your grandmother 's bottle is happy .
the fork thinks that my teacher 's ring is confused .	the fork scares my teacher 's ring is confused .
the spoon knows that my wife 's truck is confused .	the spoon talks to my wife 's truck is confused .
the hat knows that your husband 's shoe is important .	the hat helps your husband 's shoe is important .
the picture thinks that your cousin 's rug is upset .	the picture works with your cousin 's rug is upset .
the bowl knows that your dentist 's picture is wrong .	the bowl scares your dentist 's picture is wrong .
the crayon thinks that your dad 's bottle is busy .	the crayon talks to your dad 's bottle is busy .
the button thinks that your wife 's button is gentle .	the button scares your wife 's button is gentle .
the bed knows that your boss 's car is young .	the bed helps your boss 's car is young .
the plate says that my friend 's bag is boring .	the plate scares my friend 's bag is boring .
the bag thinks that my father 's book is careful .	the bag scares my father 's book is careful .
the plate knows that my husband 's cup is happy .	the plate works with my husband 's cup is happy .
the mirror thinks that my daughter 's window is tired .	the mirror works with my daughter 's window is tired .
the hat says that your brother 's book is helpful .	the hat scares your brother 's book is helpful .
the button knows that your son 's book is upset .	the button talks to your son 's book is upset .
the picture thinks that your son 's candle is nice .	the picture works with your son 's candle is nice .
the spoon thinks that your dentist 's plane is angry .	the spoon works with your dentist 's plane is angry .
the truck knows that my teacher 's plate is bored .	the truck talks to my teacher 's plate is bored .
the rocket knows that your cousin 's bowl is nice .	the rocket scares your cousin 's bowl is nice .
the shirt says that my son 's candle is bored .	the shirt helps my son 's candle is bored .
the ship knows that your father 's spoon is clever .	the ship scares your father 's spoon is clever .
the mirror says that your father 's glass is sleepy .	the mirror works with your father 's glass is sleepy .
the dish says that my sister 's rug is boring .	the dish talks to my sister 's rug is boring .
the couch says that your daughter 's rug is curious .	the couch works with your daughter 's rug is curious .
the box thinks that my doctor 's button is clever .	the box scares my doctor 's button is clever .
the box says that your mother 's car is lucky .	the box helps your mother 's car is lucky .
the plate says that your friend 's book is happy .	the plate works with your friend 's book is happy .
the plate says that my boss 's ring is sleepy .	the plate works with my boss 's ring is sleepy .
the bed says that your sister 's bottle is gentle .	the bed talks to your sister 's bottle is gentle .
the spoon thinks that your doctor 's cup is excited .	the spoon helps your doctor 's cup is excited .
the couch thinks that my father 's bottle is bored .	the couch helps my father 's bottle is bored .
the doll knows that my boss 's bottle is careful .	the doll works with my boss 's bottle is careful .
the crayon thinks that your boss 's book is quiet .	the crayon helps your boss 's book is quiet .
the door says that my husband 's rocket is boring .	the door talks to my husband 's rocket is boring .
the bowl knows that your father 's box is tall .	the bowl scares your father 's box is tall .
the plate knows that my friend 's bed is bored .	the plate helps my friend 's bed is bored .
the ship thinks that my doctor 's bowl is strong .	the ship talks to my doctor 's bowl is strong .
the car knows that your daughter 's mirror is nice .	the car talks to your daughter 's mirror is nice .
the bag thinks that my daughter 's book is lucky .	the bag talks to my daughter 's book is lucky .
the bicycle knows that your cousin 's shirt is healthy .	the bicycle helps your cousin 's shirt is healthy .
the truck says that my husband 's glass is bored .	the truck talks to my husband 's glass is bored .
the doll knows that your husband 's bag is healthy .	the doll helps your husband 's bag is healthy .
the chair knows that my mom 's plane is important .	the chair helps my mom 's plane is important .
the boat thinks that your friend 's button is important .	the boat works with your friend 's button is important .
the shirt says that my doctor 's toy is helpful .	the shirt talks to my doctor 's toy is helpful .
the ship says that your teacher 's dish is excited .	the ship talks to your teacher 's dish is excited .
the candle knows that my dad 's car is busy .	the candle scares my dad 's car is busy .
the picture knows that your son 's dish is friendly .	the picture works with your son 's dish is friendly .
the bowl thinks that my daughter 's ship is quiet .	the bowl scares my daughter 's ship is quiet .
the bowl knows that my father 's car is important .	the bowl works with my father 's car is important .
the boat knows that my doctor 's spoon is smart .	the boat works with my doctor 's spoon is smart .
the fork says that your teacher 's window is healthy .	the fork works with your teacher 's window is healthy .
the toy knows that my mother 's dish is healthy .	the toy talks to my mother 's dish is healthy .
the rug thinks that your doctor 's rug is young .	the rug talks to your doctor 's rug is young .
the toy says that your daughter 's fork is tall .	the toy scares your daughter 's fork is tall .
the cup knows that your father 's spoon is lucky .	the cup scares your father 's spoon is lucky .
the car thinks that your grandmother 's bag is excited .	the car scares your grandmother 's bag is excited .
the car knows that my cousin 's car is clever .	the car talks to my cousin 's car is clever .
the truck says that your friend 's fork is healthy .	the truck talks to your friend 's fork is healthy .
the glass says that your father 's bottle is strong .	the glass scares your father 's bottle is strong .
the doll knows that my brother 's crayon is confused .	the doll works with my brother 's crayon is confused .
the hat thinks that my husband 's hat is bored .	the hat works with my husband 's hat is bored .
the shirt says that my mother 's bottle is healthy .	the shirt scares my mother 's bottle is healthy .
the picture says that your friend 's chair is hungry .	the picture talks to your friend 's chair is hungry .
the spoon says that my dentist 's button is sleepy .	the spoon helps my dentist 's button is sleepy .
the rocket says that my sister 's boat is curious .	the rocket talks to my sister 's boat is curious .
the mirror knows that my grandmother 's ship is important .	the mirror works with my grandmother 's ship is important .
the button knows that my cousin 's mirror is upset .	the button scares my cousin 's mirror is upset .
the bag says that my dentist 's cup is helpful .	the bag helps my dentist 's cup is helpful .
the shoe thinks that your grandmother 's bowl is upset .	the shoe helps your grandmother 's bowl is upset .
the car says that your dentist 's book is kind .	the car talks to your dentist 's book is kind .
the rocket says that your daughter 's chair is upset .	the rocket works with your daughter 's chair is upset .
the car knows that my boss 's chair is strong .	the car scares my boss 's chair is strong .
the button says that your cousin 's mirror is careful .	the button talks to your cousin 's mirror is careful .
the bottle knows that my teacher 's picture is careful .	the bottle scares my teacher 's picture is careful .
the dish thinks that my cousin 's plane is surprised .	the dish talks to my cousin 's plane is surprised .
the dish says that your friend 's toy is curious .	the dish works with your friend 's toy is curious .
the chair thinks that my husband 's truck is surprised .	the chair helps my husband 's truck is surprised .
the plate thinks that your cousin 's box is wrong .	the plate scares your cousin 's box is wrong .
the door knows that your wife 's plate is confused .	the door scares your wife 's plate is confused .
the rug thinks that your mom 's book is healthy .	the rug scares your mom 's book is healthy .
the picture thinks that your wife 's book is hungry .	the picture works with your wife 's book is hungry .
the bag thinks that your teacher 's rocket is nice .	the bag talks to your teacher 's rocket is nice .
the ship knows that my mother 's toy is boring .	the ship scares my mother 's toy is boring .
the spoon knows that my mother 's bottle is lucky .	the spoon works with my mother 's bottle is lucky .
the bottle says that your mother 's ship is upset .	the bottle works with your mother 's ship is upset .
the glass says that my grandmother 's window is boring .	the glass scares my grandmother 's window is boring .
the truck thinks that my dentist 's glass is confused .	the truck scares my dentist 's glass is confused .
the spoon says that my mom 's plane is boring .	the spoon helps my mom 's plane is boring .
the chair thinks that your boss 's book is bored .	the chair helps your boss 's book is bored .
the bicycle knows that my dentist 's truck is excited .	the bicycle scares my dentist 's truck is excited .
the bed thinks that my brother 's spoon is wrong .	the bed scares my brother 's spoon is wrong .
the plane knows that your mom 's bicycle is wrong .	the plane helps your mom 's bicycle is wrong .
the toy says that your boss 's boat is young .	the toy helps your boss 's boat is young .
the door says that my boss 's couch is bored .	the door scares my boss 's couch is bored .
the cup says that my friend 's hat is quiet .	the cup helps my friend 's hat is quiet .
the rocket thinks that your brother 's button is busy .	the rocket helps your brother 's button is busy .
the fork says that your doctor 's mirror is helpful .	the fork works with your doctor 's mirror is helpful .
the plane says that my daughter 's cup is gentle .	the plane scares my daughter 's cup is gentle .
the box says that my cousin 's bed is tired .	the box talks to my cousin 's bed is tired .
the boat thinks that my son 's bed is clever .	the boat helps my son 's bed is clever .
the hat thinks that your doctor 's candle is upset .	the hat works with your doctor 's candle is upset .
the car thinks that my boss 's cup is quiet .	the car scares my boss 's cup is quiet .
the bag knows that my teacher 's box is tall .	the bag helps my teacher 's box is tall .
the car knows that your mom 's bicycle is helpful .	the car talks to your mom 's bicycle is helpful .
the bag knows that my dad 's fork is kind .	the bag helps my dad 's fork is kind .
the spoon thinks that your doctor 's couch is curious .	the spoon talks to your doctor 's couch is curious .
the ship says that my husband 's bag is strong .	the ship works with my husband 's bag is strong .
the bicycle thinks that my teacher 's bowl is clever .	the bicycle scares my teacher 's bowl is clever .
the car says that my son 's bed is excited .	the car works with my son 's bed is excited .
the crayon thinks that my father 's doll is upset .	the crayon works with my father 's doll is upset .
the plate thinks that your cousin 's bed is kind .	the plate talks to your cousin 's bed is kind .
the door says that my mother 's bowl is angry .	the door works with my mother 's bowl is angry .
the boat thinks that your dad 's candle is young .	the boat works with your dad 's candle is young .
the box knows that my dentist 's shoe is curious .	the box helps my dentist 's shoe is curious .
the couch says that my doctor 's candle is helpful .	the couch helps my doctor 's candle is helpful .
the toy knows that my dad 's car is gentle .	the toy helps my dad 's car is gentle .
the rocket thinks that your mom 's chair is sleepy .	the rocket talks to your mom 's chair is sleepy .
the truck knows that your doctor 's toy is bored .	the truck talks to your doctor 's toy is bored .
the couch thinks that my dentist 's shoe is friendly .	the couch talks to my dentist 's shoe is friendly .
the bicycle knows that your grandmother 's plate is hungry .	the bicycle helps your grandmother 's plate is hungry .
the chair knows that my grandmother 's rocket is upset .	the chair talks to my grandmother 's rocket is upset .
the hat thinks that your friend 's glass is quiet .	the hat talks to your friend 's glass is quiet .
the crayon thinks that your brother 's door is hungry .	the crayon scares your brother 's door is hungry .
the fork thinks that your son 's bicycle is young .	the fork scares your son 's bicycle is young .
the mirror knows that your mother 's shoe is careful .	the mirror talks to your mother 's shoe is careful .
the shoe thinks that my son 's crayon is friendly .	the shoe helps my son 's crayon is friendly .
the picture says that your boss 's spoon is lucky .	the picture helps your boss 's spoon is lucky .
the bicycle says that your boss 's fork is clever .	the bicycle scares your boss 's fork is clever .
the book says that your brother 's bed is young .	the book talks to your brother 's bed is young .
the boat says that your mother 's car is excited .	the boat helps your mother 's car is excited .
the bowl knows that my grandmother 's book is surprised .	the bowl helps my grandmother 's book is surprised .
the bag says that my grandmother 's rocket is busy .	the bag helps my grandmother 's rocket is busy .
the doll knows that my daughter 's picture is lucky .	the doll helps my daughter 's picture is lucky .
the mirror thinks that my friend 's mirror is hungry .	the mirror helps my friend 's mirror is hungry .
the car says that my mom 's plane is nice .	the car scares my mom 's plane is nice .
the book knows that my son 's shirt is strong .	the book helps my son 's shirt is strong .
the book says that my husband 's rug is hungry .	the book scares my husband 's rug is hungry .
the glass knows that your boss 's glass is surprised .	the glass helps your boss 's glass is surprised .
the book knows that my dentist 's candle is tall .	the book talks to my dentist 's candle is tall .
the rug knows that my mother 's glass is healthy .	the rug scares my mother 's glass is healthy .
the bed says that my cousin 's candle is tall .	the bed helps my cousin 's candle is tall .
the truck says that your friend 's bowl is clever .	the truck helps your friend 's bowl is clever .
the boat says that my daughter 's mirror is lucky .	the boat scares my daughter 's mirror is lucky .
the mirror thinks that my brother 's toy is angry .	the mirror scares my brother 's toy is angry .
the truck says that my wife 's bottle is healthy .	the truck talks to my wife 's bottle is healthy .
the chair thinks that my mother 's book is important .	the chair talks to my mother 's book is important .
the truck says that your teacher 's rocket is hungry .	the truck scares your teacher 's rocket is hungry .
the mirror says that my brother 's picture is upset .	the mirror works with my brother 's picture is upset .
the plane says that your wife 's window is smart .	the plane helps your wife 's window is smart .
the window thinks that my dad 's book is important .	the window works with my dad 's book is important .
the bed says that your sister 's picture is clever .	the bed works with your sister 's picture is clever .
the rug says that your boss 's spoon is lucky .	the rug works with your boss 's spoon is lucky .
the doll says that my daughter 's boat is upset .	the doll helps my daughter 's boat is upset .
the window thinks that my father 's boat is excited .	the window works with my father 's boat is excited .
the cup knows that your father 's window is upset .	the cup helps your father 's window is upset .
the rocket knows that my mom 's door is wrong .	the rocket talks to my mom 's door is wrong .
the ring thinks that my sister 's shoe is tired .	the ring helps my sister 's shoe is tired .
the ring thinks that my brother 's doll is sleepy .	the ring talks to my brother 's doll is sleepy .
the car thinks that your son 's boat is boring .	the car scares your son 's boat is boring .
the box knows that my dad 's dish is curious .	the box helps my dad 's dish is curious .
the fork says that your doctor 's rug is angry .	the fork helps your doctor 's rug is angry .
the truck thinks that my mom 's doll is clever .	the truck scares my mom 's doll is clever .
the couch knows that your sister 's door is hungry .	the couch scares your sister 's door is hungry .
the bag knows that your friend 's rug is boring .	the bag scares your friend 's rug is boring .
the truck knows that my sister 's glass is nice .	the truck helps my sister 's glass is nice .
the car thinks that your brother 's bicycle is curious .	the car works with your brother 's bicycle is curious .
the car knows that my dentist 's crayon is quiet .	the car works with my dentist 's crayon is quiet .
the spoon knows that your father 's truck is strong .	the spoon helps your father 's truck is strong .
the bicycle thinks that my dentist 's rocket is young .	the bicycle scares my dentist 's rocket is young .
the dish thinks that your boss 's couch is smart .	the dish scares your boss 's couch is smart .
the door knows that my daughter 's spoon is careful .	the door helps my daughter 's spoon is careful .
the mirror knows that your brother 's ring is wrong .	the mirror scares your brother 's ring is wrong .
the dish thinks that your dad 's truck is surprised .	the dish talks to your dad 's truck is surprised .
the doll knows that my dad 's mirror is angry .	the doll talks to my dad 's mirror is angry .
the boat thinks that your boss 's couch is angry .	the boat talks to your boss 's couch is angry .
the ring says that my grandmother 's couch is healthy .	the ring helps my grandmother 's couch is healthy .
the mirror thinks that my mom 's shoe is surprised .	the mirror scares my mom 's shoe is surprised .
the button knows that your husband 's ship is excited .	the button talks to your husband 's ship is excited .
the boat says that my doctor 's cup is nice .	the boat helps my doctor 's cup is nice .
the rug says that your friend 's book is careful .	the rug talks to your friend 's book is careful .
the glass thinks that your sister 's mirror is gentle .	the glass helps your sister 's mirror is gentle .
the bag knows that my dentist 's chair is gentle .	the bag works with my dentist 's chair is gentle .
the button thinks that my dad 's crayon is confused .	the button scares my dad 's crayon is confused .
the glass says that my teacher 's fork is tired .	the glass talks to my teacher 's fork is tired .
the spoon says that my brother 's crayon is kind .	the spoon scares my brother 's crayon is kind .
the mirror thinks that my son 's mirror is important .	the mirror talks to my son 's mirror is important .
the dish says that your dad 's bed is clever .	the dish scares your dad 's bed is clever .
the rocket says that my cousin 's window is gentle .	the rocket scares my cousin 's window is gentle .
the bag knows that my wife 's plate is surprised .	the bag works with my wife 's plate is surprised .
the rocket knows that your brother 's bicycle is young .	the rocket helps your brother 's bicycle is young .
the door thinks that your cousin 's cup is sleepy .	the door helps your cousin 's cup is sleepy .
the window thinks that your father 's plane is lucky .	the window helps your father 's plane is lucky .
the truck knows that my doctor 's rug is smart .	the truck scares my doctor 's rug is smart .
the boat thinks that your teacher 's bed is upset .	the boat talks to your teacher 's bed is upset .
the boat knows that my sister 's candle is busy .	the boat works with my sister 's candle is busy .
the book knows that my sister 's bowl is wrong .	the book scares my sister 's bowl is wrong .
the doll thinks that my husband 's box is smart .	the doll talks to my husband 's box is smart .
the boat thinks that your cousin 's car is gentle .	the boat talks to your cousin 's car is gentle .
the car says that your mom 's button is angry .	the car helps your mom 's button is angry .
the rocket says that your daughter 's doll is nice .	the rocket scares your daughter 's doll is nice .
the couch says that your doctor 's toy is clever .	the couch helps your doctor 's toy is clever .
the plate thinks that my husband 's ring is tall .	the plate helps my husband 's ring is tall .
the crayon says that your husband 's window is happy .	the crayon scares your husband 's window is happy .
the book says that my teacher 's bottle is careful .	the book helps my teacher 's bottle is careful .
the bed says that my mother 's boat is young .	the bed helps my mother 's boat is young .
the candle knows that my boss 's rocket is tired .	the candle talks to my boss 's rocket is tired .
the shirt thinks that your dentist 's box is hungry .	the shirt works with your dentist 's box is hungry .
the candle thinks that your grandmother 's book is upset .	the candle scares your grandmother 's book is upset .
the fork thinks that my grandmother 's book is hungry .	the fork works with my grandmother 's book is hungry .
the plane thinks that your son 's bag is kind .	the plane scares your son 's bag is kind .
the glass thinks that my mom 's shoe is gentle .	the glass helps my mom 's shoe is gentle .
the candle thinks that your sister 's car is bored .	the candle works with your sister 's car is bored .
the hat says that your daughter 's bowl is young .	the hat works with your daughter 's bowl is young .
the candle knows that my mother 's picture is busy .	the candle works with my mother 's picture is busy .
the bottle knows that my brother 's boat is friendly .	the bottle works with my brother 's boat is friendly .
the bag knows that your mom 's fork is strong .	the bag talks to your mom 's fork is strong .
the hat says that your dentist 's window is friendly .	the hat talks to your dentist 's window is friendly .
the glass says that your cousin 's window is smart .	the glass talks to your cousin 's window is smart .
the crayon thinks that my doctor 's picture is young .	the crayon scares my doctor 's picture is young .
the bowl thinks that your teacher 's rocket is tired .	the bowl scares your teacher 's rocket is tired .
the bag knows that my mother 's spoon is healthy .	the bag helps my mother 's spoon is healthy .
the dish thinks that my brother 's box is clever .	the dish helps my brother 's box is clever .
the boat says that your grandmother 's plane is bored .	the boat works with your grandmother 's plane is bored .
the button says that your brother 's spoon is strong .	the button talks to your brother 's spoon is strong .
the car says that my mom 's bicycle is careful .	the car helps my mom 's bicycle is careful .
the bed says that my brother 's bottle is lucky .	the bed talks to my brother 's bottle is lucky .
the rug thinks that your cousin 's couch is nice .	the rug works with your cousin 's couch is nice .
the shoe says that your mom 's candle is wrong .	the shoe works with your mom 's candle is wrong .
the mirror knows that my doctor 's candle is lucky .	the mirror helps my doctor 's candle is lucky .
the box knows that your teacher 's couch is gentle .	the box works with your teacher 's couch is gentle .
the shirt knows that my friend 's door is curious .	the shirt scares my friend 's door is curious .
the bicycle knows that your mother 's cup is nice .	the bicycle scares your mother 's cup is nice .
the car thinks that your husband 's chair is upset .	the car talks to your husband 's chair is upset .
the bottle says that your wife 's glass is confused .	the bottle scares your wife 's glass is confused .
the cup knows that your dentist 's spoon is angry .	the cup scares your dentist 's spoon is angry .
the doll thinks that my daughter 's shirt is bored .	the doll helps my daughter 's shirt is bored .
the rocket thinks that my husband 's hat is gentle .	the rocket talks to my husband 's hat is gentle .
the spoon knows that your husband 's rug is curious .	the spoon works with your husband 's rug is curious .
the ship knows that my mom 's toy is strong .	the ship scares my mom 's toy is strong .
the fork knows that your mother 's truck is helpful .	the fork scares your mother 's truck is helpful .
the car thinks that your brother 's spoon is smart .	the car works with your brother 's spoon is smart .
the bag says that my friend 's rocket is gentle .	the bag helps my friend 's rocket is gentle .
the fork thinks that your cousin 's toy is helpful .	the fork helps your cousin 's toy is helpful .
the window says that my cousin 's bed is gentle .	the window scares my cousin 's bed is gentle .
the glass thinks that my son 's hat is bored .	the glass works with my son 's hat is bored .
the boat says that your son 's picture is healthy .	the boat helps your son 's picture is healthy .
the ship thinks that my dentist 's book is smart .	the ship talks to my dentist 's book is smart .
the bed says that your daughter 's button is angry .	the bed talks to your daughter 's button is angry .
the plate knows that your brother 's plate is happy .	the plate talks to your brother 's plate is happy .
the plane says that my grandmother 's shirt is young .	the plane scares my grandmother 's shirt is young .
the picture thinks that my grandmother 's dish is excited .	the picture works with my grandmother 's dish is excited .
the doll says that your cousin 's spoon is busy .	the doll talks to your cousin 's spoon is busy .
the door says that your brother 's shoe is helpful .	the door talks to your brother 's shoe is helpful .
the bag says that your dentist 's bottle is friendly .	the bag helps your dentist 's bottle is friendly .
the bicycle says that my teacher 's couch is tall .	the bicycle helps my teacher 's couch is tall .
the rug says that my friend 's ring is angry .	the rug works with my friend 's ring is angry .
the cup thinks that your grandmother 's hat is careful .	the cup talks to your grandmother 's hat is careful .
the window thinks that my sister 's plate is bored .	the window helps my sister 's plate is bored .
the window knows that my mom 's shoe is tall .	the window talks to my mom 's shoe is tall .
the fork says that your sister 's truck is confused .	the fork talks to your sister 's truck is confused .
the couch thinks that your mom 's window is tired .	the couch scares your mom 's window is tired .
the bicycle says that your brother 's box is important .	the bicycle works with your brother 's box is important .
the button says that my mom 's glass is careful .	the button helps my mom 's glass is careful .
the book thinks that my brother 's bed is excited .	the book helps my brother 's bed is excited .
the shirt says that your grandmother 's ring is boring .	the shirt talks to your grandmother 's ring is boring .
the fork thinks that your sister 's dish is helpful .	the fork talks to your sister 's dish is helpful .
the bed thinks that my dentist 's box is tired .	the bed helps my dentist 's box is tired .
the ship says that your doctor 's candle is kind .	the ship scares your doctor 's candle is kind .
the window thinks that my grandmother 's bag is surprised .	the window works with my grandmother 's bag is surprised .
the bottle knows that my cousin 's spoon is quiet .	the bottle scares my cousin 's spoon is quiet .
the hat says that your teacher 's book is upset .	the hat works with your teacher 's book is upset .
the ship knows that your mother 's plate is gentle .	the ship works with your mother 's plate is gentle .
the hat says that your father 's car is tired .	the hat helps your father 's car is tired .
the plane says that your doctor 's ring is excited .	the plane works with your doctor 's ring is excited .
the button knows that your mother 's crayon is clever .	the button talks to your mother 's crayon is clever .
the chair says that my doctor 's button is tired .	the chair helps my doctor 's button is tired .
the shoe says that my husband 's bed is lucky .	the shoe helps my husband 's bed is lucky .
the boat knows that my mom 's candle is happy .	the boat helps my mom 's candle is happy .
the book knows that your mom 's window is careful .	the book helps your mom 's window is careful .
the rocket says that my wife 's bicycle is angry .	the rocket talks to my wife 's bicycle is angry .
the glass says that my boss 's chair is confused .	the glass scares my boss 's chair is confused .
the fork knows that my friend 's boat is hungry .	the fork scares my friend 's boat is hungry .
the ship thinks that your wife 's ship is smart .	the ship talks to your wife 's ship is smart .
the fork says that your boss 's car is lucky .	the fork scares your boss 's car is lucky .
the hat knows that my brother 's doll is happy .	the hat talks to my brother 's doll is happy .
the rug says that my friend 's ship is quiet .	the rug helps my friend 's ship is quiet .
the dish says that your father 's rug is kind .	the dish scares your father 's rug is kind .
the boat knows that your father 's picture is excited .	the boat talks to your father 's picture is excited .
the button thinks that my mother 's ring is careful .	the button talks to my mother 's ring is careful .
the cup says that my mother 's shirt is nice .	the cup scares my mother 's shirt is nice .
the fork thinks that your dad 's spoon is smart .	the fork scares your dad 's spoon is smart .
the boat knows that your brother 's bowl is tired .	the boat scares your brother 's bowl is tired .
the bowl thinks that my father 's window is happy .	the bowl helps my father 's window is happy .
the bowl says that your mother 's door is young .	the bowl scares your mother 's door is young .
the couch says that my father 's crayon is friendly .	the couch helps my father 's crayon is friendly .
the button knows that my doctor 's bag is hungry .	the button scares my doctor 's bag is hungry .
the box says that your father 's ship is helpful .	the box works with your father 's ship is helpful .
the bowl knows that my daughter 's boat is surprised .	the bowl works with my daughter 's boat is surprised .
the crayon thinks that my dad 's ship is helpful .	the crayon works with my dad 's ship is helpful .
the bowl thinks that my father 's box is important .	the bowl works with my father 's box is important .
the button thinks that your friend 's bicycle is smart .	the button works with your friend 's bicycle is smart .
the shoe thinks that your cousin 's toy is important .	the shoe helps your cousin 's toy is important .
the plane thinks that my wife 's picture is smart .	the plane talks to my wife 's picture is smart .
the couch knows that my brother 's bowl is careful .	the couch works with my brother 's bowl is careful .
the doll knows that your mom 's truck is happy .	the doll scares your mom 's truck is happy .
the bag thinks that your brother 's rug is upset .	the bag works with your brother 's rug is upset .
the chair knows that your wife 's shoe is upset .	the chair talks to your wife 's shoe is upset .
the fork thinks that my teacher 's spoon is kind .	the fork scares my teacher 's spoon is kind .
the chair thinks that my dad 's plane is upset .	the chair scares my dad 's plane is upset .
the mirror knows that your cousin 's book is angry .	the mirror scares your cousin 's book is angry .
the crayon knows that my dad 's bag is healthy .	the crayon scares my dad 's bag is healthy .
the bicycle thinks that your doctor 's shirt is careful .	the bicycle helps your doctor 's shirt is careful .
the book knows that your wife 's bed is quiet .	the book talks to your wife 's bed is quiet .
the book knows that my friend 's fork is boring .	the book talks to my friend 's fork is boring .
the car thinks that your sister 's glass is healthy .	the car scares your sister 's glass is healthy .
the crayon thinks that your doctor 's bag is angry .	the crayon talks to your doctor 's bag is angry .
the cup knows that my cousin 's crayon is upset .	the cup works with my cousin 's crayon is upset .
the glass knows that your boss 's crayon is bored .	the glass scares your boss 's crayon is bored .
the plate says that my friend 's candle is boring .	the plate talks to my friend 's candle is boring .
the shirt says that my wife 's door is excited .	the shirt talks to my wife 's door is excited .
the box knows that your father 's plane is lucky .	the box helps your father 's plane is lucky .
the toy knows that my daughter 's bowl is boring .	the toy works with my daughter 's bowl is boring .
the chair thinks that my teacher 's fork is tired .	the chair scares my teacher 's fork is tired .
the dish says that my teacher 's plane is gentle .	the dish works with my teacher 's plane is gentle .
the shirt knows that your brother 's candle is busy .	the shirt helps your brother 's candle is busy .
the crayon thinks that my boss 's rocket is important .	the crayon works with my boss 's rocket is important .
the bicycle knows that my grandmother 's toy is clever .	the bicycle helps my grandmother 's toy is clever .
the door says that your boss 's car is boring .	the door scares your boss 's car is boring .
the rug knows that your grandmother 's glass is careful .	the rug scares your grandmother 's glass is careful .
the toy knows that your father 's car is hungry .	the toy helps your father 's car is hungry .
the ring says that my grandmother 's book is important .	the ring talks to my grandmother 's book is important .
the rug knows that my friend 's boat is gentle .	the rug talks to my friend 's boat is gentle .
the crayon knows that your daughter 's candle is important .	the crayon scares your daughter 's candle is important .
the window says that your cousin 's boat is bored .	the window helps your cousin 's boat is bored .
the boat knows that your brother 's shoe is quiet .	the boat works with your brother 's shoe is quiet .
the chair says that your wife 's door is surprised .	the chair talks to your wife 's door is surprised .
the doll knows that your friend 's glass is surprised .	the doll works with your friend 's glass is surprised .
the couch says that my wife 's plane is hungry .	the couch talks to my wife 's plane is hungry .
the bicycle thinks that your teacher 's ring is excited .	the bicycle helps your teacher 's ring is excited .
the rug knows that my dad 's crayon is confused .	the rug works with my dad 's crayon is confused .
the bowl thinks that your friend 's plane is gentle .	the bowl scares your friend 's plane is gentle .
the shirt says that my grandmother 's crayon is clever .	the shirt scares my grandmother 's crayon is clever .
the plane says that your husband 's hat is friendly .	the plane scares your husband 's hat is friendly .
the toy says that my doctor 's truck is strong .	the toy works with my doctor 's truck is strong .
the ring knows that your dentist 's doll is friendly .	the ring helps your dentist 's doll is friendly .
the couch knows that your mother 's fork is happy .	the couch scares your mother 's fork is happy .
the book thinks that your dad 's mirror is tired .	the book talks to your dad 's mirror is tired .
the bottle thinks that your son 's ship is strong .	the bottle works with your son 's ship is strong .
the truck says that my brother 's bicycle is smart .	the truck works with my brother 's bicycle is smart .
the ship knows that your sister 's fork is young .	the ship talks to your sister 's fork is young .
the shirt knows that my mother 's book is lucky .	the shirt works with my mother 's book is lucky .
the boat knows that my husband 's boat is tired .	the boat helps my husband 's boat is tired .
the book knows that your brother 's door is lucky .	the book helps your brother 's door is lucky .
the bag says that my friend 's candle is lucky .	the bag helps my friend 's candle is lucky .
the dish thinks that your friend 's window is nice .	the dish scares your friend 's window is nice .
the mirror knows that my friend 's book is sleepy .	the mirror works with my friend 's book is sleepy .
the rug knows that your husband 's door is important .	the rug talks to your husband 's door is important .
the bowl says that my mother 's shirt is surprised .	the bowl helps my mother 's shirt is surprised .
the door says that your husband 's shoe is clever .	the door works with your husband 's shoe is clever .
the glass knows that your cousin 's bowl is helpful .	the glass scares your cousin 's bowl is helpful .
the crayon knows that your teacher 's window is quiet .	the crayon talks to your teacher 's window is quiet .
the shirt says that my grandmother 's mirror is young .	the shirt works with my grandmother 's mirror is young .
the window thinks that your mom 's picture is quiet .	the window talks to your mom 's picture is quiet .
the plane thinks that your wife 's picture is upset .	the plane helps your wife 's picture is upset .
the toy thinks that your daughter 's rug is important .	the toy helps your daughter 's rug is important .
the boat thinks that my wife 's dish is busy .	the boat works with my wife 's dish is busy .
the mirror thinks that your grandmother 's bed is busy .	the mirror helps your grandmother 's bed is busy .
the ship says that my doctor 's bed is important .	the ship talks to my doctor 's bed is important .
the doll knows that your dad 's couch is young .	the doll helps your dad 's couch is young .
the mirror knows that my dad 's candle is healthy .	the mirror scares my dad 's candle is healthy .
the rug knows that your sister 's boat is excited .	the rug talks to your sister 's boat is excited .
the boat knows that my wife 's plane is surprised .	the boat helps my wife 's plane is surprised .
the shirt thinks that my boss 's candle is nice .	the shirt helps my boss 's candle is nice .
the button says that my doctor 's shoe is nice .	the button works with my doctor 's shoe is nice .
the book knows that my brother 's mirror is careful .	the book works with my brother 's mirror is careful .
the rug thinks that your cousin 's window is quiet .	the rug talks to your cousin 's window is quiet .
the spoon knows that your daughter 's shoe is careful .	the spoon works with your daughter 's shoe is careful .
the bicycle says that your wife 's fork is smart .	the bicycle helps your wife 's fork is smart .
the shirt knows that my daughter 's plane is friendly .	the shirt helps my daughter 's plane is friendly .
the rocket knows that my wife 's rocket is friendly .	the rocket works with my wife 's rocket is friendly .
the plate says that my son 's doll is wrong .	the plate scares my son 's doll is wrong .
the button knows that my teacher 's truck is boring .	the button works with my teacher 's truck is boring .
the bag knows that your doctor 's bowl is careful .	the bag scares your doctor 's bowl is careful .
the ring says that your son 's chair is busy .	the ring helps your son 's chair is busy .
the picture says that your boss 's car is curious .	the picture scares your boss 's car is curious .
the button knows that my teacher 's book is strong .	the button scares my teacher 's book is strong .
the ship says that my wife 's boat is lucky .	the ship works with my wife 's boat is lucky .
the shirt knows that my boss 's rocket is smart .	the shirt scares my boss 's rocket is smart .
the dish says that my teacher 's toy is nice .	the dish works with my teacher 's toy is nice .
the car says that your wife 's spoon is angry .	the car talks to your wife 's spoon is angry .
the doll knows that my brother 's doll is tall .	the doll works with my brother 's doll is tall .
the rocket thinks that your teacher 's chair is quiet .	the rocket works with your teacher 's chair is quiet .
the button knows that your dentist 's chair is happy .	the button works with your dentist 's chair is happy .
the fork says that my dad 's spoon is wrong .	the fork talks to my dad 's spoon is wrong .
the bicycle says that my daughter 's doll is smart .	the bicycle works with my daughter 's doll is smart .
the boat thinks that your daughter 's button is kind .	the boat scares your daughter 's button is kind .
the bag says that your daughter 's rug is kind .	the bag scares your daughter 's rug is kind .
the ring says that your wife 's bicycle is important .	the ring works with your wife 's bicycle is important .
the couch knows that my friend 's doll is upset .	the couch works with my friend 's doll is upset .
the bowl knows that my friend 's shoe is hungry .	the bowl works with my friend 's shoe is hungry .
the dish knows that your doctor 's truck is friendly .	the dish helps your doctor 's truck is friendly .
the car knows that your cousin 's window is excited .	the car scares your cousin 's window is excited .
the plate says that my daughter 's car is surprised .	the plate works with my daughter 's car is surprised .
the window says that my mom 's couch is happy .	the window helps my mom 's couch is happy .
the bed says that my dad 's ship is confused .	the bed scares my dad 's ship is confused .
the car says that your mom 's couch is friendly .	the car works with your mom 's couch is friendly .
the chair thinks that my boss 's bag is hungry .	the chair talks to my boss 's bag is hungry .
the chair knows that my father 's chair is sleepy .	the chair helps my father 's chair is sleepy .
the fork says that your dad 's bed is happy .	the fork helps your dad 's bed is happy .
the dish knows that your cousin 's doll is surprised .	the dish scares your cousin 's doll is surprised .
the bed thinks that your daughter 's cup is bored .	the bed scares your daughter 's cup is bored .
the doll says that my sister 's cup is excited .	the doll scares my sister 's cup is excited .
the shirt says that your boss 's car is kind .	the shirt works with your boss 's car is kind .
the shirt says that your cousin 's shirt is healthy .	the shirt scares your cousin 's shirt is healthy .
the rocket thinks that your friend 's shirt is excited .	the rocket helps your friend 's shirt is excited .
the dish thinks that your sister 's bed is busy .	the dish works with your sister 's bed is busy .
the candle thinks that my doctor 's glass is young .	the candle scares my doctor 's glass is young .
the book thinks that my dad 's window is angry .	the book helps my dad 's window is angry .
the car thinks that your mother 's shirt is strong .	the car scares your mother 's shirt is strong .
the dish thinks that my mom 's spoon is healthy .	the dish works with my mom 's spoon is healthy .
the crayon thinks that your father 's shirt is surprised .	the crayon scares your father 's shirt is surprised .
the fork knows that my wife 's picture is helpful .	the fork helps my wife 's picture is helpful .
the car knows that my cousin 's car is happy .	the car works with my cousin 's car is happy .
the book says that my sister 's shirt is happy .	the book works with my sister 's shirt is happy .
the rug says that my cousin 's car is hungry .	the rug scares my cousin 's car is hungry .
the rocket says that your dentist 's fork is quiet .	the rocket talks to your dentist 's fork is quiet .
the candle thinks that your mom 's window is tired .	the candle talks to your mom 's window is tired .
the rug knows that your wife 's rocket is sleepy .	the rug talks to your wife 's rocket is sleepy .
the rug thinks that your son 's candle is gentle .	the rug talks to your son 's candle is gentle .
the rocket knows that your wife 's crayon is lucky .	the rocket works with your wife 's crayon is lucky .
the picture knows that your boss 's shoe is careful .	the picture works with your boss 's shoe is careful .
the glass says that your boss 's truck is curious .	the glass helps your boss 's truck is curious .
the fork thinks that your sister 's doll is gentle .	the fork helps your sister 's doll is gentle .
the window says that my brother 's ring is tired .	the window talks to my brother 's ring is tired .
the window knows that my dentist 's button is healthy .	the window works with my dentist 's button is healthy .
the truck thinks that my brother 's hat is happy .	the truck scares my brother 's hat is happy .
the car thinks that my doctor 's button is tired .	the car scares my doctor 's button is tired .
the bicycle says that your dentist 's candle is healthy .	the bicycle talks to your dentist 's candle is healthy .
the window knows that your dad 's ring is surprised .	the window works with your dad 's ring is surprised .
the ship thinks that my grandmother 's candle is boring .	the ship scares my grandmother 's candle is boring .
the bed thinks that your teacher 's door is quiet .	the bed helps your teacher 's door is quiet .
the mirror knows that my grandmother 's book is angry .	the mirror talks to my grandmother 's book is angry .
the crayon thinks that my friend 's rocket is hungry .	the crayon helps my friend 's rocket is hungry .
the doll says that my wife 's plate is confused .	the doll talks to my wife 's plate is confused .
the doll thinks that my cousin 's bag is lucky .	the doll works with my cousin 's bag is lucky .
the doll thinks that my dentist 's button is young .	the doll scares my dentist 's button is young .
the plane thinks that my mom 's glass is hungry .	the plane talks to my mom 's glass is hungry .
the rug thinks that my doctor 's glass is important .	the rug talks to my doctor 's glass is important .
the couch knows that your mother 's book is upset .	the couch helps your mother 's book is upset .
the dish knows that my father 's window is confused .	the dish scares my father 's window is confused .
the spoon thinks that my brother 's box is kind .	the spoon helps my brother 's box is kind .
the book says that your mom 's bed is careful .	the book scares your mom 's bed is careful .
the plane thinks that my son 's chair is healthy .	the plane talks to my son 's chair is healthy .
the book thinks that your daughter 's bag is upset .	the book scares your daughter 's bag is upset .
the spoon says that my dentist 's doll is angry .	the spoon talks to my dentist 's doll is angry .
the bed knows that your cousin 's book is strong .	the bed helps your cousin 's book is strong .
the bag thinks that your doctor 's crayon is friendly .	the bag scares your doctor 's crayon is friendly .
the spoon thinks that your daughter 's bed is bored .	the spoon helps your daughter 's bed is bored .
the window knows that your doctor 's plate is careful .	the window works with your doctor 's plate is careful .
the toy says that my friend 's rocket is tall .	the toy helps my friend 's rocket is tall .
the dish says that my son 's window is clever .	the dish works with my son 's window is clever .
the plane says that your father 's car is tired .	the plane scares your father 's car is tired .
the ship knows that your husband 's picture is curious .	the ship scares your husband 's picture is curious .
the ring thinks that your sister 's window is important .	the ring helps your sister 's window is important .
the fork thinks that my sister 's button is friendly .	the fork works with my sister 's button is friendly .
the car says that your friend 's boat is tired .	the car works with your friend 's boat is tired .
the chair thinks that your son 's bed is clever .	the chair scares your son 's bed is clever .
the plane thinks that your son 's shirt is healthy .	the plane helps your son 's shirt is healthy .
the rocket says that my wife 's hat is nice .	the rocket scares my wife 's hat is nice .
the hat says that your brother 's box is happy .	the hat scares your brother 's box is happy .
the rug thinks that your brother 's doll is young .	the rug scares your brother 's doll is young .
the door knows that your father 's toy is clever .	the door scares your father 's toy is clever .
the ring says that your son 's hat is lucky .	the ring helps your son 's hat is lucky .
the fork thinks that your husband 's boat is strong .	the fork works with your husband 's boat is strong .
the bag says that your boss 's plane is bored .	the bag talks to your boss 's plane is bored .
the window thinks that my son 's bicycle is healthy .	the window talks to my son 's bicycle is healthy .
the book knows that my cousin 's bed is gentle .	the book works with my cousin 's bed is gentle .
the glass knows that your cousin 's ring is kind .	the glass helps your cousin 's ring is kind .
the glass thinks that your doctor 's shirt is nice .	the glass talks to your doctor 's shirt is nice .
the button thinks that your husband 's shirt is nice .	the button works with your husband 's shirt is nice .
the dish says that my son 's bowl is careful .	the dish works with my son 's bowl is careful .
the mirror knows that your brother 's boat is quiet .	the mirror works with your brother 's boat is quiet .
the window knows that your brother 's button is angry .	the window helps your brother 's button is angry .
the book thinks that your dad 's shoe is curious .	the book scares your dad 's shoe is curious .
the button says that my wife 's ship is smart .	the button scares my wife 's ship is smart .
the candle knows that your mother 's window is bored .	the candle scares your mother 's window is bored .
the button thinks that my grandmother 's book is strong .	the button helps my grandmother 's book is strong .
the shirt says that my mom 's plate is healthy .	the shirt helps my mom 's plate is healthy .
the car knows that your friend 's glass is wrong .	the car scares your friend 's glass is wrong .
the box thinks that your dentist 's ship is hungry .	the box talks to your dentist 's ship is hungry .
the shirt thinks that your cousin 's plane is tall .	the shirt talks to your cousin 's plane is tall .
the bag knows that your cousin 's plate is boring .	the bag talks to your cousin 's plate is boring .
the plate knows that my sister 's bag is helpful .	the plate scares my sister 's bag is helpful .
the toy says that your mom 's car is young .	the toy helps your mom 's car is young .
the plate thinks that my mom 's hat is nice .	the plate works with my mom 's hat is nice .
the bag says that your doctor 's button is important .	the bag talks to your doctor 's button is important .
the boat knows that your friend 's bottle is lucky .	the boat talks to your friend 's bottle is lucky .
the button knows that my grandmother 's book is lucky .	the button talks to my grandmother 's book is lucky .
the button knows that your dad 's glass is wrong .	the button helps your dad 's glass is wrong .
the bag thinks that my father 's car is smart .	the bag scares my father 's car is smart .
the bowl says that your boss 's crayon is tired .	the bowl scares your boss 's crayon is tired .
the book knows that your brother 's dish is confused .	the book works with your brother 's dish is confused .
the box says that my daughter 's spoon is excited .	the box helps my daughter 's spoon is excited .
the rug says that your mother 's window is tall .	the rug talks to your mother 's window is tall .
the ship thinks that my wife 's button is curious .	the ship helps my wife 's button is curious .
the crayon knows that my mom 's car is young .	the crayon helps my mom 's car is young .
the shirt knows that my son 's shirt is excited .	the shirt scares my son 's shirt is excited .
the bicycle thinks that your daughter 's book is important .	the bicycle helps your daughter 's book is important .
the doll says that my friend 's crayon is important .	the doll works with my friend 's crayon is important .
the fork thinks that your father 's rug is hungry .	the fork scares your father 's rug is hungry .
the button knows that my teacher 's bowl is curious .	the button helps my teacher 's bowl is curious .
the boat thinks that your teacher 's window is strong .	the boat talks to your teacher 's window is strong .
the spoon knows that my son 's fork is friendly .	the spoon talks to my son 's fork is friendly .
the plate knows that my friend 's car is young .	the plate helps my friend 's car is young .
the plate knows that your father 's book is sleepy .	the plate talks to your father 's book is sleepy .
the bicycle knows that your cousin 's spoon is upset .	the bicycle scares your cousin 's spoon is upset .
the truck knows that my brother 's car is busy .	the truck talks to my brother 's car is busy .
the door knows that my friend 's book is happy .	the door helps my friend 's book is happy .
the box knows that my friend 's hat is kind .	the box works with my friend 's hat is kind .
the rocket knows that your daughter 's plate is happy .	the rocket helps your daughter 's plate is happy .
the bowl knows that your son 's shirt is young .	the bowl helps your son 's shirt is young .
the boat says that your father 's ship is tired .	the boat talks to your father 's ship is tired .
the dish says that your wife 's mirror is important .	the dish talks to your wife 's mirror is important .
the rug says that your mother 's truck is upset .	the rug helps your mother 's truck is upset .
the fork thinks that your teacher 's spoon is careful .	the fork scares your teacher 's spoon is careful .
the ring knows that your boss 's toy is smart .	the ring helps your boss 's toy is smart .
the glass knows that your friend 's truck is young .	the glass talks to your friend 's truck is young .
the bowl knows that your daughter 's picture is gentle .	the bowl scares your daughter 's picture is gentle .
the truck knows that my son 's chair is wrong .	the truck works with my son 's chair is wrong .
the window thinks that my grandmother 's shirt is boring .	the window helps my grandmother 's shirt is boring .
the plane thinks that your husband 's doll is upset .	the plane talks to your husband 's doll is upset .
the candle says that my boss 's button is tall .	the candle works with my boss 's button is tall .
the plate says that your mom 's bicycle is lucky .	the plate works with your mom 's bicycle is lucky .
the boat says that your dad 's candle is sleepy .	the boat helps your dad 's candle is sleepy .
the picture knows that your mom 's window is kind .	the picture works with your mom 's window is kind .
the picture knows that my mother 's bowl is young .	the picture helps my mother 's bowl is young .
the candle says that my grandmother 's car is important .	the candle talks to my grandmother 's car is important .
the picture knows that your father 's book is happy .	the picture talks to your father 's book is happy .
the ship knows that my husband 's crayon is sleepy .	the ship scares my husband 's crayon is sleepy .
the mirror knows that your son 's candle is hungry .	the mirror talks to your son 's candle is hungry .
the truck knows that my friend 's bottle is smart .	the truck helps my friend 's bottle is smart .
the bicycle knows that your mother 's rocket is upset .	the bicycle helps your mother 's rocket is upset .
the shirt thinks that my sister 's glass is tired .	the shirt works with my sister 's glass is tired .
the window knows that your father 's shoe is sleepy .	the window scares your father 's shoe is sleepy .
the book thinks that your grandmother 's window is strong .	the book talks to your grandmother 's window is strong .
the car thinks that your sister 's plane is healthy .	the car helps your sister 's plane is healthy .
the ship says that your friend 's door is friendly .	the ship scares your friend 's door is friendly .
the shirt knows that my mother 's candle is careful .	the shirt works with my mother 's candle is careful .
the hat says that your dentist 's plane is young .	the hat works with your dentist 's plane is young .
the bag thinks that your father 's car is kind .	the bag works with your father 's car is kind .
the boat says that your boss 's chair is strong .	the boat talks to your boss 's chair is strong .
the book thinks that your mom 's bag is upset .	the book talks to your mom 's bag is upset .
the rocket thinks that my wife 's plate is surprised .	the rocket talks to my wife 's plate is surprised .
the toy knows that your doctor 's hat is happy .	the toy works with your doctor 's hat is happy .
the glass says that my mother 's mirror is smart .	the glass talks to my mother 's mirror is smart .
the bottle thinks that my doctor 's toy is friendly .	the bottle talks to my doctor 's toy is friendly .
the fork says that your dad 's glass is clever .	the fork talks to your dad 's glass is clever .
the car knows that my grandmother 's ring is hungry .	the car works with my grandmother 's ring is hungry .
the plate thinks that your husband 's bed is sleepy .	the plate helps your husband 's bed is sleepy .
the bottle says that your teacher 's shoe is quiet .	the bottle helps your teacher 's shoe is quiet .
the boat knows that my mom 's ring is kind .	the boat scares my mom 's ring is kind .
the couch says that your cousin 's fork is hungry .	the couch works with your cousin 's fork is hungry .
the button thinks that your teacher 's car is bored .	the button helps your teacher 's car is bored .
the hat says that my husband 's boat is boring .	the hat works with my husband 's boat is boring .
the truck knows that my son 's rug is excited .	the truck helps my son 's rug is excited .
the rocket thinks that your cousin 's truck is tall .	the rocket scares your cousin 's truck is tall .
the mirror thinks that my boss 's ship is young .	the mirror works with my boss 's ship is young .
the button thinks that my wife 's bag is strong .	the button scares my wife 's bag is strong .
the bicycle thinks that my sister 's truck is wrong .	the bicycle talks to my sister 's truck is wrong .
the bag says that your doctor 's ring is tall .	the bag talks to your doctor 's ring is tall .
the car says that your doctor 's window is busy .	the car helps your doctor 's window is busy .
the window knows that your friend 's shoe is upset .	the window talks to your friend 's shoe is upset .
the ship thinks that my daughter 's door is confused .	the ship helps my daughter 's door is confused .
the car knows that my doctor 's rug is hungry .	the car works with my doctor 's rug is hungry .
the plane knows that your father 's doll is boring .	the plane works with your father 's doll is boring .
the plane says that your mother 's plane is wrong .	the plane scares your mother 's plane is wrong .
the dish knows that my teacher 's bed is wrong .	the dish scares my teacher 's bed is wrong .
the toy thinks that my sister 's plane is nice .	the toy works with my sister 's plane is nice .
the boat knows that your friend 's cup is nice .	the boat scares your friend 's cup is nice .
the book knows that your teacher 's bag is excited .	the book scares your teacher 's bag is excited .
the spoon says that my grandmother 's rocket is lucky .	the spoon helps my grandmother 's rocket is lucky .
the button thinks that my husband 's book is clever .	the button works with my husband 's book is clever .
the candle thinks that my mom 's picture is tall .	the candle works with my mom 's picture is tall .
the rug thinks that your mom 's door is important .	the rug works with your mom 's door is important .
the couch says that your husband 's bottle is friendly .	the couch helps your husband 's bottle is friendly .
the picture knows that my daughter 's shoe is tall .	the picture works with my daughter 's shoe is tall .
the crayon knows that my friend 's couch is excited .	the crayon scares my friend 's couch is excited .
the car thinks that my wife 's car is nice .	the car works with my wife 's car is nice .
the bicycle thinks that my friend 's bicycle is bored .	the bicycle scares my friend 's bicycle is bored .
the shoe knows that your brother 's ship is surprised .	the shoe talks to your brother 's ship is surprised .
the shirt thinks that my mom 's crayon is surprised .	the shirt scares my mom 's crayon is surprised .
the bed thinks that my mom 's box is surprised .	the bed talks to my mom 's box is surprised .
the dish says that my mom 's boat is upset .	the dish talks to my mom 's boat is upset .
the picture says that my dad 's shoe is healthy .	the picture talks to my dad 's shoe is healthy .
the rug thinks that your father 's cup is hungry .	the rug helps your father 's cup is hungry .
the chair knows that my doctor 's book is quiet .	the chair helps my doctor 's book is quiet .
the shirt thinks that your teacher 's ring is wrong .	the shirt talks to your teacher 's ring is wrong .
the rug knows that your mom 's bottle is quiet .	the rug helps your mom 's bottle is quiet .
the bag knows that your boss 's book is surprised .	the bag works with your boss 's book is surprised .
the book thinks that my sister 's fork is boring .	the book scares my sister 's fork is boring .
the box says that my doctor 's bicycle is angry .	the box scares my doctor 's bicycle is angry .
the boat says that your teacher 's bicycle is healthy .	the boat scares your teacher 's bicycle is healthy .
the couch knows that your brother 's candle is smart .	the couch scares your brother 's candle is smart .
the glass thinks that your dad 's rocket is kind .	the glass talks to your dad 's rocket is kind .
the cup says that your dad 's boat is wrong .	the cup helps your dad 's boat is wrong .
the car thinks that my wife 's bowl is lucky .	the car works with my wife 's bowl is lucky .
the glass knows that your dad 's hat is young .	the glass helps your dad 's hat is young .
the candle says that your doctor 's boat is hungry .	the candle helps your doctor 's boat is hungry .
the boat says that your grandmother 's window is smart .	the boat scares your grandmother 's window is smart .
the dish knows that your brother 's book is tired .	the dish scares your brother 's book is tired .
the bowl knows that my husband 's fork is bored .	the bowl scares my husband 's fork is bored .
the cup thinks that my wife 's candle is busy .	the cup scares my wife 's candle is busy .
the dish knows that my daughter 's shirt is friendly .	the dish scares my daughter 's shirt is friendly .
the boat thinks that your mom 's ship is clever .	the boat helps your mom 's ship is clever .
the ship knows that your mother 's picture is surprised .	the ship works with your mother 's picture is surprised .
the chair knows that your daughter 's toy is helpful .	the chair scares your daughter 's toy is helpful .
the truck says that my mom 's door is friendly .	the truck works with my mom 's door is friendly .
the car knows that your mom 's truck is careful .	the car works with your mom 's truck is careful .
the truck thinks that my cousin 's door is wrong .	the truck works with my cousin 's door is wrong .
the toy says that your brother 's bicycle is kind .	the toy works with your brother 's bicycle is kind .
the plane says that my doctor 's car is sleepy .	the plane works with my doctor 's car is sleepy .
the ship knows that your wife 's candle is strong .	the ship helps your wife 's candle is strong .
the crayon knows that my grandmother 's bed is hungry .	the crayon scares my grandmother 's bed is hungry .
the bowl knows that my brother 's fork is lucky .	the bowl helps my brother 's fork is lucky .
the plate knows that your brother 's hat is tall .	the plate helps your brother 's hat is tall .
the picture thinks that my son 's chair is healthy .	the picture works with my son 's chair is healthy .
the ship thinks that your brother 's doll is busy .	the ship helps your brother 's doll is busy .
the bowl knows that your dentist 's cup is kind .	the bowl helps your dentist 's cup is kind .
the spoon thinks that my mother 's car is sleepy .	the spoon helps my mother 's car is sleepy .
the glass knows that my wife 's bicycle is strong .	the glass works with my wife 's bicycle is strong .
the couch thinks that my mother 's car is important .	the couch talks to my mother 's car is important .
the ring knows that your father 's toy is boring .	the ring works with your father 's toy is boring .
the picture thinks that your father 's spoon is kind .	the picture works with your father 's spoon is kind .
the chair thinks that my son 's dish is strong .	the chair scares my son 's dish is strong .
the ring knows that my son 's glass is healthy .	the ring scares my son 's glass is healthy .
the car thinks that your doctor 's bed is boring .	the car scares your doctor 's bed is boring .
the shirt says that my dentist 's plane is surprised .	the shirt helps my dentist 's plane is surprised .
the window says that your boss 's rocket is nice .	the window helps your boss 's rocket is nice .
the mirror knows that your mother 's doll is surprised .	the mirror helps your mother 's doll is surprised .
the window says that my dentist 's book is tired .	the window talks to my dentist 's book is tired .
the book thinks that my mom 's rocket is hungry .	the book works with my mom 's rocket is hungry .
the crayon thinks that my dentist 's ring is angry .	the crayon scares my dentist 's ring is angry .
the book knows that your boss 's plate is tired .	the book talks to your boss 's plate is tired .
the shirt says that my dentist 's cup is kind .	the shirt scares my dentist 's cup is kind .
the bowl knows that your boss 's button is boring .	the bowl works with your boss 's button is boring .
the plate says that your daughter 's book is confused .	the plate works with your daughter 's book is confused .
the bottle says that my cousin 's window is hungry .	the bottle works with my cousin 's window is hungry .
the car thinks that my son 's box is excited .	the car works with my son 's box is excited .
the door thinks that your mom 's cup is wrong .	the door helps your mom 's cup is wrong .
the rocket thinks that my mom 's fork is quiet .	the rocket helps my mom 's fork is quiet .
the hat knows that your sister 's truck is angry .	the hat helps your sister 's truck is angry .
the picture thinks that my father 's ring is wrong .	the picture works with my father 's ring is wrong .
the car says that your wife 's door is friendly .	the car scares your wife 's door is friendly .
the ring knows that your husband 's ship is healthy .	the ring scares your husband 's ship is healthy .
the book knows that my grandmother 's book is hungry .	the book helps my grandmother 's book is hungry .
the picture knows that my son 's bed is friendly .	the picture talks to my son 's bed is friendly .
the box thinks that your wife 's couch is kind .	the box scares your wife 's couch is kind .
the cup knows that your teacher 's toy is busy .	the cup works with your teacher 's toy is busy .
the hat thinks that my son 's truck is tall .	the hat helps my son 's truck is tall .
the window thinks that my father 's bottle is quiet .	the window works with my father 's bottle is quiet .
the window says that my daughter 's ring is surprised .	the window works with my daughter 's ring is surprised .
the spoon thinks that my grandmother 's ring is curious .	the spoon helps my grandmother 's ring is curious .
the bicycle knows that your sister 's picture is sleepy .	the bicycle talks to your sister 's picture is sleepy .
the book says that your doctor 's box is tall .	the book scares your doctor 's box is tall .
the dish thinks that my dad 's cup is bored .	the dish helps my dad 's cup is bored .
the fork says that my doctor 's candle is smart .	the fork helps my doctor 's candle is smart .
the car thinks that my father 's dish is healthy .	the car helps my father 's dish is healthy .
the rug says that your brother 's cup is happy .	the rug scares your brother 's cup is happy .
the toy says that my daughter 's candle is friendly .	the toy talks to my daughter 's candle is friendly .
the plate thinks that my daughter 's cup is helpful .	the plate helps my daughter 's cup is helpful .
the bag knows that my husband 's rug is bored .	the bag helps my husband 's rug is bored .
the door knows that your mom 's doll is excited .	the door talks to your mom 's doll is excited .
the plate thinks that my friend 's cup is important .	the plate talks to my friend 's cup is important .
the car knows that your mother 's door is curious .	the car scares your mother 's door is curious .
the picture knows that your daughter 's chair is strong .	the picture works with your daughter 's chair is strong .
the mirror knows that my brother 's glass is gentle .	the mirror helps my brother 's glass is gentle .
the cup knows that my teacher 's ship is busy .	the cup talks to my teacher 's ship is busy .
the bicycle says that my father 's toy is lucky .	the bicycle helps my father 's toy is lucky .
the door thinks that your father 's bed is surprised .	the door works with your father 's bed is surprised .
the dish thinks that my wife 's bed is young .	the dish helps my wife 's bed is young .
the truck knows that my friend 's window is nice .	the truck works with my friend 's window is nice .
the bowl knows that your wife 's boat is angry .	the bowl scares your wife 's boat is angry .
the car thinks that my doctor 's ship is young .	the car talks to my doctor 's ship is young .
the rug knows that my friend 's spoon is hungry .	the rug helps my friend 's spoon is hungry .
the hat thinks that my boss 's box is careful .	the hat helps my boss 's box is careful .
the glass thinks that my sister 's rocket is wrong .	the glass talks to my sister 's rocket is wrong .
the candle says that your sister 's candle is tall .	the candle helps your sister 's candle is tall .
the fork knows that your daughter 's door is healthy .	the fork helps your daughter 's door is healthy .
the crayon thinks that your father 's shirt is quiet .	the crayon talks to your father 's shirt is quiet .
the bed says that your husband 's mirror is angry .	the bed works with your husband 's mirror is angry .
the window knows that your teacher 's bed is happy .	the window talks to your teacher 's bed is happy .
the dish thinks that your mother 's crayon is curious .	the dish talks to your mother 's crayon is curious .
the doll thinks that your mother 's couch is important .	the doll works with your mother 's couch is important .
the rug says that my father 's shirt is angry .	the rug helps my father 's shirt is angry .
the ring thinks that your dentist 's couch is happy .	the ring works with your dentist 's couch is happy .
the rocket says that my husband 's ship is busy .	the rocket talks to my husband 's ship is busy .
the book says that your father 's toy is boring .	the book helps your father 's toy is boring .
the truck says that my wife 's plate is bored .	the truck works with my wife 's plate is bored .
the boat thinks that your mom 's rug is healthy .	the boat helps your mom 's rug is healthy .
the shirt says that my dad 's bicycle is confused .	the shirt helps my dad 's bicycle is confused .
the car says that your friend 's box is sleepy .	the car scares your friend 's box is sleepy .
the ring thinks that my doctor 's plane is important .	the ring helps my doctor 's plane is important .
the shoe says that your son 's mirror is sleepy .	the shoe talks to your son 's mirror is sleepy .
the book knows that your mother 's shoe is lucky .	the book helps your mother 's shoe is lucky .
the chair knows that my friend 's shoe is lucky .	the chair talks to my friend 's shoe is lucky .
the ship says that my mother 's shirt is sleepy .	the ship scares my mother 's shirt is sleepy .
the toy says that your dad 's car is boring .	the toy scares your dad 's car is boring .
the car thinks that my dentist 's plane is nice .	the car works with my dentist 's plane is nice .
the mirror knows that your husband 's bicycle is tall .	the mirror works with your husband 's bicycle is tall .
the book says that your mom 's book is gentle .	the book helps your mom 's book is gentle .
the cup knows that your grandmother 's bed is gentle .	the cup talks to your grandmother 's bed is gentle .
the couch thinks that your doctor 's cup is smart .	the couch scares your doctor 's cup is smart .
the picture knows that my boss 's ship is bored .	the picture helps my boss 's ship is bored .
the truck says that your dentist 's boat is boring .	the truck talks to your dentist 's boat is boring .
the truck says that your son 's bed is important .	the truck scares your son 's bed is important .
the button knows that your sister 's truck is sleepy .	the button talks to your sister 's truck is sleepy .
the mirror knows that your mom 's window is lucky .	the mirror scares your mom 's window is lucky .
the car thinks that your mom 's rug is angry .	the car scares your mom 's rug is angry .
the doll thinks that my friend 's button is healthy .	the doll talks to my friend 's button is healthy .
the cup says that my son 's dish is important .	the cup helps my son 's dish is important .
the cup knows that my wife 's ship is helpful .	the cup scares my wife 's ship is helpful .
the book knows that your daughter 's dish is tall .	the book talks to your daughter 's dish is tall .
the doll knows that my brother 's bicycle is careful .	the doll helps my brother 's bicycle is careful .
the book says that my daughter 's book is friendly .	the book helps my daughter 's book is friendly .
the window thinks that your cousin 's bed is clever .	the window talks to your cousin 's bed is clever .
the bag knows that my sister 's toy is hungry .	the bag helps my sister 's toy is hungry .
the rug says that your boss 's car is kind .	the rug talks to your boss 's car is kind .
the ring knows that my grandmother 's ship is curious .	the ring scares my grandmother 's ship is curious .
the ship says that my boss 's rocket is bored .	the ship helps my boss 's rocket is bored .
the book thinks that my husband 's boat is curious .	the book helps my husband 's boat is curious .
the book thinks that your doctor 's window is curious .	the book scares your doctor 's window is curious .
the glass says that my friend 's shoe is healthy .	the glass scares my friend 's shoe is healthy .
the shirt thinks that your sister 's bed is tall .	the shirt scares your sister 's bed is tall .
the car thinks that your son 's spoon is curious .	the car works with your son 's spoon is curious .
the bicycle knows that your doctor 's candle is kind .	the bicycle scares your doctor 's candle is kind .
the bicycle knows that your daughter 's rug is surprised .	the bicycle helps your daughter 's rug is surprised .
the doll knows that your husband 's chair is wrong .	the doll works with your husband 's chair is wrong .
the book knows that your dad 's boat is upset .	the book scares your dad 's boat is upset .
the doll says that your father 's hat is kind .	the doll scares your father 's hat is kind .
the shoe knows that my grandmother 's truck is gentle .	the shoe talks to my grandmother 's truck is gentle .
the car thinks that my husband 's door is helpful .	the car helps my husband 's door is helpful .
the car knows that your boss 's car is angry .	the car scares your boss 's car is angry .
the box thinks that my dad 's bed is surprised .	the box scares my dad 's bed is surprised .
the book says that your grandmother 's bicycle is tall .	the book scares your grandmother 's bicycle is tall .
the button thinks that my sister 's rocket is tall .	the button talks to my sister 's rocket is tall .
the plane knows that your brother 's couch is friendly .	the plane scares your brother 's couch is friendly .
the plate knows that your dentist 's cup is helpful .	the plate scares your dentist 's cup is helpful .
the bottle knows that my mother 's dish is busy .	the bottle talks to my mother 's dish is busy .
the doll says that my father 's rug is smart .	the doll helps my father 's rug is smart .
the fork thinks that my cousin 's plane is lucky .	the fork works with my cousin 's plane is lucky .
the cup says that my mother 's picture is strong .	the cup works with my mother 's picture is strong .
the bicycle thinks that your friend 's bag is excited .	the bicycle scares your friend 's bag is excited .
the hat thinks that your cousin 's boat is young .	the hat works with your cousin 's boat is young .
the box thinks that your teacher 's shirt is young .	the box talks to your teacher 's shirt is young .
the box thinks that your mother 's picture is happy .	the box works with your mother 's picture is happy .
the rocket says that my mom 's car is happy .	the rocket helps my mom 's car is happy .
the fork says that your grandmother 's book is excited .	the fork scares your grandmother 's book is excited .
the bag says that my wife 's rocket is busy .	the bag scares my wife 's rocket is busy .
the rug thinks that your sister 's ship is strong .	the rug talks to your sister 's ship is strong .
the glass says that my mom 's crayon is sleepy .	the glass scares my mom 's crayon is sleepy .
the shirt thinks that your mother 's candle is excited .	the shirt works with your mother 's candle is excited .
the mirror says that your dad 's bottle is curious .	the mirror scares your dad 's bottle is curious .
the ring thinks that my son 's fork is smart .	the ring talks to my son 's fork is smart .
the bed says that your father 's boat is smart .	the bed works with your father 's boat is smart .
the hat thinks that my grandmother 's bag is sleepy .	the hat works with my grandmother 's bag is sleepy .
the toy thinks that my teacher 's cup is boring .	the toy scares my teacher 's cup is boring .
the shirt says that your brother 's box is angry .	the shirt works with your brother 's box is angry .
the car thinks that your mom 's rocket is hungry .	the car helps your mom 's rocket is hungry .
the crayon thinks that your mother 's rocket is friendly .	the crayon works with your mother 's rocket is friendly .
the car knows that your teacher 's hat is sleepy .	the car works with your teacher 's hat is sleepy .
the hat knows that my mother 's ship is curious .	the hat works with my mother 's ship is curious .
the spoon knows that your mother 's box is healthy .	the spoon scares your mother 's box is healthy .
the crayon thinks that my brother 's dish is young .	the crayon helps my brother 's dish is young .
the book knows that your dad 's picture is young .	the book talks to your dad 's picture is young .
the doll knows that your mother 's glass is happy .	the doll talks to your mother 's glass is happy .
the plate thinks that your husband 's truck is careful .	the plate talks to your husband 's truck is careful .
the mirror knows that your grandmother 's window is healthy .	the mirror scares your grandmother 's window is healthy .
the picture thinks that your dentist 's mirror is kind .	the picture works with your dentist 's mirror is kind .
the rug knows that my grandmother 's crayon is lucky .	the rug scares my grandmother 's crayon is lucky .
the bicycle says that your cousin 's ship is tall .	the bicycle works with your cousin 's ship is tall .
the book knows that my teacher 's door is upset .	the book talks to my teacher 's door is upset .
the bag says that my wife 's bowl is boring .	the bag helps my wife 's bowl is boring .
the box says that my friend 's mirror is smart .	the box helps my friend 's mirror is smart .
the mirror thinks that your teacher 's dish is curious .	the mirror helps your teacher 's dish is curious .
the shirt knows that your boss 's glass is excited .	the shirt talks to your boss 's glass is excited .
the doll thinks that your dentist 's book is nice .	the doll helps your dentist 's book is nice .
the rocket thinks that my brother 's fork is gentle .	the rocket scares my brother 's fork is gentle .
the bicycle knows that your wife 's candle is clever .	the bicycle talks to your wife 's candle is clever .
the rug thinks that your wife 's boat is bored .	the rug helps your wife 's boat is bored .
the fork says that your mother 's door is helpful .	the fork works with your mother 's door is helpful .
the ship knows that my dad 's bicycle is surprised .	the ship scares my dad 's bicycle is surprised .
the window thinks that your sister 's spoon is excited .	the window scares your sister 's spoon is excited .
the boat says that my sister 's shoe is surprised .	the boat helps my sister 's shoe is surprised .
