the dentist knows that your brother 's brother 's boss 's mother 's husband is bored .	the dentist talks to your brother 's brother 's boss 's mother 's husband is bored .
the dentist says that your friend 's teacher 's cousin 's father 's doctor is healthy .	the dentist talks to your friend 's teacher 's cousin 's father 's doctor is healthy .
Linda thinks that your sister 's doctor 's son 's daughter 's cousin is kind .	Linda helps your sister 's doctor 's son 's daughter 's cousin is kind .
Liam knows that your teacher 's brother 's dentist 's doctor 's teacher is busy .	Liam scares your teacher 's brother 's dentist 's doctor 's teacher is busy .
April says that my dad 's husband 's mom 's friend 's dad is gentle .	April works with my dad 's husband 's mom 's friend 's dad is gentle .
my dentist knows that your boss 's brother 's wife 's cousin 's teacher is kind .	my dentist scares your boss 's brother 's wife 's cousin 's teacher is kind .
the teacher says that my daughter 's brother 's boss 's sister 's wife is excited .	the teacher scares my daughter 's brother 's boss 's sister 's wife is excited .
the customer knows that your boss 's grandmother 's sister 's father 's boss is nice .	the customer helps your boss 's grandmother 's sister 's father 's boss is nice .
Jane thinks that my friend 's mother 's teacher 's wife 's wife is busy .	Jane helps my friend 's mother 's teacher 's wife 's wife is busy .
the child says that my sister 's mother 's boss 's dentist 's doctor is important .	the child talks to my sister 's mother 's boss 's dentist 's doctor is important .
Jessica knows that your wife 's son 's dentist 's dentist 's cousin is careful .	Jessica talks to your wife 's son 's dentist 's dentist 's cousin is careful .
the dentist says that your wife 's grandmother 's mom 's dad 's sister is boring .	the dentist helps your wife 's grandmother 's mom 's dad 's sister is boring .
your teacher knows that your friend 's husband 's son 's daughter 's teacher is healthy .	your teacher helps your friend 's husband 's son 's daughter 's teacher is healthy .
the dancer thinks that my doctor 's dad 's dad 's sister 's boss is angry .	the dancer scares my doctor 's dad 's dad 's sister 's boss is angry .
Samantha thinks that my mom 's teacher 's mother 's cousin 's daughter is surprised .	Samantha works with my mom 's teacher 's mother 's cousin 's daughter is surprised .
Mark knows that your mother 's brother 's mother 's doctor 's cousin is healthy .	Mark talks to your mother 's brother 's mother 's doctor 's cousin is healthy .
your friend thinks that my dad 's teacher 's mom 's grandmother 's friend is tall .	your friend scares my dad 's teacher 's mom 's grandmother 's friend is tall .
your teacher knows that my daughter 's father 's dentist 's mother 's husband is boring .	your teacher talks to my daughter 's father 's dentist 's mother 's husband is boring .
Thomas knows that your son 's wife 's cousin 's wife 's grandmother is smart .	Thomas works with your son 's wife 's cousin 's wife 's grandmother is smart .
your cousin knows that my teacher 's grandmother 's doctor 's boss 's teacher is surprised .	your cousin scares my teacher 's grandmother 's doctor 's boss 's teacher is surprised .
the teacher knows that my brother 's teacher 's mother 's husband 's boss is excited .	the teacher scares my brother 's teacher 's mother 's husband 's boss is excited .
your boss says that your mom 's father 's son 's mother 's friend is smart .	your boss scares your mom 's father 's son 's mother 's friend is smart .
Frank says that your sister 's cousin 's brother 's mom 's teacher is sleepy .	Frank works with your sister 's cousin 's brother 's mom 's teacher is sleepy .
the child thinks that your sister 's brother 's mom 's boss 's wife is bored .	the child works with your sister 's brother 's mom 's boss 's wife is bored .
the person thinks that my cousin 's wife 's friend 's brother 's dad is wrong .	the person helps my cousin 's wife 's friend 's brother 's dad is wrong .
my doctor thinks that your husband 's husband 's mother 's friend 's daughter is upset .	my doctor works with your husband 's husband 's mother 's friend 's daughter is upset .
the adult says that your son 's brother 's cousin 's dad 's mom is strong .	the adult works with your son 's brother 's cousin 's dad 's mom is strong .
the person knows that my husband 's daughter 's grandmother 's daughter 's cousin is lucky .	the person helps my husband 's daughter 's grandmother 's daughter 's cousin is lucky .
your boss says that my son 's dad 's son 's sister 's husband is wrong .	your boss works with my son 's dad 's son 's sister 's husband is wrong .
the dentist says that my father 's dad 's friend 's doctor 's teacher is bored .	the dentist scares my father 's dad 's friend 's doctor 's teacher is bored .
the dentist thinks that my doctor 's dad 's dentist 's mother 's son is curious .	the dentist helps my doctor 's dad 's dentist 's mother 's son is curious .
your doctor thinks that my son 's friend 's boss 's mother 's husband is curious .	your doctor talks to my son 's friend 's boss 's mother 's husband is curious .
Wendy says that your cousin 's dentist 's son 's teacher 's sister is tall .	Wendy works with your cousin 's dentist 's son 's teacher 's sister is tall .
Denise knows that my son 's doctor 's dad 's dentist 's wife is tall .	Denise works with my son 's doctor 's dad 's dentist 's wife is tall .
the adult knows that your friend 's grandmother 's wife 's wife 's wife is busy .	the adult works with your friend 's grandmother 's wife 's wife 's wife is busy .
the person says that my wife 's son 's husband 's cousin 's teacher is clever .	the person works with my wife 's son 's husband 's cousin 's teacher is clever .
Frank knows that your boss 's doctor 's son 's mom 's teacher is healthy .	Frank helps your boss 's doctor 's son 's mom 's teacher is healthy .
Susan says that my son 's friend 's wife 's teacher 's daughter is busy .	Susan scares my son 's friend 's wife 's teacher 's daughter is busy .
Nicole says that my husband 's teacher 's mother 's dentist 's cousin is confused .	Nicole scares my husband 's teacher 's mother 's dentist 's cousin is confused .
David thinks that my cousin 's friend 's dentist 's mother 's friend is healthy .	David scares my cousin 's friend 's dentist 's mother 's friend is healthy .
Thomas says that your wife 's dentist 's boss 's dentist 's sister is important .	Thomas scares your wife 's dentist 's boss 's dentist 's sister is important .
my friend thinks that your daughter 's mom 's dentist 's dentist 's boss is happy .	my friend helps your daughter 's mom 's dentist 's dentist 's boss is happy .
the customer knows that your dentist 's son 's cousin 's teacher 's wife is surprised .	the customer talks to your dentist 's son 's cousin 's teacher 's wife is surprised .
my teacher knows that your father 's brother 's brother 's friend 's grandmother is nice .	my teacher scares your father 's brother 's brother 's friend 's grandmother is nice .
your dentist says that your doctor 's daughter 's mother 's husband 's mother is tired .	your dentist scares your doctor 's daughter 's mother 's husband 's mother is tired .
the teacher thinks that your husband 's mother 's mother 's father 's mother is kind .	the teacher scares your husband 's mother 's mother 's father 's mother is kind .
your doctor says that your father 's sister 's mother 's son 's friend is curious .	your doctor talks to your father 's sister 's mother 's son 's friend is curious .
Andrew says that my doctor 's daughter 's sister 's doctor 's mom is confused .	Andrew works with my doctor 's daughter 's sister 's doctor 's mom is confused .
the customer knows that your dad 's father 's brother 's boss 's daughter is kind .	the customer scares your dad 's father 's brother 's boss 's daughter is kind .
Anne says that my cousin 's mother 's cousin 's dentist 's mom is clever .	Anne scares my cousin 's mother 's cousin 's dentist 's mom is clever .
the dancer says that my mother 's friend 's boss 's dad 's dad is strong .	the dancer helps my mother 's friend 's boss 's dad 's dad is strong .
the patient thinks that my grandmother 's cousin 's son 's daughter 's cousin is clever .	the patient helps my grandmother 's cousin 's son 's daughter 's cousin is clever .
the adult says that my husband 's wife 's daughter 's daughter 's son is nice .	the adult helps my husband 's wife 's daughter 's daughter 's son is nice .
Donna says that my brother 's husband 's boss 's sister 's boss is surprised .	Donna works with my brother 's husband 's boss 's sister 's boss is surprised .
Aaron thinks that my teacher 's teacher 's mom 's daughter 's doctor is kind .	Aaron scares my teacher 's teacher 's mom 's daughter 's doctor is kind .
Amelia says that your mom 's dad 's father 's dad 's brother is careful .	Amelia helps your mom 's dad 's father 's dad 's brother is careful .
Lisa knows that your dad 's boss 's grandmother 's doctor 's cousin is smart .	Lisa talks to your dad 's boss 's grandmother 's doctor 's cousin is smart .
the adult thinks that your doctor 's grandmother 's daughter 's wife 's grandmother is tired .	the adult helps your doctor 's grandmother 's daughter 's wife 's grandmother is tired .
your cousin knows that my daughter 's wife 's grandmother 's dad 's husband is boring .	your cousin helps my daughter 's wife 's grandmother 's dad 's husband is boring .
Alice knows that my sister 's mom 's friend 's doctor 's mom is young .	Alice helps my sister 's mom 's friend 's doctor 's mom is young .
Patrick thinks that your father 's grandmother 's grandmother 's brother 's mom is surprised .	Patrick helps your father 's grandmother 's grandmother 's brother 's mom is surprised .
the driver knows that my teacher 's wife 's grandmother 's grandmother 's husband is busy .	the driver helps my teacher 's wife 's grandmother 's grandmother 's husband is busy .
Paul knows that your father 's dad 's mother 's wife 's dentist is boring .	Paul works with your father 's dad 's mother 's wife 's dentist is boring .
your cousin says that my husband 's teacher 's wife 's brother 's daughter is curious .	your cousin scares my husband 's teacher 's wife 's brother 's daughter is curious .
your boss knows that my teacher 's teacher 's doctor 's dentist 's boss is helpful .	your boss works with my teacher 's teacher 's doctor 's dentist 's boss is helpful .
the child thinks that my father 's husband 's teacher 's daughter 's wife is hungry .	the child helps my father 's husband 's teacher 's daughter 's wife is hungry .
Robert thinks that my father 's boss 's doctor 's dad 's dentist is clever .	Robert helps my father 's boss 's doctor 's dad 's dentist is clever .
Anna says that your friend 's grandmother 's mom 's daughter 's father is healthy .	Anna scares your friend 's grandmother 's mom 's daughter 's father is healthy .
the customer says that your dad 's boss 's husband 's husband 's brother is gentle .	the customer talks to your dad 's boss 's husband 's husband 's brother is gentle .
Jane says that my mom 's mom 's boss 's brother 's dentist is lucky .	Jane works with my mom 's mom 's boss 's brother 's dentist is lucky .
your friend says that my dad 's brother 's dad 's son 's father is bored .	your friend scares my dad 's brother 's dad 's son 's father is bored .
Catherine thinks that your dentist 's dad 's grandmother 's sister 's son is upset .	Catherine helps your dentist 's dad 's grandmother 's sister 's son is upset .
your dentist knows that your doctor 's father 's mother 's husband 's mother is healthy .	your dentist talks to your doctor 's father 's mother 's husband 's mother is healthy .
your friend says that my boss 's husband 's friend 's daughter 's cousin is careful .	your friend helps my boss 's husband 's friend 's daughter 's cousin is careful .
the dancer says that your doctor 's dad 's friend 's teacher 's dad is excited .	the dancer scares your doctor 's dad 's friend 's teacher 's dad is excited .
Thomas knows that your father 's mom 's grandmother 's sister 's brother is upset .	Thomas helps your father 's mom 's grandmother 's sister 's brother is upset .
my doctor knows that your friend 's cousin 's sister 's mother 's father is busy .	my doctor talks to your friend 's cousin 's sister 's mother 's father is busy .
Steven thinks that my friend 's cousin 's sister 's son 's cousin is friendly .	Steven works with my friend 's cousin 's sister 's son 's cousin is friendly .
Wendy says that your son 's cousin 's teacher 's boss 's dentist is upset .	Wendy talks to your son 's cousin 's teacher 's boss 's dentist is upset .
your friend thinks that my cousin 's cousin 's wife 's friend 's mother is healthy .	your friend helps my cousin 's cousin 's wife 's friend 's mother is healthy .
Becca says that your brother 's doctor 's sister 's mother 's mother is important .	Becca talks to your brother 's doctor 's sister 's mother 's mother is important .
Denise knows that my sister 's sister 's boss 's dentist 's daughter is boring .	Denise helps my sister 's sister 's boss 's dentist 's daughter is boring .
your dentist says that your dad 's friend 's doctor 's mother 's friend is hungry .	your dentist talks to your dad 's friend 's doctor 's mother 's friend is hungry .
Lisa knows that my father 's boss 's teacher 's dad 's friend is busy .	Lisa helps my father 's boss 's teacher 's dad 's friend is busy .
Linda thinks that my grandmother 's friend 's daughter 's wife 's son is upset .	Linda talks to my grandmother 's friend 's daughter 's wife 's son is upset .
Peter knows that my wife 's cousin 's dentist 's wife 's cousin is wrong .	Peter works with my wife 's cousin 's dentist 's wife 's cousin is wrong .
your dentist says that your grandmother 's son 's doctor 's son 's doctor is excited .	your dentist works with your grandmother 's son 's doctor 's son 's doctor is excited .
your friend thinks that your son 's son 's husband 's friend 's wife is gentle .	your friend talks to your son 's son 's husband 's friend 's wife is gentle .
Richard says that my teacher 's mother 's teacher 's dentist 's mother is quiet .	Richard helps my teacher 's mother 's teacher 's dentist 's mother is quiet .
George says that my grandmother 's teacher 's sister 's father 's dentist is gentle .	George scares my grandmother 's teacher 's sister 's father 's dentist is gentle .
my teacher says that my father 's sister 's grandmother 's cousin 's dad is confused .	my teacher scares my father 's sister 's grandmother 's cousin 's dad is confused .
Emily thinks that your mom 's doctor 's teacher 's doctor 's doctor is smart .	Emily scares your mom 's doctor 's teacher 's doctor 's doctor is smart .
the dentist thinks that your mom 's father 's dad 's mom 's brother is smart .	the dentist talks to your mom 's father 's dad 's mom 's brother is smart .
my teacher thinks that my husband 's son 's husband 's son 's dentist is helpful .	my teacher scares my husband 's son 's husband 's son 's dentist is helpful .
my friend thinks that your grandmother 's brother 's son 's sister 's brother is helpful .	my friend scares your grandmother 's brother 's son 's sister 's brother is helpful .
Jill thinks that my dad 's sister 's father 's teacher 's mother is strong .	Jill works with my dad 's sister 's father 's teacher 's mother is strong .
the dentist thinks that your mother 's grandmother 's dad 's boss 's boss is happy .	the dentist helps your mother 's grandmother 's dad 's boss 's boss is happy .
your teacher knows that your sister 's daughter 's sister 's sister 's daughter is surprised .	your teacher scares your sister 's daughter 's sister 's sister 's daughter is surprised .
Kristen says that your boss 's doctor 's teacher 's father 's doctor is helpful .	Kristen works with your boss 's doctor 's teacher 's father 's doctor is helpful .
Paul says that your doctor 's cousin 's boss 's daughter 's mom is boring .	Paul scares your doctor 's cousin 's boss 's daughter 's mom is boring .
my cousin thinks that my boss 's grandmother 's daughter 's wife 's dentist is strong .	my cousin talks to my boss 's grandmother 's daughter 's wife 's dentist is strong .
the adult knows that my daughter 's sister 's son 's brother 's teacher is careful .	the adult helps my daughter 's sister 's son 's brother 's teacher is careful .
my dentist thinks that your son 's friend 's son 's sister 's mom is strong .	my dentist talks to your son 's friend 's son 's sister 's mom is strong .
my boss says that your friend 's son 's boss 's doctor 's dentist is happy .	my boss works with your friend 's son 's boss 's doctor 's dentist is happy .
Martin knows that your daughter 's dentist 's cousin 's son 's grandmother is surprised .	Martin works with your daughter 's dentist 's cousin 's son 's grandmother is surprised .
my dentist knows that my cousin 's husband 's grandmother 's friend 's doctor is smart .	my dentist helps my cousin 's husband 's grandmother 's friend 's doctor is smart .
my friend knows that my sister 's boss 's brother 's mother 's son is healthy .	my friend helps my sister 's boss 's brother 's mother 's son is healthy .
my dentist knows that my sister 's friend 's dad 's mother 's dad is tall .	my dentist talks to my sister 's friend 's dad 's mother 's dad is tall .
my teacher thinks that your son 's brother 's wife 's sister 's teacher is healthy .	my teacher scares your son 's brother 's wife 's sister 's teacher is healthy .
your teacher thinks that your wife 's teacher 's dad 's husband 's dentist is smart .	your teacher scares your wife 's teacher 's dad 's husband 's dentist is smart .
your dentist knows that my doctor 's father 's cousin 's wife 's doctor is friendly .	your dentist talks to my doctor 's father 's cousin 's wife 's doctor is friendly .
the child says that your brother 's dentist 's mom 's cousin 's cousin is excited .	the child works with your brother 's dentist 's mom 's cousin 's cousin is excited .
your friend thinks that my husband 's boss 's mom 's husband 's husband is upset .	your friend helps my husband 's boss 's mom 's husband 's husband is upset .
the customer says that my teacher 's grandmother 's dentist 's father 's sister is friendly .	the customer scares my teacher 's grandmother 's dentist 's father 's sister is friendly .
the customer says that your brother 's sister 's dentist 's sister 's cousin is excited .	the customer scares your brother 's sister 's dentist 's sister 's cousin is excited .
Travis thinks that your teacher 's brother 's doctor 's teacher 's dad is careful .	Travis talks to your teacher 's brother 's doctor 's teacher 's dad is careful .
the adult thinks that your husband 's dentist 's doctor 's husband 's grandmother is young .	the adult talks to your husband 's dentist 's doctor 's husband 's grandmother is young .
Jerry says that your boss 's sister 's father 's dad 's teacher is young .	Jerry works with your boss 's sister 's father 's dad 's teacher is young .
Julie says that your son 's mother 's father 's brother 's sister is friendly .	Julie talks to your son 's mother 's father 's brother 's sister is friendly .
the child says that your cousin 's dentist 's daughter 's son 's son is quiet .	the child scares your cousin 's dentist 's daughter 's son 's son is quiet .
Tracy thinks that my friend 's brother 's mom 's cousin 's cousin is strong .	Tracy helps my friend 's brother 's mom 's cousin 's cousin is strong .
my teacher says that my friend 's grandmother 's mom 's dad 's mother is busy .	my teacher works with my friend 's grandmother 's mom 's dad 's mother is busy .
the customer thinks that my doctor 's mother 's grandmother 's husband 's mom is happy .	the customer talks to my doctor 's mother 's grandmother 's husband 's mom is happy .
the customer knows that your mom 's son 's dentist 's boss 's wife is upset .	the customer helps your mom 's son 's dentist 's boss 's wife is upset .
Jessica says that your cousin 's mom 's cousin 's doctor 's mom is wrong .	Jessica talks to your cousin 's mom 's cousin 's doctor 's mom is wrong .
your boss says that your teacher 's daughter 's grandmother 's dad 's dad is hungry .	your boss scares your teacher 's daughter 's grandmother 's dad 's dad is hungry .
your dentist thinks that my husband 's grandmother 's brother 's sister 's mom is quiet .	your dentist talks to my husband 's grandmother 's brother 's sister 's mom is quiet .
the doctor thinks that my father 's father 's wife 's dentist 's dad is hungry .	the doctor works with my father 's father 's wife 's dentist 's dad is hungry .
the doctor knows that your husband 's friend 's wife 's husband 's teacher is important .	the doctor scares your husband 's friend 's wife 's husband 's teacher is important .
George says that your wife 's mom 's doctor 's boss 's daughter is hungry .	George talks to your wife 's mom 's doctor 's boss 's daughter is hungry .
my cousin thinks that your husband 's sister 's doctor 's brother 's dad is young .	my cousin helps your husband 's sister 's doctor 's brother 's dad is young .
Amelia knows that your mother 's sister 's grandmother 's cousin 's mother is wrong .	Amelia works with your mother 's sister 's grandmother 's cousin 's mother is wrong .
my dentist knows that your dentist 's boss 's husband 's wife 's daughter is helpful .	my dentist scares your dentist 's boss 's husband 's wife 's daughter is helpful .
the teacher thinks that your grandmother 's dentist 's wife 's dentist 's son is upset .	the teacher talks to your grandmother 's dentist 's wife 's dentist 's son is upset .
your doctor knows that your cousin 's mom 's wife 's cousin 's doctor is surprised .	your doctor scares your cousin 's mom 's wife 's cousin 's doctor is surprised .
Karen knows that your dad 's wife 's dad 's father 's dentist is upset .	Karen scares your dad 's wife 's dad 's father 's dentist is upset .
Emily thinks that my mom 's sister 's doctor 's daughter 's wife is surprised .	Emily works with my mom 's sister 's doctor 's daughter 's wife is surprised .
your dentist says that my boss 's son 's friend 's mom 's daughter is careful .	your dentist works with my boss 's son 's friend 's mom 's daughter is careful .
my teacher says that my doctor 's friend 's doctor 's dad 's mom is sleepy .	my teacher helps my doctor 's friend 's doctor 's dad 's mom is sleepy .
my friend says that your son 's mom 's sister 's mother 's doctor is strong .	my friend helps your son 's mom 's sister 's mother 's doctor is strong .
Naomi knows that my boss 's husband 's dad 's wife 's sister is young .	Naomi works with my boss 's husband 's dad 's wife 's sister is young .
your boss thinks that your teacher 's friend 's daughter 's mom 's father is clever .	your boss scares your teacher 's friend 's daughter 's mom 's father is clever .
your dentist thinks that your brother 's father 's dad 's mom 's son is upset .	your dentist works with your brother 's father 's dad 's mom 's son is upset .
your doctor knows that my husband 's teacher 's brother 's doctor 's boss is gentle .	your doctor works with my husband 's teacher 's brother 's doctor 's boss is gentle .
your dentist says that my friend 's mother 's grandmother 's brother 's dad is hungry .	your dentist talks to my friend 's mother 's grandmother 's brother 's dad is hungry .
Brian thinks that my father 's doctor 's doctor 's boss 's father is smart .	Brian scares my father 's doctor 's doctor 's boss 's father is smart .
Jane thinks that my wife 's mom 's daughter 's son 's cousin is confused .	Jane talks to my wife 's mom 's daughter 's son 's cousin is confused .
Jessica thinks that my dentist 's grandmother 's husband 's dentist 's dentist is angry .	Jessica helps my dentist 's grandmother 's husband 's dentist 's dentist is angry .
Richard thinks that your daughter 's cousin 's son 's brother 's dentist is bored .	Richard scares your daughter 's cousin 's son 's brother 's dentist is bored .
Sandra says that my mom 's dentist 's husband 's father 's sister is helpful .	Sandra scares my mom 's dentist 's husband 's father 's sister is helpful .
the child says that your cousin 's brother 's mom 's grandmother 's doctor is kind .	the child talks to your cousin 's brother 's mom 's grandmother 's doctor is kind .
Michelle thinks that your cousin 's friend 's son 's son 's mother is confused .	Michelle scares your cousin 's friend 's son 's son 's mother is confused .
your boss thinks that your boss 's dentist 's grandmother 's dentist 's wife is curious .	your boss works with your boss 's dentist 's grandmother 's dentist 's wife is curious .
your cousin thinks that your son 's daughter 's mother 's teacher 's father is friendly .	your cousin helps your son 's daughter 's mother 's teacher 's father is friendly .
my cousin says that my daughter 's wife 's mom 's dad 's son is quiet .	my cousin helps my daughter 's wife 's mom 's dad 's son is quiet .
the adult knows that your father 's son 's teacher 's boss 's mom is helpful .	the adult talks to your father 's son 's teacher 's boss 's mom is helpful .
your dentist says that my friend 's sister 's wife 's mom 's dentist is sleepy .	your dentist works with my friend 's sister 's wife 's mom 's dentist is sleepy .
your friend says that your husband 's grandmother 's friend 's son 's son is young .	your friend scares your husband 's grandmother 's friend 's son 's son is young .
the adult knows that your boss 's boss 's cousin 's boss 's dad is important .	the adult scares your boss 's boss 's cousin 's boss 's dad is important .
the dancer says that your sister 's daughter 's wife 's boss 's sister is quiet .	the dancer talks to your sister 's daughter 's wife 's boss 's sister is quiet .
my friend says that my mom 's dentist 's brother 's boss 's mother is tall .	my friend works with my mom 's dentist 's brother 's boss 's mother is tall .
the dancer knows that your boss 's father 's brother 's son 's wife is friendly .	the dancer works with your boss 's father 's brother 's son 's wife is friendly .
the adult says that my husband 's boss 's friend 's dentist 's dentist is bored .	the adult helps my husband 's boss 's friend 's dentist 's dentist is bored .
the customer thinks that my brother 's friend 's grandmother 's daughter 's mother is friendly .	the customer helps my brother 's friend 's grandmother 's daughter 's mother is friendly .
your friend says that your doctor 's teacher 's doctor 's dentist 's mother is upset .	your friend helps your doctor 's teacher 's doctor 's dentist 's mother is upset .
the driver says that your dad 's wife 's friend 's brother 's cousin is young .	the driver talks to your dad 's wife 's friend 's brother 's cousin is young .
the doctor says that my daughter 's cousin 's friend 's mother 's boss is confused .	the doctor scares my daughter 's cousin 's friend 's mother 's boss is confused .
my friend thinks that my wife 's brother 's son 's husband 's husband is bored .	my friend scares my wife 's brother 's son 's husband 's husband is bored .
Eric knows that your daughter 's cousin 's teacher 's dad 's son is gentle .	Eric works with your daughter 's cousin 's teacher 's dad 's son is gentle .
my cousin knows that my brother 's mom 's dentist 's cousin 's teacher is excited .	my cousin works with my brother 's mom 's dentist 's cousin 's teacher is excited .
the teacher says that your friend 's brother 's brother 's mom 's friend is tall .	the teacher talks to your friend 's brother 's brother 's mom 's friend is tall .
the dentist says that my boss 's husband 's dad 's teacher 's dad is happy .	the dentist scares my boss 's husband 's dad 's teacher 's dad is happy .
your teacher thinks that my wife 's dad 's father 's husband 's mother is sleepy .	your teacher helps my wife 's dad 's father 's husband 's mother is sleepy .
the person knows that your wife 's cousin 's mom 's dad 's dad is tired .	the person talks to your wife 's cousin 's mom 's dad 's dad is tired .
Julia knows that your wife 's wife 's mother 's mom 's teacher is busy .	Julia helps your wife 's wife 's mother 's mom 's teacher is busy .
the adult thinks that your wife 's cousin 's daughter 's doctor 's dad is tall .	the adult works with your wife 's cousin 's daughter 's doctor 's dad is tall .
the customer says that your mother 's doctor 's boss 's teacher 's father is friendly .	the customer helps your mother 's doctor 's boss 's teacher 's father is friendly .
Deborah knows that my daughter 's friend 's cousin 's mom 's husband is lucky .	Deborah helps my daughter 's friend 's cousin 's mom 's husband is lucky .
the dentist says that my dad 's dentist 's mother 's mother 's teacher is excited .	the dentist scares my dad 's dentist 's mother 's mother 's teacher is excited .
your teacher knows that your friend 's boss 's father 's father 's wife is friendly .	your teacher scares your friend 's boss 's father 's father 's wife is friendly .
the teacher knows that your friend 's teacher 's grandmother 's cousin 's mother is strong .	the teacher scares your friend 's teacher 's grandmother 's cousin 's mother is strong .
my cousin thinks that my wife 's teacher 's daughter 's sister 's cousin is bored .	my cousin helps my wife 's teacher 's daughter 's sister 's cousin is bored .
the adult knows that your mom 's doctor 's cousin 's son 's father is surprised .	the adult scares your mom 's doctor 's cousin 's son 's father is surprised .
the person knows that my dentist 's father 's father 's son 's wife is busy .	the person works with my dentist 's father 's father 's son 's wife is busy .
Adam knows that my mother 's father 's teacher 's cousin 's grandmother is kind .	Adam talks to my mother 's father 's teacher 's cousin 's grandmother is kind .
Elizabeth says that my grandmother 's father 's boss 's dad 's daughter is upset .	Elizabeth helps my grandmother 's father 's boss 's dad 's daughter is upset .
Nina thinks that your grandmother 's grandmother 's sister 's mother 's husband is nice .	Nina helps your grandmother 's grandmother 's sister 's mother 's husband is nice .
the driver knows that your friend 's son 's wife 's friend 's daughter is surprised .	the driver talks to your friend 's son 's wife 's friend 's daughter is surprised .
the customer says that my friend 's teacher 's daughter 's teacher 's grandmother is young .	the customer talks to my friend 's teacher 's daughter 's teacher 's grandmother is young .
the customer thinks that my mother 's grandmother 's father 's doctor 's father is tall .	the customer helps my mother 's grandmother 's father 's doctor 's father is tall .
the person thinks that your daughter 's brother 's husband 's son 's son is curious .	the person works with your daughter 's brother 's husband 's son 's son is curious .
your teacher thinks that your dad 's father 's father 's dentist 's daughter is curious .	your teacher helps your dad 's father 's father 's dentist 's daughter is curious .
Kevin says that my daughter 's grandmother 's wife 's sister 's dentist is happy .	Kevin works with my daughter 's grandmother 's wife 's sister 's dentist is happy .
the person thinks that your doctor 's mother 's father 's grandmother 's husband is tired .	the person helps your doctor 's mother 's father 's grandmother 's husband is tired .
Donna thinks that your doctor 's cousin 's boss 's mother 's mother is kind .	Donna talks to your doctor 's cousin 's boss 's mother 's mother is kind .
the dancer knows that your teacher 's mother 's boss 's dentist 's friend is surprised .	the dancer works with your teacher 's mother 's boss 's dentist 's friend is surprised .
your doctor says that your mother 's mother 's sister 's boss 's mother is confused .	your doctor scares your mother 's mother 's sister 's boss 's mother is confused .
my cousin thinks that my friend 's boss 's brother 's grandmother 's wife is careful .	my cousin talks to my friend 's boss 's brother 's grandmother 's wife is careful .
the dentist knows that my mom 's sister 's brother 's mother 's daughter is tall .	the dentist works with my mom 's sister 's brother 's mother 's daughter is tall .
Erin knows that my father 's husband 's father 's sister 's dad is healthy .	Erin scares my father 's husband 's father 's sister 's dad is healthy .
your cousin knows that your cousin 's daughter 's cousin 's cousin 's son is boring .	your cousin talks to your cousin 's daughter 's cousin 's cousin 's son is boring .
Joseph knows that my dentist 's wife 's teacher 's mother 's grandmother is surprised .	Joseph helps my dentist 's wife 's teacher 's mother 's grandmother is surprised .
my cousin thinks that my friend 's mom 's husband 's sister 's friend is healthy .	my cousin talks to my friend 's mom 's husband 's sister 's friend is healthy .
the teacher says that my boss 's sister 's dentist 's mom 's boss is lucky .	the teacher talks to my boss 's sister 's dentist 's mom 's boss is lucky .
the person thinks that your dad 's son 's boss 's teacher 's dentist is smart .	the person helps your dad 's son 's boss 's teacher 's dentist is smart .
the child thinks that my grandmother 's friend 's teacher 's mom 's son is friendly .	the child helps my grandmother 's friend 's teacher 's mom 's son is friendly .
Jessica says that my husband 's dad 's sister 's cousin 's daughter is nice .	Jessica helps my husband 's dad 's sister 's cousin 's daughter is nice .
your cousin knows that my sister 's daughter 's boss 's wife 's friend is gentle .	your cousin helps my sister 's daughter 's boss 's wife 's friend is gentle .
Michael says that your doctor 's brother 's sister 's mother 's son is surprised .	Michael helps your doctor 's brother 's sister 's mother 's son is surprised .
your friend knows that my wife 's teacher 's friend 's teacher 's friend is tired .	your friend talks to my wife 's teacher 's friend 's teacher 's friend is tired .
your doctor knows that your brother 's teacher 's friend 's dentist 's teacher is upset .	your doctor helps your brother 's teacher 's friend 's dentist 's teacher is upset .
the teacher says that my doctor 's son 's friend 's brother 's daughter is strong .	the teacher helps my doctor 's son 's friend 's brother 's daughter is strong .
the person thinks that your dentist 's sister 's friend 's daughter 's husband is healthy .	the person helps your dentist 's sister 's friend 's daughter 's husband is healthy .
the teacher thinks that your son 's boss 's cousin 's wife 's husband is careful .	the teacher scares your son 's boss 's cousin 's wife 's husband is careful .
your teacher knows that my dentist 's mother 's cousin 's father 's boss is smart .	your teacher helps my dentist 's mother 's cousin 's father 's boss is smart .
the dancer knows that your friend 's dentist 's mom 's dentist 's brother is sleepy .	the dancer scares your friend 's dentist 's mom 's dentist 's brother is sleepy .
the adult thinks that your dentist 's teacher 's dad 's brother 's grandmother is kind .	the adult works with your dentist 's teacher 's dad 's brother 's grandmother is kind .
your doctor knows that my daughter 's boss 's cousin 's sister 's father is important .	your doctor helps my daughter 's boss 's cousin 's sister 's father is important .
Daniel says that my boss 's grandmother 's grandmother 's dad 's mother is happy .	Daniel scares my boss 's grandmother 's grandmother 's dad 's mother is happy .
the adult thinks that my grandmother 's teacher 's son 's cousin 's grandmother is happy .	the adult talks to my grandmother 's teacher 's son 's cousin 's grandmother is happy .
the teacher knows that my boss 's sister 's doctor 's mother 's boss is happy .	the teacher scares my boss 's sister 's doctor 's mother 's boss is happy .
the teacher says that my dentist 's wife 's doctor 's grandmother 's son is boring .	the teacher helps my dentist 's wife 's doctor 's grandmother 's son is boring .
Anna thinks that my son 's boss 's cousin 's dentist 's sister is important .	Anna helps my son 's boss 's cousin 's dentist 's sister is important .
the patient thinks that my dentist 's dentist 's mom 's mother 's boss is sleepy .	the patient helps my dentist 's dentist 's mom 's mother 's boss is sleepy .
the doctor thinks that your teacher 's mother 's boss 's boss 's doctor is quiet .	the doctor scares your teacher 's mother 's boss 's boss 's doctor is quiet .
the dentist says that my father 's cousin 's cousin 's grandmother 's son is clever .	the dentist talks to my father 's cousin 's cousin 's grandmother 's son is clever .
your boss says that my teacher 's mother 's boss 's mom 's teacher is helpful .	your boss works with my teacher 's mother 's boss 's mom 's teacher is helpful .
the customer says that your dentist 's doctor 's grandmother 's grandmother 's husband is upset .	the customer helps your dentist 's doctor 's grandmother 's grandmother 's husband is upset .
my boss says that your mother 's teacher 's sister 's mom 's dentist is confused .	my boss talks to your mother 's teacher 's sister 's mom 's dentist is confused .
the person thinks that your cousin 's father 's mother 's mother 's grandmother is quiet .	the person helps your cousin 's father 's mother 's mother 's grandmother is quiet .
Gregory knows that my wife 's son 's friend 's sister 's father is surprised .	Gregory works with my wife 's son 's friend 's sister 's father is surprised .
your cousin says that my husband 's father 's teacher 's husband 's teacher is important .	your cousin talks to my husband 's father 's teacher 's husband 's teacher is important .
Frank says that your wife 's grandmother 's mom 's wife 's mom is helpful .	Frank helps your wife 's grandmother 's mom 's wife 's mom is helpful .
Nancy knows that your boss 's wife 's doctor 's sister 's dentist is kind .	Nancy works with your boss 's wife 's doctor 's sister 's dentist is kind .
the child says that my boss 's husband 's teacher 's doctor 's wife is angry .	the child works with my boss 's husband 's teacher 's doctor 's wife is angry .
your teacher says that my dentist 's doctor 's wife 's father 's daughter is friendly .	your teacher helps my dentist 's doctor 's wife 's father 's daughter is friendly .
the doctor thinks that my dentist 's son 's mom 's boss 's friend is excited .	the doctor talks to my dentist 's son 's mom 's boss 's friend is excited .
the child knows that your dentist 's dad 's son 's husband 's husband is friendly .	the child talks to your dentist 's dad 's son 's husband 's husband is friendly .
Elizabeth knows that my friend 's dentist 's daughter 's mother 's boss is kind .	Elizabeth talks to my friend 's dentist 's daughter 's mother 's boss is kind .
the driver thinks that your doctor 's grandmother 's cousin 's friend 's brother is gentle .	the driver helps your doctor 's grandmother 's cousin 's friend 's brother is gentle .
David thinks that my wife 's dad 's mom 's grandmother 's boss is friendly .	David talks to my wife 's dad 's mom 's grandmother 's boss is friendly .
my dentist says that my father 's boss 's mother 's son 's father is tired .	my dentist helps my father 's boss 's mother 's son 's father is tired .
the driver thinks that my wife 's cousin 's dentist 's husband 's teacher is important .	the driver works with my wife 's cousin 's dentist 's husband 's teacher is important .
Patrick says that your grandmother 's mom 's mom 's dad 's father is gentle .	Patrick works with your grandmother 's mom 's mom 's dad 's father is gentle .
your cousin knows that my boss 's brother 's sister 's sister 's grandmother is angry .	your cousin helps my boss 's brother 's sister 's sister 's grandmother is angry .
Thomas thinks that your cousin 's doctor 's grandmother 's husband 's dad is lucky .	Thomas works with your cousin 's doctor 's grandmother 's husband 's dad is lucky .
my cousin thinks that your doctor 's cousin 's wife 's husband 's daughter is strong .	my cousin scares your doctor 's cousin 's wife 's husband 's daughter is strong .
the child thinks that my teacher 's boss 's father 's dad 's son is tired .	the child talks to my teacher 's boss 's father 's dad 's son is tired .
the driver thinks that my dentist 's boss 's son 's dentist 's dentist is excited .	the driver helps my dentist 's boss 's son 's dentist 's dentist is excited .
Brian says that my boss 's brother 's grandmother 's teacher 's grandmother is smart .	Brian scares my boss 's brother 's grandmother 's teacher 's grandmother is smart .
the customer knows that my grandmother 's sister 's dentist 's brother 's dentist is careful .	the customer works with my grandmother 's sister 's dentist 's brother 's dentist is careful .
my cousin knows that my sister 's mom 's brother 's mom 's teacher is kind .	my cousin talks to my sister 's mom 's brother 's mom 's teacher is kind .
Jason thinks that my son 's cousin 's dad 's friend 's boss is quiet .	Jason scares my son 's cousin 's dad 's friend 's boss is quiet .
the dentist thinks that your son 's cousin 's boss 's brother 's dentist is excited .	the dentist scares your son 's cousin 's boss 's brother 's dentist is excited .
Adam thinks that my sister 's grandmother 's cousin 's grandmother 's cousin is clever .	Adam talks to my sister 's grandmother 's cousin 's grandmother 's cousin is clever .
Cindy thinks that my son 's wife 's doctor 's dad 's brother is happy .	Cindy scares my son 's wife 's doctor 's dad 's brother is happy .
Robert thinks that my grandmother 's father 's son 's wife 's friend is angry .	Robert scares my grandmother 's father 's son 's wife 's friend is angry .
the patient thinks that your wife 's mom 's cousin 's mother 's dentist is wrong .	the patient talks to your wife 's mom 's cousin 's mother 's dentist is wrong .
the person thinks that your friend 's wife 's brother 's sister 's sister is busy .	the person scares your friend 's wife 's brother 's sister 's sister is busy .
your boss thinks that your wife 's mom 's husband 's wife 's mom is kind .	your boss talks to your wife 's mom 's husband 's wife 's mom is kind .
my teacher knows that your teacher 's wife 's mom 's father 's cousin is upset .	my teacher helps your teacher 's wife 's mom 's father 's cousin is upset .
my doctor says that my dad 's mom 's boss 's husband 's father is nice .	my doctor talks to my dad 's mom 's boss 's husband 's father is nice .
my boss says that my dad 's cousin 's sister 's mom 's grandmother is surprised .	my boss scares my dad 's cousin 's sister 's mom 's grandmother is surprised .
the driver thinks that your dentist 's cousin 's wife 's sister 's mother is tall .	the driver scares your dentist 's cousin 's wife 's sister 's mother is tall .
Cindy knows that your wife 's father 's daughter 's grandmother 's doctor is helpful .	Cindy talks to your wife 's father 's daughter 's grandmother 's doctor is helpful .
the patient says that my dentist 's cousin 's doctor 's mom 's sister is happy .	the patient works with my dentist 's cousin 's doctor 's mom 's sister is happy .
the person knows that your husband 's doctor 's husband 's mother 's husband is surprised .	the person scares your husband 's doctor 's husband 's mother 's husband is surprised .
your friend knows that your daughter 's friend 's brother 's mom 's friend is angry .	your friend works with your daughter 's friend 's brother 's mom 's friend is angry .
Thomas thinks that your mom 's father 's sister 's sister 's husband is lucky .	Thomas scares your mom 's father 's sister 's sister 's husband is lucky .
the patient says that your doctor 's sister 's sister 's brother 's wife is strong .	the patient scares your doctor 's sister 's sister 's brother 's wife is strong .
the teacher knows that my teacher 's friend 's brother 's dad 's dentist is tall .	the teacher talks to my teacher 's friend 's brother 's dad 's dentist is tall .
the dentist knows that my mom 's dentist 's dentist 's mom 's boss is helpful .	the dentist scares my mom 's dentist 's dentist 's mom 's boss is helpful .
the person thinks that my grandmother 's mom 's boss 's boss 's doctor is boring .	the person helps my grandmother 's mom 's boss 's boss 's doctor is boring .
Carol says that my cousin 's daughter 's grandmother 's friend 's daughter is curious .	Carol talks to my cousin 's daughter 's grandmother 's friend 's daughter is curious .
Martin says that your boss 's wife 's son 's sister 's mother is hungry .	Martin scares your boss 's wife 's son 's sister 's mother is hungry .
Leslie knows that my doctor 's son 's mother 's dentist 's wife is young .	Leslie works with my doctor 's son 's mother 's dentist 's wife is young .
my doctor knows that your brother 's friend 's wife 's dad 's mom is wrong .	my doctor talks to your brother 's friend 's wife 's dad 's mom is wrong .
George says that my dentist 's daughter 's wife 's dentist 's brother is healthy .	George helps my dentist 's daughter 's wife 's dentist 's brother is healthy .
your dentist thinks that my dad 's cousin 's sister 's mother 's brother is sleepy .	your dentist talks to my dad 's cousin 's sister 's mother 's brother is sleepy .
your cousin knows that my daughter 's sister 's mom 's brother 's daughter is careful .	your cousin talks to my daughter 's sister 's mom 's brother 's daughter is careful .
the driver says that my grandmother 's friend 's dad 's son 's cousin is tired .	the driver scares my grandmother 's friend 's dad 's son 's cousin is tired .
the driver knows that my mother 's wife 's daughter 's wife 's sister is helpful .	the driver talks to my mother 's wife 's daughter 's wife 's sister is helpful .
the dentist says that your boss 's brother 's cousin 's boss 's doctor is tired .	the dentist scares your boss 's brother 's cousin 's boss 's doctor is tired .
the doctor says that your boss 's son 's dad 's cousin 's friend is kind .	the doctor helps your boss 's son 's dad 's cousin 's friend is kind .
the child thinks that your cousin 's brother 's grandmother 's sister 's brother is gentle .	the child talks to your cousin 's brother 's grandmother 's sister 's brother is gentle .
Becky knows that my husband 's grandmother 's father 's brother 's doctor is tired .	Becky scares my husband 's grandmother 's father 's brother 's doctor is tired .
the dancer knows that your mom 's mom 's doctor 's mother 's cousin is important .	the dancer scares your mom 's mom 's doctor 's mother 's cousin is important .
the driver thinks that my daughter 's mom 's father 's boss 's teacher is curious .	the driver works with my daughter 's mom 's father 's boss 's teacher is curious .
the dentist says that your friend 's teacher 's boss 's boss 's teacher is lucky .	the dentist works with your friend 's teacher 's boss 's boss 's teacher is lucky .
the dancer thinks that my son 's doctor 's brother 's dentist 's dentist is bored .	the dancer helps my son 's doctor 's brother 's dentist 's dentist is bored .
your doctor knows that your dentist 's sister 's cousin 's mom 's mother is bored .	your doctor helps your dentist 's sister 's cousin 's mom 's mother is bored .
the teacher says that my friend 's father 's friend 's mom 's dentist is important .	the teacher talks to my friend 's father 's friend 's mom 's dentist is important .
the teacher knows that my brother 's sister 's friend 's brother 's cousin is bored .	the teacher scares my brother 's sister 's friend 's brother 's cousin is bored .
my teacher knows that your doctor 's cousin 's mother 's mom 's daughter is tired .	my teacher works with your doctor 's cousin 's mother 's mom 's daughter is tired .
my dentist thinks that my daughter 's doctor 's husband 's sister 's grandmother is tall .	my dentist scares my daughter 's doctor 's husband 's sister 's grandmother is tall .
the child thinks that your dad 's brother 's wife 's brother 's husband is clever .	the child scares your dad 's brother 's wife 's brother 's husband is clever .
your teacher says that your boss 's teacher 's dad 's dentist 's brother is quiet .	your teacher talks to your boss 's teacher 's dad 's dentist 's brother is quiet .
the dancer knows that your boss 's doctor 's grandmother 's dad 's brother is sleepy .	the dancer helps your boss 's doctor 's grandmother 's dad 's brother is sleepy .
my teacher thinks that your doctor 's cousin 's father 's sister 's dentist is sleepy .	my teacher works with your doctor 's cousin 's father 's sister 's dentist is sleepy .
your dentist knows that your dentist 's dentist 's teacher 's teacher 's dad is boring .	your dentist works with your dentist 's dentist 's teacher 's teacher 's dad is boring .
the person says that your grandmother 's daughter 's son 's grandmother 's son is curious .	the person talks to your grandmother 's daughter 's son 's grandmother 's son is curious .
the doctor knows that your sister 's mother 's boss 's boss 's wife is happy .	the doctor scares your sister 's mother 's boss 's boss 's wife is happy .
Donna says that your daughter 's friend 's dentist 's brother 's teacher is tired .	Donna talks to your daughter 's friend 's dentist 's brother 's teacher is tired .
David says that my husband 's teacher 's brother 's cousin 's grandmother is excited .	David helps my husband 's teacher 's brother 's cousin 's grandmother is excited .
Vanessa says that my husband 's cousin 's mother 's dad 's grandmother is quiet .	Vanessa talks to my husband 's cousin 's mother 's dad 's grandmother is quiet .
my teacher knows that your sister 's mother 's brother 's boss 's grandmother is curious .	my teacher scares your sister 's mother 's brother 's boss 's grandmother is curious .
Rebecca knows that your wife 's boss 's husband 's father 's son is young .	Rebecca helps your wife 's boss 's husband 's father 's son is young .
Sally knows that your husband 's brother 's grandmother 's wife 's friend is confused .	Sally talks to your husband 's brother 's grandmother 's wife 's friend is confused .
my teacher says that my daughter 's mother 's friend 's dentist 's sister is confused .	my teacher works with my daughter 's mother 's friend 's dentist 's sister is confused .
your cousin thinks that your teacher 's teacher 's doctor 's grandmother 's boss is hungry .	your cousin works with your teacher 's teacher 's doctor 's grandmother 's boss is hungry .
my dentist says that your son 's sister 's doctor 's wife 's mom is tired .	my dentist works with your son 's sister 's doctor 's wife 's mom is tired .
your friend thinks that my wife 's friend 's daughter 's mom 's son is kind .	your friend helps my wife 's friend 's daughter 's mom 's son is kind .
the dancer says that your doctor 's grandmother 's dad 's mom 's mother is busy .	the dancer talks to your doctor 's grandmother 's dad 's mom 's mother is busy .
the adult thinks that your wife 's wife 's daughter 's grandmother 's daughter is smart .	the adult works with your wife 's wife 's daughter 's grandmother 's daughter is smart .
Rebecca thinks that your mom 's husband 's son 's daughter 's grandmother is happy .	Rebecca works with your mom 's husband 's son 's daughter 's grandmother is happy .
Michelle knows that your doctor 's wife 's dad 's dentist 's cousin is confused .	Michelle helps your doctor 's wife 's dad 's dentist 's cousin is confused .
Thomas knows that my grandmother 's son 's boss 's grandmother 's sister is tired .	Thomas works with my grandmother 's son 's boss 's grandmother 's sister is tired .
the driver thinks that my dentist 's daughter 's grandmother 's sister 's wife is helpful .	the driver scares my dentist 's daughter 's grandmother 's sister 's wife is helpful .
my dentist thinks that my teacher 's friend 's daughter 's doctor 's teacher is important .	my dentist talks to my teacher 's friend 's daughter 's doctor 's teacher is important .
the person knows that your friend 's brother 's friend 's mom 's teacher is gentle .	the person works with your friend 's brother 's friend 's mom 's teacher is gentle .
my dentist knows that my daughter 's dentist 's cousin 's friend 's grandmother is hungry .	my dentist scares my daughter 's dentist 's cousin 's friend 's grandmother is hungry .
my cousin knows that my sister 's teacher 's friend 's brother 's son is nice .	my cousin talks to my sister 's teacher 's friend 's brother 's son is nice .
my teacher thinks that my cousin 's mom 's mother 's father 's daughter is sleepy .	my teacher talks to my cousin 's mom 's mother 's father 's daughter is sleepy .
your doctor says that my brother 's wife 's cousin 's sister 's boss is curious .	your doctor works with my brother 's wife 's cousin 's sister 's boss is curious .
the dancer says that my teacher 's friend 's friend 's grandmother 's sister is young .	the dancer helps my teacher 's friend 's friend 's grandmother 's sister is young .
Amelia knows that your grandmother 's brother 's boss 's teacher 's dad is young .	Amelia helps your grandmother 's brother 's boss 's teacher 's dad is young .
the person says that your son 's son 's doctor 's husband 's dad is curious .	the person scares your son 's son 's doctor 's husband 's dad is curious .
Michael knows that my son 's teacher 's teacher 's sister 's grandmother is quiet .	Michael works with my son 's teacher 's teacher 's sister 's grandmother is quiet .
the dentist thinks that my doctor 's husband 's doctor 's son 's friend is helpful .	the dentist scares my doctor 's husband 's doctor 's son 's friend is helpful .
your friend thinks that my wife 's friend 's wife 's dentist 's brother is clever .	your friend scares my wife 's friend 's wife 's dentist 's brother is clever .
the doctor knows that your friend 's son 's brother 's husband 's dad is boring .	the doctor talks to your friend 's son 's brother 's husband 's dad is boring .
your teacher thinks that your daughter 's boss 's husband 's teacher 's mother is young .	your teacher talks to your daughter 's boss 's husband 's teacher 's mother is young .
your teacher thinks that my mom 's son 's grandmother 's sister 's wife is healthy .	your teacher helps my mom 's son 's grandmother 's sister 's wife is healthy .
my dentist knows that my sister 's dentist 's cousin 's husband 's doctor is important .	my dentist talks to my sister 's dentist 's cousin 's husband 's doctor is important .
your teacher thinks that your cousin 's son 's teacher 's sister 's mother is busy .	your teacher works with your cousin 's son 's teacher 's sister 's mother is busy .
Jennifer thinks that my sister 's dentist 's friend 's father 's boss is angry .	Jennifer works with my sister 's dentist 's friend 's father 's boss is angry .
my teacher says that my dad 's dad 's wife 's grandmother 's daughter is lucky .	my teacher helps my dad 's dad 's wife 's grandmother 's daughter is lucky .
my cousin thinks that my brother 's grandmother 's boss 's daughter 's doctor is healthy .	my cousin scares my brother 's grandmother 's boss 's daughter 's doctor is healthy .
the dancer says that my grandmother 's son 's boss 's mom 's teacher is young .	the dancer works with my grandmother 's son 's boss 's mom 's teacher is young .
George knows that your mother 's cousin 's sister 's son 's sister is friendly .	George scares your mother 's cousin 's sister 's son 's sister is friendly .
Melissa knows that your dad 's friend 's daughter 's cousin 's daughter is sleepy .	Melissa scares your dad 's friend 's daughter 's cousin 's daughter is sleepy .
my cousin says that your mother 's brother 's boss 's teacher 's mother is gentle .	my cousin talks to your mother 's brother 's boss 's teacher 's mother is gentle .
the driver knows that your brother 's daughter 's father 's father 's brother is important .	the driver helps your brother 's daughter 's father 's father 's brother is important .
the patient says that my teacher 's son 's husband 's father 's husband is young .	the patient talks to my teacher 's son 's husband 's father 's husband is young .
Alice thinks that my grandmother 's daughter 's wife 's boss 's father is clever .	Alice talks to my grandmother 's daughter 's wife 's boss 's father is clever .
the customer thinks that your mother 's mother 's daughter 's mom 's mother is careful .	the customer scares your mother 's mother 's daughter 's mom 's mother is careful .
my teacher says that my doctor 's friend 's grandmother 's daughter 's dad is tired .	my teacher scares my doctor 's friend 's grandmother 's daughter 's dad is tired .
the dentist knows that your dentist 's wife 's boss 's grandmother 's son is tall .	the dentist talks to your dentist 's wife 's boss 's grandmother 's son is tall .
the child says that my doctor 's teacher 's grandmother 's friend 's sister is confused .	the child helps my doctor 's teacher 's grandmother 's friend 's sister is confused .
the doctor knows that my daughter 's cousin 's mom 's mom 's boss is friendly .	the doctor scares my daughter 's cousin 's mom 's mom 's boss is friendly .
the child thinks that your son 's son 's son 's boss 's doctor is helpful .	the child helps your son 's son 's son 's boss 's doctor is helpful .
Aaron thinks that your doctor 's mother 's teacher 's sister 's wife is careful .	Aaron scares your doctor 's mother 's teacher 's sister 's wife is careful .
the driver says that my teacher 's wife 's son 's father 's brother is tall .	the driver helps my teacher 's wife 's son 's father 's brother is tall .
the teacher knows that your father 's daughter 's daughter 's brother 's doctor is gentle .	the teacher scares your father 's daughter 's daughter 's brother 's doctor is gentle .
the child says that my cousin 's teacher 's sister 's wife 's son is angry .	the child scares my cousin 's teacher 's sister 's wife 's son is angry .
my doctor thinks that your sister 's dentist 's daughter 's grandmother 's dentist is kind .	my doctor talks to your sister 's dentist 's daughter 's grandmother 's dentist is kind .
the customer thinks that your brother 's dentist 's son 's doctor 's mom is helpful .	the customer helps your brother 's dentist 's son 's doctor 's mom is helpful .
your boss knows that my grandmother 's son 's doctor 's father 's teacher is lucky .	your boss talks to my grandmother 's son 's doctor 's father 's teacher is lucky .
Julia thinks that my teacher 's doctor 's teacher 's dentist 's daughter is excited .	Julia talks to my teacher 's doctor 's teacher 's dentist 's daughter is excited .
Paul thinks that my son 's mother 's sister 's dad 's father is smart .	Paul scares my son 's mother 's sister 's dad 's father is smart .
the person knows that my daughter 's mother 's cousin 's friend 's teacher is friendly .	the person works with my daughter 's mother 's cousin 's friend 's teacher is friendly .
the dancer knows that your cousin 's friend 's mother 's wife 's father is careful .	the dancer talks to your cousin 's friend 's mother 's wife 's father is careful .
the teacher thinks that your wife 's mom 's brother 's father 's brother is clever .	the teacher works with your wife 's mom 's brother 's father 's brother is clever .
Becky says that your cousin 's husband 's boss 's husband 's brother is careful .	Becky talks to your cousin 's husband 's boss 's husband 's brother is careful .
my friend says that your grandmother 's cousin 's father 's father 's wife is excited .	my friend scares your grandmother 's cousin 's father 's father 's wife is excited .
your friend thinks that my sister 's dentist 's sister 's doctor 's cousin is tall .	your friend scares my sister 's dentist 's sister 's doctor 's cousin is tall .
your doctor knows that my dentist 's wife 's dentist 's son 's dentist is busy .	your doctor scares my dentist 's wife 's dentist 's son 's dentist is busy .
the adult thinks that my wife 's daughter 's son 's sister 's father is boring .	the adult talks to my wife 's daughter 's son 's sister 's father is boring .
the patient says that my brother 's sister 's father 's daughter 's friend is sleepy .	the patient works with my brother 's sister 's father 's daughter 's friend is sleepy .
the adult thinks that your wife 's father 's mom 's sister 's sister is strong .	the adult talks to your wife 's father 's mom 's sister 's sister is strong .
the customer knows that your boss 's sister 's teacher 's dentist 's son is careful .	the customer helps your boss 's sister 's teacher 's dentist 's son is careful .
Amelia says that my daughter 's mom 's cousin 's daughter 's brother is quiet .	Amelia talks to my daughter 's mom 's cousin 's daughter 's brother is quiet .
your dentist says that your daughter 's dad 's wife 's husband 's mom is young .	your dentist works with your daughter 's dad 's wife 's husband 's mom is young .
the dentist knows that my teacher 's boss 's dad 's dad 's sister is boring .	the dentist scares my teacher 's boss 's dad 's dad 's sister is boring .
your cousin knows that my father 's daughter 's boss 's mother 's dentist is important .	your cousin talks to my father 's daughter 's boss 's mother 's dentist is important .
your boss says that my son 's son 's dentist 's dad 's teacher is upset .	your boss talks to my son 's son 's dentist 's dad 's teacher is upset .
Naomi knows that my teacher 's husband 's dad 's friend 's dad is lucky .	Naomi helps my teacher 's husband 's dad 's friend 's dad is lucky .
Elizabeth thinks that my father 's father 's mother 's dad 's cousin is friendly .	Elizabeth scares my father 's father 's mother 's dad 's cousin is friendly .
the customer knows that your wife 's dad 's boss 's teacher 's mom is nice .	the customer talks to your wife 's dad 's boss 's teacher 's mom is nice .
your friend knows that my grandmother 's grandmother 's father 's cousin 's wife is smart .	your friend scares my grandmother 's grandmother 's father 's cousin 's wife is smart .
my dentist knows that my daughter 's mom 's sister 's dentist 's teacher is helpful .	my dentist talks to my daughter 's mom 's sister 's dentist 's teacher is helpful .
Denise knows that your grandmother 's mom 's sister 's dad 's doctor is curious .	Denise works with your grandmother 's mom 's sister 's dad 's doctor is curious .
the dentist thinks that your doctor 's sister 's father 's doctor 's wife is clever .	the dentist works with your doctor 's sister 's father 's doctor 's wife is clever .
Michelle knows that my cousin 's daughter 's grandmother 's brother 's boss is wrong .	Michelle works with my cousin 's daughter 's grandmother 's brother 's boss is wrong .
the dancer knows that your sister 's wife 's boss 's husband 's husband is upset .	the dancer talks to your sister 's wife 's boss 's husband 's husband is upset .
your friend says that your doctor 's husband 's dentist 's teacher 's teacher is tired .	your friend works with your doctor 's husband 's dentist 's teacher 's teacher is tired .
the doctor knows that your mother 's dad 's dad 's dad 's dentist is strong .	the doctor helps your mother 's dad 's dad 's dad 's dentist is strong .
my teacher says that my friend 's dad 's teacher 's grandmother 's father is wrong .	my teacher talks to my friend 's dad 's teacher 's grandmother 's father is wrong .
your teacher thinks that your teacher 's husband 's brother 's son 's doctor is clever .	your teacher helps your teacher 's husband 's brother 's son 's doctor is clever .
my dentist says that your boss 's doctor 's grandmother 's dentist 's cousin is helpful .	my dentist talks to your boss 's doctor 's grandmother 's dentist 's cousin is helpful .
the adult thinks that your wife 's dad 's brother 's wife 's doctor is kind .	the adult works with your wife 's dad 's brother 's wife 's doctor is kind .
your teacher knows that your mother 's son 's grandmother 's mother 's cousin is curious .	your teacher scares your mother 's son 's grandmother 's mother 's cousin is curious .
my teacher thinks that my mother 's mom 's dentist 's friend 's sister is young .	my teacher helps my mother 's mom 's dentist 's friend 's sister is young .
the dentist thinks that my dentist 's teacher 's doctor 's daughter 's husband is angry .	the dentist works with my dentist 's teacher 's doctor 's daughter 's husband is angry .
the customer knows that my brother 's mom 's husband 's cousin 's husband is surprised .	the customer helps my brother 's mom 's husband 's cousin 's husband is surprised .
the dentist says that my boss 's sister 's cousin 's grandmother 's dad is healthy .	the dentist works with my boss 's sister 's cousin 's grandmother 's dad is healthy .
the dancer knows that my husband 's wife 's husband 's mother 's wife is strong .	the dancer helps my husband 's wife 's husband 's mother 's wife is strong .
the driver says that my mom 's dad 's brother 's teacher 's son is quiet .	the driver talks to my mom 's dad 's brother 's teacher 's son is quiet .
Erin thinks that your daughter 's mom 's son 's friend 's father is upset .	Erin talks to your daughter 's mom 's son 's friend 's father is upset .
my dentist knows that your boss 's teacher 's wife 's mom 's father is quiet .	my dentist works with your boss 's teacher 's wife 's mom 's father is quiet .
your doctor thinks that your cousin 's teacher 's grandmother 's boss 's grandmother is gentle .	your doctor works with your cousin 's teacher 's grandmother 's boss 's grandmother is gentle .
Brian knows that my mom 's brother 's brother 's doctor 's father is curious .	Brian talks to my mom 's brother 's brother 's doctor 's father is curious .
the doctor knows that my wife 's dad 's grandmother 's son 's doctor is nice .	the doctor helps my wife 's dad 's grandmother 's son 's doctor is nice .
Kristen knows that my son 's grandmother 's brother 's teacher 's daughter is quiet .	Kristen scares my son 's grandmother 's brother 's teacher 's daughter is quiet .
Alexander knows that your son 's dentist 's mother 's sister 's mother is clever .	Alexander works with your son 's dentist 's mother 's sister 's mother is clever .
Mark knows that your mother 's husband 's grandmother 's friend 's daughter is wrong .	Mark works with your mother 's husband 's grandmother 's friend 's daughter is wrong .
your doctor knows that your cousin 's cousin 's boss 's friend 's sister is busy .	your doctor helps your cousin 's cousin 's boss 's friend 's sister is busy .
Aaron says that my daughter 's daughter 's mom 's son 's husband is curious .	Aaron scares my daughter 's daughter 's mom 's son 's husband is curious .
Carol says that my doctor 's friend 's mother 's dad 's wife is healthy .	Carol works with my doctor 's friend 's mother 's dad 's wife is healthy .
Laurie says that your mom 's husband 's doctor 's dentist 's dad is important .	Laurie helps your mom 's husband 's doctor 's dentist 's dad is important .
the teacher knows that my dad 's daughter 's cousin 's wife 's dad is hungry .	the teacher talks to my dad 's daughter 's cousin 's wife 's dad is hungry .
Rebecca thinks that my dad 's doctor 's wife 's mom 's brother is wrong .	Rebecca scares my dad 's doctor 's wife 's mom 's brother is wrong .
John thinks that my father 's dad 's wife 's sister 's boss is young .	John scares my father 's dad 's wife 's sister 's boss is young .
your friend thinks that my brother 's wife 's grandmother 's husband 's dad is important .	your friend talks to my brother 's wife 's grandmother 's husband 's dad is important .
your dentist says that my grandmother 's mom 's son 's dentist 's doctor is quiet .	your dentist scares my grandmother 's mom 's son 's dentist 's doctor is quiet .
your teacher says that my mother 's mom 's mom 's dentist 's friend is bored .	your teacher scares my mother 's mom 's mom 's dentist 's friend is bored .
the teacher says that my dad 's boss 's boss 's wife 's dad is quiet .	the teacher talks to my dad 's boss 's boss 's wife 's dad is quiet .
Deborah thinks that my dentist 's boss 's father 's wife 's mother is tired .	Deborah scares my dentist 's boss 's father 's wife 's mother is tired .
Frank says that your mom 's mom 's sister 's brother 's wife is sleepy .	Frank talks to your mom 's mom 's sister 's brother 's wife is sleepy .
your boss says that my son 's grandmother 's cousin 's cousin 's mom is tall .	your boss helps my son 's grandmother 's cousin 's cousin 's mom is tall .
the dentist thinks that your friend 's brother 's teacher 's mother 's mother is bored .	the dentist works with your friend 's brother 's teacher 's mother 's mother is bored .
your boss knows that my father 's dad 's dentist 's husband 's mom is confused .	your boss helps my father 's dad 's dentist 's husband 's mom is confused .
my dentist thinks that my friend 's mother 's friend 's teacher 's mom is tall .	my dentist helps my friend 's mother 's friend 's teacher 's mom is tall .
Allison thinks that your dentist 's grandmother 's wife 's brother 's mom is excited .	Allison works with your dentist 's grandmother 's wife 's brother 's mom is excited .
the doctor thinks that my wife 's cousin 's friend 's brother 's teacher is bored .	the doctor scares my wife 's cousin 's friend 's brother 's teacher is bored .
the adult says that your wife 's mom 's daughter 's cousin 's wife is upset .	the adult scares your wife 's mom 's daughter 's cousin 's wife is upset .
the doctor knows that your dad 's husband 's daughter 's sister 's friend is curious .	the doctor scares your dad 's husband 's daughter 's sister 's friend is curious .
Bill thinks that your father 's friend 's daughter 's boss 's boss is important .	Bill scares your father 's friend 's daughter 's boss 's boss is important .
my doctor thinks that your boss 's dentist 's boss 's dad 's mom is important .	my doctor helps your boss 's dentist 's boss 's dad 's mom is important .
the teacher knows that my friend 's grandmother 's dad 's daughter 's daughter is quiet .	the teacher scares my friend 's grandmother 's dad 's daughter 's daughter is quiet .
the dancer says that your father 's dad 's dentist 's wife 's friend is curious .	the dancer scares your father 's dad 's dentist 's wife 's friend is curious .
the dancer says that your boss 's wife 's brother 's mom 's sister is lucky .	the dancer works with your boss 's wife 's brother 's mom 's sister is lucky .
Thomas knows that your dentist 's wife 's cousin 's son 's sister is clever .	Thomas talks to your dentist 's wife 's cousin 's son 's sister is clever .
the teacher thinks that my sister 's teacher 's boss 's teacher 's dentist is happy .	the teacher scares my sister 's teacher 's boss 's teacher 's dentist is happy .
Scott says that your dad 's mom 's son 's mother 's dentist is quiet .	Scott scares your dad 's mom 's son 's mother 's dentist is quiet .
my cousin knows that my husband 's father 's teacher 's cousin 's wife is tired .	my cousin scares my husband 's father 's teacher 's cousin 's wife is tired .
the child knows that your dentist 's daughter 's mother 's teacher 's son is wrong .	the child talks to your dentist 's daughter 's mother 's teacher 's son is wrong .
my friend knows that my mother 's wife 's brother 's dentist 's mother is healthy .	my friend scares my mother 's wife 's brother 's dentist 's mother is healthy .
Tracy thinks that my grandmother 's husband 's mother 's boss 's daughter is angry .	Tracy talks to my grandmother 's husband 's mother 's boss 's daughter is angry .
Nancy says that my daughter 's teacher 's husband 's boss 's mom is healthy .	Nancy works with my daughter 's teacher 's husband 's boss 's mom is healthy .
Denise knows that my friend 's sister 's dentist 's boss 's sister is sleepy .	Denise talks to my friend 's sister 's dentist 's boss 's sister is sleepy .
your cousin thinks that your mother 's sister 's dad 's father 's mom is boring .	your cousin helps your mother 's sister 's dad 's father 's mom is boring .
your friend thinks that my friend 's dentist 's boss 's dentist 's dentist is helpful .	your friend helps my friend 's dentist 's boss 's dentist 's dentist is helpful .
your cousin knows that my friend 's mother 's teacher 's mom 's doctor is happy .	your cousin helps my friend 's mother 's teacher 's mom 's doctor is happy .
Michael thinks that your dentist 's wife 's mother 's dentist 's doctor is tall .	Michael helps your dentist 's wife 's mother 's dentist 's doctor is tall .
Elizabeth thinks that your father 's mom 's doctor 's mom 's friend is wrong .	Elizabeth helps your father 's mom 's doctor 's mom 's friend is wrong .
the child says that your dad 's wife 's wife 's dentist 's mom is tired .	the child works with your dad 's wife 's wife 's dentist 's mom is tired .
Judy knows that my dad 's friend 's dentist 's friend 's sister is nice .	Judy helps my dad 's friend 's dentist 's friend 's sister is nice .
your friend knows that your grandmother 's mother 's friend 's grandmother 's friend is busy .	your friend scares your grandmother 's mother 's friend 's grandmother 's friend is busy .
Steve knows that your father 's grandmother 's son 's mom 's son is tired .	Steve scares your father 's grandmother 's son 's mom 's son is tired .
Julia knows that your boss 's cousin 's cousin 's boss 's mom is curious .	Julia works with your boss 's cousin 's cousin 's boss 's mom is curious .
my dentist thinks that my boss 's dentist 's mother 's wife 's mother is gentle .	my dentist talks to my boss 's dentist 's mother 's wife 's mother is gentle .
the dentist says that your grandmother 's daughter 's brother 's teacher 's brother is healthy .	the dentist talks to your grandmother 's daughter 's brother 's teacher 's brother is healthy .
my dentist knows that my teacher 's sister 's friend 's doctor 's wife is sleepy .	my dentist works with my teacher 's sister 's friend 's doctor 's wife is sleepy .
Tracy says that my sister 's daughter 's doctor 's teacher 's wife is busy .	Tracy talks to my sister 's daughter 's doctor 's teacher 's wife is busy .
Nina knows that my dad 's grandmother 's wife 's daughter 's grandmother is bored .	Nina talks to my dad 's grandmother 's wife 's daughter 's grandmother is bored .
the driver knows that my dad 's friend 's dad 's doctor 's dentist is gentle .	the driver helps my dad 's friend 's dad 's doctor 's dentist is gentle .
Vanessa says that your friend 's wife 's boss 's daughter 's boss is surprised .	Vanessa helps your friend 's wife 's boss 's daughter 's boss is surprised .
my doctor knows that your boss 's mom 's grandmother 's father 's dentist is surprised .	my doctor scares your boss 's mom 's grandmother 's father 's dentist is surprised .
Karen thinks that my cousin 's sister 's wife 's husband 's father is sleepy .	Karen works with my cousin 's sister 's wife 's husband 's father is sleepy .
the child says that your grandmother 's doctor 's wife 's mom 's son is smart .	the child talks to your grandmother 's doctor 's wife 's mom 's son is smart .
the dancer says that your cousin 's wife 's husband 's husband 's dentist is kind .	the dancer works with your cousin 's wife 's husband 's husband 's dentist is kind .
your teacher thinks that your daughter 's grandmother 's sister 's wife 's husband is boring .	your teacher scares your daughter 's grandmother 's sister 's wife 's husband is boring .
the adult says that your mom 's dentist 's doctor 's mother 's boss is smart .	the adult works with your mom 's dentist 's doctor 's mother 's boss is smart .
the person knows that my sister 's doctor 's dentist 's friend 's friend is careful .	the person works with my sister 's doctor 's dentist 's friend 's friend is careful .
Anne says that your mother 's cousin 's friend 's brother 's grandmother is kind .	Anne helps your mother 's cousin 's friend 's brother 's grandmother is kind .
the teacher thinks that my father 's brother 's cousin 's cousin 's friend is gentle .	the teacher works with my father 's brother 's cousin 's cousin 's friend is gentle .
Sarah knows that my grandmother 's mom 's mom 's sister 's father is young .	Sarah scares my grandmother 's mom 's mom 's sister 's father is young .
my dentist thinks that my grandmother 's daughter 's boss 's mom 's son is excited .	my dentist talks to my grandmother 's daughter 's boss 's mom 's son is excited .
the adult thinks that my friend 's mother 's dentist 's dad 's son is excited .	the adult scares my friend 's mother 's dentist 's dad 's son is excited .
your cousin thinks that my grandmother 's boss 's dentist 's sister 's boss is excited .	your cousin helps my grandmother 's boss 's dentist 's sister 's boss is excited .
my dentist thinks that my son 's daughter 's doctor 's boss 's mother is boring .	my dentist helps my son 's daughter 's doctor 's boss 's mother is boring .
the dentist says that your cousin 's dad 's husband 's cousin 's teacher is hungry .	the dentist talks to your cousin 's dad 's husband 's cousin 's teacher is hungry .
my boss says that your dentist 's grandmother 's grandmother 's wife 's daughter is curious .	my boss talks to your dentist 's grandmother 's grandmother 's wife 's daughter is curious .
your doctor thinks that your mom 's sister 's brother 's cousin 's cousin is strong .	your doctor helps your mom 's sister 's brother 's cousin 's cousin is strong .
Martin says that my daughter 's boss 's dad 's dad 's boss is smart .	Martin works with my daughter 's boss 's dad 's dad 's boss is smart .
the driver says that my mom 's mom 's dentist 's father 's teacher is angry .	the driver works with my mom 's mom 's dentist 's father 's teacher is angry .
my boss thinks that your teacher 's wife 's son 's cousin 's son is lucky .	my boss works with your teacher 's wife 's son 's cousin 's son is lucky .
the dentist knows that my sister 's boss 's dentist 's boss 's father is friendly .	the dentist talks to my sister 's boss 's dentist 's boss 's father is friendly .
my dentist says that your husband 's teacher 's mom 's dad 's mother is friendly .	my dentist works with your husband 's teacher 's mom 's dad 's mother is friendly .
the dancer says that your teacher 's grandmother 's son 's wife 's sister is confused .	the dancer scares your teacher 's grandmother 's son 's wife 's sister is confused .
my doctor thinks that my mom 's boss 's mother 's mother 's daughter is important .	my doctor helps my mom 's boss 's mother 's mother 's daughter is important .
your boss thinks that your daughter 's boss 's sister 's sister 's mother is kind .	your boss talks to your daughter 's boss 's sister 's sister 's mother is kind .
your doctor says that my grandmother 's boss 's father 's friend 's cousin is tall .	your doctor works with my grandmother 's boss 's father 's friend 's cousin is tall .
your teacher thinks that my mom 's friend 's wife 's son 's doctor is strong .	your teacher helps my mom 's friend 's wife 's son 's doctor is strong .
your friend thinks that your cousin 's sister 's daughter 's doctor 's father is happy .	your friend works with your cousin 's sister 's daughter 's doctor 's father is happy .
the customer knows that my husband 's doctor 's father 's son 's dad is sleepy .	the customer talks to my husband 's doctor 's father 's son 's dad is sleepy .
the patient thinks that your grandmother 's sister 's doctor 's mother 's dad is strong .	the patient talks to your grandmother 's sister 's doctor 's mother 's dad is strong .
the patient says that my brother 's dad 's dentist 's daughter 's friend is excited .	the patient works with my brother 's dad 's dentist 's daughter 's friend is excited .
the dentist says that your son 's cousin 's friend 's mother 's son is confused .	the dentist works with your son 's cousin 's friend 's mother 's son is confused .
your teacher thinks that your mother 's boss 's mom 's husband 's daughter is lucky .	your teacher helps your mother 's boss 's mom 's husband 's daughter is lucky .
the person says that your doctor 's husband 's daughter 's teacher 's father is busy .	the person talks to your doctor 's husband 's daughter 's teacher 's father is busy .
Paul thinks that my teacher 's daughter 's teacher 's brother 's father is curious .	Paul scares my teacher 's daughter 's teacher 's brother 's father is curious .
the teacher knows that my father 's friend 's daughter 's teacher 's mother is clever .	the teacher helps my father 's friend 's daughter 's teacher 's mother is clever .
the dentist knows that my sister 's wife 's brother 's sister 's friend is angry .	the dentist scares my sister 's wife 's brother 's sister 's friend is angry .
my boss thinks that my brother 's father 's dentist 's doctor 's father is gentle .	my boss works with my brother 's father 's dentist 's doctor 's father is gentle .
Aaron knows that my father 's friend 's brother 's mother 's mother is tall .	Aaron scares my father 's friend 's brother 's mother 's mother is tall .
the patient knows that your dad 's boss 's wife 's cousin 's brother is friendly .	the patient helps your dad 's boss 's wife 's cousin 's brother is friendly .
Christopher knows that your brother 's boss 's mom 's grandmother 's mother is busy .	Christopher scares your brother 's boss 's mom 's grandmother 's mother is busy .
Timothy says that my cousin 's son 's boss 's sister 's cousin is helpful .	Timothy talks to my cousin 's son 's boss 's sister 's cousin is helpful .
the teacher thinks that your husband 's sister 's daughter 's teacher 's friend is wrong .	the teacher helps your husband 's sister 's daughter 's teacher 's friend is wrong .
your teacher thinks that your daughter 's wife 's wife 's cousin 's sister is surprised .	your teacher works with your daughter 's wife 's wife 's cousin 's sister is surprised .
Wendy knows that my teacher 's brother 's son 's husband 's doctor is kind .	Wendy works with my teacher 's brother 's son 's husband 's doctor is kind .
Todd says that your father 's son 's sister 's dentist 's husband is nice .	Todd scares your father 's son 's sister 's dentist 's husband is nice .
the dancer says that my son 's daughter 's boss 's daughter 's father is important .	the dancer works with my son 's daughter 's boss 's daughter 's father is important .
the driver knows that your friend 's boss 's sister 's dentist 's dad is surprised .	the driver scares your friend 's boss 's sister 's dentist 's dad is surprised .
Wendy says that your daughter 's mom 's husband 's brother 's dentist is tall .	Wendy talks to your daughter 's mom 's husband 's brother 's dentist is tall .
the doctor thinks that your wife 's husband 's dentist 's father 's husband is smart .	the doctor scares your wife 's husband 's dentist 's father 's husband is smart .
the dancer knows that your mother 's husband 's dentist 's doctor 's dad is curious .	the dancer helps your mother 's husband 's dentist 's doctor 's dad is curious .
my friend knows that your boss 's dad 's sister 's dad 's husband is happy .	my friend scares your boss 's dad 's sister 's dad 's husband is happy .
Julie says that your brother 's sister 's father 's husband 's teacher is healthy .	Julie helps your brother 's sister 's father 's husband 's teacher is healthy .
the teacher knows that my grandmother 's teacher 's boss 's teacher 's brother is busy .	the teacher scares my grandmother 's teacher 's boss 's teacher 's brother is busy .
the dentist thinks that your cousin 's wife 's brother 's father 's father is tired .	the dentist works with your cousin 's wife 's brother 's father 's father is tired .
my boss knows that your sister 's mother 's friend 's father 's son is nice .	my boss talks to your sister 's mother 's friend 's father 's son is nice .
my doctor thinks that my son 's son 's son 's boss 's sister is important .	my doctor talks to my son 's son 's son 's boss 's sister is important .
the doctor knows that my daughter 's dentist 's son 's boss 's grandmother is excited .	the doctor talks to my daughter 's dentist 's son 's boss 's grandmother is excited .
the patient knows that your father 's husband 's friend 's son 's doctor is clever .	the patient scares your father 's husband 's friend 's son 's doctor is clever .
the adult knows that my grandmother 's teacher 's boss 's son 's brother is clever .	the adult talks to my grandmother 's teacher 's boss 's son 's brother is clever .
the customer thinks that your mother 's grandmother 's boss 's husband 's wife is angry .	the customer helps your mother 's grandmother 's boss 's husband 's wife is angry .
your friend says that your son 's brother 's wife 's wife 's cousin is curious .	your friend works with your son 's brother 's wife 's wife 's cousin is curious .
your doctor knows that your sister 's teacher 's father 's husband 's son is strong .	your doctor works with your sister 's teacher 's father 's husband 's son is strong .
Denise knows that your dad 's daughter 's mother 's dad 's teacher is clever .	Denise talks to your dad 's daughter 's mother 's dad 's teacher is clever .
my doctor says that your dentist 's dentist 's boss 's dad 's mom is surprised .	my doctor works with your dentist 's dentist 's boss 's dad 's mom is surprised .
my friend says that your dad 's sister 's cousin 's cousin 's son is hungry .	my friend helps your dad 's sister 's cousin 's cousin 's son is hungry .
the teacher knows that your son 's sister 's dad 's father 's daughter is nice .	the teacher helps your son 's sister 's dad 's father 's daughter is nice .
Melissa says that your friend 's mom 's grandmother 's father 's son is nice .	Melissa helps your friend 's mom 's grandmother 's father 's son is nice .
William knows that my teacher 's mother 's dad 's mom 's cousin is important .	William helps my teacher 's mother 's dad 's mom 's cousin is important .
the teacher says that your brother 's father 's teacher 's doctor 's doctor is young .	the teacher helps your brother 's father 's teacher 's doctor 's doctor is young .
Becky knows that your dad 's mom 's brother 's mom 's brother is hungry .	Becky works with your dad 's mom 's brother 's mom 's brother is hungry .
the doctor says that my husband 's doctor 's brother 's dentist 's wife is tall .	the doctor scares my husband 's doctor 's brother 's dentist 's wife is tall .
your cousin knows that my friend 's husband 's boss 's friend 's dentist is friendly .	your cousin helps my friend 's husband 's boss 's friend 's dentist is friendly .
the dentist knows that my daughter 's sister 's grandmother 's teacher 's boss is curious .	the dentist scares my daughter 's sister 's grandmother 's teacher 's boss is curious .
your dentist knows that my brother 's doctor 's cousin 's friend 's brother is upset .	your dentist talks to my brother 's doctor 's cousin 's friend 's brother is upset .
the patient knows that my dentist 's brother 's husband 's dad 's mother is busy .	the patient scares my dentist 's brother 's husband 's dad 's mother is busy .
the adult thinks that my cousin 's mother 's boss 's cousin 's dentist is confused .	the adult talks to my cousin 's mother 's boss 's cousin 's dentist is confused .
the driver knows that your mother 's sister 's wife 's wife 's friend is busy .	the driver scares your mother 's sister 's wife 's wife 's friend is busy .
Melissa says that your teacher 's son 's grandmother 's father 's son is quiet .	Melissa talks to your teacher 's son 's grandmother 's father 's son is quiet .
my doctor thinks that your boss 's grandmother 's grandmother 's dad 's mom is hungry .	my doctor scares your boss 's grandmother 's grandmother 's dad 's mom is hungry .
your friend knows that my cousin 's teacher 's friend 's grandmother 's sister is careful .	your friend works with my cousin 's teacher 's friend 's grandmother 's sister is careful .
the dancer thinks that your friend 's mom 's grandmother 's father 's cousin is sleepy .	the dancer helps your friend 's mom 's grandmother 's father 's cousin is sleepy .
my dentist thinks that my boss 's dad 's doctor 's husband 's brother is wrong .	my dentist talks to my boss 's dad 's doctor 's husband 's brother is wrong .
the driver thinks that your mother 's doctor 's teacher 's mom 's brother is friendly .	the driver works with your mother 's doctor 's teacher 's mom 's brother is friendly .
Anne says that your husband 's father 's father 's dad 's cousin is strong .	Anne works with your husband 's father 's father 's dad 's cousin is strong .
my friend says that your son 's daughter 's dentist 's daughter 's teacher is friendly .	my friend talks to your son 's daughter 's dentist 's daughter 's teacher is friendly .
the customer knows that my brother 's dad 's boss 's husband 's dad is friendly .	the customer scares my brother 's dad 's boss 's husband 's dad is friendly .
the dancer knows that your dentist 's mother 's boss 's cousin 's doctor is boring .	the dancer talks to your dentist 's mother 's boss 's cousin 's doctor is boring .
Anna thinks that your brother 's daughter 's son 's daughter 's dad is busy .	Anna helps your brother 's daughter 's son 's daughter 's dad is busy .
Ann knows that your wife 's brother 's teacher 's sister 's wife is nice .	Ann works with your wife 's brother 's teacher 's sister 's wife is nice .
Daniel knows that your cousin 's husband 's sister 's dentist 's boss is confused .	Daniel talks to your cousin 's husband 's sister 's dentist 's boss is confused .
your teacher says that my mother 's cousin 's boss 's son 's sister is tall .	your teacher helps my mother 's cousin 's boss 's son 's sister is tall .
Eric knows that your daughter 's friend 's daughter 's father 's dentist is busy .	Eric talks to your daughter 's friend 's daughter 's father 's dentist is busy .
Amy says that my dentist 's father 's doctor 's daughter 's mother is quiet .	Amy works with my dentist 's father 's doctor 's daughter 's mother is quiet .
the person knows that your friend 's daughter 's grandmother 's teacher 's boss is excited .	the person works with your friend 's daughter 's grandmother 's teacher 's boss is excited .
my doctor says that your dentist 's wife 's friend 's cousin 's dad is kind .	my doctor scares your dentist 's wife 's friend 's cousin 's dad is kind .
Barbara says that your wife 's daughter 's friend 's mom 's dad is tall .	Barbara scares your wife 's daughter 's friend 's mom 's dad is tall .
the patient says that your father 's brother 's doctor 's grandmother 's cousin is boring .	the patient scares your father 's brother 's doctor 's grandmother 's cousin is boring .
Linda says that your cousin 's dad 's friend 's son 's mother is important .	Linda helps your cousin 's dad 's friend 's son 's mother is important .
Sara says that my friend 's sister 's boss 's father 's sister is surprised .	Sara talks to my friend 's sister 's boss 's father 's sister is surprised .
Adam thinks that your sister 's dad 's doctor 's cousin 's grandmother is tall .	Adam works with your sister 's dad 's doctor 's cousin 's grandmother is tall .
Donald knows that my cousin 's teacher 's brother 's doctor 's mom is happy .	Donald works with my cousin 's teacher 's brother 's doctor 's mom is happy .
Steve says that your mother 's boss 's son 's dentist 's wife is young .	Steve works with your mother 's boss 's son 's dentist 's wife is young .
your cousin knows that your teacher 's husband 's boss 's father 's son is quiet .	your cousin talks to your teacher 's husband 's boss 's father 's son is quiet .
my boss knows that my husband 's doctor 's teacher 's friend 's friend is smart .	my boss works with my husband 's doctor 's teacher 's friend 's friend is smart .
the child knows that my doctor 's father 's mom 's brother 's teacher is helpful .	the child works with my doctor 's father 's mom 's brother 's teacher is helpful .
Samantha thinks that my sister 's brother 's cousin 's teacher 's daughter is quiet .	Samantha scares my sister 's brother 's cousin 's teacher 's daughter is quiet .
the teacher says that my boss 's mom 's father 's mother 's cousin is helpful .	the teacher scares my boss 's mom 's father 's mother 's cousin is helpful .
my dentist thinks that your teacher 's cousin 's dad 's dad 's cousin is confused .	my dentist scares your teacher 's cousin 's dad 's dad 's cousin is confused .
my dentist says that my husband 's brother 's dentist 's brother 's sister is quiet .	my dentist works with my husband 's brother 's dentist 's brother 's sister is quiet .
Amelia knows that your doctor 's mother 's father 's brother 's father is lucky .	Amelia helps your doctor 's mother 's father 's brother 's father is lucky .
Travis knows that my doctor 's grandmother 's brother 's grandmother 's brother is confused .	Travis scares my doctor 's grandmother 's brother 's grandmother 's brother is confused .
your cousin knows that your teacher 's grandmother 's sister 's sister 's friend is strong .	your cousin helps your teacher 's grandmother 's sister 's sister 's friend is strong .
my dentist thinks that your father 's doctor 's wife 's mother 's son is happy .	my dentist helps your father 's doctor 's wife 's mother 's son is happy .
Dan says that my boss 's sister 's father 's brother 's cousin is clever .	Dan scares my boss 's sister 's father 's brother 's cousin is clever .
your cousin knows that your friend 's boss 's mother 's wife 's sister is bored .	your cousin works with your friend 's boss 's mother 's wife 's sister is bored .
my cousin says that my grandmother 's son 's father 's dad 's doctor is important .	my cousin works with my grandmother 's son 's father 's dad 's doctor is important .
the dentist thinks that my wife 's dad 's doctor 's grandmother 's mom is friendly .	the dentist works with my wife 's dad 's doctor 's grandmother 's mom is friendly .
the dancer thinks that my sister 's grandmother 's dad 's father 's teacher is strong .	the dancer talks to my sister 's grandmother 's dad 's father 's teacher is strong .
Karen says that your teacher 's friend 's dad 's cousin 's boss is curious .	Karen works with your teacher 's friend 's dad 's cousin 's boss is curious .
the person says that my cousin 's daughter 's husband 's teacher 's daughter is happy .	the person helps my cousin 's daughter 's husband 's teacher 's daughter is happy .
Dan says that my friend 's daughter 's dentist 's father 's dad is wrong .	Dan helps my friend 's daughter 's dentist 's father 's dad is wrong .
the person knows that your teacher 's doctor 's teacher 's cousin 's brother is gentle .	the person scares your teacher 's doctor 's teacher 's cousin 's brother is gentle .
my cousin says that your friend 's grandmother 's father 's father 's friend is busy .	my cousin scares your friend 's grandmother 's father 's father 's friend is busy .
the child says that my wife 's teacher 's dentist 's daughter 's dad is clever .	the child helps my wife 's teacher 's dentist 's daughter 's dad is clever .
the driver thinks that my grandmother 's grandmother 's brother 's mother 's wife is strong .	the driver talks to my grandmother 's grandmother 's brother 's mother 's wife is strong .
Linda thinks that my son 's dad 's mom 's mother 's mom is smart .	Linda scares my son 's dad 's mom 's mother 's mom is smart .
your boss thinks that my teacher 's mother 's boss 's cousin 's cousin is bored .	your boss helps my teacher 's mother 's boss 's cousin 's cousin is bored .
Anne thinks that my brother 's boss 's father 's wife 's cousin is curious .	Anne helps my brother 's boss 's father 's wife 's cousin is curious .
the driver says that your sister 's wife 's brother 's boss 's dad is quiet .	the driver helps your sister 's wife 's brother 's boss 's dad is quiet .
my teacher knows that your dentist 's cousin 's doctor 's dentist 's son is friendly .	my teacher scares your dentist 's cousin 's doctor 's dentist 's son is friendly .
Janet says that my husband 's dentist 's teacher 's mom 's mom is important .	Janet helps my husband 's dentist 's teacher 's mom 's mom is important .
the teacher knows that your boss 's boss 's daughter 's mom 's teacher is tired .	the teacher works with your boss 's boss 's daughter 's mom 's teacher is tired .
your teacher thinks that my mother 's mom 's dad 's doctor 's son is boring .	your teacher helps my mother 's mom 's dad 's doctor 's son is boring .
Dan thinks that my friend 's dad 's brother 's boss 's daughter is tall .	Dan works with my friend 's dad 's brother 's boss 's daughter is tall .
Rachel says that my dentist 's cousin 's dentist 's dad 's boss is lucky .	Rachel scares my dentist 's cousin 's dentist 's dad 's boss is lucky .
your teacher says that my sister 's sister 's mother 's husband 's grandmother is smart .	your teacher helps my sister 's sister 's mother 's husband 's grandmother is smart .
Kevin knows that my dad 's grandmother 's son 's son 's dentist is busy .	Kevin talks to my dad 's grandmother 's son 's son 's dentist is busy .
Ronald says that your brother 's daughter 's daughter 's dad 's son is quiet .	Ronald helps your brother 's daughter 's daughter 's dad 's son is quiet .
Carol knows that my mother 's doctor 's grandmother 's cousin 's cousin is sleepy .	Carol talks to my mother 's doctor 's grandmother 's cousin 's cousin is sleepy .
Dan knows that my sister 's daughter 's mom 's brother 's father is careful .	Dan helps my sister 's daughter 's mom 's brother 's father is careful .
Frank knows that your doctor 's dentist 's daughter 's husband 's daughter is clever .	Frank scares your doctor 's dentist 's daughter 's husband 's daughter is clever .
the patient says that my mother 's teacher 's mother 's friend 's dentist is happy .	the patient helps my mother 's teacher 's mother 's friend 's dentist is happy .
the driver knows that my boss 's teacher 's doctor 's doctor 's dad is wrong .	the driver helps my boss 's teacher 's doctor 's doctor 's dad is wrong .
Ann knows that your wife 's father 's dad 's brother 's daughter is lucky .	Ann talks to your wife 's father 's dad 's brother 's daughter is lucky .
April says that my son 's grandmother 's father 's friend 's father is healthy .	April works with my son 's grandmother 's father 's friend 's father is healthy .
your dentist thinks that my teacher 's father 's dad 's brother 's friend is nice .	your dentist helps my teacher 's father 's dad 's brother 's friend is nice .
Erin knows that my doctor 's daughter 's sister 's father 's mother is smart .	Erin helps my doctor 's daughter 's sister 's father 's mother is smart .
Richard knows that my grandmother 's son 's daughter 's father 's grandmother is careful .	Richard talks to my grandmother 's son 's daughter 's father 's grandmother is careful .
the dentist knows that my brother 's teacher 's son 's husband 's brother is surprised .	the dentist scares my brother 's teacher 's son 's husband 's brother is surprised .
my dentist says that my dentist 's boss 's cousin 's wife 's sister is hungry .	my dentist helps my dentist 's boss 's cousin 's wife 's sister is hungry .
the teacher knows that my grandmother 's dad 's husband 's friend 's father is friendly .	the teacher scares my grandmother 's dad 's husband 's friend 's father is friendly .
my teacher thinks that my father 's sister 's friend 's grandmother 's friend is kind .	my teacher talks to my father 's sister 's friend 's grandmother 's friend is kind .
my boss thinks that your father 's cousin 's doctor 's father 's husband is important .	my boss works with your father 's cousin 's doctor 's father 's husband is important .
my dentist knows that your boss 's son 's daughter 's mother 's daughter is smart .	my dentist helps your boss 's son 's daughter 's mother 's daughter is smart .
the patient says that my husband 's doctor 's boss 's dentist 's wife is lucky .	the patient works with my husband 's doctor 's boss 's dentist 's wife is lucky .
your teacher thinks that your mother 's teacher 's dad 's wife 's brother is angry .	your teacher helps your mother 's teacher 's dad 's wife 's brother is angry .
Christopher knows that my mom 's son 's dentist 's sister 's father is nice .	Christopher scares my mom 's son 's dentist 's sister 's father is nice .
the child says that your father 's doctor 's mom 's boss 's mother is healthy .	the child helps your father 's doctor 's mom 's boss 's mother is healthy .
Carol knows that your teacher 's grandmother 's wife 's father 's cousin is excited .	Carol scares your teacher 's grandmother 's wife 's father 's cousin is excited .
Renee knows that my brother 's sister 's mother 's grandmother 's son is careful .	Renee scares my brother 's sister 's mother 's grandmother 's son is careful .
Kevin knows that my father 's sister 's sister 's dad 's dad is busy .	Kevin works with my father 's sister 's sister 's dad 's dad is busy .
the dancer thinks that my daughter 's father 's cousin 's boss 's teacher is friendly .	the dancer talks to my daughter 's father 's cousin 's boss 's teacher is friendly .
my dentist thinks that your dad 's teacher 's dad 's mom 's son is healthy .	my dentist scares your dad 's teacher 's dad 's mom 's son is healthy .
Marie says that your dad 's daughter 's teacher 's mom 's boss is strong .	Marie works with your dad 's daughter 's teacher 's mom 's boss is strong .
the doctor knows that my daughter 's friend 's mother 's cousin 's husband is nice .	the doctor scares my daughter 's friend 's mother 's cousin 's husband is nice .
your boss knows that my wife 's son 's son 's brother 's teacher is upset .	your boss helps my wife 's son 's son 's brother 's teacher is upset .
my cousin thinks that your mother 's cousin 's friend 's dentist 's friend is sleepy .	my cousin helps your mother 's cousin 's friend 's dentist 's friend is sleepy .
Cindy says that your brother 's mother 's brother 's father 's boss is careful .	Cindy helps your brother 's mother 's brother 's father 's boss is careful .
Eric thinks that my son 's cousin 's brother 's mother 's boss is helpful .	Eric scares my son 's cousin 's brother 's mother 's boss is helpful .
the person says that your dentist 's sister 's friend 's dad 's grandmother is tall .	the person talks to your dentist 's sister 's friend 's dad 's grandmother is tall .
the child says that my sister 's teacher 's cousin 's cousin 's doctor is upset .	the child talks to my sister 's teacher 's cousin 's cousin 's doctor is upset .
your doctor says that my sister 's boss 's teacher 's friend 's sister is bored .	your doctor talks to my sister 's boss 's teacher 's friend 's sister is bored .
the customer thinks that your doctor 's dentist 's teacher 's cousin 's sister is careful .	the customer talks to your doctor 's dentist 's teacher 's cousin 's sister is careful .
Todd knows that my friend 's teacher 's cousin 's mother 's daughter is helpful .	Todd scares my friend 's teacher 's cousin 's mother 's daughter is helpful .
your boss says that your sister 's grandmother 's sister 's dad 's sister is angry .	your boss helps your sister 's grandmother 's sister 's dad 's sister is angry .
Dan says that your wife 's doctor 's doctor 's grandmother 's dad is important .	Dan works with your wife 's doctor 's doctor 's grandmother 's dad is important .
my friend says that your dad 's grandmother 's doctor 's dad 's father is tired .	my friend talks to your dad 's grandmother 's doctor 's dad 's father is tired .
your boss says that your friend 's wife 's mom 's sister 's mom is angry .	your boss helps your friend 's wife 's mom 's sister 's mom is angry .
the customer knows that my father 's boss 's doctor 's son 's teacher is boring .	the customer helps my father 's boss 's doctor 's son 's teacher is boring .
Naomi thinks that my son 's son 's daughter 's cousin 's son is careful .	Naomi helps my son 's son 's daughter 's cousin 's son is careful .
your friend knows that my sister 's husband 's wife 's sister 's daughter is surprised .	your friend scares my sister 's husband 's wife 's sister 's daughter is surprised .
the customer thinks that your brother 's doctor 's friend 's wife 's sister is hungry .	the customer talks to your brother 's doctor 's friend 's wife 's sister is hungry .
Thomas thinks that my friend 's friend 's brother 's mom 's dentist is kind .	Thomas helps my friend 's friend 's brother 's mom 's dentist is kind .
the customer knows that your mom 's teacher 's teacher 's husband 's father is smart .	the customer talks to your mom 's teacher 's teacher 's husband 's father is smart .
my dentist says that my wife 's father 's teacher 's cousin 's sister is healthy .	my dentist works with my wife 's father 's teacher 's cousin 's sister is healthy .
the dentist thinks that your grandmother 's cousin 's wife 's dentist 's son is strong .	the dentist scares your grandmother 's cousin 's wife 's dentist 's son is strong .
Sara thinks that your dad 's husband 's daughter 's mom 's daughter is important .	Sara scares your dad 's husband 's daughter 's mom 's daughter is important .
my cousin knows that my sister 's boss 's friend 's grandmother 's brother is tall .	my cousin helps my sister 's boss 's friend 's grandmother 's brother is tall .
your teacher thinks that my boss 's husband 's doctor 's wife 's wife is gentle .	your teacher helps my boss 's husband 's doctor 's wife 's wife is gentle .
the dentist says that your wife 's dad 's wife 's mother 's brother is important .	the dentist scares your wife 's dad 's wife 's mother 's brother is important .
the driver knows that my teacher 's husband 's teacher 's sister 's friend is wrong .	the driver talks to my teacher 's husband 's teacher 's sister 's friend is wrong .
your dentist thinks that my cousin 's doctor 's brother 's wife 's doctor is tired .	your dentist scares my cousin 's doctor 's brother 's wife 's doctor is tired .
William says that your mom 's mom 's dad 's teacher 's cousin is wrong .	William talks to your mom 's mom 's dad 's teacher 's cousin is wrong .
Nancy knows that my mother 's mom 's brother 's son 's brother is lucky .	Nancy works with my mother 's mom 's brother 's son 's brother is lucky .
the patient says that your husband 's son 's daughter 's teacher 's wife is sleepy .	the patient helps your husband 's son 's daughter 's teacher 's wife is sleepy .
Kevin thinks that my teacher 's sister 's wife 's doctor 's doctor is smart .	Kevin helps my teacher 's sister 's wife 's doctor 's doctor is smart .
Timothy thinks that your mother 's grandmother 's mom 's boss 's wife is tall .	Timothy works with your mother 's grandmother 's mom 's boss 's wife is tall .
your dentist says that your husband 's friend 's daughter 's boss 's son is healthy .	your dentist works with your husband 's friend 's daughter 's boss 's son is healthy .
your boss knows that your cousin 's grandmother 's grandmother 's daughter 's father is quiet .	your boss scares your cousin 's grandmother 's grandmother 's daughter 's father is quiet .
the dancer says that your friend 's husband 's dentist 's father 's dentist is friendly .	the dancer works with your friend 's husband 's dentist 's father 's dentist is friendly .
Jennifer thinks that my cousin 's daughter 's doctor 's daughter 's boss is nice .	Jennifer scares my cousin 's daughter 's doctor 's daughter 's boss is nice .
Anne says that your teacher 's mom 's father 's cousin 's dad is wrong .	Anne helps your teacher 's mom 's father 's cousin 's dad is wrong .
Peter says that my sister 's dad 's teacher 's grandmother 's teacher is angry .	Peter scares my sister 's dad 's teacher 's grandmother 's teacher is angry .
my boss says that your brother 's teacher 's grandmother 's friend 's teacher is bored .	my boss talks to your brother 's teacher 's grandmother 's friend 's teacher is bored .
Denise knows that your mom 's grandmother 's brother 's son 's cousin is tall .	Denise talks to your mom 's grandmother 's brother 's son 's cousin is tall .
Sally says that your son 's daughter 's sister 's brother 's boss is smart .	Sally talks to your son 's daughter 's sister 's brother 's boss is smart .
Sandra says that my friend 's husband 's son 's doctor 's mother is lucky .	Sandra scares my friend 's husband 's son 's doctor 's mother is lucky .
my dentist thinks that my dad 's father 's wife 's doctor 's mother is healthy .	my dentist works with my dad 's father 's wife 's doctor 's mother is healthy .
my cousin knows that your dad 's cousin 's mom 's dad 's grandmother is kind .	my cousin talks to your dad 's cousin 's mom 's dad 's grandmother is kind .
the person says that my boss 's father 's friend 's wife 's daughter is tired .	the person helps my boss 's father 's friend 's wife 's daughter is tired .
Allison knows that my wife 's brother 's sister 's son 's husband is clever .	Allison talks to my wife 's brother 's sister 's son 's husband is clever .
Rebecca thinks that your dentist 's mom 's brother 's friend 's sister is important .	Rebecca helps your dentist 's mom 's brother 's friend 's sister is important .
Adam thinks that your brother 's sister 's daughter 's husband 's daughter is confused .	Adam helps your brother 's sister 's daughter 's husband 's daughter is confused .
the adult thinks that my brother 's doctor 's cousin 's husband 's friend is excited .	the adult helps my brother 's doctor 's cousin 's husband 's friend is excited .
the teacher knows that my boss 's mom 's friend 's father 's boss is bored .	the teacher works with my boss 's mom 's friend 's father 's boss is bored .
April knows that my boss 's cousin 's doctor 's boss 's husband is angry .	April talks to my boss 's cousin 's doctor 's boss 's husband is angry .
your dentist knows that your boss 's sister 's husband 's brother 's teacher is upset .	your dentist helps your boss 's sister 's husband 's brother 's teacher is upset .
Lisa thinks that your dad 's husband 's mom 's doctor 's brother is busy .	Lisa scares your dad 's husband 's mom 's doctor 's brother is busy .
your doctor thinks that my boss 's husband 's husband 's cousin 's sister is nice .	your doctor helps my boss 's husband 's husband 's cousin 's sister is nice .
the adult thinks that my husband 's wife 's cousin 's brother 's son is wrong .	the adult scares my husband 's wife 's cousin 's brother 's son is wrong .
my boss knows that my dentist 's sister 's daughter 's husband 's father is tall .	my boss scares my dentist 's sister 's daughter 's husband 's father is tall .
the teacher thinks that my teacher 's wife 's doctor 's cousin 's friend is quiet .	the teacher talks to my teacher 's wife 's doctor 's cousin 's friend is quiet .
the teacher thinks that your brother 's friend 's cousin 's grandmother 's cousin is sleepy .	the teacher helps your brother 's friend 's cousin 's grandmother 's cousin is sleepy .
my dentist thinks that my mother 's wife 's sister 's friend 's grandmother is happy .	my dentist scares my mother 's wife 's sister 's friend 's grandmother is happy .
my doctor thinks that my mom 's friend 's brother 's mom 's grandmother is helpful .	my doctor scares my mom 's friend 's brother 's mom 's grandmother is helpful .
Andrew says that my sister 's brother 's mother 's sister 's brother is excited .	Andrew works with my sister 's brother 's mother 's sister 's brother is excited .
Michelle thinks that your teacher 's brother 's grandmother 's doctor 's sister is wrong .	Michelle works with your teacher 's brother 's grandmother 's doctor 's sister is wrong .
my doctor thinks that your dentist 's husband 's mother 's husband 's mom is happy .	my doctor works with your dentist 's husband 's mother 's husband 's mom is happy .
Jessica says that my daughter 's dad 's dad 's daughter 's mom is quiet .	Jessica scares my daughter 's dad 's dad 's daughter 's mom is quiet .
Samantha knows that your brother 's dad 's wife 's teacher 's brother is strong .	Samantha scares your brother 's dad 's wife 's teacher 's brother is strong .
my doctor knows that my dentist 's friend 's mother 's brother 's teacher is nice .	my doctor talks to my dentist 's friend 's mother 's brother 's teacher is nice .
the customer says that your wife 's mom 's cousin 's husband 's daughter is quiet .	the customer talks to your wife 's mom 's cousin 's husband 's daughter is quiet .
the driver thinks that your friend 's father 's daughter 's mother 's friend is lucky .	the driver helps your friend 's father 's daughter 's mother 's friend is lucky .
Wendy thinks that my cousin 's mother 's friend 's daughter 's grandmother is smart .	Wendy works with my cousin 's mother 's friend 's daughter 's grandmother is smart .
my boss knows that your mother 's father 's doctor 's mom 's mom is important .	my boss scares your mother 's father 's doctor 's mom 's mom is important .
Rebecca knows that my mother 's teacher 's dentist 's doctor 's boss is tired .	Rebecca scares my mother 's teacher 's dentist 's doctor 's boss is tired .
the customer thinks that my brother 's father 's brother 's grandmother 's doctor is young .	the customer helps my brother 's father 's brother 's grandmother 's doctor is young .
my cousin thinks that my cousin 's mother 's husband 's cousin 's brother is friendly .	my cousin talks to my cousin 's mother 's husband 's cousin 's brother is friendly .
the doctor thinks that your cousin 's dentist 's cousin 's boss 's mom is upset .	the doctor talks to your cousin 's dentist 's cousin 's boss 's mom is upset .
your friend says that my teacher 's mom 's teacher 's mom 's brother is young .	your friend works with my teacher 's mom 's teacher 's mom 's brother is young .
the adult thinks that your daughter 's father 's cousin 's sister 's husband is careful .	the adult talks to your daughter 's father 's cousin 's sister 's husband is careful .
Judy knows that my husband 's wife 's cousin 's sister 's doctor is gentle .	Judy scares my husband 's wife 's cousin 's sister 's doctor is gentle .
the dancer knows that my son 's dentist 's son 's father 's mom is curious .	the dancer scares my son 's dentist 's son 's father 's mom is curious .
the teacher thinks that your grandmother 's friend 's dad 's sister 's sister is upset .	the teacher scares your grandmother 's friend 's dad 's sister 's sister is upset .
Becky says that my dentist 's son 's cousin 's cousin 's brother is confused .	Becky talks to my dentist 's son 's cousin 's cousin 's brother is confused .
Michael thinks that your father 's dad 's mother 's son 's mother is healthy .	Michael works with your father 's dad 's mother 's son 's mother is healthy .
your cousin knows that my cousin 's boss 's dentist 's mom 's boss is happy .	your cousin works with my cousin 's boss 's dentist 's mom 's boss is happy .
Todd says that your wife 's doctor 's boss 's mother 's daughter is wrong .	Todd scares your wife 's doctor 's boss 's mother 's daughter is wrong .
the person knows that my father 's boss 's mom 's sister 's dentist is gentle .	the person talks to my father 's boss 's mom 's sister 's dentist is gentle .
the customer says that your cousin 's teacher 's daughter 's brother 's sister is nice .	the customer works with your cousin 's teacher 's daughter 's brother 's sister is nice .
Lisa says that my father 's cousin 's dentist 's sister 's wife is kind .	Lisa talks to my father 's cousin 's dentist 's sister 's wife is kind .
the dancer thinks that your teacher 's mother 's boss 's doctor 's teacher is strong .	the dancer helps your teacher 's mother 's boss 's doctor 's teacher is strong .
my friend knows that my grandmother 's husband 's wife 's grandmother 's grandmother is hungry .	my friend works with my grandmother 's husband 's wife 's grandmother 's grandmother is hungry .
the doctor says that your dad 's mom 's teacher 's brother 's mom is busy .	the doctor scares your dad 's mom 's teacher 's brother 's mom is busy .
the customer thinks that your doctor 's dad 's brother 's boss 's mother is young .	the customer talks to your doctor 's dad 's brother 's boss 's mother is young .
my dentist thinks that your teacher 's grandmother 's brother 's boss 's husband is happy .	my dentist scares your teacher 's grandmother 's brother 's boss 's husband is happy .
Julia knows that my dad 's boss 's dentist 's husband 's doctor is excited .	Julia scares my dad 's boss 's dentist 's husband 's doctor is excited .
Becca thinks that your dentist 's father 's doctor 's brother 's boss is tired .	Becca scares your dentist 's father 's doctor 's brother 's boss is tired .
Jerry knows that my husband 's son 's doctor 's cousin 's mother is gentle .	Jerry works with my husband 's son 's doctor 's cousin 's mother is gentle .
the child thinks that my son 's boss 's cousin 's doctor 's dentist is bored .	the child helps my son 's boss 's cousin 's doctor 's dentist is bored .
Jessica thinks that my son 's grandmother 's daughter 's dentist 's grandmother is young .	Jessica helps my son 's grandmother 's daughter 's dentist 's grandmother is young .
my doctor knows that your dentist 's dad 's sister 's brother 's daughter is tall .	my doctor scares your dentist 's dad 's sister 's brother 's daughter is tall .
my cousin says that your brother 's dad 's father 's husband 's friend is curious .	my cousin helps your brother 's dad 's father 's husband 's friend is curious .
your friend says that my friend 's dentist 's brother 's mom 's grandmother is nice .	your friend scares my friend 's dentist 's brother 's mom 's grandmother is nice .
my teacher thinks that your mom 's dad 's teacher 's teacher 's dad is young .	my teacher scares your mom 's dad 's teacher 's teacher 's dad is young .
the person says that my mother 's mom 's husband 's boss 's doctor is kind .	the person talks to my mother 's mom 's husband 's boss 's doctor is kind .
Frank thinks that your son 's wife 's boss 's doctor 's daughter is surprised .	Frank helps your son 's wife 's boss 's doctor 's daughter is surprised .
Nicole says that my doctor 's mother 's teacher 's daughter 's teacher is tired .	Nicole talks to my doctor 's mother 's teacher 's daughter 's teacher is tired .
the dentist knows that your daughter 's sister 's dad 's sister 's daughter is hungry .	the dentist works with your daughter 's sister 's dad 's sister 's daughter is hungry .
my doctor knows that your grandmother 's father 's husband 's cousin 's friend is hungry .	my doctor works with your grandmother 's father 's husband 's cousin 's friend is hungry .
Judy knows that your son 's teacher 's father 's dad 's teacher is excited .	Judy talks to your son 's teacher 's father 's dad 's teacher is excited .
Elizabeth says that my dentist 's sister 's father 's cousin 's mother is curious .	Elizabeth works with my dentist 's sister 's father 's cousin 's mother is curious .
the dentist knows that my friend 's boss 's brother 's grandmother 's mom is hungry .	the dentist talks to my friend 's boss 's brother 's grandmother 's mom is hungry .
the doctor knows that my teacher 's mother 's father 's boss 's dentist is young .	the doctor helps my teacher 's mother 's father 's boss 's dentist is young .
Leslie knows that your daughter 's mother 's daughter 's mother 's husband is important .	Leslie talks to your daughter 's mother 's daughter 's mother 's husband is important .
the dentist knows that your dad 's brother 's sister 's mom 's father is healthy .	the dentist helps your dad 's brother 's sister 's mom 's father is healthy .
Amelia knows that your friend 's dad 's mother 's husband 's boss is sleepy .	Amelia scares your friend 's dad 's mother 's husband 's boss is sleepy .
the teacher thinks that my grandmother 's father 's son 's boss 's husband is helpful .	the teacher works with my grandmother 's father 's son 's boss 's husband is helpful .
the person says that your grandmother 's teacher 's dentist 's mom 's sister is lucky .	the person helps your grandmother 's teacher 's dentist 's mom 's sister is lucky .
George knows that your sister 's teacher 's husband 's teacher 's daughter is busy .	George works with your sister 's teacher 's husband 's teacher 's daughter is busy .
my dentist thinks that your doctor 's son 's dad 's wife 's wife is boring .	my dentist works with your doctor 's son 's dad 's wife 's wife is boring .
the doctor says that your dentist 's teacher 's mom 's daughter 's daughter is wrong .	the doctor helps your dentist 's teacher 's mom 's daughter 's daughter is wrong .
my dentist knows that your son 's boss 's grandmother 's brother 's cousin is gentle .	my dentist scares your son 's boss 's grandmother 's brother 's cousin is gentle .
Amy says that my doctor 's doctor 's wife 's daughter 's dad is friendly .	Amy scares my doctor 's doctor 's wife 's daughter 's dad is friendly .
your friend says that my father 's boss 's wife 's father 's wife is confused .	your friend helps my father 's boss 's wife 's father 's wife is confused .
the patient thinks that my dentist 's son 's son 's grandmother 's son is bored .	the patient scares my dentist 's son 's son 's grandmother 's son is bored .
my teacher says that my mother 's dentist 's mother 's daughter 's husband is surprised .	my teacher talks to my mother 's dentist 's mother 's daughter 's husband is surprised .
the driver knows that your grandmother 's doctor 's sister 's dentist 's teacher is smart .	the driver works with your grandmother 's doctor 's sister 's dentist 's teacher is smart .
my teacher knows that my wife 's husband 's doctor 's husband 's mother is happy .	my teacher talks to my wife 's husband 's doctor 's husband 's mother is happy .
Laura knows that my teacher 's dentist 's father 's daughter 's father is wrong .	Laura helps my teacher 's dentist 's father 's daughter 's father is wrong .
my doctor knows that my son 's mom 's friend 's mom 's father is careful .	my doctor talks to my son 's mom 's friend 's mom 's father is careful .
your doctor knows that your teacher 's dad 's sister 's brother 's sister is sleepy .	your doctor helps your teacher 's dad 's sister 's brother 's sister is sleepy .
Laurie thinks that my daughter 's boss 's husband 's son 's dentist is wrong .	Laurie talks to my daughter 's boss 's husband 's son 's dentist is wrong .
Jessica thinks that your mother 's mom 's mother 's mother 's doctor is young .	Jessica helps your mother 's mom 's mother 's mother 's doctor is young .
Jill knows that your husband 's mom 's wife 's wife 's brother is quiet .	Jill helps your husband 's mom 's wife 's wife 's brother is quiet .
Martin says that your sister 's brother 's mom 's grandmother 's boss is clever .	Martin talks to your sister 's brother 's mom 's grandmother 's boss is clever .
my teacher knows that my friend 's cousin 's mother 's dentist 's wife is angry .	my teacher talks to my friend 's cousin 's mother 's dentist 's wife is angry .
Jerry says that my dad 's boss 's doctor 's friend 's daughter is young .	Jerry scares my dad 's boss 's doctor 's friend 's daughter is young .
Kristen knows that your friend 's friend 's brother 's dad 's daughter is bored .	Kristen scares your friend 's friend 's brother 's dad 's daughter is bored .
your dentist says that your mother 's dad 's father 's grandmother 's mom is bored .	your dentist talks to your mother 's dad 's father 's grandmother 's mom is bored .
Sara knows that my mother 's son 's cousin 's wife 's wife is angry .	Sara works with my mother 's son 's cousin 's wife 's wife is angry .
the adult knows that my mom 's cousin 's mom 's mother 's friend is gentle .	the adult works with my mom 's cousin 's mom 's mother 's friend is gentle .
the teacher knows that your brother 's daughter 's grandmother 's wife 's doctor is upset .	the teacher helps your brother 's daughter 's grandmother 's wife 's doctor is upset .
Dan knows that your husband 's boss 's father 's son 's cousin is angry .	Dan scares your husband 's boss 's father 's son 's cousin is angry .
Amy thinks that my dad 's mother 's cousin 's friend 's brother is smart .	Amy helps my dad 's mother 's cousin 's friend 's brother is smart .
the dentist knows that your brother 's mother 's dentist 's doctor 's wife is helpful .	the dentist works with your brother 's mother 's dentist 's doctor 's wife is helpful .
the teacher knows that your mother 's teacher 's dentist 's friend 's dentist is careful .	the teacher helps your mother 's teacher 's dentist 's friend 's dentist is careful .
the dancer knows that your daughter 's grandmother 's grandmother 's mom 's grandmother is important .	the dancer talks to your daughter 's grandmother 's grandmother 's mom 's grandmother is important .
my friend knows that my mother 's wife 's sister 's friend 's mother is nice .	my friend works with my mother 's wife 's sister 's friend 's mother is nice .
my boss says that my son 's grandmother 's dad 's friend 's cousin is clever .	my boss works with my son 's grandmother 's dad 's friend 's cousin is clever .
the adult thinks that your dentist 's mother 's brother 's cousin 's husband is nice .	the adult works with your dentist 's mother 's brother 's cousin 's husband is nice .
Paul says that my grandmother 's father 's father 's daughter 's friend is busy .	Paul works with my grandmother 's father 's father 's daughter 's friend is busy .
the dancer thinks that your brother 's cousin 's father 's doctor 's mom is quiet .	the dancer scares your brother 's cousin 's father 's doctor 's mom is quiet .
Anne says that your sister 's mother 's dad 's father 's husband is kind .	Anne helps your sister 's mother 's dad 's father 's husband is kind .
Bill thinks that my father 's cousin 's husband 's mother 's mom is healthy .	Bill works with my father 's cousin 's husband 's mother 's mom is healthy .
your cousin knows that your brother 's boss 's cousin 's son 's grandmother is smart .	your cousin works with your brother 's boss 's cousin 's son 's grandmother is smart .
the dancer says that my wife 's doctor 's dad 's cousin 's dentist is tall .	the dancer talks to my wife 's doctor 's dad 's cousin 's dentist is tall .
Richard says that my cousin 's father 's daughter 's mom 's husband is gentle .	Richard scares my cousin 's father 's daughter 's mom 's husband is gentle .
the driver thinks that my doctor 's boss 's mom 's grandmother 's dentist is young .	the driver helps my doctor 's boss 's mom 's grandmother 's dentist is young .
my dentist says that your dad 's mother 's dentist 's cousin 's mom is careful .	my dentist talks to your dad 's mother 's dentist 's cousin 's mom is careful .
my teacher thinks that my father 's wife 's sister 's sister 's teacher is excited .	my teacher works with my father 's wife 's sister 's sister 's teacher is excited .
your doctor says that your daughter 's grandmother 's boss 's son 's mother is bored .	your doctor works with your daughter 's grandmother 's boss 's son 's mother is bored .
the adult knows that your wife 's cousin 's mother 's friend 's husband is tall .	the adult talks to your wife 's cousin 's mother 's friend 's husband is tall .
my boss knows that my daughter 's wife 's mother 's doctor 's dad is curious .	my boss helps my daughter 's wife 's mother 's doctor 's dad is curious .
the patient says that your husband 's grandmother 's mother 's doctor 's husband is lucky .	the patient scares your husband 's grandmother 's mother 's doctor 's husband is lucky .
William knows that my friend 's boss 's grandmother 's dentist 's dentist is young .	William talks to my friend 's boss 's grandmother 's dentist 's dentist is young .
Becky knows that my brother 's husband 's mom 's teacher 's brother is hungry .	Becky works with my brother 's husband 's mom 's teacher 's brother is hungry .
Susan thinks that my sister 's son 's sister 's mother 's mom is smart .	Susan talks to my sister 's son 's sister 's mother 's mom is smart .
the teacher says that your friend 's mom 's boss 's grandmother 's boss is careful .	the teacher helps your friend 's mom 's boss 's grandmother 's boss is careful .
my cousin says that your mom 's boss 's son 's mother 's friend is busy .	my cousin works with your mom 's boss 's son 's mother 's friend is busy .
your boss says that your wife 's mom 's husband 's mom 's mom is quiet .	your boss helps your wife 's mom 's husband 's mom 's mom is quiet .
your doctor says that my teacher 's son 's sister 's dad 's dad is tired .	your doctor helps my teacher 's son 's sister 's dad 's dad is tired .
your friend says that my brother 's son 's mom 's son 's mom is quiet .	your friend scares my brother 's son 's mom 's son 's mom is quiet .
the dancer thinks that my sister 's grandmother 's dad 's doctor 's teacher is hungry .	the dancer works with my sister 's grandmother 's dad 's doctor 's teacher is hungry .
my teacher says that my brother 's daughter 's doctor 's father 's son is bored .	my teacher scares my brother 's daughter 's doctor 's father 's son is bored .
Cindy knows that your sister 's mother 's husband 's dentist 's wife is important .	Cindy helps your sister 's mother 's husband 's dentist 's wife is important .
your boss knows that your dentist 's teacher 's dentist 's son 's mom is helpful .	your boss works with your dentist 's teacher 's dentist 's son 's mom is helpful .
your doctor says that my dad 's friend 's boss 's teacher 's friend is lucky .	your doctor works with my dad 's friend 's boss 's teacher 's friend is lucky .
the customer knows that my dad 's mother 's mom 's dentist 's father is upset .	the customer talks to my dad 's mother 's mom 's dentist 's father is upset .
your dentist knows that your brother 's mother 's mom 's wife 's brother is lucky .	your dentist scares your brother 's mother 's mom 's wife 's brother is lucky .
my teacher thinks that my husband 's sister 's grandmother 's teacher 's boss is busy .	my teacher talks to my husband 's sister 's grandmother 's teacher 's boss is busy .
Aaron knows that your mother 's doctor 's daughter 's friend 's teacher is clever .	Aaron helps your mother 's doctor 's daughter 's friend 's teacher is clever .
the teacher says that your boss 's husband 's wife 's teacher 's father is confused .	the teacher talks to your boss 's husband 's wife 's teacher 's father is confused .
your friend thinks that my friend 's sister 's dentist 's boss 's sister is important .	your friend talks to my friend 's sister 's dentist 's boss 's sister is important .
my friend thinks that my grandmother 's cousin 's husband 's dad 's mom is tall .	my friend helps my grandmother 's cousin 's husband 's dad 's mom is tall .
Todd says that your boss 's mom 's mother 's dad 's dad is excited .	Todd works with your boss 's mom 's mother 's dad 's dad is excited .
Richard knows that your father 's sister 's dad 's father 's daughter is careful .	Richard scares your father 's sister 's dad 's father 's daughter is careful .
the child thinks that my dad 's husband 's wife 's cousin 's dentist is healthy .	the child scares my dad 's husband 's wife 's cousin 's dentist is healthy .
the doctor knows that my dad 's friend 's teacher 's daughter 's brother is friendly .	the doctor works with my dad 's friend 's teacher 's daughter 's brother is friendly .
the patient thinks that my mother 's cousin 's mom 's dad 's cousin is friendly .	the patient helps my mother 's cousin 's mom 's dad 's cousin is friendly .
the person thinks that my friend 's dentist 's friend 's dentist 's doctor is angry .	the person scares my friend 's dentist 's friend 's dentist 's doctor is angry .
Steven thinks that your dentist 's friend 's husband 's boss 's wife is friendly .	Steven works with your dentist 's friend 's husband 's boss 's wife is friendly .
the adult says that my daughter 's grandmother 's daughter 's daughter 's sister is happy .	the adult scares my daughter 's grandmother 's daughter 's daughter 's sister is happy .
the doctor knows that my doctor 's wife 's husband 's father 's sister is tall .	the doctor talks to my doctor 's wife 's husband 's father 's sister is tall .
your boss knows that your wife 's doctor 's mother 's mother 's husband is sleepy .	your boss helps your wife 's doctor 's mother 's mother 's husband is sleepy .
the doctor thinks that your mother 's teacher 's husband 's mother 's husband is surprised .	the doctor helps your mother 's teacher 's husband 's mother 's husband is surprised .
Susan knows that my daughter 's father 's father 's boss 's doctor is quiet .	Susan scares my daughter 's father 's father 's boss 's doctor is quiet .
your teacher says that my teacher 's daughter 's husband 's mom 's son is confused .	your teacher helps my teacher 's daughter 's husband 's mom 's son is confused .
the dancer thinks that your brother 's friend 's son 's wife 's friend is wrong .	the dancer works with your brother 's friend 's son 's wife 's friend is wrong .
Frank says that my son 's teacher 's father 's sister 's boss is strong .	Frank scares my son 's teacher 's father 's sister 's boss is strong .
Judy says that your brother 's father 's mother 's brother 's doctor is careful .	Judy talks to your brother 's father 's mother 's brother 's doctor is careful .
your doctor says that your teacher 's husband 's husband 's sister 's boss is nice .	your doctor helps your teacher 's husband 's husband 's sister 's boss is nice .
the person knows that my husband 's father 's doctor 's dad 's husband is angry .	the person works with my husband 's father 's doctor 's dad 's husband is angry .
the driver says that your father 's boss 's mom 's mom 's grandmother is healthy .	the driver helps your father 's boss 's mom 's mom 's grandmother is healthy .
my friend thinks that my mom 's daughter 's mother 's mother 's sister is happy .	my friend talks to my mom 's daughter 's mother 's mother 's sister is happy .
the child says that my boss 's father 's daughter 's friend 's wife is lucky .	the child helps my boss 's father 's daughter 's friend 's wife is lucky .
my teacher knows that my brother 's sister 's grandmother 's mom 's cousin is friendly .	my teacher scares my brother 's sister 's grandmother 's mom 's cousin is friendly .
the person says that my teacher 's wife 's dentist 's teacher 's teacher is confused .	the person scares my teacher 's wife 's dentist 's teacher 's teacher is confused .
the teacher says that my sister 's grandmother 's son 's husband 's friend is upset .	the teacher talks to my sister 's grandmother 's son 's husband 's friend is upset .
the dentist knows that your dad 's daughter 's teacher 's husband 's husband is kind .	the dentist helps your dad 's daughter 's teacher 's husband 's husband is kind .
my teacher knows that your brother 's grandmother 's husband 's dentist 's wife is kind .	my teacher talks to your brother 's grandmother 's husband 's dentist 's wife is kind .
the teacher says that my friend 's husband 's wife 's mother 's sister is helpful .	the teacher talks to my friend 's husband 's wife 's mother 's sister is helpful .
the doctor thinks that my son 's father 's friend 's friend 's sister is clever .	the doctor talks to my son 's father 's friend 's friend 's sister is clever .
the dentist says that my sister 's cousin 's friend 's cousin 's dad is upset .	the dentist works with my sister 's cousin 's friend 's cousin 's dad is upset .
your teacher thinks that your boss 's daughter 's daughter 's brother 's friend is quiet .	your teacher talks to your boss 's daughter 's daughter 's brother 's friend is quiet .
the person says that my teacher 's wife 's grandmother 's daughter 's grandmother is tall .	the person helps my teacher 's wife 's grandmother 's daughter 's grandmother is tall .
the driver says that my brother 's brother 's father 's doctor 's wife is angry .	the driver scares my brother 's brother 's father 's doctor 's wife is angry .
the adult says that my brother 's sister 's mother 's brother 's mother is busy .	the adult works with my brother 's sister 's mother 's brother 's mother is busy .
Anne says that my mom 's friend 's daughter 's wife 's wife is wrong .	Anne works with my mom 's friend 's daughter 's wife 's wife is wrong .
the adult thinks that my mother 's cousin 's dad 's son 's sister is busy .	the adult helps my mother 's cousin 's dad 's son 's sister is busy .
my friend thinks that my dad 's teacher 's friend 's father 's doctor is nice .	my friend works with my dad 's teacher 's friend 's father 's doctor is nice .
Donald says that my daughter 's husband 's father 's son 's father is nice .	Donald helps my daughter 's husband 's father 's son 's father is nice .
your dentist thinks that your sister 's wife 's wife 's wife 's husband is busy .	your dentist works with your sister 's wife 's wife 's wife 's husband is busy .
the patient thinks that my father 's teacher 's father 's dentist 's dentist is excited .	the patient talks to my father 's teacher 's father 's dentist 's dentist is excited .
Kevin knows that my mother 's grandmother 's wife 's sister 's boss is quiet .	Kevin works with my mother 's grandmother 's wife 's sister 's boss is quiet .
your teacher says that my mom 's boss 's daughter 's boss 's friend is tired .	your teacher scares my mom 's boss 's daughter 's boss 's friend is tired .
my dentist knows that your daughter 's boss 's teacher 's sister 's dentist is lucky .	my dentist talks to your daughter 's boss 's teacher 's sister 's dentist is lucky .
the patient thinks that your son 's friend 's daughter 's son 's mom is sleepy .	the patient works with your son 's friend 's daughter 's son 's mom is sleepy .
my boss thinks that your grandmother 's dad 's mom 's husband 's mother is surprised .	my boss works with your grandmother 's dad 's mom 's husband 's mother is surprised .
my cousin thinks that my daughter 's husband 's doctor 's teacher 's mother is tall .	my cousin works with my daughter 's husband 's doctor 's teacher 's mother is tall .
the patient thinks that your father 's doctor 's husband 's dad 's dentist is healthy .	the patient helps your father 's doctor 's husband 's dad 's dentist is healthy .
the dentist says that my daughter 's father 's boss 's cousin 's father is hungry .	the dentist works with my daughter 's father 's boss 's cousin 's father is hungry .
Sandra thinks that your daughter 's dad 's mother 's friend 's grandmother is boring .	Sandra scares your daughter 's dad 's mother 's friend 's grandmother is boring .
my dentist thinks that my dentist 's wife 's husband 's friend 's father is wrong .	my dentist scares my dentist 's wife 's husband 's friend 's father is wrong .
Catherine says that your daughter 's doctor 's mom 's doctor 's dentist is kind .	Catherine talks to your daughter 's doctor 's mom 's doctor 's dentist is kind .
Barbara thinks that your mom 's brother 's teacher 's daughter 's teacher is tired .	Barbara helps your mom 's brother 's teacher 's daughter 's teacher is tired .
Ann knows that your brother 's doctor 's doctor 's mother 's mother is confused .	Ann talks to your brother 's doctor 's doctor 's mother 's mother is confused .
the doctor says that my mother 's friend 's son 's son 's mom is careful .	the doctor helps my mother 's friend 's son 's son 's mom is careful .
your cousin thinks that your cousin 's husband 's boss 's brother 's brother is important .	your cousin scares your cousin 's husband 's boss 's brother 's brother is important .
Brett knows that my friend 's mother 's grandmother 's dad 's dentist is helpful .	Brett works with my friend 's mother 's grandmother 's dad 's dentist is helpful .
the teacher thinks that your cousin 's wife 's dentist 's cousin 's brother is boring .	the teacher helps your cousin 's wife 's dentist 's cousin 's brother is boring .
your boss knows that your brother 's grandmother 's sister 's daughter 's husband is wrong .	your boss works with your brother 's grandmother 's sister 's daughter 's husband is wrong .
your cousin thinks that my mom 's boss 's friend 's mom 's sister is quiet .	your cousin talks to my mom 's boss 's friend 's mom 's sister is quiet .
Nancy thinks that your mom 's mom 's doctor 's dentist 's dentist is happy .	Nancy helps your mom 's mom 's doctor 's dentist 's dentist is happy .
my friend says that my doctor 's boss 's doctor 's mom 's brother is tired .	my friend talks to my doctor 's boss 's doctor 's mom 's brother is tired .
your boss says that my grandmother 's sister 's cousin 's wife 's boss is important .	your boss scares my grandmother 's sister 's cousin 's wife 's boss is important .
Allison says that my friend 's cousin 's dentist 's sister 's wife is gentle .	Allison scares my friend 's cousin 's dentist 's sister 's wife is gentle .
Sandra says that my mom 's mother 's grandmother 's dad 's daughter is important .	Sandra works with my mom 's mother 's grandmother 's dad 's daughter is important .
your boss knows that my mom 's boss 's mom 's mom 's doctor is busy .	your boss works with my mom 's boss 's mom 's mom 's doctor is busy .
the doctor says that your daughter 's sister 's brother 's friend 's grandmother is gentle .	the doctor talks to your daughter 's sister 's brother 's friend 's grandmother is gentle .
the adult knows that my doctor 's brother 's friend 's dad 's dentist is careful .	the adult talks to my doctor 's brother 's friend 's dad 's dentist is careful .
the driver says that my cousin 's cousin 's friend 's brother 's daughter is bored .	the driver scares my cousin 's cousin 's friend 's brother 's daughter is bored .
my dentist says that your son 's mom 's mother 's boss 's teacher is smart .	my dentist scares your son 's mom 's mother 's boss 's teacher is smart .
your boss thinks that your mother 's grandmother 's daughter 's husband 's son is smart .	your boss helps your mother 's grandmother 's daughter 's husband 's son is smart .
your dentist says that my mom 's wife 's mother 's teacher 's wife is tall .	your dentist works with my mom 's wife 's mother 's teacher 's wife is tall .
Nina says that my mom 's mother 's son 's sister 's sister is surprised .	Nina helps my mom 's mother 's son 's sister 's sister is surprised .
the child says that your sister 's son 's wife 's boss 's father is tired .	the child works with your sister 's son 's wife 's boss 's father is tired .
the dancer knows that my mother 's cousin 's sister 's dad 's father is curious .	the dancer works with my mother 's cousin 's sister 's dad 's father is curious .
the dentist thinks that your husband 's boss 's mother 's sister 's teacher is sleepy .	the dentist helps your husband 's boss 's mother 's sister 's teacher is sleepy .
your dentist thinks that your brother 's daughter 's husband 's mom 's doctor is gentle .	your dentist helps your brother 's daughter 's husband 's mom 's doctor is gentle .
your boss thinks that your father 's wife 's friend 's mother 's cousin is nice .	your boss scares your father 's wife 's friend 's mother 's cousin is nice .
Nicole thinks that my friend 's daughter 's friend 's son 's cousin is upset .	Nicole scares my friend 's daughter 's friend 's son 's cousin is upset .
Naomi knows that your grandmother 's cousin 's mother 's dentist 's husband is important .	Naomi scares your grandmother 's cousin 's mother 's dentist 's husband is important .
Jane thinks that your grandmother 's boss 's brother 's teacher 's boss is surprised .	Jane scares your grandmother 's boss 's brother 's teacher 's boss is surprised .
my doctor says that my sister 's daughter 's mom 's sister 's husband is gentle .	my doctor talks to my sister 's daughter 's mom 's sister 's husband is gentle .
the patient thinks that your father 's sister 's friend 's son 's boss is careful .	the patient talks to your father 's sister 's friend 's son 's boss is careful .
my friend thinks that your son 's grandmother 's mom 's doctor 's teacher is nice .	my friend talks to your son 's grandmother 's mom 's doctor 's teacher is nice .
Donald says that my wife 's husband 's son 's dentist 's mother is tall .	Donald scares my wife 's husband 's son 's dentist 's mother is tall .
Daniel thinks that my doctor 's son 's wife 's brother 's brother is smart .	Daniel works with my doctor 's son 's wife 's brother 's brother is smart .
Todd thinks that your doctor 's dad 's father 's boss 's mom is happy .	Todd helps your doctor 's dad 's father 's boss 's mom is happy .
the child says that my friend 's husband 's grandmother 's father 's teacher is confused .	the child talks to my friend 's husband 's grandmother 's father 's teacher is confused .
my teacher thinks that your sister 's daughter 's wife 's wife 's dentist is curious .	my teacher works with your sister 's daughter 's wife 's wife 's dentist is curious .
your cousin knows that your doctor 's friend 's dentist 's son 's son is sleepy .	your cousin helps your doctor 's friend 's dentist 's son 's son is sleepy .
the patient knows that your dentist 's dad 's doctor 's father 's husband is gentle .	the patient helps your dentist 's dad 's doctor 's father 's husband is gentle .
Thomas knows that your son 's dad 's brother 's boss 's dentist is angry .	Thomas talks to your son 's dad 's brother 's boss 's dentist is angry .
your friend says that your dentist 's friend 's teacher 's mother 's dad is nice .	your friend talks to your dentist 's friend 's teacher 's mother 's dad is nice .
your doctor knows that your sister 's son 's dad 's mom 's mother is angry .	your doctor works with your sister 's son 's dad 's mom 's mother is angry .
my cousin says that my son 's mother 's wife 's husband 's sister is smart .	my cousin helps my son 's mother 's wife 's husband 's sister is smart .
Amelia says that my friend 's grandmother 's dad 's father 's brother is angry .	Amelia scares my friend 's grandmother 's dad 's father 's brother is angry .
the patient says that your daughter 's father 's friend 's dentist 's mom is helpful .	the patient talks to your daughter 's father 's friend 's dentist 's mom is helpful .
Amy says that my grandmother 's mother 's boss 's wife 's grandmother is sleepy .	Amy helps my grandmother 's mother 's boss 's wife 's grandmother is sleepy .
your boss knows that my mom 's dentist 's dad 's sister 's dentist is tall .	your boss scares my mom 's dentist 's dad 's sister 's dentist is tall .
Timothy says that my mother 's brother 's daughter 's husband 's doctor is quiet .	Timothy works with my mother 's brother 's daughter 's husband 's doctor is quiet .
the customer thinks that your wife 's dentist 's husband 's husband 's boss is excited .	the customer talks to your wife 's dentist 's husband 's husband 's boss is excited .
my teacher says that your mother 's wife 's husband 's sister 's mom is healthy .	my teacher talks to your mother 's wife 's husband 's sister 's mom is healthy .
your teacher says that my teacher 's father 's daughter 's wife 's mother is boring .	your teacher talks to my teacher 's father 's daughter 's wife 's mother is boring .
my dentist says that your son 's teacher 's daughter 's friend 's mom is surprised .	my dentist works with your son 's teacher 's daughter 's friend 's mom is surprised .
the patient knows that my teacher 's wife 's brother 's dad 's mom is gentle .	the patient scares my teacher 's wife 's brother 's dad 's mom is gentle .
Jerry knows that your husband 's grandmother 's friend 's mother 's dad is excited .	Jerry talks to your husband 's grandmother 's friend 's mother 's dad is excited .
your doctor thinks that my teacher 's sister 's boss 's son 's grandmother is healthy .	your doctor scares my teacher 's sister 's boss 's son 's grandmother is healthy .
your boss knows that my cousin 's dentist 's cousin 's dad 's daughter is nice .	your boss talks to my cousin 's dentist 's cousin 's dad 's daughter is nice .
your boss says that your grandmother 's grandmother 's doctor 's husband 's dentist is sleepy .	your boss helps your grandmother 's grandmother 's doctor 's husband 's dentist is sleepy .
your boss thinks that my teacher 's wife 's husband 's sister 's teacher is friendly .	your boss scares my teacher 's wife 's husband 's sister 's teacher is friendly .
the adult says that your cousin 's wife 's wife 's boss 's wife is nice .	the adult helps your cousin 's wife 's wife 's boss 's wife is nice .
Vanessa says that your son 's husband 's wife 's cousin 's father is gentle .	Vanessa works with your son 's husband 's wife 's cousin 's father is gentle .
the adult knows that my doctor 's sister 's boss 's sister 's brother is clever .	the adult helps my doctor 's sister 's boss 's sister 's brother is clever .
the dentist knows that my brother 's husband 's mother 's husband 's friend is important .	the dentist works with my brother 's husband 's mother 's husband 's friend is important .
the patient says that your son 's daughter 's father 's boss 's grandmother is angry .	the patient helps your son 's daughter 's father 's boss 's grandmother is angry .
the driver thinks that my husband 's husband 's boss 's dad 's mom is young .	the driver scares my husband 's husband 's boss 's dad 's mom is young .
your boss thinks that your teacher 's doctor 's son 's mom 's son is sleepy .	your boss works with your teacher 's doctor 's son 's mom 's son is sleepy .
your teacher says that your brother 's father 's teacher 's father 's mother is angry .	your teacher works with your brother 's father 's teacher 's father 's mother is angry .
Rebecca knows that your mom 's grandmother 's son 's sister 's husband is angry .	Rebecca works with your mom 's grandmother 's son 's sister 's husband is angry .
Steve knows that your cousin 's grandmother 's dad 's mom 's father is tired .	Steve talks to your cousin 's grandmother 's dad 's mom 's father is tired .
Carol says that my mom 's father 's son 's sister 's cousin is bored .	Carol works with my mom 's father 's son 's sister 's cousin is bored .
Melissa knows that my daughter 's dentist 's boss 's grandmother 's father is happy .	Melissa talks to my daughter 's dentist 's boss 's grandmother 's father is happy .
the driver thinks that your sister 's mother 's brother 's husband 's brother is nice .	the driver helps your sister 's mother 's brother 's husband 's brother is nice .
the person thinks that your father 's daughter 's mom 's dad 's brother is helpful .	the person talks to your father 's daughter 's mom 's dad 's brother is helpful .
my friend says that your mother 's dad 's husband 's dentist 's dad is curious .	my friend talks to your mother 's dad 's husband 's dentist 's dad is curious .
Adam knows that your teacher 's teacher 's teacher 's mom 's doctor is quiet .	Adam talks to your teacher 's teacher 's teacher 's mom 's doctor is quiet .
the adult says that my friend 's friend 's sister 's boss 's teacher is kind .	the adult talks to my friend 's friend 's sister 's boss 's teacher is kind .
the driver says that your daughter 's grandmother 's wife 's teacher 's husband is busy .	the driver talks to your daughter 's grandmother 's wife 's teacher 's husband is busy .
your boss thinks that my mom 's grandmother 's wife 's grandmother 's husband is excited .	your boss scares my mom 's grandmother 's wife 's grandmother 's husband is excited .
your boss says that my brother 's doctor 's husband 's dad 's cousin is strong .	your boss talks to my brother 's doctor 's husband 's dad 's cousin is strong .
the adult thinks that your husband 's friend 's sister 's sister 's teacher is clever .	the adult works with your husband 's friend 's sister 's sister 's teacher is clever .
Todd says that your doctor 's mother 's father 's boss 's friend is angry .	Todd scares your doctor 's mother 's father 's boss 's friend is angry .
Patrick thinks that your dentist 's dentist 's dentist 's father 's brother is angry .	Patrick works with your dentist 's dentist 's dentist 's father 's brother is angry .
the dancer knows that my boss 's boss 's dad 's grandmother 's brother is clever .	the dancer helps my boss 's boss 's dad 's grandmother 's brother is clever .
my doctor thinks that my mother 's daughter 's dentist 's mother 's dentist is helpful .	my doctor works with my mother 's daughter 's dentist 's mother 's dentist is helpful .
Julia says that my sister 's grandmother 's doctor 's brother 's doctor is confused .	Julia scares my sister 's grandmother 's doctor 's brother 's doctor is confused .
my friend thinks that my grandmother 's son 's brother 's mom 's wife is boring .	my friend scares my grandmother 's son 's brother 's mom 's wife is boring .
Becky says that your boss 's cousin 's dad 's mother 's teacher is busy .	Becky talks to your boss 's cousin 's dad 's mother 's teacher is busy .
your boss knows that your sister 's boss 's dentist 's mom 's son is wrong .	your boss scares your sister 's boss 's dentist 's mom 's son is wrong .
your friend says that your teacher 's sister 's cousin 's doctor 's mother is confused .	your friend works with your teacher 's sister 's cousin 's doctor 's mother is confused .
Melissa says that my daughter 's teacher 's sister 's teacher 's son is kind .	Melissa scares my daughter 's teacher 's sister 's teacher 's son is kind .
your doctor thinks that your friend 's friend 's daughter 's son 's dad is nice .	your doctor helps your friend 's friend 's daughter 's son 's dad is nice .
Barbara knows that my sister 's boss 's grandmother 's daughter 's father is upset .	Barbara helps my sister 's boss 's grandmother 's daughter 's father is upset .
your teacher thinks that my teacher 's dentist 's boss 's cousin 's daughter is kind .	your teacher works with my teacher 's dentist 's boss 's cousin 's daughter is kind .
the adult says that my wife 's wife 's dad 's grandmother 's grandmother is surprised .	the adult scares my wife 's wife 's dad 's grandmother 's grandmother is surprised .
the person thinks that your father 's mom 's father 's doctor 's son is bored .	the person works with your father 's mom 's father 's doctor 's son is bored .
Andrew thinks that your daughter 's doctor 's father 's sister 's grandmother is clever .	Andrew helps your daughter 's doctor 's father 's sister 's grandmother is clever .
Sally thinks that my friend 's boss 's son 's teacher 's doctor is helpful .	Sally helps my friend 's boss 's son 's teacher 's doctor is helpful .
the adult says that my mother 's doctor 's sister 's cousin 's daughter is lucky .	the adult helps my mother 's doctor 's sister 's cousin 's daughter is lucky .
my boss says that my daughter 's daughter 's father 's grandmother 's daughter is nice .	my boss helps my daughter 's daughter 's father 's grandmother 's daughter is nice .
Samantha says that my cousin 's dad 's mother 's teacher 's cousin is clever .	Samantha helps my cousin 's dad 's mother 's teacher 's cousin is clever .
Christopher thinks that your grandmother 's mother 's dentist 's boss 's teacher is careful .	Christopher scares your grandmother 's mother 's dentist 's boss 's teacher is careful .
my cousin thinks that your father 's dad 's mother 's teacher 's cousin is busy .	my cousin works with your father 's dad 's mother 's teacher 's cousin is busy .
my teacher says that your doctor 's doctor 's mom 's teacher 's mom is quiet .	my teacher scares your doctor 's doctor 's mom 's teacher 's mom is quiet .
your dentist knows that my doctor 's cousin 's mother 's cousin 's teacher is kind .	your dentist helps my doctor 's cousin 's mother 's cousin 's teacher is kind .
your dentist says that my doctor 's father 's father 's son 's friend is friendly .	your dentist scares my doctor 's father 's father 's son 's friend is friendly .
the person says that my doctor 's dentist 's sister 's husband 's father is quiet .	the person scares my doctor 's dentist 's sister 's husband 's father is quiet .
Ann knows that my cousin 's wife 's daughter 's wife 's mother is excited .	Ann helps my cousin 's wife 's daughter 's wife 's mother is excited .
my doctor thinks that my sister 's mom 's mother 's daughter 's father is strong .	my doctor helps my sister 's mom 's mother 's daughter 's father is strong .
the patient says that my wife 's son 's wife 's cousin 's daughter is friendly .	the patient scares my wife 's son 's wife 's cousin 's daughter is friendly .
your friend says that your husband 's dentist 's brother 's doctor 's son is helpful .	your friend works with your husband 's dentist 's brother 's doctor 's son is helpful .
your dentist says that your cousin 's son 's cousin 's teacher 's daughter is hungry .	your dentist scares your cousin 's son 's cousin 's teacher 's daughter is hungry .
the child knows that your mom 's sister 's sister 's son 's wife is tired .	the child works with your mom 's sister 's sister 's son 's wife is tired .
Noah thinks that your cousin 's sister 's son 's daughter 's mother is sleepy .	Noah works with your cousin 's sister 's son 's daughter 's mother is sleepy .
Timothy knows that your mother 's friend 's father 's dentist 's son is kind .	Timothy works with your mother 's friend 's father 's dentist 's son is kind .
the adult says that my dentist 's mother 's dentist 's dad 's sister is happy .	the adult talks to my dentist 's mother 's dentist 's dad 's sister is happy .
the customer thinks that my brother 's boss 's sister 's brother 's sister is confused .	the customer scares my brother 's boss 's sister 's brother 's sister is confused .
your friend knows that your mom 's cousin 's mother 's mom 's sister is young .	your friend works with your mom 's cousin 's mother 's mom 's sister is young .
your dentist knows that your friend 's boss 's son 's doctor 's mother is curious .	your dentist works with your friend 's boss 's son 's doctor 's mother is curious .
my doctor thinks that your friend 's son 's boss 's daughter 's dad is upset .	my doctor scares your friend 's son 's boss 's daughter 's dad is upset .
your dentist knows that my son 's father 's friend 's father 's doctor is smart .	your dentist talks to my son 's father 's friend 's father 's doctor is smart .
your friend knows that my dad 's doctor 's dad 's father 's brother is tall .	your friend talks to my dad 's doctor 's dad 's father 's brother is tall .
Brett says that my friend 's sister 's doctor 's son 's cousin is nice .	Brett scares my friend 's sister 's doctor 's son 's cousin is nice .
the adult knows that my cousin 's dentist 's dentist 's father 's cousin is strong .	the adult helps my cousin 's dentist 's dentist 's father 's cousin is strong .
the driver thinks that your brother 's son 's teacher 's brother 's boss is busy .	the driver helps your brother 's son 's teacher 's brother 's boss is busy .
my dentist knows that your grandmother 's doctor 's grandmother 's daughter 's teacher is lucky .	my dentist works with your grandmother 's doctor 's grandmother 's daughter 's teacher is lucky .
David says that your teacher 's dad 's cousin 's cousin 's doctor is wrong .	David helps your teacher 's dad 's cousin 's cousin 's doctor is wrong .
the child knows that my teacher 's father 's mother 's mother 's father is important .	the child works with my teacher 's father 's mother 's mother 's father is important .
the dentist thinks that your brother 's son 's dentist 's dentist 's father is angry .	the dentist helps your brother 's son 's dentist 's dentist 's father is angry .
Adam knows that your teacher 's son 's brother 's husband 's doctor is strong .	Adam works with your teacher 's son 's brother 's husband 's doctor is strong .
the child knows that my father 's teacher 's father 's father 's father is tired .	the child helps my father 's teacher 's father 's father 's father is tired .
your boss knows that your mom 's wife 's sister 's daughter 's cousin is quiet .	your boss scares your mom 's wife 's sister 's daughter 's cousin is quiet .
your dentist says that your father 's brother 's cousin 's brother 's sister is hungry .	your dentist helps your father 's brother 's cousin 's brother 's sister is hungry .
your teacher knows that your sister 's brother 's teacher 's daughter 's mom is friendly .	your teacher works with your sister 's brother 's teacher 's daughter 's mom is friendly .
my teacher knows that your son 's daughter 's boss 's teacher 's husband is clever .	my teacher works with your son 's daughter 's boss 's teacher 's husband is clever .
the adult knows that your wife 's friend 's mom 's wife 's daughter is bored .	the adult talks to your wife 's friend 's mom 's wife 's daughter is bored .
the dentist thinks that my friend 's friend 's son 's dad 's dad is excited .	the dentist helps my friend 's friend 's son 's dad 's dad is excited .
the teacher knows that your grandmother 's son 's daughter 's wife 's cousin is curious .	the teacher talks to your grandmother 's son 's daughter 's wife 's cousin is curious .
the patient says that your dentist 's sister 's son 's teacher 's sister is lucky .	the patient talks to your dentist 's sister 's son 's teacher 's sister is lucky .
the dancer thinks that my son 's wife 's friend 's father 's dad is happy .	the dancer helps my son 's wife 's friend 's father 's dad is happy .
the dentist knows that my daughter 's boss 's sister 's doctor 's wife is friendly .	the dentist works with my daughter 's boss 's sister 's doctor 's wife is friendly .
the dancer knows that your boss 's dentist 's brother 's husband 's father is confused .	the dancer talks to your boss 's dentist 's brother 's husband 's father is confused .
the dancer thinks that my daughter 's grandmother 's son 's teacher 's wife is careful .	the dancer talks to my daughter 's grandmother 's son 's teacher 's wife is careful .
the driver thinks that my dentist 's wife 's dentist 's brother 's doctor is smart .	the driver talks to my dentist 's wife 's dentist 's brother 's doctor is smart .
your dentist thinks that my father 's boss 's teacher 's boss 's mom is quiet .	your dentist helps my father 's boss 's teacher 's boss 's mom is quiet .
the customer says that your doctor 's friend 's son 's teacher 's grandmother is busy .	the customer helps your doctor 's friend 's son 's teacher 's grandmother is busy .
Frank knows that my cousin 's grandmother 's doctor 's boss 's sister is important .	Frank talks to my cousin 's grandmother 's doctor 's boss 's sister is important .
the adult says that my cousin 's cousin 's boss 's son 's sister is nice .	the adult scares my cousin 's cousin 's boss 's son 's sister is nice .
