the child knows that your mom 's sister 's boss 's father is young .	the child works with your mom 's sister 's boss 's father is young .
Timothy thinks that your boss 's dad 's husband 's sister is happy .	Timothy helps your boss 's dad 's husband 's sister is happy .
your friend knows that your cousin 's husband 's dad 's dentist is busy .	your friend works with your cousin 's husband 's dad 's dentist is busy .
the child thinks that your son 's mother 's dad 's doctor is busy .	the child works with your son 's mother 's dad 's doctor is busy .
the dentist knows that my husband 's friend 's doctor 's brother is boring .	the dentist scares my husband 's friend 's doctor 's brother is boring .
the adult knows that my doctor 's friend 's brother 's grandmother is young .	the adult works with my doctor 's friend 's brother 's grandmother is young .
the adult knows that your daughter 's cousin 's mom 's sister is important .	the adult helps your daughter 's cousin 's mom 's sister is important .
the patient thinks that my friend 's mom 's father 's dentist is gentle .	the patient talks to my friend 's mom 's father 's dentist is gentle .
the child thinks that your dad 's sister 's boss 's dad is surprised .	the child talks to your dad 's sister 's boss 's dad is surprised .
the driver thinks that my husband 's mother 's brother 's brother is strong .	the driver scares my husband 's mother 's brother 's brother is strong .
my doctor knows that your daughter 's father 's husband 's teacher is clever .	my doctor talks to your daughter 's father 's husband 's teacher is clever .
your friend knows that your teacher 's wife 's daughter 's dentist is happy .	your friend scares your teacher 's wife 's daughter 's dentist is happy .
Wendy thinks that my dentist 's grandmother 's father 's dad is helpful .	Wendy scares my dentist 's grandmother 's father 's dad is helpful .
my cousin says that my grandmother 's sister 's dentist 's daughter is helpful .	my cousin helps my grandmother 's sister 's dentist 's daughter is helpful .
Elizabeth knows that my son 's doctor 's daughter 's grandmother is curious .	Elizabeth works with my son 's doctor 's daughter 's grandmother is curious .
Michael thinks that my brother 's teacher 's boss 's grandmother is lucky .	Michael scares my brother 's teacher 's boss 's grandmother is lucky .
the patient thinks that my teacher 's mom 's husband 's grandmother is smart .	the patient talks to my teacher 's mom 's husband 's grandmother is smart .
Becky thinks that my dentist 's father 's dentist 's wife is tall .	Becky scares my dentist 's father 's dentist 's wife is tall .
your doctor knows that your grandmother 's doctor 's husband 's teacher is confused .	your doctor scares your grandmother 's doctor 's husband 's teacher is confused .
Andrew thinks that your doctor 's doctor 's grandmother 's brother is curious .	Andrew scares your doctor 's doctor 's grandmother 's brother is curious .
the adult knows that my mom 's daughter 's boss 's teacher is clever .	the adult scares my mom 's daughter 's boss 's teacher is clever .
Todd knows that my son 's husband 's teacher 's boss is strong .	Todd talks to my son 's husband 's teacher 's boss is strong .
my doctor thinks that my teacher 's daughter 's dad 's father is surprised .	my doctor talks to my teacher 's daughter 's dad 's father is surprised .
the patient thinks that your grandmother 's dad 's wife 's father is busy .	the patient scares your grandmother 's dad 's wife 's father is busy .
my friend knows that your doctor 's husband 's son 's husband is surprised .	my friend scares your doctor 's husband 's son 's husband is surprised .
your dentist thinks that your son 's son 's cousin 's mom is happy .	your dentist talks to your son 's son 's cousin 's mom is happy .
Naomi says that your dad 's husband 's husband 's teacher is kind .	Naomi scares your dad 's husband 's husband 's teacher is kind .
my cousin thinks that my teacher 's friend 's mom 's boss is nice .	my cousin works with my teacher 's friend 's mom 's boss is nice .
the dentist says that your brother 's brother 's wife 's teacher is surprised .	the dentist scares your brother 's brother 's wife 's teacher is surprised .
Todd thinks that my daughter 's dad 's grandmother 's wife is lucky .	Todd works with my daughter 's dad 's grandmother 's wife is lucky .
the patient thinks that your husband 's grandmother 's teacher 's mother is confused .	the patient helps your husband 's grandmother 's teacher 's mother is confused .
my cousin says that my mother 's cousin 's mom 's mom is young .	my cousin talks to my mother 's cousin 's mom 's mom is young .
the child knows that my boss 's dad 's dad 's grandmother is quiet .	the child helps my boss 's dad 's dad 's grandmother is quiet .
Allison thinks that my daughter 's mom 's husband 's dad is wrong .	Allison works with my daughter 's mom 's husband 's dad is wrong .
your doctor thinks that your dad 's boss 's grandmother 's sister is excited .	your doctor helps your dad 's boss 's grandmother 's sister is excited .
your friend says that your friend 's daughter 's dad 's cousin is excited .	your friend works with your friend 's daughter 's dad 's cousin is excited .
the adult knows that my cousin 's husband 's father 's son is important .	the adult helps my cousin 's husband 's father 's son is important .
Andrew knows that your grandmother 's boss 's teacher 's cousin is strong .	Andrew talks to your grandmother 's boss 's teacher 's cousin is strong .
the adult says that your cousin 's cousin 's grandmother 's mom is young .	the adult scares your cousin 's cousin 's grandmother 's mom is young .
your friend says that my dad 's husband 's boss 's teacher is angry .	your friend helps my dad 's husband 's boss 's teacher is angry .
Donna knows that your mom 's cousin 's husband 's dentist is healthy .	Donna scares your mom 's cousin 's husband 's dentist is healthy .
Anne says that your friend 's wife 's doctor 's mother is healthy .	Anne works with your friend 's wife 's doctor 's mother is healthy .
Scott knows that your grandmother 's cousin 's son 's cousin is surprised .	Scott talks to your grandmother 's cousin 's son 's cousin is surprised .
Eric says that your mom 's doctor 's sister 's mom is busy .	Eric scares your mom 's doctor 's sister 's mom is busy .
Sally knows that my mother 's husband 's brother 's friend is smart .	Sally talks to my mother 's husband 's brother 's friend is smart .
Wendy thinks that your grandmother 's father 's wife 's husband is surprised .	Wendy helps your grandmother 's father 's wife 's husband is surprised .
the child says that your son 's boss 's sister 's father is sleepy .	the child helps your son 's boss 's sister 's father is sleepy .
your dentist thinks that my brother 's son 's boss 's boss is curious .	your dentist works with my brother 's son 's boss 's boss is curious .
your doctor thinks that your husband 's friend 's grandmother 's dentist is sleepy .	your doctor helps your husband 's friend 's grandmother 's dentist is sleepy .
Karen thinks that your doctor 's daughter 's dentist 's boss is busy .	Karen works with your doctor 's daughter 's dentist 's boss is busy .
Judy says that your wife 's brother 's son 's brother is clever .	Judy helps your wife 's brother 's son 's brother is clever .
your doctor knows that my wife 's sister 's sister 's sister is happy .	your doctor works with my wife 's sister 's sister 's sister is happy .
my boss says that my mother 's friend 's husband 's daughter is gentle .	my boss works with my mother 's friend 's husband 's daughter is gentle .
the patient knows that your boss 's mom 's dentist 's husband is nice .	the patient works with your boss 's mom 's dentist 's husband is nice .
Julie says that your friend 's mom 's teacher 's boss is wrong .	Julie works with your friend 's mom 's teacher 's boss is wrong .
Richard knows that my friend 's teacher 's sister 's grandmother is tired .	Richard scares my friend 's teacher 's sister 's grandmother is tired .
Jill knows that your grandmother 's mom 's daughter 's dad is healthy .	Jill scares your grandmother 's mom 's daughter 's dad is healthy .
Leslie says that my doctor 's cousin 's dad 's brother is confused .	Leslie helps my doctor 's cousin 's dad 's brother is confused .
Donna says that my wife 's teacher 's daughter 's brother is tired .	Donna talks to my wife 's teacher 's daughter 's brother is tired .
David says that your dentist 's daughter 's teacher 's mom is busy .	David scares your dentist 's daughter 's teacher 's mom is busy .
your teacher says that my dad 's sister 's sister 's grandmother is gentle .	your teacher works with my dad 's sister 's sister 's grandmother is gentle .
Sally says that your dentist 's daughter 's brother 's wife is boring .	Sally scares your dentist 's daughter 's brother 's wife is boring .
my cousin says that your mother 's father 's doctor 's sister is angry .	my cousin scares your mother 's father 's doctor 's sister is angry .
the customer knows that my friend 's sister 's brother 's wife is kind .	the customer scares my friend 's sister 's brother 's wife is kind .
Ronald says that my son 's brother 's dad 's brother is busy .	Ronald works with my son 's brother 's dad 's brother is busy .
the person knows that your sister 's daughter 's daughter 's husband is confused .	the person scares your sister 's daughter 's daughter 's husband is confused .
my teacher thinks that your sister 's father 's wife 's grandmother is surprised .	my teacher helps your sister 's father 's wife 's grandmother is surprised .
your dentist knows that my mother 's husband 's teacher 's boss is happy .	your dentist talks to my mother 's husband 's teacher 's boss is happy .
the dancer says that your dad 's sister 's mother 's boss is sleepy .	the dancer helps your dad 's sister 's mother 's boss is sleepy .
the adult thinks that my husband 's cousin 's dad 's father is smart .	the adult works with my husband 's cousin 's dad 's father is smart .
Jason says that your brother 's grandmother 's daughter 's wife is lucky .	Jason helps your brother 's grandmother 's daughter 's wife is lucky .
the dancer thinks that your teacher 's wife 's teacher 's cousin is lucky .	the dancer talks to your teacher 's wife 's teacher 's cousin is lucky .
the teacher says that your teacher 's husband 's daughter 's mom is smart .	the teacher scares your teacher 's husband 's daughter 's mom is smart .
the patient thinks that your son 's father 's wife 's teacher is angry .	the patient scares your son 's father 's wife 's teacher is angry .
your dentist says that your dentist 's grandmother 's dentist 's mother is gentle .	your dentist scares your dentist 's grandmother 's dentist 's mother is gentle .
the customer says that your mother 's wife 's teacher 's boss is lucky .	the customer works with your mother 's wife 's teacher 's boss is lucky .
the driver says that my brother 's sister 's friend 's son is happy .	the driver scares my brother 's sister 's friend 's son is happy .
my dentist says that your teacher 's cousin 's son 's daughter is helpful .	my dentist scares your teacher 's cousin 's son 's daughter is helpful .
Deborah thinks that your grandmother 's grandmother 's boss 's dentist is tall .	Deborah scares your grandmother 's grandmother 's boss 's dentist is tall .
the teacher knows that my teacher 's son 's dad 's boss is helpful .	the teacher works with my teacher 's son 's dad 's boss is helpful .
Renee thinks that your daughter 's sister 's wife 's mom is important .	Renee helps your daughter 's sister 's wife 's mom is important .
the patient knows that your brother 's husband 's father 's father is curious .	the patient works with your brother 's husband 's father 's father is curious .
Anna thinks that your doctor 's grandmother 's husband 's dentist is young .	Anna scares your doctor 's grandmother 's husband 's dentist is young .
my boss says that your sister 's mom 's mom 's mother is tall .	my boss talks to your sister 's mom 's mom 's mother is tall .
Linda says that your teacher 's boss 's friend 's friend is kind .	Linda talks to your teacher 's boss 's friend 's friend is kind .
my boss says that your father 's brother 's friend 's friend is confused .	my boss scares your father 's brother 's friend 's friend is confused .
Jessica knows that my cousin 's mother 's mother 's daughter is lucky .	Jessica helps my cousin 's mother 's mother 's daughter is lucky .
your boss thinks that my dentist 's friend 's brother 's dentist is kind .	your boss helps my dentist 's friend 's brother 's dentist is kind .
Donna says that your dentist 's son 's grandmother 's grandmother is helpful .	Donna works with your dentist 's son 's grandmother 's grandmother is helpful .
the person thinks that your dentist 's husband 's mother 's wife is tired .	the person scares your dentist 's husband 's mother 's wife is tired .
the driver thinks that my daughter 's son 's mother 's daughter is confused .	the driver talks to my daughter 's son 's mother 's daughter is confused .
the dancer knows that my wife 's teacher 's grandmother 's mom is quiet .	the dancer works with my wife 's teacher 's grandmother 's mom is quiet .
the doctor knows that your son 's brother 's doctor 's boss is strong .	the doctor works with your son 's brother 's doctor 's boss is strong .
my friend thinks that my wife 's wife 's boss 's father is careful .	my friend talks to my wife 's wife 's boss 's father is careful .
Laurie says that your dentist 's dad 's daughter 's teacher is happy .	Laurie helps your dentist 's dad 's daughter 's teacher is happy .
Barbara thinks that your son 's daughter 's mother 's boss is healthy .	Barbara talks to your son 's daughter 's mother 's boss is healthy .
the adult thinks that my grandmother 's sister 's doctor 's mom is careful .	the adult scares my grandmother 's sister 's doctor 's mom is careful .
my dentist says that your wife 's husband 's mom 's dad is smart .	my dentist works with your wife 's husband 's mom 's dad is smart .
the person says that my brother 's wife 's son 's boss is busy .	the person scares my brother 's wife 's son 's boss is busy .
my teacher says that my doctor 's dentist 's cousin 's friend is young .	my teacher works with my doctor 's dentist 's cousin 's friend is young .
the dancer thinks that your wife 's grandmother 's teacher 's cousin is young .	the dancer helps your wife 's grandmother 's teacher 's cousin is young .
my dentist knows that my sister 's dad 's mother 's mom is strong .	my dentist works with my sister 's dad 's mother 's mom is strong .
the person knows that your dad 's wife 's daughter 's son is kind .	the person scares your dad 's wife 's daughter 's son is kind .
the dentist says that my son 's son 's mom 's son is upset .	the dentist helps my son 's son 's mom 's son is upset .
the dentist says that my cousin 's grandmother 's grandmother 's father is excited .	the dentist talks to my cousin 's grandmother 's grandmother 's father is excited .
the adult says that my grandmother 's doctor 's sister 's boss is smart .	the adult talks to my grandmother 's doctor 's sister 's boss is smart .
my friend thinks that my mom 's dad 's dentist 's father is sleepy .	my friend talks to my mom 's dad 's dentist 's father is sleepy .
your doctor thinks that your grandmother 's doctor 's father 's husband is quiet .	your doctor helps your grandmother 's doctor 's father 's husband is quiet .
the person knows that my wife 's teacher 's daughter 's cousin is healthy .	the person works with my wife 's teacher 's daughter 's cousin is healthy .
my dentist says that my father 's cousin 's wife 's doctor is confused .	my dentist helps my father 's cousin 's wife 's doctor is confused .
Allison thinks that your sister 's doctor 's teacher 's teacher is hungry .	Allison talks to your sister 's doctor 's teacher 's teacher is hungry .
Vanessa knows that your daughter 's doctor 's grandmother 's dad is smart .	Vanessa scares your daughter 's doctor 's grandmother 's dad is smart .
Sarah knows that my boss 's mother 's dentist 's dentist is helpful .	Sarah scares my boss 's mother 's dentist 's dentist is helpful .
Samantha knows that your doctor 's wife 's cousin 's mother is excited .	Samantha scares your doctor 's wife 's cousin 's mother is excited .
my teacher knows that your father 's sister 's sister 's son is happy .	my teacher scares your father 's sister 's sister 's son is happy .
Becky knows that your doctor 's son 's wife 's son is friendly .	Becky works with your doctor 's son 's wife 's son is friendly .
my doctor says that my son 's teacher 's son 's sister is happy .	my doctor talks to my son 's teacher 's son 's sister is happy .
your dentist knows that your son 's daughter 's boss 's daughter is upset .	your dentist helps your son 's daughter 's boss 's daughter is upset .
my friend says that my sister 's teacher 's mom 's wife is kind .	my friend talks to my sister 's teacher 's mom 's wife is kind .
Stephanie knows that your cousin 's dad 's wife 's husband is hungry .	Stephanie scares your cousin 's dad 's wife 's husband is hungry .
the child thinks that your son 's mother 's doctor 's brother is surprised .	the child scares your son 's mother 's doctor 's brother is surprised .
Bill knows that my father 's mother 's dad 's dad is helpful .	Bill talks to my father 's mother 's dad 's dad is helpful .
Denise thinks that my friend 's wife 's daughter 's husband is excited .	Denise talks to my friend 's wife 's daughter 's husband is excited .
the teacher thinks that my grandmother 's mother 's daughter 's grandmother is helpful .	the teacher helps my grandmother 's mother 's daughter 's grandmother is helpful .
Thomas thinks that your husband 's boss 's dentist 's grandmother is lucky .	Thomas helps your husband 's boss 's dentist 's grandmother is lucky .
the doctor knows that your mom 's cousin 's boss 's doctor is kind .	the doctor works with your mom 's cousin 's boss 's doctor is kind .
Denise thinks that your grandmother 's son 's sister 's boss is excited .	Denise helps your grandmother 's son 's sister 's boss is excited .
Karen knows that my mother 's grandmother 's sister 's cousin is sleepy .	Karen scares my mother 's grandmother 's sister 's cousin is sleepy .
Robert says that your wife 's grandmother 's wife 's sister is important .	Robert scares your wife 's grandmother 's wife 's sister is important .
my doctor knows that my daughter 's dentist 's doctor 's dad is helpful .	my doctor scares my daughter 's dentist 's doctor 's dad is helpful .
your cousin knows that my daughter 's cousin 's mom 's dad is confused .	your cousin works with my daughter 's cousin 's mom 's dad is confused .
the dancer knows that your cousin 's son 's husband 's wife is upset .	the dancer helps your cousin 's son 's husband 's wife is upset .
your boss knows that my grandmother 's teacher 's daughter 's cousin is nice .	your boss helps my grandmother 's teacher 's daughter 's cousin is nice .
the dentist says that my wife 's dentist 's daughter 's dad is strong .	the dentist scares my wife 's dentist 's daughter 's dad is strong .
Judy knows that your dad 's son 's husband 's father is wrong .	Judy talks to your dad 's son 's husband 's father is wrong .
the customer knows that my brother 's dentist 's dentist 's mom is bored .	the customer scares my brother 's dentist 's dentist 's mom is bored .
April thinks that your dad 's son 's boss 's friend is gentle .	April scares your dad 's son 's boss 's friend is gentle .
your boss thinks that your daughter 's father 's mother 's father is strong .	your boss scares your daughter 's father 's mother 's father is strong .
your friend thinks that your mother 's friend 's dad 's dentist is curious .	your friend works with your mother 's friend 's dad 's dentist is curious .
my friend knows that my daughter 's brother 's doctor 's daughter is tall .	my friend works with my daughter 's brother 's doctor 's daughter is tall .
the adult says that your father 's sister 's father 's husband is helpful .	the adult scares your father 's sister 's father 's husband is helpful .
your friend knows that my cousin 's mother 's dad 's sister is lucky .	your friend talks to my cousin 's mother 's dad 's sister is lucky .
my dentist knows that my cousin 's dad 's doctor 's teacher is angry .	my dentist helps my cousin 's dad 's doctor 's teacher is angry .
the dentist knows that your dentist 's husband 's daughter 's brother is helpful .	the dentist talks to your dentist 's husband 's daughter 's brother is helpful .
the dancer thinks that your dad 's grandmother 's wife 's dentist is smart .	the dancer scares your dad 's grandmother 's wife 's dentist is smart .
Catherine thinks that my wife 's dad 's dad 's son is lucky .	Catherine talks to my wife 's dad 's dad 's son is lucky .
Jill thinks that my wife 's wife 's mom 's father is upset .	Jill talks to my wife 's wife 's mom 's father is upset .
your cousin knows that my teacher 's teacher 's boss 's dad is healthy .	your cousin scares my teacher 's teacher 's boss 's dad is healthy .
my doctor knows that your dad 's father 's grandmother 's doctor is important .	my doctor talks to your dad 's father 's grandmother 's doctor is important .
the teacher thinks that my brother 's wife 's friend 's mother is strong .	the teacher scares my brother 's wife 's friend 's mother is strong .
your doctor says that your dad 's teacher 's wife 's grandmother is clever .	your doctor works with your dad 's teacher 's wife 's grandmother is clever .
the driver thinks that your wife 's mom 's sister 's friend is friendly .	the driver scares your wife 's mom 's sister 's friend is friendly .
the doctor says that my cousin 's boss 's grandmother 's mom is lucky .	the doctor works with my cousin 's boss 's grandmother 's mom is lucky .
your dentist thinks that my brother 's boss 's doctor 's brother is lucky .	your dentist scares my brother 's boss 's doctor 's brother is lucky .
my dentist knows that my sister 's daughter 's teacher 's daughter is careful .	my dentist works with my sister 's daughter 's teacher 's daughter is careful .
the dancer knows that your cousin 's teacher 's mother 's grandmother is tall .	the dancer talks to your cousin 's teacher 's mother 's grandmother is tall .
Sally thinks that my doctor 's teacher 's mother 's friend is tired .	Sally helps my doctor 's teacher 's mother 's friend is tired .
Amelia thinks that your dad 's dad 's mom 's friend is helpful .	Amelia scares your dad 's dad 's mom 's friend is helpful .
your doctor knows that my cousin 's boss 's boss 's sister is surprised .	your doctor works with my cousin 's boss 's boss 's sister is surprised .
the teacher knows that my sister 's father 's wife 's mother is gentle .	the teacher scares my sister 's father 's wife 's mother is gentle .
my boss knows that your friend 's sister 's daughter 's friend is curious .	my boss talks to your friend 's sister 's daughter 's friend is curious .
Kristen knows that my dad 's sister 's daughter 's husband is smart .	Kristen talks to my dad 's sister 's daughter 's husband is smart .
Karen thinks that your cousin 's daughter 's mother 's dad is smart .	Karen helps your cousin 's daughter 's mother 's dad is smart .
Melissa thinks that my dentist 's mom 's boss 's sister is confused .	Melissa talks to my dentist 's mom 's boss 's sister is confused .
Jill thinks that my mom 's doctor 's dentist 's friend is quiet .	Jill works with my mom 's doctor 's dentist 's friend is quiet .
Janet thinks that your boss 's grandmother 's friend 's mother is curious .	Janet scares your boss 's grandmother 's friend 's mother is curious .
the person says that your boss 's teacher 's daughter 's son is boring .	the person works with your boss 's teacher 's daughter 's son is boring .
the driver says that my sister 's sister 's doctor 's teacher is tall .	the driver works with my sister 's sister 's doctor 's teacher is tall .
Brett knows that my friend 's brother 's husband 's grandmother is sleepy .	Brett scares my friend 's brother 's husband 's grandmother is sleepy .
the adult says that your daughter 's husband 's grandmother 's boss is curious .	the adult works with your daughter 's husband 's grandmother 's boss is curious .
Erin thinks that your mother 's dad 's brother 's dad is confused .	Erin scares your mother 's dad 's brother 's dad is confused .
Carol says that your mom 's teacher 's son 's dad is nice .	Carol helps your mom 's teacher 's son 's dad is nice .
Jessica says that my dad 's father 's wife 's daughter is busy .	Jessica helps my dad 's father 's wife 's daughter is busy .
my teacher thinks that your dad 's mom 's husband 's cousin is lucky .	my teacher works with your dad 's mom 's husband 's cousin is lucky .
the doctor says that my teacher 's daughter 's mom 's brother is sleepy .	the doctor helps my teacher 's daughter 's mom 's brother is sleepy .
my doctor knows that my dentist 's daughter 's brother 's son is angry .	my doctor works with my dentist 's daughter 's brother 's son is angry .
my dentist knows that your father 's husband 's brother 's dad is clever .	my dentist scares your father 's husband 's brother 's dad is clever .
Andrew knows that my teacher 's mother 's friend 's boss is bored .	Andrew talks to my teacher 's mother 's friend 's boss is bored .
my teacher says that my grandmother 's son 's dad 's dentist is busy .	my teacher helps my grandmother 's son 's dad 's dentist is busy .
the child thinks that my brother 's husband 's daughter 's grandmother is bored .	the child helps my brother 's husband 's daughter 's grandmother is bored .
Peter knows that your daughter 's teacher 's son 's cousin is surprised .	Peter talks to your daughter 's teacher 's son 's cousin is surprised .
your friend thinks that my mom 's teacher 's grandmother 's brother is busy .	your friend scares my mom 's teacher 's grandmother 's brother is busy .
my teacher knows that my dad 's sister 's father 's wife is tired .	my teacher scares my dad 's sister 's father 's wife is tired .
the dancer thinks that your daughter 's dad 's dentist 's dentist is gentle .	the dancer scares your daughter 's dad 's dentist 's dentist is gentle .
Leslie thinks that my daughter 's mother 's mom 's cousin is bored .	Leslie helps my daughter 's mother 's mom 's cousin is bored .
George says that your daughter 's friend 's wife 's sister is smart .	George helps your daughter 's friend 's wife 's sister is smart .
Jill knows that your mother 's boss 's dentist 's mom is smart .	Jill works with your mother 's boss 's dentist 's mom is smart .
Emily knows that my sister 's mom 's cousin 's grandmother is friendly .	Emily helps my sister 's mom 's cousin 's grandmother is friendly .
Tracy knows that my husband 's wife 's daughter 's husband is wrong .	Tracy scares my husband 's wife 's daughter 's husband is wrong .
Patrick thinks that your husband 's grandmother 's mother 's husband is curious .	Patrick helps your husband 's grandmother 's mother 's husband is curious .
my boss thinks that my mom 's cousin 's sister 's cousin is boring .	my boss works with my mom 's cousin 's sister 's cousin is boring .
Linda thinks that my teacher 's doctor 's mother 's father is busy .	Linda scares my teacher 's doctor 's mother 's father is busy .
the teacher says that my son 's cousin 's mother 's dad is curious .	the teacher scares my son 's cousin 's mother 's dad is curious .
Sandra thinks that your daughter 's cousin 's father 's friend is busy .	Sandra talks to your daughter 's cousin 's father 's friend is busy .
your teacher says that your doctor 's teacher 's brother 's boss is helpful .	your teacher works with your doctor 's teacher 's brother 's boss is helpful .
your cousin says that my mother 's friend 's mom 's brother is bored .	your cousin helps my mother 's friend 's mom 's brother is bored .
your doctor knows that your dentist 's friend 's dad 's teacher is bored .	your doctor scares your dentist 's friend 's dad 's teacher is bored .
the patient knows that your brother 's sister 's dentist 's brother is healthy .	the patient talks to your brother 's sister 's dentist 's brother is healthy .
the customer says that your doctor 's dad 's daughter 's cousin is upset .	the customer helps your doctor 's dad 's daughter 's cousin is upset .
Nicole says that your cousin 's dentist 's husband 's daughter is surprised .	Nicole talks to your cousin 's dentist 's husband 's daughter is surprised .
my doctor knows that your dentist 's boss 's dad 's sister is important .	my doctor talks to your dentist 's boss 's dad 's sister is important .
your doctor knows that your dentist 's teacher 's dentist 's wife is gentle .	your doctor works with your dentist 's teacher 's dentist 's wife is gentle .
the child knows that my daughter 's mom 's grandmother 's daughter is tall .	the child talks to my daughter 's mom 's grandmother 's daughter is tall .
the person thinks that my wife 's sister 's son 's wife is young .	the person talks to my wife 's sister 's son 's wife is young .
the teacher says that your sister 's cousin 's dentist 's daughter is helpful .	the teacher helps your sister 's cousin 's dentist 's daughter is helpful .
Kevin says that my friend 's father 's mother 's brother is tall .	Kevin scares my friend 's father 's mother 's brother is tall .
the customer says that my wife 's brother 's dad 's son is careful .	the customer works with my wife 's brother 's dad 's son is careful .
your friend knows that your father 's sister 's wife 's son is strong .	your friend scares your father 's sister 's wife 's son is strong .
the adult thinks that your grandmother 's mother 's friend 's grandmother is upset .	the adult scares your grandmother 's mother 's friend 's grandmother is upset .
Travis says that your husband 's mom 's brother 's grandmother is gentle .	Travis talks to your husband 's mom 's brother 's grandmother is gentle .
the child knows that your teacher 's dentist 's wife 's husband is curious .	the child talks to your teacher 's dentist 's wife 's husband is curious .
your cousin says that my teacher 's daughter 's dentist 's father is confused .	your cousin scares my teacher 's daughter 's dentist 's father is confused .
my teacher thinks that your doctor 's friend 's grandmother 's father is lucky .	my teacher talks to your doctor 's friend 's grandmother 's father is lucky .
your friend says that your friend 's mother 's doctor 's mother is lucky .	your friend works with your friend 's mother 's doctor 's mother is lucky .
the patient knows that my dad 's dentist 's son 's son is boring .	the patient works with my dad 's dentist 's son 's son is boring .
the doctor knows that my husband 's dentist 's daughter 's dentist is upset .	the doctor scares my husband 's dentist 's daughter 's dentist is upset .
Stephanie thinks that your husband 's mother 's son 's dad is hungry .	Stephanie talks to your husband 's mother 's son 's dad is hungry .
your doctor says that your boss 's boss 's husband 's mother is lucky .	your doctor talks to your boss 's boss 's husband 's mother is lucky .
my doctor knows that your doctor 's father 's doctor 's grandmother is tall .	my doctor helps your doctor 's father 's doctor 's grandmother is tall .
the driver thinks that your dentist 's daughter 's sister 's husband is clever .	the driver helps your dentist 's daughter 's sister 's husband is clever .
the person knows that your sister 's doctor 's dad 's cousin is angry .	the person talks to your sister 's doctor 's dad 's cousin is angry .
the driver knows that your brother 's daughter 's father 's wife is gentle .	the driver works with your brother 's daughter 's father 's wife is gentle .
Frank thinks that your husband 's daughter 's mom 's boss is healthy .	Frank scares your husband 's daughter 's mom 's boss is healthy .
my boss knows that my son 's boss 's friend 's sister is lucky .	my boss talks to my son 's boss 's friend 's sister is lucky .
your dentist knows that my brother 's teacher 's sister 's wife is important .	your dentist talks to my brother 's teacher 's sister 's wife is important .
Anne knows that your dentist 's dad 's daughter 's brother is careful .	Anne helps your dentist 's dad 's daughter 's brother is careful .
my doctor knows that your grandmother 's friend 's teacher 's cousin is healthy .	my doctor works with your grandmother 's friend 's teacher 's cousin is healthy .
the patient knows that your brother 's mom 's boss 's doctor is tired .	the patient scares your brother 's mom 's boss 's doctor is tired .
Brian says that your father 's cousin 's father 's father is tall .	Brian scares your father 's cousin 's father 's father is tall .
your teacher thinks that your son 's dad 's grandmother 's dad is careful .	your teacher scares your son 's dad 's grandmother 's dad is careful .
Eric knows that my cousin 's mother 's cousin 's boss is important .	Eric works with my cousin 's mother 's cousin 's boss is important .
the patient knows that my friend 's cousin 's mother 's grandmother is tall .	the patient helps my friend 's cousin 's mother 's grandmother is tall .
the child says that your grandmother 's cousin 's mom 's doctor is tall .	the child scares your grandmother 's cousin 's mom 's doctor is tall .
my boss says that my cousin 's son 's cousin 's brother is tired .	my boss helps my cousin 's son 's cousin 's brother is tired .
Janet thinks that your son 's mother 's boss 's sister is young .	Janet works with your son 's mother 's boss 's sister is young .
Travis says that my dad 's cousin 's teacher 's son is tired .	Travis scares my dad 's cousin 's teacher 's son is tired .
Anna knows that your dentist 's brother 's friend 's son is tired .	Anna helps your dentist 's brother 's friend 's son is tired .
your doctor says that my dentist 's doctor 's sister 's son is wrong .	your doctor works with my dentist 's doctor 's sister 's son is wrong .
James thinks that your friend 's daughter 's dad 's husband is nice .	James works with your friend 's daughter 's dad 's husband is nice .
your dentist knows that my sister 's friend 's cousin 's doctor is happy .	your dentist helps my sister 's friend 's cousin 's doctor is happy .
the adult thinks that your cousin 's teacher 's cousin 's sister is nice .	the adult scares your cousin 's teacher 's cousin 's sister is nice .
Melissa knows that your friend 's teacher 's brother 's boss is clever .	Melissa works with your friend 's teacher 's brother 's boss is clever .
my friend thinks that my sister 's doctor 's daughter 's doctor is quiet .	my friend talks to my sister 's doctor 's daughter 's doctor is quiet .
Michael knows that your son 's mom 's wife 's grandmother is quiet .	Michael scares your son 's mom 's wife 's grandmother is quiet .
the teacher thinks that your dentist 's boss 's son 's cousin is kind .	the teacher talks to your dentist 's boss 's son 's cousin is kind .
my dentist knows that my cousin 's teacher 's teacher 's friend is happy .	my dentist helps my cousin 's teacher 's teacher 's friend is happy .
Robert says that my doctor 's friend 's daughter 's grandmother is nice .	Robert helps my doctor 's friend 's daughter 's grandmother is nice .
the child says that my teacher 's boss 's husband 's sister is boring .	the child helps my teacher 's boss 's husband 's sister is boring .
my doctor knows that my wife 's mom 's doctor 's dentist is young .	my doctor helps my wife 's mom 's doctor 's dentist is young .
the person says that your dad 's son 's daughter 's sister is sleepy .	the person works with your dad 's son 's daughter 's sister is sleepy .
Guy knows that your father 's dad 's daughter 's mother is smart .	Guy talks to your father 's dad 's daughter 's mother is smart .
Rebecca knows that your doctor 's mom 's brother 's teacher is nice .	Rebecca works with your doctor 's mom 's brother 's teacher is nice .
Brian thinks that my teacher 's friend 's sister 's friend is young .	Brian talks to my teacher 's friend 's sister 's friend is young .
Donald knows that your brother 's brother 's husband 's cousin is careful .	Donald scares your brother 's brother 's husband 's cousin is careful .
the teacher says that your sister 's husband 's teacher 's husband is excited .	the teacher scares your sister 's husband 's teacher 's husband is excited .
the child thinks that my teacher 's cousin 's daughter 's doctor is happy .	the child works with my teacher 's cousin 's daughter 's doctor is happy .
the adult says that my mother 's doctor 's doctor 's dentist is bored .	the adult helps my mother 's doctor 's doctor 's dentist is bored .
the customer thinks that your husband 's teacher 's daughter 's dentist is gentle .	the customer scares your husband 's teacher 's daughter 's dentist is gentle .
the dentist says that my sister 's mom 's friend 's father is surprised .	the dentist works with my sister 's mom 's friend 's father is surprised .
Adam says that your mother 's dad 's brother 's sister is young .	Adam helps your mother 's dad 's brother 's sister is young .
the child says that your husband 's mother 's dentist 's son is boring .	the child works with your husband 's mother 's dentist 's son is boring .
the driver thinks that my cousin 's friend 's sister 's daughter is healthy .	the driver talks to my cousin 's friend 's sister 's daughter is healthy .
Paul says that your son 's son 's wife 's sister is tired .	Paul helps your son 's son 's wife 's sister is tired .
the driver knows that your friend 's son 's brother 's teacher is angry .	the driver helps your friend 's son 's brother 's teacher is angry .
my cousin knows that your cousin 's doctor 's mom 's friend is careful .	my cousin talks to your cousin 's doctor 's mom 's friend is careful .
Rachel knows that my brother 's son 's sister 's doctor is happy .	Rachel works with my brother 's son 's sister 's doctor is happy .
Eric thinks that your mom 's sister 's dentist 's grandmother is healthy .	Eric works with your mom 's sister 's dentist 's grandmother is healthy .
the person thinks that your doctor 's sister 's husband 's husband is important .	the person talks to your doctor 's sister 's husband 's husband is important .
your boss knows that my friend 's father 's teacher 's teacher is gentle .	your boss talks to my friend 's father 's teacher 's teacher is gentle .
Jessica says that my grandmother 's friend 's son 's dad is careful .	Jessica scares my grandmother 's friend 's son 's dad is careful .
the child says that your son 's sister 's mom 's doctor is smart .	the child talks to your son 's sister 's mom 's doctor is smart .
the teacher thinks that my son 's father 's dad 's dad is surprised .	the teacher talks to my son 's father 's dad 's dad is surprised .
your boss thinks that your teacher 's mom 's husband 's son is confused .	your boss talks to your teacher 's mom 's husband 's son is confused .
the driver knows that your son 's sister 's teacher 's mother is clever .	the driver works with your son 's sister 's teacher 's mother is clever .
Laura says that my dad 's friend 's sister 's sister is tired .	Laura works with my dad 's friend 's sister 's sister is tired .
Richard says that my mother 's mother 's wife 's dentist is wrong .	Richard scares my mother 's mother 's wife 's dentist is wrong .
Kayla thinks that my mom 's grandmother 's friend 's father is important .	Kayla helps my mom 's grandmother 's friend 's father is important .
my boss knows that your father 's mom 's father 's son is strong .	my boss scares your father 's mom 's father 's son is strong .
your teacher thinks that my friend 's husband 's boss 's sister is gentle .	your teacher scares my friend 's husband 's boss 's sister is gentle .
Kevin knows that my wife 's son 's son 's dad is important .	Kevin works with my wife 's son 's son 's dad is important .
the person thinks that my dad 's son 's husband 's doctor is quiet .	the person works with my dad 's son 's husband 's doctor is quiet .
my friend says that your wife 's boss 's mother 's grandmother is upset .	my friend talks to your wife 's boss 's mother 's grandmother is upset .
the dentist knows that your grandmother 's daughter 's daughter 's wife is hungry .	the dentist talks to your grandmother 's daughter 's daughter 's wife is hungry .
my doctor thinks that your husband 's dentist 's mother 's wife is young .	my doctor scares your husband 's dentist 's mother 's wife is young .
Peter says that your wife 's dentist 's husband 's grandmother is wrong .	Peter scares your wife 's dentist 's husband 's grandmother is wrong .
Kristen says that my dentist 's husband 's father 's dad is strong .	Kristen helps my dentist 's husband 's father 's dad is strong .
the teacher says that my dad 's dad 's dad 's sister is happy .	the teacher talks to my dad 's dad 's dad 's sister is happy .
your doctor says that your dentist 's sister 's dad 's wife is upset .	your doctor talks to your dentist 's sister 's dad 's wife is upset .
George thinks that your grandmother 's mom 's teacher 's dentist is tall .	George scares your grandmother 's mom 's teacher 's dentist is tall .
Jerry knows that your mom 's teacher 's mother 's mom is lucky .	Jerry helps your mom 's teacher 's mother 's mom is lucky .
Jane says that your son 's brother 's husband 's sister is clever .	Jane talks to your son 's brother 's husband 's sister is clever .
your teacher thinks that your boss 's husband 's teacher 's friend is excited .	your teacher talks to your boss 's husband 's teacher 's friend is excited .
Richard thinks that my teacher 's teacher 's dentist 's husband is angry .	Richard helps my teacher 's teacher 's dentist 's husband is angry .
Liam thinks that my friend 's dentist 's teacher 's mom is curious .	Liam talks to my friend 's dentist 's teacher 's mom is curious .
the person says that your grandmother 's boss 's father 's dentist is wrong .	the person helps your grandmother 's boss 's father 's dentist is wrong .
your dentist thinks that your cousin 's friend 's brother 's wife is boring .	your dentist scares your cousin 's friend 's brother 's wife is boring .
my teacher knows that your sister 's dad 's cousin 's boss is boring .	my teacher scares your sister 's dad 's cousin 's boss is boring .
my cousin says that your daughter 's daughter 's teacher 's dad is friendly .	my cousin works with your daughter 's daughter 's teacher 's dad is friendly .
Carl knows that my teacher 's father 's boss 's husband is busy .	Carl scares my teacher 's father 's boss 's husband is busy .
Steven thinks that your cousin 's mom 's teacher 's dad is friendly .	Steven works with your cousin 's mom 's teacher 's dad is friendly .
Leslie thinks that my teacher 's teacher 's brother 's husband is important .	Leslie scares my teacher 's teacher 's brother 's husband is important .
the dancer thinks that your grandmother 's cousin 's son 's grandmother is wrong .	the dancer scares your grandmother 's cousin 's son 's grandmother is wrong .
the patient thinks that your mother 's boss 's doctor 's teacher is boring .	the patient scares your mother 's boss 's doctor 's teacher is boring .
the driver says that your teacher 's father 's friend 's grandmother is happy .	the driver talks to your teacher 's father 's friend 's grandmother is happy .
your friend says that your wife 's doctor 's mom 's doctor is important .	your friend talks to your wife 's doctor 's mom 's doctor is important .
the child thinks that my wife 's father 's father 's daughter is helpful .	the child talks to my wife 's father 's father 's daughter is helpful .
my teacher thinks that my brother 's boss 's cousin 's cousin is smart .	my teacher works with my brother 's boss 's cousin 's cousin is smart .
Brett thinks that your teacher 's dad 's doctor 's mother is young .	Brett works with your teacher 's dad 's doctor 's mother is young .
my boss thinks that my cousin 's brother 's friend 's daughter is gentle .	my boss talks to my cousin 's brother 's friend 's daughter is gentle .
your doctor knows that your wife 's teacher 's father 's brother is excited .	your doctor helps your wife 's teacher 's father 's brother is excited .
my dentist thinks that your grandmother 's son 's brother 's boss is lucky .	my dentist works with your grandmother 's son 's brother 's boss is lucky .
Deborah says that your dentist 's wife 's son 's boss is friendly .	Deborah talks to your dentist 's wife 's son 's boss is friendly .
Nancy says that my son 's teacher 's son 's cousin is boring .	Nancy scares my son 's teacher 's son 's cousin is boring .
Jill knows that my sister 's brother 's cousin 's teacher is busy .	Jill talks to my sister 's brother 's cousin 's teacher is busy .
Judy thinks that your teacher 's sister 's brother 's teacher is young .	Judy works with your teacher 's sister 's brother 's teacher is young .
Kayla says that your daughter 's brother 's dad 's boss is confused .	Kayla helps your daughter 's brother 's dad 's boss is confused .
your teacher thinks that my wife 's wife 's cousin 's grandmother is angry .	your teacher talks to my wife 's wife 's cousin 's grandmother is angry .
Donald knows that my brother 's mother 's husband 's son is angry .	Donald works with my brother 's mother 's husband 's son is angry .
the dancer says that your doctor 's brother 's boss 's grandmother is lucky .	the dancer talks to your doctor 's brother 's boss 's grandmother is lucky .
Donna says that my boss 's wife 's doctor 's friend is hungry .	Donna scares my boss 's wife 's doctor 's friend is hungry .
Adam says that your mom 's boss 's friend 's doctor is curious .	Adam helps your mom 's boss 's friend 's doctor is curious .
Barbara knows that your boss 's friend 's father 's grandmother is tired .	Barbara helps your boss 's friend 's father 's grandmother is tired .
George thinks that my son 's mom 's brother 's mom is careful .	George works with my son 's mom 's brother 's mom is careful .
your teacher thinks that your teacher 's dad 's sister 's cousin is careful .	your teacher works with your teacher 's dad 's sister 's cousin is careful .
Liam says that your boss 's teacher 's wife 's wife is gentle .	Liam works with your boss 's teacher 's wife 's wife is gentle .
the teacher says that your teacher 's grandmother 's cousin 's brother is helpful .	the teacher scares your teacher 's grandmother 's cousin 's brother is helpful .
your cousin says that my friend 's dentist 's daughter 's brother is tired .	your cousin works with my friend 's dentist 's daughter 's brother is tired .
Deborah says that your son 's mom 's doctor 's son is tired .	Deborah works with your son 's mom 's doctor 's son is tired .
John thinks that my dad 's brother 's sister 's dentist is gentle .	John talks to my dad 's brother 's sister 's dentist is gentle .
the dancer knows that your teacher 's brother 's doctor 's brother is healthy .	the dancer helps your teacher 's brother 's doctor 's brother is healthy .
your boss thinks that my son 's mother 's son 's dad is sleepy .	your boss talks to my son 's mother 's son 's dad is sleepy .
Laurie thinks that your grandmother 's husband 's doctor 's doctor is wrong .	Laurie talks to your grandmother 's husband 's doctor 's doctor is wrong .
Jennifer thinks that my mother 's mother 's wife 's cousin is wrong .	Jennifer works with my mother 's mother 's wife 's cousin is wrong .
my boss thinks that your mother 's friend 's boss 's father is helpful .	my boss helps your mother 's friend 's boss 's father is helpful .
the dancer says that my sister 's brother 's doctor 's brother is surprised .	the dancer scares my sister 's brother 's doctor 's brother is surprised .
the adult thinks that your grandmother 's wife 's dentist 's daughter is tall .	the adult works with your grandmother 's wife 's dentist 's daughter is tall .
your friend knows that your mother 's friend 's sister 's husband is clever .	your friend helps your mother 's friend 's sister 's husband is clever .
your friend says that my doctor 's grandmother 's dad 's brother is tired .	your friend works with my doctor 's grandmother 's dad 's brother is tired .
my friend thinks that your son 's brother 's grandmother 's grandmother is curious .	my friend scares your son 's brother 's grandmother 's grandmother is curious .
your doctor knows that your mom 's brother 's teacher 's husband is bored .	your doctor works with your mom 's brother 's teacher 's husband is bored .
Aaron knows that your friend 's daughter 's boss 's doctor is important .	Aaron talks to your friend 's daughter 's boss 's doctor is important .
my boss says that my mom 's father 's sister 's doctor is sleepy .	my boss helps my mom 's father 's sister 's doctor is sleepy .
my doctor thinks that your daughter 's teacher 's grandmother 's wife is important .	my doctor works with your daughter 's teacher 's grandmother 's wife is important .
the adult knows that your son 's husband 's sister 's grandmother is nice .	the adult scares your son 's husband 's sister 's grandmother is nice .
my boss thinks that your grandmother 's father 's wife 's boss is gentle .	my boss works with your grandmother 's father 's wife 's boss is gentle .
the patient says that my sister 's friend 's brother 's son is excited .	the patient works with my sister 's friend 's brother 's son is excited .
the patient says that your father 's daughter 's mother 's teacher is wrong .	the patient talks to your father 's daughter 's mother 's teacher is wrong .
my doctor thinks that my dad 's doctor 's boss 's boss is strong .	my doctor helps my dad 's doctor 's boss 's boss is strong .
my doctor says that my teacher 's dad 's husband 's cousin is smart .	my doctor scares my teacher 's dad 's husband 's cousin is smart .
your cousin knows that my mother 's son 's dentist 's friend is happy .	your cousin talks to my mother 's son 's dentist 's friend is happy .
Ann thinks that my son 's brother 's mother 's friend is busy .	Ann talks to my son 's brother 's mother 's friend is busy .
David thinks that my mother 's sister 's boss 's sister is angry .	David helps my mother 's sister 's boss 's sister is angry .
my teacher says that my boss 's mother 's mother 's father is bored .	my teacher works with my boss 's mother 's mother 's father is bored .
the customer says that your husband 's teacher 's doctor 's son is careful .	the customer works with your husband 's teacher 's doctor 's son is careful .
Barbara thinks that my teacher 's dad 's daughter 's father is friendly .	Barbara helps my teacher 's dad 's daughter 's father is friendly .
Kayla knows that your mother 's dad 's doctor 's father is helpful .	Kayla talks to your mother 's dad 's doctor 's father is helpful .
my boss says that my sister 's grandmother 's daughter 's son is quiet .	my boss scares my sister 's grandmother 's daughter 's son is quiet .
the teacher says that your father 's husband 's dad 's friend is busy .	the teacher scares your father 's husband 's dad 's friend is busy .
your teacher thinks that your cousin 's husband 's grandmother 's friend is strong .	your teacher scares your cousin 's husband 's grandmother 's friend is strong .
your cousin thinks that your wife 's father 's husband 's grandmother is happy .	your cousin talks to your wife 's father 's husband 's grandmother is happy .
the doctor thinks that my mom 's grandmother 's doctor 's mother is happy .	the doctor helps my mom 's grandmother 's doctor 's mother is happy .
the dentist knows that my mother 's boss 's brother 's father is upset .	the dentist scares my mother 's boss 's brother 's father is upset .
Dan thinks that my mother 's sister 's sister 's father is smart .	Dan scares my mother 's sister 's sister 's father is smart .
my teacher says that my mother 's mom 's cousin 's father is important .	my teacher scares my mother 's mom 's cousin 's father is important .
your doctor thinks that your son 's doctor 's teacher 's boss is upset .	your doctor helps your son 's doctor 's teacher 's boss is upset .
Ronald says that my friend 's grandmother 's wife 's cousin is excited .	Ronald helps my friend 's grandmother 's wife 's cousin is excited .
Bill says that my mother 's mom 's father 's mom is surprised .	Bill works with my mother 's mom 's father 's mom is surprised .
your teacher says that my daughter 's dad 's mom 's doctor is angry .	your teacher scares my daughter 's dad 's mom 's doctor is angry .
my dentist knows that your sister 's wife 's mom 's dentist is curious .	my dentist helps your sister 's wife 's mom 's dentist is curious .
Liam thinks that your father 's sister 's son 's teacher is nice .	Liam helps your father 's sister 's son 's teacher is nice .
the teacher knows that your boss 's doctor 's mom 's daughter is hungry .	the teacher talks to your boss 's doctor 's mom 's daughter is hungry .
the customer says that my teacher 's cousin 's dad 's brother is happy .	the customer helps my teacher 's cousin 's dad 's brother is happy .
the child thinks that your cousin 's mom 's mom 's dad is kind .	the child helps your cousin 's mom 's mom 's dad is kind .
the person says that my grandmother 's mom 's brother 's mother is excited .	the person works with my grandmother 's mom 's brother 's mother is excited .
the person knows that your dentist 's boss 's daughter 's grandmother is hungry .	the person talks to your dentist 's boss 's daughter 's grandmother is hungry .
Judy knows that my father 's mother 's husband 's mother is wrong .	Judy works with my father 's mother 's husband 's mother is wrong .
my boss knows that your son 's dad 's grandmother 's boss is busy .	my boss talks to your son 's dad 's grandmother 's boss is busy .
Donald thinks that your sister 's mother 's cousin 's doctor is hungry .	Donald scares your sister 's mother 's cousin 's doctor is hungry .
Allison thinks that your grandmother 's sister 's daughter 's mom is gentle .	Allison scares your grandmother 's sister 's daughter 's mom is gentle .
the doctor knows that my mother 's father 's teacher 's cousin is hungry .	the doctor helps my mother 's father 's teacher 's cousin is hungry .
Michelle knows that your friend 's teacher 's teacher 's husband is happy .	Michelle works with your friend 's teacher 's teacher 's husband is happy .
my teacher says that your daughter 's sister 's dad 's wife is nice .	my teacher works with your daughter 's sister 's dad 's wife is nice .
my teacher thinks that my wife 's doctor 's father 's husband is friendly .	my teacher scares my wife 's doctor 's father 's husband is friendly .
your teacher says that my brother 's husband 's father 's friend is surprised .	your teacher helps my brother 's husband 's father 's friend is surprised .
Barbara thinks that your son 's mother 's cousin 's father is strong .	Barbara scares your son 's mother 's cousin 's father is strong .
the doctor knows that my father 's sister 's dentist 's brother is gentle .	the doctor talks to my father 's sister 's dentist 's brother is gentle .
your doctor knows that my teacher 's wife 's sister 's husband is upset .	your doctor talks to my teacher 's wife 's sister 's husband is upset .
your dentist says that my mom 's mother 's friend 's teacher is nice .	your dentist scares my mom 's mother 's friend 's teacher is nice .
your dentist says that your boss 's cousin 's boss 's friend is surprised .	your dentist scares your boss 's cousin 's boss 's friend is surprised .
Julie thinks that your husband 's cousin 's wife 's dad is lucky .	Julie helps your husband 's cousin 's wife 's dad is lucky .
Todd thinks that your boss 's doctor 's dad 's dad is important .	Todd talks to your boss 's doctor 's dad 's dad is important .
my teacher thinks that my doctor 's brother 's friend 's mom is sleepy .	my teacher helps my doctor 's brother 's friend 's mom is sleepy .
Rebecca knows that my cousin 's cousin 's father 's son is nice .	Rebecca works with my cousin 's cousin 's father 's son is nice .
Catherine knows that my daughter 's teacher 's mom 's brother is young .	Catherine scares my daughter 's teacher 's mom 's brother is young .
my teacher knows that your sister 's friend 's doctor 's father is young .	my teacher helps your sister 's friend 's doctor 's father is young .
the dentist thinks that my mom 's sister 's father 's doctor is tall .	the dentist helps my mom 's sister 's father 's doctor is tall .
my cousin thinks that your cousin 's wife 's father 's mom is clever .	my cousin helps your cousin 's wife 's father 's mom is clever .
my doctor says that my grandmother 's father 's dentist 's brother is confused .	my doctor scares my grandmother 's father 's dentist 's brother is confused .
the child says that your daughter 's son 's sister 's mom is happy .	the child scares your daughter 's son 's sister 's mom is happy .
your friend knows that your grandmother 's teacher 's wife 's grandmother is bored .	your friend works with your grandmother 's teacher 's wife 's grandmother is bored .
your boss thinks that your husband 's dad 's dentist 's mom is bored .	your boss scares your husband 's dad 's dentist 's mom is bored .
the driver thinks that your friend 's dad 's dentist 's mom is young .	the driver talks to your friend 's dad 's dentist 's mom is young .
the person says that your son 's daughter 's mom 's son is sleepy .	the person works with your son 's daughter 's mom 's son is sleepy .
the customer says that my teacher 's father 's grandmother 's teacher is healthy .	the customer scares my teacher 's father 's grandmother 's teacher is healthy .
David thinks that my wife 's son 's boss 's mom is important .	David scares my wife 's son 's boss 's mom is important .
your teacher knows that your cousin 's boss 's grandmother 's wife is sleepy .	your teacher talks to your cousin 's boss 's grandmother 's wife is sleepy .
James says that your son 's cousin 's grandmother 's dad is surprised .	James helps your son 's cousin 's grandmother 's dad is surprised .
the teacher says that my boss 's wife 's son 's cousin is tall .	the teacher scares my boss 's wife 's son 's cousin is tall .
Julie thinks that my friend 's cousin 's son 's dentist is happy .	Julie talks to my friend 's cousin 's son 's dentist is happy .
the teacher says that your brother 's cousin 's boss 's doctor is angry .	the teacher talks to your brother 's cousin 's boss 's doctor is angry .
Alice thinks that my grandmother 's mother 's cousin 's dentist is friendly .	Alice talks to my grandmother 's mother 's cousin 's dentist is friendly .
my cousin says that my sister 's teacher 's daughter 's brother is healthy .	my cousin talks to my sister 's teacher 's daughter 's brother is healthy .
my boss knows that your brother 's dentist 's brother 's friend is curious .	my boss works with your brother 's dentist 's brother 's friend is curious .
your doctor says that my mom 's husband 's sister 's father is helpful .	your doctor talks to my mom 's husband 's sister 's father is helpful .
your boss knows that my mom 's mother 's sister 's dad is bored .	your boss works with my mom 's mother 's sister 's dad is bored .
your teacher thinks that my sister 's wife 's husband 's father is tall .	your teacher works with my sister 's wife 's husband 's father is tall .
the dentist knows that my mother 's wife 's friend 's father is gentle .	the dentist talks to my mother 's wife 's friend 's father is gentle .
your boss thinks that my mother 's mom 's father 's daughter is smart .	your boss works with my mother 's mom 's father 's daughter is smart .
the dancer says that my cousin 's son 's cousin 's daughter is boring .	the dancer helps my cousin 's son 's cousin 's daughter is boring .
Laurie knows that my son 's sister 's teacher 's dentist is wrong .	Laurie helps my son 's sister 's teacher 's dentist is wrong .
the adult says that your teacher 's husband 's mother 's daughter is angry .	the adult scares your teacher 's husband 's mother 's daughter is angry .
the person thinks that my cousin 's dentist 's wife 's friend is careful .	the person talks to my cousin 's dentist 's wife 's friend is careful .
my doctor knows that your wife 's dentist 's mother 's son is quiet .	my doctor scares your wife 's dentist 's mother 's son is quiet .
Noah thinks that your sister 's mother 's son 's dentist is tall .	Noah talks to your sister 's mother 's son 's dentist is tall .
Carl thinks that my doctor 's friend 's boss 's sister is excited .	Carl talks to my doctor 's friend 's boss 's sister is excited .
Jennifer knows that my grandmother 's teacher 's mom 's boss is friendly .	Jennifer scares my grandmother 's teacher 's mom 's boss is friendly .
the patient says that my boss 's teacher 's dad 's dentist is tall .	the patient helps my boss 's teacher 's dad 's dentist is tall .
the driver thinks that my boss 's boss 's daughter 's friend is kind .	the driver works with my boss 's boss 's daughter 's friend is kind .
Sarah says that your mother 's boss 's daughter 's dentist is busy .	Sarah works with your mother 's boss 's daughter 's dentist is busy .
Lisa thinks that my dad 's daughter 's grandmother 's dad is surprised .	Lisa works with my dad 's daughter 's grandmother 's dad is surprised .
Ronald knows that your brother 's wife 's mom 's teacher is nice .	Ronald talks to your brother 's wife 's mom 's teacher is nice .
my cousin knows that my grandmother 's mom 's son 's mother is tired .	my cousin scares my grandmother 's mom 's son 's mother is tired .
Julie thinks that my daughter 's dad 's daughter 's grandmother is tall .	Julie talks to my daughter 's dad 's daughter 's grandmother is tall .
the dancer thinks that my friend 's daughter 's teacher 's son is upset .	the dancer helps my friend 's daughter 's teacher 's son is upset .
your boss says that my brother 's son 's mom 's son is wrong .	your boss scares my brother 's son 's mom 's son is wrong .
Nina says that your friend 's father 's son 's wife is curious .	Nina works with your friend 's father 's son 's wife is curious .
Judy thinks that your friend 's son 's mother 's son is busy .	Judy scares your friend 's son 's mother 's son is busy .
the doctor thinks that your father 's boss 's boss 's doctor is bored .	the doctor works with your father 's boss 's boss 's doctor is bored .
my friend says that your daughter 's mom 's cousin 's teacher is excited .	my friend helps your daughter 's mom 's cousin 's teacher is excited .
the customer knows that my doctor 's daughter 's friend 's son is bored .	the customer works with my doctor 's daughter 's friend 's son is bored .
the dancer thinks that your sister 's son 's cousin 's brother is quiet .	the dancer works with your sister 's son 's cousin 's brother is quiet .
my teacher knows that my doctor 's son 's friend 's son is bored .	my teacher talks to my doctor 's son 's friend 's son is bored .
your cousin knows that your husband 's mother 's grandmother 's wife is hungry .	your cousin talks to your husband 's mother 's grandmother 's wife is hungry .
the doctor says that my boss 's sister 's husband 's grandmother is happy .	the doctor helps my boss 's sister 's husband 's grandmother is happy .
my teacher knows that your dentist 's friend 's grandmother 's brother is upset .	my teacher helps your dentist 's friend 's grandmother 's brother is upset .
your boss thinks that my cousin 's friend 's doctor 's mother is busy .	your boss scares my cousin 's friend 's doctor 's mother is busy .
Todd thinks that your son 's teacher 's dentist 's husband is friendly .	Todd works with your son 's teacher 's dentist 's husband is friendly .
David knows that your husband 's friend 's mom 's wife is angry .	David talks to your husband 's friend 's mom 's wife is angry .
my cousin says that my wife 's cousin 's mom 's grandmother is healthy .	my cousin talks to my wife 's cousin 's mom 's grandmother is healthy .
your friend knows that your wife 's doctor 's dad 's son is surprised .	your friend talks to your wife 's doctor 's dad 's son is surprised .
my dentist says that your husband 's daughter 's husband 's sister is curious .	my dentist works with your husband 's daughter 's husband 's sister is curious .
your doctor says that my teacher 's dentist 's brother 's boss is surprised .	your doctor talks to my teacher 's dentist 's brother 's boss is surprised .
your dentist says that your husband 's friend 's teacher 's wife is kind .	your dentist helps your husband 's friend 's teacher 's wife is kind .
Donna knows that your son 's husband 's dentist 's dad is clever .	Donna works with your son 's husband 's dentist 's dad is clever .
the customer says that your wife 's dentist 's cousin 's cousin is tall .	the customer talks to your wife 's dentist 's cousin 's cousin is tall .
the patient says that your daughter 's mother 's mother 's boss is gentle .	the patient talks to your daughter 's mother 's mother 's boss is gentle .
my cousin says that your daughter 's sister 's wife 's grandmother is lucky .	my cousin scares your daughter 's sister 's wife 's grandmother is lucky .
Steven knows that my sister 's daughter 's doctor 's grandmother is gentle .	Steven scares my sister 's daughter 's doctor 's grandmother is gentle .
Kevin knows that your mom 's doctor 's daughter 's son is nice .	Kevin helps your mom 's doctor 's daughter 's son is nice .
my dentist says that your son 's doctor 's brother 's grandmother is excited .	my dentist works with your son 's doctor 's brother 's grandmother is excited .
the driver thinks that my son 's father 's father 's doctor is angry .	the driver scares my son 's father 's father 's doctor is angry .
Patrick thinks that your cousin 's friend 's grandmother 's dentist is important .	Patrick works with your cousin 's friend 's grandmother 's dentist is important .
the adult thinks that my cousin 's husband 's sister 's cousin is boring .	the adult works with my cousin 's husband 's sister 's cousin is boring .
Gregory says that my doctor 's mother 's sister 's brother is lucky .	Gregory works with my doctor 's mother 's sister 's brother is lucky .
Jennifer knows that my father 's dad 's sister 's friend is smart .	Jennifer scares my father 's dad 's sister 's friend is smart .
your doctor says that my mom 's wife 's friend 's teacher is tired .	your doctor works with my mom 's wife 's friend 's teacher is tired .
Anna says that my friend 's mom 's brother 's daughter is kind .	Anna talks to my friend 's mom 's brother 's daughter is kind .
the doctor knows that my daughter 's teacher 's son 's sister is hungry .	the doctor helps my daughter 's teacher 's son 's sister is hungry .
the adult thinks that your son 's friend 's teacher 's dad is nice .	the adult scares your son 's friend 's teacher 's dad is nice .
George says that your grandmother 's mother 's daughter 's father is helpful .	George helps your grandmother 's mother 's daughter 's father is helpful .
the teacher knows that my cousin 's teacher 's mom 's dad is smart .	the teacher talks to my cousin 's teacher 's mom 's dad is smart .
the patient says that my doctor 's boss 's dad 's dad is curious .	the patient scares my doctor 's boss 's dad 's dad is curious .
Anna thinks that my friend 's dentist 's father 's husband is smart .	Anna works with my friend 's dentist 's father 's husband is smart .
Nina says that your son 's teacher 's cousin 's mother is angry .	Nina helps your son 's teacher 's cousin 's mother is angry .
the patient thinks that your mother 's mom 's sister 's mom is sleepy .	the patient helps your mother 's mom 's sister 's mom is sleepy .
the teacher thinks that your teacher 's mom 's cousin 's father is hungry .	the teacher helps your teacher 's mom 's cousin 's father is hungry .
your boss knows that your sister 's wife 's grandmother 's dentist is bored .	your boss helps your sister 's wife 's grandmother 's dentist is bored .
Sally knows that my doctor 's son 's father 's teacher is excited .	Sally helps my doctor 's son 's father 's teacher is excited .
the driver knows that my sister 's father 's mother 's wife is curious .	the driver scares my sister 's father 's mother 's wife is curious .
Patrick says that my grandmother 's boss 's cousin 's wife is hungry .	Patrick scares my grandmother 's boss 's cousin 's wife is hungry .
Laura knows that your cousin 's teacher 's daughter 's cousin is tall .	Laura talks to your cousin 's teacher 's daughter 's cousin is tall .
the teacher thinks that your son 's daughter 's teacher 's mom is gentle .	the teacher scares your son 's daughter 's teacher 's mom is gentle .
my boss says that my boss 's dentist 's brother 's dentist is surprised .	my boss helps my boss 's dentist 's brother 's dentist is surprised .
Scott knows that your dad 's friend 's dentist 's mom is wrong .	Scott scares your dad 's friend 's dentist 's mom is wrong .
Ann says that my father 's son 's doctor 's dentist is hungry .	Ann helps my father 's son 's doctor 's dentist is hungry .
the dentist knows that my cousin 's son 's friend 's teacher is upset .	the dentist works with my cousin 's son 's friend 's teacher is upset .
my teacher says that my teacher 's dentist 's dad 's brother is hungry .	my teacher scares my teacher 's dentist 's dad 's brother is hungry .
Vanessa says that my cousin 's dad 's wife 's husband is helpful .	Vanessa helps my cousin 's dad 's wife 's husband is helpful .
Guy thinks that your daughter 's dad 's wife 's sister is healthy .	Guy works with your daughter 's dad 's wife 's sister is healthy .
the child says that your husband 's son 's teacher 's husband is hungry .	the child helps your husband 's son 's teacher 's husband is hungry .
Carl says that your wife 's mother 's dentist 's daughter is angry .	Carl talks to your wife 's mother 's dentist 's daughter is angry .
the doctor thinks that your mother 's cousin 's husband 's mother is confused .	the doctor helps your mother 's cousin 's husband 's mother is confused .
Brian thinks that your son 's dentist 's brother 's brother is friendly .	Brian works with your son 's dentist 's brother 's brother is friendly .
the customer says that your teacher 's mother 's brother 's daughter is strong .	the customer works with your teacher 's mother 's brother 's daughter is strong .
the adult says that your husband 's father 's grandmother 's dad is surprised .	the adult works with your husband 's father 's grandmother 's dad is surprised .
your friend thinks that your father 's son 's husband 's dad is angry .	your friend talks to your father 's son 's husband 's dad is angry .
the patient thinks that my father 's cousin 's teacher 's mom is friendly .	the patient talks to my father 's cousin 's teacher 's mom is friendly .
Jason knows that your wife 's mother 's grandmother 's daughter is young .	Jason scares your wife 's mother 's grandmother 's daughter is young .
the person knows that your son 's brother 's husband 's brother is tall .	the person helps your son 's brother 's husband 's brother is tall .
Adam knows that your doctor 's boss 's dad 's teacher is hungry .	Adam helps your doctor 's boss 's dad 's teacher is hungry .
Jerry thinks that my father 's grandmother 's cousin 's brother is clever .	Jerry scares my father 's grandmother 's cousin 's brother is clever .
the doctor says that your teacher 's doctor 's mom 's teacher is tall .	the doctor works with your teacher 's doctor 's mom 's teacher is tall .
my dentist thinks that my son 's doctor 's mom 's mom is tired .	my dentist scares my son 's doctor 's mom 's mom is tired .
Alice knows that my cousin 's son 's sister 's cousin is healthy .	Alice scares my cousin 's son 's sister 's cousin is healthy .
the customer says that your sister 's sister 's mother 's cousin is strong .	the customer scares your sister 's sister 's mother 's cousin is strong .
Martin says that my boss 's doctor 's mother 's wife is angry .	Martin talks to my boss 's doctor 's mother 's wife is angry .
Donald thinks that your mom 's father 's daughter 's wife is sleepy .	Donald helps your mom 's father 's daughter 's wife is sleepy .
the person says that your grandmother 's daughter 's mom 's friend is strong .	the person scares your grandmother 's daughter 's mom 's friend is strong .
Nina says that your mother 's dentist 's sister 's husband is helpful .	Nina scares your mother 's dentist 's sister 's husband is helpful .
my friend knows that my grandmother 's brother 's dentist 's friend is strong .	my friend works with my grandmother 's brother 's dentist 's friend is strong .
Frank says that my mom 's father 's father 's doctor is important .	Frank scares my mom 's father 's father 's doctor is important .
Ronald says that your sister 's husband 's mother 's dad is tired .	Ronald talks to your sister 's husband 's mother 's dad is tired .
your boss knows that your dad 's doctor 's dad 's friend is upset .	your boss scares your dad 's doctor 's dad 's friend is upset .
the dancer says that your brother 's boss 's dentist 's dad is young .	the dancer talks to your brother 's boss 's dentist 's dad is young .
the driver knows that your sister 's doctor 's son 's dentist is angry .	the driver works with your sister 's doctor 's son 's dentist is angry .
William knows that your doctor 's teacher 's boss 's husband is sleepy .	William helps your doctor 's teacher 's boss 's husband is sleepy .
your teacher says that your mother 's daughter 's mom 's father is excited .	your teacher works with your mother 's daughter 's mom 's father is excited .
the patient says that your sister 's doctor 's wife 's daughter is confused .	the patient helps your sister 's doctor 's wife 's daughter is confused .
my teacher says that my dad 's daughter 's dad 's son is tired .	my teacher works with my dad 's daughter 's dad 's son is tired .
the dancer thinks that your doctor 's son 's wife 's son is gentle .	the dancer talks to your doctor 's son 's wife 's son is gentle .
the doctor knows that your dentist 's sister 's sister 's wife is nice .	the doctor scares your dentist 's sister 's sister 's wife is nice .
Judy says that my grandmother 's grandmother 's doctor 's dentist is helpful .	Judy helps my grandmother 's grandmother 's doctor 's dentist is helpful .
Nina says that your father 's teacher 's mom 's boss is happy .	Nina works with your father 's teacher 's mom 's boss is happy .
the person knows that your mom 's daughter 's wife 's father is careful .	the person talks to your mom 's daughter 's wife 's father is careful .
Patrick knows that my dad 's father 's sister 's son is boring .	Patrick helps my dad 's father 's sister 's son is boring .
your dentist thinks that my boss 's dad 's son 's brother is gentle .	your dentist talks to my boss 's dad 's son 's brother is gentle .
my dentist thinks that your dentist 's grandmother 's sister 's teacher is boring .	my dentist scares your dentist 's grandmother 's sister 's teacher is boring .
the dancer thinks that your cousin 's cousin 's sister 's sister is boring .	the dancer works with your cousin 's cousin 's sister 's sister is boring .
your teacher says that your cousin 's sister 's friend 's brother is young .	your teacher works with your cousin 's sister 's friend 's brother is young .
the teacher says that my brother 's doctor 's husband 's mom is lucky .	the teacher talks to my brother 's doctor 's husband 's mom is lucky .
the doctor says that my wife 's daughter 's cousin 's friend is angry .	the doctor talks to my wife 's daughter 's cousin 's friend is angry .
Susan thinks that my cousin 's daughter 's sister 's mom is excited .	Susan works with my cousin 's daughter 's sister 's mom is excited .
my boss thinks that my boss 's brother 's brother 's dad is busy .	my boss works with my boss 's brother 's brother 's dad is busy .
the customer knows that my cousin 's friend 's dentist 's teacher is busy .	the customer scares my cousin 's friend 's dentist 's teacher is busy .
my cousin says that my sister 's mom 's husband 's mother is confused .	my cousin talks to my sister 's mom 's husband 's mother is confused .
Allison says that my friend 's mom 's son 's dad is busy .	Allison works with my friend 's mom 's son 's dad is busy .
the dentist says that your dad 's boss 's friend 's doctor is hungry .	the dentist helps your dad 's boss 's friend 's doctor is hungry .
Laurie thinks that your dentist 's father 's son 's teacher is young .	Laurie talks to your dentist 's father 's son 's teacher is young .
your dentist knows that my friend 's daughter 's son 's son is excited .	your dentist works with my friend 's daughter 's son 's son is excited .
the customer knows that your sister 's friend 's teacher 's grandmother is confused .	the customer helps your sister 's friend 's teacher 's grandmother is confused .
the person thinks that your brother 's doctor 's cousin 's mom is gentle .	the person talks to your brother 's doctor 's cousin 's mom is gentle .
Ann knows that your friend 's father 's father 's cousin is happy .	Ann works with your friend 's father 's father 's cousin is happy .
Rachel knows that your dentist 's husband 's doctor 's cousin is surprised .	Rachel talks to your dentist 's husband 's doctor 's cousin is surprised .
your teacher knows that your teacher 's husband 's grandmother 's boss is quiet .	your teacher works with your teacher 's husband 's grandmother 's boss is quiet .
Alice thinks that my dentist 's boss 's wife 's friend is careful .	Alice works with my dentist 's boss 's wife 's friend is careful .
your teacher knows that my dad 's son 's teacher 's father is curious .	your teacher talks to my dad 's son 's teacher 's father is curious .
Kristen thinks that my teacher 's teacher 's mother 's daughter is busy .	Kristen works with my teacher 's teacher 's mother 's daughter is busy .
the child says that my daughter 's husband 's husband 's husband is smart .	the child works with my daughter 's husband 's husband 's husband is smart .
the child knows that your sister 's grandmother 's sister 's wife is lucky .	the child talks to your sister 's grandmother 's sister 's wife is lucky .
the person knows that your grandmother 's mom 's boss 's boss is clever .	the person scares your grandmother 's mom 's boss 's boss is clever .
your cousin knows that my grandmother 's mom 's boss 's brother is nice .	your cousin scares my grandmother 's mom 's boss 's brother is nice .
Vanessa thinks that my husband 's mom 's friend 's brother is tall .	Vanessa works with my husband 's mom 's friend 's brother is tall .
my dentist says that my son 's dentist 's husband 's mother is busy .	my dentist scares my son 's dentist 's husband 's mother is busy .
Renee says that your mom 's husband 's teacher 's boss is bored .	Renee scares your mom 's husband 's teacher 's boss is bored .
the child thinks that my teacher 's son 's husband 's wife is clever .	the child works with my teacher 's son 's husband 's wife is clever .
Steve says that your daughter 's dad 's grandmother 's cousin is strong .	Steve helps your daughter 's dad 's grandmother 's cousin is strong .
the person thinks that my husband 's sister 's teacher 's son is nice .	the person works with my husband 's sister 's teacher 's son is nice .
my cousin says that my mom 's cousin 's grandmother 's boss is healthy .	my cousin works with my mom 's cousin 's grandmother 's boss is healthy .
Frank thinks that my teacher 's son 's father 's sister is lucky .	Frank scares my teacher 's son 's father 's sister is lucky .
the child knows that your cousin 's dentist 's mom 's mother is happy .	the child works with your cousin 's dentist 's mom 's mother is happy .
the customer thinks that my doctor 's teacher 's sister 's dentist is strong .	the customer works with my doctor 's teacher 's sister 's dentist is strong .
the doctor thinks that my grandmother 's grandmother 's son 's teacher is tall .	the doctor talks to my grandmother 's grandmother 's son 's teacher is tall .
Anna says that your son 's sister 's doctor 's wife is tall .	Anna scares your son 's sister 's doctor 's wife is tall .
your friend thinks that your father 's wife 's grandmother 's mom is excited .	your friend scares your father 's wife 's grandmother 's mom is excited .
the adult says that my cousin 's friend 's brother 's teacher is nice .	the adult scares my cousin 's friend 's brother 's teacher is nice .
Christopher knows that my son 's teacher 's son 's boss is kind .	Christopher helps my son 's teacher 's son 's boss is kind .
the child knows that your mom 's mom 's daughter 's dentist is nice .	the child talks to your mom 's mom 's daughter 's dentist is nice .
Laura knows that my friend 's mother 's cousin 's doctor is gentle .	Laura works with my friend 's mother 's cousin 's doctor is gentle .
my dentist says that my brother 's husband 's cousin 's teacher is bored .	my dentist talks to my brother 's husband 's cousin 's teacher is bored .
Rebecca knows that my teacher 's dentist 's doctor 's cousin is friendly .	Rebecca helps my teacher 's dentist 's doctor 's cousin is friendly .
your doctor knows that your sister 's dad 's son 's friend is surprised .	your doctor helps your sister 's dad 's son 's friend is surprised .
Erin thinks that my grandmother 's cousin 's sister 's husband is clever .	Erin scares my grandmother 's cousin 's sister 's husband is clever .
Laura says that my daughter 's grandmother 's son 's sister is clever .	Laura scares my daughter 's grandmother 's son 's sister is clever .
Frank thinks that your dad 's wife 's wife 's doctor is tired .	Frank scares your dad 's wife 's wife 's doctor is tired .
the driver thinks that my mom 's friend 's father 's mom is tall .	the driver talks to my mom 's friend 's father 's mom is tall .
Joseph says that my doctor 's cousin 's doctor 's dentist is gentle .	Joseph works with my doctor 's cousin 's doctor 's dentist is gentle .
the adult says that my friend 's daughter 's dentist 's father is surprised .	the adult scares my friend 's daughter 's dentist 's father is surprised .
your teacher thinks that your mother 's teacher 's daughter 's dentist is surprised .	your teacher works with your mother 's teacher 's daughter 's dentist is surprised .
the adult knows that your father 's doctor 's father 's friend is upset .	the adult works with your father 's doctor 's father 's friend is upset .
your doctor says that your boss 's dad 's brother 's boss is wrong .	your doctor scares your boss 's dad 's brother 's boss is wrong .
the person says that my husband 's mom 's son 's sister is strong .	the person scares my husband 's mom 's son 's sister is strong .
Richard says that your mom 's dad 's husband 's wife is busy .	Richard scares your mom 's dad 's husband 's wife is busy .
the person knows that my boss 's daughter 's cousin 's dentist is kind .	the person works with my boss 's daughter 's cousin 's dentist is kind .
the doctor knows that your dad 's teacher 's daughter 's father is lucky .	the doctor scares your dad 's teacher 's daughter 's father is lucky .
Sara thinks that my teacher 's teacher 's dad 's dentist is smart .	Sara talks to my teacher 's teacher 's dad 's dentist is smart .
my boss thinks that your friend 's husband 's son 's daughter is smart .	my boss works with your friend 's husband 's son 's daughter is smart .
your boss thinks that my doctor 's friend 's wife 's brother is young .	your boss talks to my doctor 's friend 's wife 's brother is young .
the doctor knows that my boss 's grandmother 's mother 's daughter is tall .	the doctor scares my boss 's grandmother 's mother 's daughter is tall .
the patient thinks that my friend 's teacher 's boss 's teacher is important .	the patient scares my friend 's teacher 's boss 's teacher is important .
the adult knows that your father 's mother 's sister 's friend is healthy .	the adult works with your father 's mother 's sister 's friend is healthy .
the dancer thinks that my mom 's dad 's wife 's brother is careful .	the dancer talks to my mom 's dad 's wife 's brother is careful .
my friend thinks that my friend 's daughter 's boss 's dentist is tired .	my friend talks to my friend 's daughter 's boss 's dentist is tired .
Rachel says that your daughter 's son 's teacher 's friend is excited .	Rachel helps your daughter 's son 's teacher 's friend is excited .
my cousin thinks that my father 's boss 's sister 's doctor is important .	my cousin helps my father 's boss 's sister 's doctor is important .
the patient knows that my grandmother 's grandmother 's doctor 's mother is confused .	the patient helps my grandmother 's grandmother 's doctor 's mother is confused .
Naomi thinks that my husband 's friend 's dentist 's mom is wrong .	Naomi works with my husband 's friend 's dentist 's mom is wrong .
the patient says that my sister 's boss 's cousin 's dad is tall .	the patient scares my sister 's boss 's cousin 's dad is tall .
your boss thinks that your mother 's son 's mom 's mother is hungry .	your boss talks to your mother 's son 's mom 's mother is hungry .
your boss says that your brother 's cousin 's boss 's father is young .	your boss talks to your brother 's cousin 's boss 's father is young .
your doctor thinks that my father 's teacher 's doctor 's husband is happy .	your doctor scares my father 's teacher 's doctor 's husband is happy .
the child knows that my father 's dad 's father 's sister is gentle .	the child talks to my father 's dad 's father 's sister is gentle .
David says that my father 's friend 's mom 's cousin is clever .	David scares my father 's friend 's mom 's cousin is clever .
the child thinks that my dad 's boss 's sister 's sister is friendly .	the child works with my dad 's boss 's sister 's sister is friendly .
the dentist knows that my dentist 's cousin 's teacher 's friend is important .	the dentist talks to my dentist 's cousin 's teacher 's friend is important .
Guy knows that my teacher 's wife 's mother 's grandmother is sleepy .	Guy works with my teacher 's wife 's mother 's grandmother is sleepy .
Allison knows that your daughter 's teacher 's dentist 's sister is tired .	Allison helps your daughter 's teacher 's dentist 's sister is tired .
the customer says that your teacher 's dad 's doctor 's grandmother is surprised .	the customer talks to your teacher 's dad 's doctor 's grandmother is surprised .
my doctor says that my father 's cousin 's son 's father is careful .	my doctor scares my father 's cousin 's son 's father is careful .
the customer knows that your sister 's daughter 's father 's mother is kind .	the customer talks to your sister 's daughter 's father 's mother is kind .
your doctor says that your daughter 's grandmother 's grandmother 's sister is curious .	your doctor scares your daughter 's grandmother 's grandmother 's sister is curious .
the child says that my son 's grandmother 's husband 's dentist is healthy .	the child works with my son 's grandmother 's husband 's dentist is healthy .
your doctor says that your dad 's boss 's dad 's father is busy .	your doctor scares your dad 's boss 's dad 's father is busy .
the person thinks that your mother 's daughter 's cousin 's father is boring .	the person scares your mother 's daughter 's cousin 's father is boring .
Jessica says that my cousin 's teacher 's husband 's father is gentle .	Jessica scares my cousin 's teacher 's husband 's father is gentle .
Amelia says that my mom 's son 's dad 's mother is curious .	Amelia talks to my mom 's son 's dad 's mother is curious .
my friend knows that your brother 's cousin 's dad 's dentist is smart .	my friend talks to your brother 's cousin 's dad 's dentist is smart .
your teacher knows that your cousin 's dentist 's mother 's mother is angry .	your teacher scares your cousin 's dentist 's mother 's mother is angry .
Peter says that your dentist 's wife 's brother 's grandmother is bored .	Peter helps your dentist 's wife 's brother 's grandmother is bored .
the customer says that your dad 's mother 's mom 's wife is sleepy .	the customer scares your dad 's mother 's mom 's wife is sleepy .
your dentist thinks that your brother 's brother 's sister 's mother is important .	your dentist helps your brother 's brother 's sister 's mother is important .
the dentist knows that my sister 's cousin 's son 's dentist is tall .	the dentist works with my sister 's cousin 's son 's dentist is tall .
Jessica says that your mother 's brother 's brother 's teacher is boring .	Jessica helps your mother 's brother 's brother 's teacher is boring .
Jill knows that your cousin 's dentist 's sister 's boss is boring .	Jill scares your cousin 's dentist 's sister 's boss is boring .
your teacher thinks that your son 's brother 's teacher 's dad is busy .	your teacher talks to your son 's brother 's teacher 's dad is busy .
my teacher knows that my dad 's dad 's mother 's grandmother is careful .	my teacher helps my dad 's dad 's mother 's grandmother is careful .
Richard knows that your doctor 's grandmother 's brother 's son is healthy .	Richard works with your doctor 's grandmother 's brother 's son is healthy .
Scott says that my daughter 's boss 's boss 's brother is kind .	Scott scares my daughter 's boss 's boss 's brother is kind .
the dancer thinks that your sister 's brother 's friend 's dentist is curious .	the dancer works with your sister 's brother 's friend 's dentist is curious .
Julia knows that my doctor 's cousin 's husband 's mom is hungry .	Julia talks to my doctor 's cousin 's husband 's mom is hungry .
Christopher says that my daughter 's doctor 's sister 's mom is strong .	Christopher scares my daughter 's doctor 's sister 's mom is strong .
my boss knows that your brother 's grandmother 's husband 's friend is hungry .	my boss works with your brother 's grandmother 's husband 's friend is hungry .
the doctor says that your husband 's daughter 's dad 's grandmother is strong .	the doctor talks to your husband 's daughter 's dad 's grandmother is strong .
the driver thinks that your cousin 's brother 's mother 's daughter is happy .	the driver helps your cousin 's brother 's mother 's daughter is happy .
the customer knows that your mother 's grandmother 's brother 's mom is sleepy .	the customer scares your mother 's grandmother 's brother 's mom is sleepy .
the dentist thinks that my sister 's son 's husband 's son is confused .	the dentist works with my sister 's son 's husband 's son is confused .
Linda knows that your doctor 's dentist 's friend 's cousin is important .	Linda scares your doctor 's dentist 's friend 's cousin is important .
my friend knows that your dentist 's dad 's grandmother 's cousin is friendly .	my friend talks to your dentist 's dad 's grandmother 's cousin is friendly .
Guy knows that my mom 's sister 's daughter 's grandmother is hungry .	Guy scares my mom 's sister 's daughter 's grandmother is hungry .
my dentist thinks that your daughter 's dad 's wife 's sister is young .	my dentist works with your daughter 's dad 's wife 's sister is young .
Adam knows that your grandmother 's dad 's cousin 's friend is careful .	Adam works with your grandmother 's dad 's cousin 's friend is careful .
Eric knows that your brother 's wife 's mother 's mom is clever .	Eric works with your brother 's wife 's mother 's mom is clever .
the dancer knows that your friend 's mother 's mom 's dentist is helpful .	the dancer works with your friend 's mother 's mom 's dentist is helpful .
the doctor knows that my boss 's mother 's boss 's mom is excited .	the doctor scares my boss 's mother 's boss 's mom is excited .
my boss knows that my teacher 's doctor 's cousin 's mother is tall .	my boss helps my teacher 's doctor 's cousin 's mother is tall .
the customer thinks that my brother 's wife 's wife 's dentist is kind .	the customer talks to my brother 's wife 's wife 's dentist is kind .
your boss says that your cousin 's mom 's brother 's grandmother is bored .	your boss helps your cousin 's mom 's brother 's grandmother is bored .
Richard thinks that your sister 's mother 's father 's dad is quiet .	Richard scares your sister 's mother 's father 's dad is quiet .
the patient says that my sister 's wife 's father 's mom is surprised .	the patient talks to my sister 's wife 's father 's mom is surprised .
your friend says that your wife 's teacher 's husband 's brother is busy .	your friend scares your wife 's teacher 's husband 's brother is busy .
the doctor thinks that my daughter 's father 's grandmother 's grandmother is surprised .	the doctor talks to my daughter 's father 's grandmother 's grandmother is surprised .
the driver thinks that your dentist 's sister 's dentist 's daughter is confused .	the driver helps your dentist 's sister 's dentist 's daughter is confused .
your cousin knows that my wife 's husband 's friend 's wife is tall .	your cousin works with my wife 's husband 's friend 's wife is tall .
the person thinks that my daughter 's mom 's mother 's husband is excited .	the person scares my daughter 's mom 's mother 's husband is excited .
the doctor says that your boss 's boss 's daughter 's wife is tired .	the doctor talks to your boss 's boss 's daughter 's wife is tired .
Sara knows that your boss 's cousin 's dad 's sister is clever .	Sara scares your boss 's cousin 's dad 's sister is clever .
the customer knows that your dentist 's daughter 's grandmother 's wife is boring .	the customer works with your dentist 's daughter 's grandmother 's wife is boring .
Leslie thinks that my boss 's teacher 's brother 's friend is excited .	Leslie talks to my boss 's teacher 's brother 's friend is excited .
the driver knows that my teacher 's sister 's daughter 's father is confused .	the driver scares my teacher 's sister 's daughter 's father is confused .
Liam says that your friend 's friend 's wife 's dad is confused .	Liam works with your friend 's friend 's wife 's dad is confused .
Liam thinks that your son 's mom 's sister 's mom is surprised .	Liam works with your son 's mom 's sister 's mom is surprised .
Janet thinks that your brother 's sister 's doctor 's sister is angry .	Janet talks to your brother 's sister 's doctor 's sister is angry .
the patient says that your brother 's wife 's mom 's sister is nice .	the patient works with your brother 's wife 's mom 's sister is nice .
the teacher thinks that your boss 's wife 's boss 's daughter is excited .	the teacher works with your boss 's wife 's boss 's daughter is excited .
the dancer thinks that your sister 's daughter 's doctor 's daughter is sleepy .	the dancer scares your sister 's daughter 's doctor 's daughter is sleepy .
Susan knows that my cousin 's husband 's friend 's grandmother is tired .	Susan helps my cousin 's husband 's friend 's grandmother is tired .
the doctor knows that my wife 's sister 's husband 's son is curious .	the doctor scares my wife 's sister 's husband 's son is curious .
the person thinks that my dad 's friend 's cousin 's mother is clever .	the person helps my dad 's friend 's cousin 's mother is clever .
Steven thinks that my dentist 's mother 's friend 's dad is lucky .	Steven works with my dentist 's mother 's friend 's dad is lucky .
my boss says that your friend 's mom 's dad 's doctor is young .	my boss scares your friend 's mom 's dad 's doctor is young .
the person says that my son 's cousin 's father 's boss is wrong .	the person talks to my son 's cousin 's father 's boss is wrong .
your dentist knows that your daughter 's brother 's wife 's grandmother is helpful .	your dentist scares your daughter 's brother 's wife 's grandmother is helpful .
my friend thinks that your boss 's mom 's mother 's cousin is young .	my friend talks to your boss 's mom 's mother 's cousin is young .
your teacher knows that your sister 's father 's grandmother 's son is bored .	your teacher works with your sister 's father 's grandmother 's son is bored .
your friend thinks that my mom 's friend 's grandmother 's doctor is busy .	your friend works with my mom 's friend 's grandmother 's doctor is busy .
the adult knows that my husband 's daughter 's dad 's doctor is gentle .	the adult works with my husband 's daughter 's dad 's doctor is gentle .
my boss says that my sister 's mother 's brother 's doctor is important .	my boss talks to my sister 's mother 's brother 's doctor is important .
the driver knows that your mother 's teacher 's dentist 's wife is angry .	the driver scares your mother 's teacher 's dentist 's wife is angry .
the child knows that my son 's doctor 's teacher 's daughter is tired .	the child talks to my son 's doctor 's teacher 's daughter is tired .
my dentist thinks that my daughter 's mom 's dentist 's boss is angry .	my dentist scares my daughter 's mom 's dentist 's boss is angry .
the dancer knows that my teacher 's father 's brother 's cousin is bored .	the dancer helps my teacher 's father 's brother 's cousin is bored .
Elizabeth knows that your teacher 's mom 's sister 's dad is wrong .	Elizabeth talks to your teacher 's mom 's sister 's dad is wrong .
Marie says that my sister 's cousin 's son 's grandmother is clever .	Marie talks to my sister 's cousin 's son 's grandmother is clever .
your teacher says that your sister 's father 's friend 's daughter is friendly .	your teacher scares your sister 's father 's friend 's daughter is friendly .
my boss knows that your friend 's dad 's wife 's boss is smart .	my boss scares your friend 's dad 's wife 's boss is smart .
Guy thinks that my friend 's son 's daughter 's mother is healthy .	Guy talks to my friend 's son 's daughter 's mother is healthy .
Kayla knows that your mother 's husband 's son 's grandmother is friendly .	Kayla helps your mother 's husband 's son 's grandmother is friendly .
Lisa says that my teacher 's mother 's son 's wife is helpful .	Lisa helps my teacher 's mother 's son 's wife is helpful .
Nicole says that your teacher 's friend 's husband 's daughter is nice .	Nicole scares your teacher 's friend 's husband 's daughter is nice .
the doctor thinks that your wife 's father 's brother 's mother is nice .	the doctor works with your wife 's father 's brother 's mother is nice .
the customer knows that my sister 's dentist 's brother 's brother is surprised .	the customer works with my sister 's dentist 's brother 's brother is surprised .
the driver thinks that my friend 's daughter 's dad 's teacher is quiet .	the driver scares my friend 's daughter 's dad 's teacher is quiet .
the patient thinks that your grandmother 's boss 's dentist 's husband is tired .	the patient helps your grandmother 's boss 's dentist 's husband is tired .
your teacher knows that your cousin 's son 's brother 's wife is strong .	your teacher works with your cousin 's son 's brother 's wife is strong .
your friend thinks that my friend 's cousin 's boss 's dad is clever .	your friend scares my friend 's cousin 's boss 's dad is clever .
the child says that your mom 's sister 's son 's daughter is angry .	the child helps your mom 's sister 's son 's daughter is angry .
the teacher says that my sister 's teacher 's cousin 's son is hungry .	the teacher talks to my sister 's teacher 's cousin 's son is hungry .
Rebecca says that my father 's mom 's cousin 's brother is upset .	Rebecca helps my father 's mom 's cousin 's brother is upset .
Alexander says that your brother 's sister 's brother 's son is helpful .	Alexander works with your brother 's sister 's brother 's son is helpful .
your friend thinks that your wife 's sister 's mother 's mother is careful .	your friend helps your wife 's sister 's mother 's mother is careful .
Catherine says that your husband 's cousin 's brother 's grandmother is important .	Catherine helps your husband 's cousin 's brother 's grandmother is important .
your boss knows that my dad 's doctor 's husband 's father is sleepy .	your boss talks to my dad 's doctor 's husband 's father is sleepy .
Susan thinks that my dad 's sister 's husband 's dentist is sleepy .	Susan scares my dad 's sister 's husband 's dentist is sleepy .
Sarah thinks that my brother 's dad 's brother 's doctor is excited .	Sarah works with my brother 's dad 's brother 's doctor is excited .
the customer thinks that your cousin 's husband 's father 's grandmother is strong .	the customer talks to your cousin 's husband 's father 's grandmother is strong .
Joseph says that my brother 's wife 's doctor 's grandmother is lucky .	Joseph talks to my brother 's wife 's doctor 's grandmother is lucky .
the adult knows that my mom 's brother 's dad 's sister is surprised .	the adult helps my mom 's brother 's dad 's sister is surprised .
Michael thinks that my husband 's teacher 's dentist 's mother is upset .	Michael works with my husband 's teacher 's dentist 's mother is upset .
Barbara knows that my sister 's sister 's daughter 's teacher is strong .	Barbara scares my sister 's sister 's daughter 's teacher is strong .
Anne says that your brother 's teacher 's mom 's friend is surprised .	Anne helps your brother 's teacher 's mom 's friend is surprised .
the child knows that my husband 's father 's grandmother 's boss is upset .	the child works with my husband 's father 's grandmother 's boss is upset .
Eric knows that my wife 's mom 's doctor 's wife is sleepy .	Eric scares my wife 's mom 's doctor 's wife is sleepy .
Carl thinks that my boss 's son 's grandmother 's friend is friendly .	Carl talks to my boss 's son 's grandmother 's friend is friendly .
Karen knows that your father 's dentist 's husband 's mom is careful .	Karen helps your father 's dentist 's husband 's mom is careful .
the teacher knows that my father 's friend 's daughter 's grandmother is friendly .	the teacher scares my father 's friend 's daughter 's grandmother is friendly .
my doctor thinks that my friend 's daughter 's dentist 's mother is curious .	my doctor talks to my friend 's daughter 's dentist 's mother is curious .
your boss thinks that my boss 's sister 's mother 's husband is happy .	your boss scares my boss 's sister 's mother 's husband is happy .
the driver says that your mother 's grandmother 's mother 's father is gentle .	the driver scares your mother 's grandmother 's mother 's father is gentle .
the patient says that my doctor 's mother 's sister 's doctor is friendly .	the patient works with my doctor 's mother 's sister 's doctor is friendly .
Richard says that your boss 's husband 's boss 's friend is curious .	Richard talks to your boss 's husband 's boss 's friend is curious .
my friend thinks that my son 's friend 's mother 's sister is hungry .	my friend works with my son 's friend 's mother 's sister is hungry .
the person says that your dad 's sister 's cousin 's doctor is helpful .	the person talks to your dad 's sister 's cousin 's doctor is helpful .
the child knows that your daughter 's teacher 's wife 's husband is sleepy .	the child talks to your daughter 's teacher 's wife 's husband is sleepy .
your boss thinks that my brother 's mother 's mother 's wife is confused .	your boss helps my brother 's mother 's mother 's wife is confused .
the dentist says that my dentist 's teacher 's dad 's dentist is nice .	the dentist works with my dentist 's teacher 's dad 's dentist is nice .
the child says that my son 's friend 's daughter 's dentist is kind .	the child helps my son 's friend 's daughter 's dentist is kind .
the dentist thinks that my father 's grandmother 's boss 's father is tall .	the dentist helps my father 's grandmother 's boss 's father is tall .
the adult says that your daughter 's teacher 's brother 's teacher is tall .	the adult works with your daughter 's teacher 's brother 's teacher is tall .
Janet thinks that my grandmother 's brother 's boss 's grandmother is curious .	Janet scares my grandmother 's brother 's boss 's grandmother is curious .
Laurie knows that your doctor 's grandmother 's mother 's sister is important .	Laurie talks to your doctor 's grandmother 's mother 's sister is important .
your boss says that my wife 's daughter 's son 's wife is boring .	your boss scares my wife 's daughter 's son 's wife is boring .
the child says that my brother 's husband 's grandmother 's friend is busy .	the child works with my brother 's husband 's grandmother 's friend is busy .
the dentist says that your mom 's friend 's friend 's brother is strong .	the dentist talks to your mom 's friend 's friend 's brother is strong .
John says that my boss 's husband 's dad 's friend is angry .	John talks to my boss 's husband 's dad 's friend is angry .
the child knows that my sister 's teacher 's dad 's husband is important .	the child talks to my sister 's teacher 's dad 's husband is important .
the doctor knows that your father 's doctor 's grandmother 's grandmother is confused .	the doctor helps your father 's doctor 's grandmother 's grandmother is confused .
the driver says that my grandmother 's mother 's sister 's doctor is happy .	the driver scares my grandmother 's mother 's sister 's doctor is happy .
Becky knows that your sister 's dad 's son 's brother is confused .	Becky talks to your sister 's dad 's son 's brother is confused .
your dentist knows that my friend 's grandmother 's grandmother 's mom is surprised .	your dentist works with my friend 's grandmother 's grandmother 's mom is surprised .
Elizabeth says that my dentist 's doctor 's mom 's dad is excited .	Elizabeth works with my dentist 's doctor 's mom 's dad is excited .
the dancer thinks that your daughter 's mom 's friend 's husband is strong .	the dancer scares your daughter 's mom 's friend 's husband is strong .
my boss thinks that my sister 's mother 's wife 's son is angry .	my boss works with my sister 's mother 's wife 's son is angry .
your dentist says that your sister 's doctor 's dad 's cousin is important .	your dentist works with your sister 's doctor 's dad 's cousin is important .
the teacher says that your cousin 's son 's grandmother 's boss is clever .	the teacher talks to your cousin 's son 's grandmother 's boss is clever .
your cousin knows that my son 's mother 's grandmother 's teacher is smart .	your cousin works with my son 's mother 's grandmother 's teacher is smart .
Melissa thinks that my mother 's mom 's dentist 's son is wrong .	Melissa helps my mother 's mom 's dentist 's son is wrong .
my friend says that my dad 's cousin 's teacher 's boss is smart .	my friend scares my dad 's cousin 's teacher 's boss is smart .
your boss thinks that your teacher 's grandmother 's friend 's doctor is strong .	your boss talks to your teacher 's grandmother 's friend 's doctor is strong .
the child thinks that your dad 's cousin 's father 's daughter is friendly .	the child talks to your dad 's cousin 's father 's daughter is friendly .
the teacher thinks that my dentist 's son 's mother 's friend is important .	the teacher works with my dentist 's son 's mother 's friend is important .
Richard says that my cousin 's doctor 's mom 's daughter is friendly .	Richard works with my cousin 's doctor 's mom 's daughter is friendly .
my friend thinks that your husband 's father 's husband 's dad is friendly .	my friend talks to your husband 's father 's husband 's dad is friendly .
the customer thinks that my wife 's mother 's cousin 's grandmother is curious .	the customer talks to my wife 's mother 's cousin 's grandmother is curious .
the person knows that my boss 's doctor 's teacher 's daughter is boring .	the person talks to my boss 's doctor 's teacher 's daughter is boring .
Todd thinks that your mom 's grandmother 's grandmother 's father is kind .	Todd talks to your mom 's grandmother 's grandmother 's father is kind .
your doctor thinks that your sister 's cousin 's wife 's son is tired .	your doctor scares your sister 's cousin 's wife 's son is tired .
my dentist thinks that my grandmother 's mother 's wife 's teacher is important .	my dentist helps my grandmother 's mother 's wife 's teacher is important .
Kevin says that your mom 's teacher 's sister 's dad is confused .	Kevin talks to your mom 's teacher 's sister 's dad is confused .
my dentist says that your husband 's brother 's dad 's sister is sleepy .	my dentist helps your husband 's brother 's dad 's sister is sleepy .
Anne knows that your friend 's cousin 's dentist 's friend is smart .	Anne works with your friend 's cousin 's dentist 's friend is smart .
the teacher thinks that your grandmother 's grandmother 's mother 's cousin is angry .	the teacher scares your grandmother 's grandmother 's mother 's cousin is angry .
the customer knows that your cousin 's father 's daughter 's son is smart .	the customer helps your cousin 's father 's daughter 's son is smart .
the dancer thinks that my mom 's husband 's teacher 's teacher is hungry .	the dancer works with my mom 's husband 's teacher 's teacher is hungry .
your dentist thinks that my doctor 's friend 's mother 's dad is angry .	your dentist scares my doctor 's friend 's mother 's dad is angry .
the person thinks that my brother 's cousin 's grandmother 's son is friendly .	the person helps my brother 's cousin 's grandmother 's son is friendly .
Travis thinks that my grandmother 's husband 's sister 's dad is friendly .	Travis talks to my grandmother 's husband 's sister 's dad is friendly .
the teacher says that my teacher 's mom 's teacher 's doctor is bored .	the teacher helps my teacher 's mom 's teacher 's doctor is bored .
my boss thinks that your husband 's mom 's mother 's father is young .	my boss scares your husband 's mom 's mother 's father is young .
the doctor thinks that my mother 's father 's daughter 's dad is happy .	the doctor helps my mother 's father 's daughter 's dad is happy .
your boss says that my husband 's grandmother 's wife 's grandmother is careful .	your boss works with my husband 's grandmother 's wife 's grandmother is careful .
Andrew thinks that my cousin 's grandmother 's brother 's dentist is gentle .	Andrew works with my cousin 's grandmother 's brother 's dentist is gentle .
Carl thinks that my dad 's father 's son 's husband is clever .	Carl works with my dad 's father 's son 's husband is clever .
Julie thinks that my dad 's teacher 's mom 's teacher is kind .	Julie talks to my dad 's teacher 's mom 's teacher is kind .
your friend thinks that your husband 's dentist 's mother 's brother is boring .	your friend talks to your husband 's dentist 's mother 's brother is boring .
the dentist knows that my daughter 's brother 's mother 's cousin is clever .	the dentist helps my daughter 's brother 's mother 's cousin is clever .
the child knows that your brother 's son 's husband 's dad is angry .	the child scares your brother 's son 's husband 's dad is angry .
the adult knows that my doctor 's grandmother 's dad 's son is kind .	the adult talks to my doctor 's grandmother 's dad 's son is kind .
the dentist says that your boss 's husband 's sister 's son is healthy .	the dentist scares your boss 's husband 's sister 's son is healthy .
my friend thinks that your father 's grandmother 's grandmother 's sister is healthy .	my friend helps your father 's grandmother 's grandmother 's sister is healthy .
your cousin thinks that my daughter 's sister 's doctor 's cousin is boring .	your cousin works with my daughter 's sister 's doctor 's cousin is boring .
my friend says that my dentist 's son 's dad 's doctor is smart .	my friend helps my dentist 's son 's dad 's doctor is smart .
my friend knows that your friend 's mom 's wife 's teacher is excited .	my friend helps your friend 's mom 's wife 's teacher is excited .
Judy knows that my husband 's dad 's cousin 's mom is smart .	Judy scares my husband 's dad 's cousin 's mom is smart .
my boss knows that your son 's husband 's mother 's father is helpful .	my boss helps your son 's husband 's mother 's father is helpful .
Sally says that my dentist 's husband 's son 's sister is healthy .	Sally talks to my dentist 's husband 's son 's sister is healthy .
your cousin thinks that my mom 's grandmother 's father 's son is important .	your cousin scares my mom 's grandmother 's father 's son is important .
Jerry says that your brother 's mother 's daughter 's mom is kind .	Jerry scares your brother 's mother 's daughter 's mom is kind .
the dentist knows that your husband 's teacher 's dentist 's boss is lucky .	the dentist works with your husband 's teacher 's dentist 's boss is lucky .
my cousin thinks that my teacher 's father 's teacher 's wife is sleepy .	my cousin scares my teacher 's father 's teacher 's wife is sleepy .
the doctor knows that your father 's friend 's father 's mother is angry .	the doctor talks to your father 's friend 's father 's mother is angry .
the dancer says that my cousin 's mother 's friend 's mother is careful .	the dancer scares my cousin 's mother 's friend 's mother is careful .
the customer says that my teacher 's mom 's daughter 's wife is wrong .	the customer talks to my teacher 's mom 's daughter 's wife is wrong .
Bill thinks that your mom 's doctor 's mom 's teacher is happy .	Bill talks to your mom 's doctor 's mom 's teacher is happy .
the driver says that your sister 's father 's dentist 's brother is sleepy .	the driver helps your sister 's father 's dentist 's brother is sleepy .
the driver says that my dentist 's husband 's cousin 's mother is tired .	the driver talks to my dentist 's husband 's cousin 's mother is tired .
Donna says that my wife 's grandmother 's cousin 's daughter is wrong .	Donna helps my wife 's grandmother 's cousin 's daughter is wrong .
Stephanie knows that your sister 's friend 's friend 's boss is busy .	Stephanie works with your sister 's friend 's friend 's boss is busy .
Nina thinks that my daughter 's father 's husband 's cousin is bored .	Nina helps my daughter 's father 's husband 's cousin is bored .
Melissa says that your brother 's dad 's dad 's dad is strong .	Melissa helps your brother 's dad 's dad 's dad is strong .
Guy thinks that your doctor 's teacher 's son 's daughter is lucky .	Guy scares your doctor 's teacher 's son 's daughter is lucky .
my dentist thinks that your dentist 's grandmother 's husband 's dad is gentle .	my dentist works with your dentist 's grandmother 's husband 's dad is gentle .
the customer thinks that my mom 's daughter 's grandmother 's sister is wrong .	the customer works with my mom 's daughter 's grandmother 's sister is wrong .
George thinks that my husband 's son 's friend 's boss is friendly .	George helps my husband 's son 's friend 's boss is friendly .
the customer thinks that your mom 's sister 's mom 's friend is confused .	the customer works with your mom 's sister 's mom 's friend is confused .
your boss knows that your dentist 's husband 's boss 's grandmother is tired .	your boss talks to your dentist 's husband 's boss 's grandmother is tired .
the dancer says that your father 's father 's grandmother 's wife is wrong .	the dancer talks to your father 's father 's grandmother 's wife is wrong .
the teacher says that my doctor 's wife 's cousin 's wife is bored .	the teacher helps my doctor 's wife 's cousin 's wife is bored .
my teacher knows that your brother 's boss 's wife 's friend is busy .	my teacher works with your brother 's boss 's wife 's friend is busy .
your teacher thinks that your daughter 's daughter 's boss 's father is kind .	your teacher helps your daughter 's daughter 's boss 's father is kind .
the doctor thinks that your friend 's mother 's sister 's cousin is clever .	the doctor helps your friend 's mother 's sister 's cousin is clever .
the adult says that my cousin 's son 's teacher 's son is sleepy .	the adult helps my cousin 's son 's teacher 's son is sleepy .
the child thinks that my daughter 's mother 's dentist 's friend is boring .	the child scares my daughter 's mother 's dentist 's friend is boring .
the person knows that your boss 's wife 's dentist 's grandmother is excited .	the person works with your boss 's wife 's dentist 's grandmother is excited .
your friend thinks that your teacher 's grandmother 's cousin 's mom is kind .	your friend helps your teacher 's grandmother 's cousin 's mom is kind .
the person knows that my husband 's dad 's mother 's daughter is angry .	the person talks to my husband 's dad 's mother 's daughter is angry .
the dancer says that my dad 's boss 's teacher 's mom is wrong .	the dancer scares my dad 's boss 's teacher 's mom is wrong .
the adult knows that your mom 's doctor 's boss 's cousin is smart .	the adult works with your mom 's doctor 's boss 's cousin is smart .
the driver thinks that your friend 's boss 's sister 's dad is healthy .	the driver scares your friend 's boss 's sister 's dad is healthy .
my dentist says that my doctor 's dad 's dentist 's son is bored .	my dentist works with my doctor 's dad 's dentist 's son is bored .
the patient thinks that your grandmother 's dad 's cousin 's dad is boring .	the patient works with your grandmother 's dad 's cousin 's dad is boring .
Patrick says that your wife 's husband 's grandmother 's brother is strong .	Patrick works with your wife 's husband 's grandmother 's brother is strong .
the dentist thinks that your father 's boss 's friend 's boss is smart .	the dentist scares your father 's boss 's friend 's boss is smart .
the person knows that my son 's father 's husband 's son is quiet .	the person works with my son 's father 's husband 's son is quiet .
Travis knows that your mother 's father 's dad 's daughter is nice .	Travis talks to your mother 's father 's dad 's daughter is nice .
the dancer knows that my son 's dentist 's mom 's husband is helpful .	the dancer helps my son 's dentist 's mom 's husband is helpful .
James says that your brother 's son 's cousin 's son is smart .	James scares your brother 's son 's cousin 's son is smart .
Barbara knows that my daughter 's sister 's friend 's daughter is busy .	Barbara scares my daughter 's sister 's friend 's daughter is busy .
the customer says that your husband 's cousin 's father 's friend is busy .	the customer helps your husband 's cousin 's father 's friend is busy .
the adult thinks that your daughter 's son 's mom 's friend is healthy .	the adult helps your daughter 's son 's mom 's friend is healthy .
your cousin says that my grandmother 's daughter 's doctor 's son is helpful .	your cousin works with my grandmother 's daughter 's doctor 's son is helpful .
your cousin thinks that your wife 's friend 's friend 's mother is important .	your cousin helps your wife 's friend 's friend 's mother is important .
the patient thinks that my mom 's friend 's father 's husband is tall .	the patient talks to my mom 's friend 's father 's husband is tall .
my boss says that my son 's grandmother 's sister 's father is happy .	my boss helps my son 's grandmother 's sister 's father is happy .
the doctor says that your brother 's father 's wife 's mom is lucky .	the doctor helps your brother 's father 's wife 's mom is lucky .
Christopher knows that your friend 's grandmother 's cousin 's grandmother is healthy .	Christopher scares your friend 's grandmother 's cousin 's grandmother is healthy .
my teacher says that your dad 's teacher 's dentist 's daughter is tired .	my teacher talks to your dad 's teacher 's dentist 's daughter is tired .
the adult thinks that my father 's friend 's sister 's mom is confused .	the adult works with my father 's friend 's sister 's mom is confused .
my cousin says that my sister 's dentist 's boss 's father is healthy .	my cousin helps my sister 's dentist 's boss 's father is healthy .
the person knows that your sister 's husband 's father 's friend is excited .	the person works with your sister 's husband 's father 's friend is excited .
the customer thinks that your father 's husband 's brother 's father is curious .	the customer scares your father 's husband 's brother 's father is curious .
my doctor knows that my daughter 's daughter 's teacher 's father is hungry .	my doctor talks to my daughter 's daughter 's teacher 's father is hungry .
my dentist says that my father 's son 's friend 's boss is kind .	my dentist helps my father 's son 's friend 's boss is kind .
your teacher knows that my doctor 's grandmother 's cousin 's friend is angry .	your teacher works with my doctor 's grandmother 's cousin 's friend is angry .
Steve knows that your daughter 's doctor 's daughter 's grandmother is excited .	Steve scares your daughter 's doctor 's daughter 's grandmother is excited .
the teacher knows that your son 's brother 's brother 's son is boring .	the teacher scares your son 's brother 's brother 's son is boring .
Sarah thinks that my son 's doctor 's dad 's doctor is smart .	Sarah works with my son 's doctor 's dad 's doctor is smart .
my teacher says that your doctor 's mom 's daughter 's wife is angry .	my teacher works with your doctor 's mom 's daughter 's wife is angry .
my friend knows that my doctor 's grandmother 's teacher 's dentist is friendly .	my friend scares my doctor 's grandmother 's teacher 's dentist is friendly .
your boss says that your mother 's father 's dad 's sister is boring .	your boss scares your mother 's father 's dad 's sister is boring .
your cousin knows that my grandmother 's boss 's brother 's dad is angry .	your cousin helps my grandmother 's boss 's brother 's dad is angry .
your teacher thinks that your grandmother 's dentist 's boss 's father is healthy .	your teacher talks to your grandmother 's dentist 's boss 's father is healthy .
the person thinks that your mom 's dentist 's mom 's teacher is friendly .	the person helps your mom 's dentist 's mom 's teacher is friendly .
the adult thinks that your brother 's dad 's teacher 's mom is healthy .	the adult works with your brother 's dad 's teacher 's mom is healthy .
Liam thinks that my son 's teacher 's dentist 's brother is careful .	Liam helps my son 's teacher 's dentist 's brother is careful .
the adult knows that your mom 's boss 's doctor 's doctor is smart .	the adult talks to your mom 's boss 's doctor 's doctor is smart .
the adult says that my teacher 's father 's father 's daughter is busy .	the adult works with my teacher 's father 's father 's daughter is busy .
the dancer says that my teacher 's dad 's sister 's boss is smart .	the dancer talks to my teacher 's dad 's sister 's boss is smart .
William thinks that your mother 's sister 's doctor 's daughter is important .	William talks to your mother 's sister 's doctor 's daughter is important .
Wendy thinks that my father 's cousin 's husband 's husband is hungry .	Wendy scares my father 's cousin 's husband 's husband is hungry .
your teacher knows that your daughter 's teacher 's doctor 's son is busy .	your teacher scares your daughter 's teacher 's doctor 's son is busy .
your friend thinks that your mother 's doctor 's son 's brother is helpful .	your friend scares your mother 's doctor 's son 's brother is helpful .
my boss knows that my brother 's cousin 's husband 's cousin is kind .	my boss talks to my brother 's cousin 's husband 's cousin is kind .
Guy says that your friend 's sister 's mom 's dentist is boring .	Guy scares your friend 's sister 's mom 's dentist is boring .
Michelle thinks that my wife 's doctor 's grandmother 's son is lucky .	Michelle works with my wife 's doctor 's grandmother 's son is lucky .
my dentist knows that my dentist 's cousin 's dad 's husband is kind .	my dentist talks to my dentist 's cousin 's dad 's husband is kind .
Lisa thinks that my sister 's doctor 's mother 's cousin is important .	Lisa talks to my sister 's doctor 's mother 's cousin is important .
your dentist thinks that my wife 's father 's husband 's grandmother is angry .	your dentist talks to my wife 's father 's husband 's grandmother is angry .
your cousin thinks that my teacher 's father 's dad 's brother is kind .	your cousin helps my teacher 's father 's dad 's brother is kind .
Allison thinks that your sister 's father 's dad 's sister is sleepy .	Allison scares your sister 's father 's dad 's sister is sleepy .
my teacher thinks that your boss 's wife 's teacher 's son is strong .	my teacher helps your boss 's wife 's teacher 's son is strong .
Steve knows that your daughter 's mom 's dad 's wife is kind .	Steve works with your daughter 's mom 's dad 's wife is kind .
the person thinks that my son 's mom 's father 's husband is tired .	the person talks to my son 's mom 's father 's husband is tired .
the customer thinks that my dentist 's husband 's daughter 's cousin is tall .	the customer helps my dentist 's husband 's daughter 's cousin is tall .
the customer says that your son 's dad 's wife 's son is clever .	the customer talks to your son 's dad 's wife 's son is clever .
Sarah knows that your wife 's brother 's dentist 's doctor is busy .	Sarah works with your wife 's brother 's dentist 's doctor is busy .
the driver knows that my wife 's mother 's grandmother 's husband is curious .	the driver talks to my wife 's mother 's grandmother 's husband is curious .
the teacher thinks that my mother 's friend 's mom 's daughter is tired .	the teacher helps my mother 's friend 's mom 's daughter is tired .
Peter thinks that my friend 's sister 's son 's friend is careful .	Peter works with my friend 's sister 's son 's friend is careful .
Joseph knows that my brother 's sister 's grandmother 's brother is lucky .	Joseph helps my brother 's sister 's grandmother 's brother is lucky .
my dentist knows that my friend 's wife 's cousin 's mom is kind .	my dentist talks to my friend 's wife 's cousin 's mom is kind .
my boss knows that my dentist 's sister 's dentist 's teacher is smart .	my boss works with my dentist 's sister 's dentist 's teacher is smart .
Liam thinks that my boss 's cousin 's mom 's brother is friendly .	Liam works with my boss 's cousin 's mom 's brother is friendly .
Alexander thinks that your mom 's dad 's brother 's doctor is bored .	Alexander talks to your mom 's dad 's brother 's doctor is bored .
William says that my wife 's mother 's husband 's doctor is confused .	William talks to my wife 's mother 's husband 's doctor is confused .
my boss thinks that your mother 's grandmother 's friend 's doctor is tired .	my boss works with your mother 's grandmother 's friend 's doctor is tired .
the teacher thinks that your wife 's sister 's friend 's grandmother is hungry .	the teacher scares your wife 's sister 's friend 's grandmother is hungry .
the doctor knows that my husband 's teacher 's dad 's wife is excited .	the doctor works with my husband 's teacher 's dad 's wife is excited .
your boss knows that your daughter 's cousin 's grandmother 's daughter is quiet .	your boss scares your daughter 's cousin 's grandmother 's daughter is quiet .
your doctor thinks that your daughter 's dad 's son 's son is tall .	your doctor works with your daughter 's dad 's son 's son is tall .
Stephanie says that your dad 's mom 's brother 's boss is happy .	Stephanie talks to your dad 's mom 's brother 's boss is happy .
Julia thinks that my brother 's cousin 's teacher 's sister is angry .	Julia scares my brother 's cousin 's teacher 's sister is angry .
Jennifer says that my teacher 's boss 's teacher 's dentist is friendly .	Jennifer talks to my teacher 's boss 's teacher 's dentist is friendly .
the adult thinks that your mother 's daughter 's friend 's friend is curious .	the adult helps your mother 's daughter 's friend 's friend is curious .
the driver thinks that my boss 's wife 's teacher 's cousin is friendly .	the driver helps my boss 's wife 's teacher 's cousin is friendly .
the dentist thinks that my husband 's teacher 's brother 's mom is quiet .	the dentist works with my husband 's teacher 's brother 's mom is quiet .
the person thinks that your dad 's wife 's dad 's mom is bored .	the person talks to your dad 's wife 's dad 's mom is bored .
the customer knows that my wife 's father 's wife 's daughter is friendly .	the customer talks to my wife 's father 's wife 's daughter is friendly .
the person knows that my boss 's daughter 's dad 's son is friendly .	the person helps my boss 's daughter 's dad 's son is friendly .
Karen says that your daughter 's wife 's grandmother 's boss is nice .	Karen scares your daughter 's wife 's grandmother 's boss is nice .
Becky thinks that your mom 's boss 's daughter 's father is bored .	Becky talks to your mom 's boss 's daughter 's father is bored .
the adult thinks that my teacher 's daughter 's wife 's boss is surprised .	the adult scares my teacher 's daughter 's wife 's boss is surprised .
Leslie says that my brother 's grandmother 's brother 's mother is lucky .	Leslie scares my brother 's grandmother 's brother 's mother is lucky .
the doctor knows that your friend 's doctor 's dad 's father is boring .	the doctor talks to your friend 's doctor 's dad 's father is boring .
Gregory knows that your father 's grandmother 's brother 's teacher is careful .	Gregory scares your father 's grandmother 's brother 's teacher is careful .
Laurie says that my brother 's mother 's mother 's sister is tall .	Laurie works with my brother 's mother 's mother 's sister is tall .
the patient says that my father 's father 's dentist 's wife is curious .	the patient scares my father 's father 's dentist 's wife is curious .
the child says that my mom 's husband 's dad 's father is busy .	the child works with my mom 's husband 's dad 's father is busy .
my doctor knows that your doctor 's boss 's husband 's wife is tired .	my doctor works with your doctor 's boss 's husband 's wife is tired .
Alexander says that your grandmother 's wife 's daughter 's teacher is gentle .	Alexander helps your grandmother 's wife 's daughter 's teacher is gentle .
Jason says that my teacher 's wife 's doctor 's grandmother is healthy .	Jason talks to my teacher 's wife 's doctor 's grandmother is healthy .
the patient knows that your cousin 's boss 's wife 's doctor is wrong .	the patient works with your cousin 's boss 's wife 's doctor is wrong .
the teacher knows that my doctor 's dentist 's dentist 's friend is nice .	the teacher works with my doctor 's dentist 's dentist 's friend is nice .
my boss says that my husband 's wife 's son 's daughter is gentle .	my boss works with my husband 's wife 's son 's daughter is gentle .
Christopher says that my doctor 's friend 's father 's son is helpful .	Christopher talks to my doctor 's friend 's father 's son is helpful .
the teacher says that your grandmother 's son 's teacher 's dentist is busy .	the teacher works with your grandmother 's son 's teacher 's dentist is busy .
my cousin thinks that my dentist 's husband 's doctor 's father is helpful .	my cousin talks to my dentist 's husband 's doctor 's father is helpful .
Julie knows that your cousin 's mom 's teacher 's father is angry .	Julie scares your cousin 's mom 's teacher 's father is angry .
your doctor knows that your daughter 's son 's mom 's daughter is friendly .	your doctor works with your daughter 's son 's mom 's daughter is friendly .
Janet thinks that my husband 's son 's grandmother 's dentist is confused .	Janet helps my husband 's son 's grandmother 's dentist is confused .
Ronald says that your mom 's husband 's friend 's daughter is healthy .	Ronald talks to your mom 's husband 's friend 's daughter is healthy .
Andrew knows that my cousin 's sister 's cousin 's husband is confused .	Andrew works with my cousin 's sister 's cousin 's husband is confused .
Paul thinks that your father 's brother 's boss 's teacher is bored .	Paul talks to your father 's brother 's boss 's teacher is bored .
your doctor knows that my daughter 's daughter 's father 's grandmother is friendly .	your doctor scares my daughter 's daughter 's father 's grandmother is friendly .
my friend thinks that your cousin 's grandmother 's teacher 's father is upset .	my friend helps your cousin 's grandmother 's teacher 's father is upset .
the dancer thinks that your friend 's dentist 's brother 's husband is confused .	the dancer works with your friend 's dentist 's brother 's husband is confused .
Alice says that my daughter 's cousin 's teacher 's friend is tall .	Alice scares my daughter 's cousin 's teacher 's friend is tall .
the customer says that my daughter 's father 's dentist 's boss is happy .	the customer helps my daughter 's father 's dentist 's boss is happy .
the customer thinks that my husband 's dentist 's father 's sister is upset .	the customer helps my husband 's dentist 's father 's sister is upset .
Anna thinks that your boss 's friend 's boss 's friend is gentle .	Anna helps your boss 's friend 's boss 's friend is gentle .
the dancer thinks that my husband 's sister 's dad 's father is strong .	the dancer helps my husband 's sister 's dad 's father is strong .
your friend says that my wife 's husband 's teacher 's wife is angry .	your friend works with my wife 's husband 's teacher 's wife is angry .
the driver says that your cousin 's husband 's teacher 's mother is surprised .	the driver scares your cousin 's husband 's teacher 's mother is surprised .
Allison knows that your son 's grandmother 's daughter 's doctor is upset .	Allison works with your son 's grandmother 's daughter 's doctor is upset .
your teacher thinks that my cousin 's mom 's dad 's father is boring .	your teacher works with my cousin 's mom 's dad 's father is boring .
Joseph thinks that your cousin 's daughter 's dentist 's teacher is young .	Joseph scares your cousin 's daughter 's dentist 's teacher is young .
your teacher thinks that your grandmother 's mom 's friend 's father is wrong .	your teacher helps your grandmother 's mom 's friend 's father is wrong .
Alexander knows that your doctor 's dentist 's mother 's dad is healthy .	Alexander helps your doctor 's dentist 's mother 's dad is healthy .
your teacher thinks that my friend 's wife 's son 's husband is bored .	your teacher works with my friend 's wife 's son 's husband is bored .
the person says that your daughter 's brother 's mom 's son is smart .	the person talks to your daughter 's brother 's mom 's son is smart .
Sandra thinks that my boss 's cousin 's husband 's daughter is smart .	Sandra scares my boss 's cousin 's husband 's daughter is smart .
Jennifer says that my dentist 's mother 's daughter 's grandmother is careful .	Jennifer works with my dentist 's mother 's daughter 's grandmother is careful .
Elizabeth knows that my brother 's wife 's dad 's boss is busy .	Elizabeth talks to my brother 's wife 's dad 's boss is busy .
Richard thinks that your mother 's grandmother 's mom 's dad is hungry .	Richard works with your mother 's grandmother 's mom 's dad is hungry .
your boss knows that your father 's sister 's dentist 's son is important .	your boss works with your father 's sister 's dentist 's son is important .
the person thinks that my boss 's doctor 's dad 's mother is tall .	the person helps my boss 's doctor 's dad 's mother is tall .
the child says that your doctor 's father 's mother 's brother is quiet .	the child scares your doctor 's father 's mother 's brother is quiet .
your boss says that my wife 's sister 's brother 's grandmother is nice .	your boss works with my wife 's sister 's brother 's grandmother is nice .
the dentist says that my dad 's brother 's father 's daughter is lucky .	the dentist scares my dad 's brother 's father 's daughter is lucky .
George says that your boss 's doctor 's dad 's dentist is busy .	George talks to your boss 's doctor 's dad 's dentist is busy .
the person thinks that your husband 's doctor 's doctor 's husband is young .	the person helps your husband 's doctor 's doctor 's husband is young .
the adult knows that your dad 's cousin 's brother 's father is quiet .	the adult talks to your dad 's cousin 's brother 's father is quiet .
my dentist thinks that your teacher 's brother 's husband 's mom is clever .	my dentist helps your teacher 's brother 's husband 's mom is clever .
my cousin thinks that my brother 's brother 's brother 's boss is kind .	my cousin talks to my brother 's brother 's brother 's boss is kind .
my teacher says that your cousin 's dentist 's father 's brother is lucky .	my teacher helps your cousin 's dentist 's father 's brother is lucky .
the customer thinks that your father 's doctor 's mom 's father is busy .	the customer helps your father 's doctor 's mom 's father is busy .
your boss knows that my husband 's husband 's daughter 's dad is lucky .	your boss talks to my husband 's husband 's daughter 's dad is lucky .
your friend knows that your mom 's sister 's father 's husband is sleepy .	your friend scares your mom 's sister 's father 's husband is sleepy .
Gregory says that your son 's mom 's mother 's mother is lucky .	Gregory works with your son 's mom 's mother 's mother is lucky .
the driver says that my sister 's grandmother 's grandmother 's mother is gentle .	the driver helps my sister 's grandmother 's grandmother 's mother is gentle .
my cousin says that my mom 's boss 's grandmother 's mom is sleepy .	my cousin works with my mom 's boss 's grandmother 's mom is sleepy .
Catherine knows that my sister 's brother 's father 's dad is quiet .	Catherine scares my sister 's brother 's father 's dad is quiet .
the customer thinks that my dentist 's teacher 's mother 's husband is lucky .	the customer helps my dentist 's teacher 's mother 's husband is lucky .
my teacher knows that your boss 's mother 's cousin 's friend is nice .	my teacher scares your boss 's mother 's cousin 's friend is nice .
Jason thinks that my friend 's friend 's daughter 's grandmother is friendly .	Jason scares my friend 's friend 's daughter 's grandmother is friendly .
the doctor says that my mom 's dentist 's mom 's son is wrong .	the doctor works with my mom 's dentist 's mom 's son is wrong .
Catherine says that your teacher 's mom 's dentist 's sister is careful .	Catherine helps your teacher 's mom 's dentist 's sister is careful .
your doctor says that my mother 's grandmother 's brother 's father is curious .	your doctor works with my mother 's grandmother 's brother 's father is curious .
Nancy knows that your daughter 's son 's cousin 's grandmother is friendly .	Nancy talks to your daughter 's son 's cousin 's grandmother is friendly .
Anne knows that my dentist 's grandmother 's teacher 's friend is boring .	Anne scares my dentist 's grandmother 's teacher 's friend is boring .
your doctor knows that my husband 's cousin 's teacher 's friend is confused .	your doctor talks to my husband 's cousin 's teacher 's friend is confused .
Jane says that my mother 's husband 's husband 's son is helpful .	Jane scares my mother 's husband 's husband 's son is helpful .
the child thinks that my mom 's friend 's brother 's wife is upset .	the child talks to my mom 's friend 's brother 's wife is upset .
Sally thinks that your sister 's brother 's father 's daughter is lucky .	Sally works with your sister 's brother 's father 's daughter is lucky .
your dentist says that my father 's grandmother 's sister 's father is excited .	your dentist works with my father 's grandmother 's sister 's father is excited .
my cousin knows that my brother 's son 's brother 's brother is excited .	my cousin talks to my brother 's son 's brother 's brother is excited .
your doctor says that your cousin 's sister 's son 's boss is excited .	your doctor works with your cousin 's sister 's son 's boss is excited .
Cindy knows that your daughter 's doctor 's mother 's son is wrong .	Cindy works with your daughter 's doctor 's mother 's son is wrong .
Deborah says that your teacher 's doctor 's dentist 's sister is strong .	Deborah scares your teacher 's doctor 's dentist 's sister is strong .
Donna thinks that your dad 's daughter 's brother 's boss is tired .	Donna scares your dad 's daughter 's brother 's boss is tired .
your teacher says that my son 's husband 's wife 's daughter is wrong .	your teacher scares my son 's husband 's wife 's daughter is wrong .
the person thinks that my husband 's dad 's doctor 's grandmother is boring .	the person helps my husband 's dad 's doctor 's grandmother is boring .
Alexander says that your dentist 's mother 's dentist 's wife is important .	Alexander scares your dentist 's mother 's dentist 's wife is important .
my cousin says that your doctor 's boss 's mom 's cousin is gentle .	my cousin works with your doctor 's boss 's mom 's cousin is gentle .
Martin says that my grandmother 's brother 's daughter 's cousin is wrong .	Martin works with my grandmother 's brother 's daughter 's cousin is wrong .
Ronald knows that my cousin 's wife 's brother 's son is excited .	Ronald scares my cousin 's wife 's brother 's son is excited .
your cousin says that your mom 's teacher 's cousin 's friend is young .	your cousin works with your mom 's teacher 's cousin 's friend is young .
the driver knows that your sister 's wife 's mother 's cousin is bored .	the driver scares your sister 's wife 's mother 's cousin is bored .
Ronald knows that your sister 's father 's daughter 's sister is surprised .	Ronald works with your sister 's father 's daughter 's sister is surprised .
your teacher thinks that your mom 's daughter 's sister 's dad is smart .	your teacher works with your mom 's daughter 's sister 's dad is smart .
the driver says that your brother 's dentist 's brother 's doctor is surprised .	the driver scares your brother 's dentist 's brother 's doctor is surprised .
your doctor thinks that your doctor 's boss 's boss 's teacher is friendly .	your doctor scares your doctor 's boss 's boss 's teacher is friendly .
the doctor thinks that my cousin 's father 's son 's mother is healthy .	the doctor helps my cousin 's father 's son 's mother is healthy .
Richard knows that my mom 's cousin 's mom 's sister is wrong .	Richard talks to my mom 's cousin 's mom 's sister is wrong .
the child thinks that my friend 's husband 's sister 's mother is smart .	the child talks to my friend 's husband 's sister 's mother is smart .
your teacher thinks that your son 's doctor 's mother 's brother is lucky .	your teacher helps your son 's doctor 's mother 's brother is lucky .
Sandra knows that your sister 's father 's wife 's cousin is strong .	Sandra works with your sister 's father 's wife 's cousin is strong .
Renee thinks that your brother 's cousin 's father 's father is confused .	Renee works with your brother 's cousin 's father 's father is confused .
Sally knows that your wife 's teacher 's brother 's dentist is smart .	Sally works with your wife 's teacher 's brother 's dentist is smart .
Elizabeth says that my cousin 's doctor 's dentist 's dad is young .	Elizabeth helps my cousin 's doctor 's dentist 's dad is young .
my dentist thinks that my grandmother 's dentist 's wife 's father is angry .	my dentist scares my grandmother 's dentist 's wife 's father is angry .
the dentist knows that your grandmother 's mom 's daughter 's mom is upset .	the dentist works with your grandmother 's mom 's daughter 's mom is upset .
