Susan sent my dad 's son 's friend 's brother 's doctor 's teacher 's dad the button .	Susan kept my dad 's son 's friend 's brother 's doctor 's teacher 's dad the button .
Christopher showed your husband 's teacher 's cousin 's wife 's father 's sister 's daughter the door .	Christopher moved your husband 's teacher 's cousin 's wife 's father 's sister 's daughter the door .
my dentist showed my brother 's doctor 's teacher 's father 's grandmother 's father 's boss the cup .	my dentist shook my brother 's doctor 's teacher 's father 's grandmother 's father 's boss the cup .
Amy bought my grandmother 's husband 's sister 's dentist 's teacher 's teacher 's wife the shirt .	Amy dropped my grandmother 's husband 's sister 's dentist 's teacher 's teacher 's wife the shirt .
my teacher sent my daughter 's mother 's dad 's daughter 's daughter 's mother 's daughter the car .	my teacher dropped my daughter 's mother 's dad 's daughter 's daughter 's mother 's daughter the car .
your dentist showed your dad 's mom 's cousin 's teacher 's cousin 's teacher 's mom the button .	your dentist lost your dad 's mom 's cousin 's teacher 's cousin 's teacher 's mom the button .
Patrick gave my grandmother 's boss 's father 's teacher 's husband 's son 's teacher the toy .	Patrick dropped my grandmother 's boss 's father 's teacher 's husband 's son 's teacher the toy .
Anna gave your mother 's doctor 's mom 's son 's dad 's mom 's cousin the hat .	Anna dropped your mother 's doctor 's mom 's son 's dad 's mom 's cousin the hat .
Peter sent my boss 's boss 's husband 's son 's brother 's grandmother 's husband the dish .	Peter cleaned my boss 's boss 's husband 's son 's brother 's grandmother 's husband the dish .
my cousin sent my father 's boss 's cousin 's teacher 's grandmother 's father 's dad the crayon .	my cousin dropped my father 's boss 's cousin 's teacher 's grandmother 's father 's dad the crayon .
your dentist sent your friend 's brother 's wife 's dad 's wife 's grandmother 's grandmother the truck .	your dentist shook your friend 's brother 's wife 's dad 's wife 's grandmother 's grandmother the truck .
my boss bought my mother 's dad 's dad 's doctor 's son 's sister 's boss the plane .	my boss lost my mother 's dad 's dad 's doctor 's son 's sister 's boss the plane .
the customer bought my dentist 's mom 's dad 's dad 's dentist 's mother 's grandmother the bag .	the customer held my dentist 's mom 's dad 's dad 's dentist 's mother 's grandmother the bag .
the customer gave my cousin 's father 's mom 's doctor 's daughter 's father 's dad the doll .	the customer shook my cousin 's father 's mom 's doctor 's daughter 's father 's dad the doll .
the person showed your father 's mom 's wife 's teacher 's boss 's grandmother 's friend the ring .	the person dropped your father 's mom 's wife 's teacher 's boss 's grandmother 's friend the ring .
my doctor showed your grandmother 's daughter 's dentist 's husband 's husband 's doctor 's son the book .	my doctor dropped your grandmother 's daughter 's dentist 's husband 's husband 's doctor 's son the book .
Paul gave my brother 's father 's father 's sister 's daughter 's husband 's mother the door .	Paul held my brother 's father 's father 's sister 's daughter 's husband 's mother the door .
your friend gave my dad 's dentist 's brother 's cousin 's dentist 's wife 's brother the bowl .	your friend kept my dad 's dentist 's brother 's cousin 's dentist 's wife 's brother the bowl .
your teacher showed my father 's teacher 's son 's doctor 's grandmother 's father 's wife the picture .	your teacher held my father 's teacher 's son 's doctor 's grandmother 's father 's wife the picture .
the driver showed my wife 's husband 's dad 's mom 's grandmother 's dentist 's grandmother the fork .	the driver shook my wife 's husband 's dad 's mom 's grandmother 's dentist 's grandmother the fork .
George sent my friend 's father 's sister 's daughter 's dad 's daughter 's wife the boat .	George cleaned my friend 's father 's sister 's daughter 's dad 's daughter 's wife the boat .
Sara showed my son 's mother 's cousin 's son 's grandmother 's son 's dentist the truck .	Sara cleaned my son 's mother 's cousin 's son 's grandmother 's son 's dentist the truck .
Amy showed your husband 's father 's mother 's cousin 's dad 's mother 's father the truck .	Amy dropped your husband 's father 's mother 's cousin 's dad 's mother 's father the truck .
William gave your cousin 's husband 's brother 's sister 's mom 's brother 's wife the plane .	William dropped your cousin 's husband 's brother 's sister 's mom 's brother 's wife the plane .
my doctor bought your son 's mom 's mom 's boss 's dad 's brother 's husband the crayon .	my doctor dropped your son 's mom 's mom 's boss 's dad 's brother 's husband the crayon .
Carl showed your boss 's sister 's grandmother 's friend 's son 's mother 's grandmother the door .	Carl moved your boss 's sister 's grandmother 's friend 's son 's mother 's grandmother the door .
the adult showed my wife 's doctor 's dad 's grandmother 's sister 's mom 's dad the couch .	the adult dropped my wife 's doctor 's dad 's grandmother 's sister 's mom 's dad the couch .
my friend gave your boss 's mom 's husband 's daughter 's son 's mother 's husband the rug .	my friend cleaned your boss 's mom 's husband 's daughter 's son 's mother 's husband the rug .
your dentist bought my dentist 's doctor 's daughter 's wife 's sister 's daughter 's dentist the cup .	your dentist moved my dentist 's doctor 's daughter 's wife 's sister 's daughter 's dentist the cup .
the dentist sent my husband 's teacher 's grandmother 's teacher 's wife 's doctor 's father the spoon .	the dentist kept my husband 's teacher 's grandmother 's teacher 's wife 's doctor 's father the spoon .
the dentist gave my doctor 's friend 's sister 's mom 's husband 's dad 's dentist the bed .	the dentist moved my doctor 's friend 's sister 's mom 's husband 's dad 's dentist the bed .
the patient showed my daughter 's mom 's dad 's boss 's teacher 's friend 's husband the box .	the patient moved my daughter 's mom 's dad 's boss 's teacher 's friend 's husband the box .
your cousin sent my teacher 's daughter 's boss 's dad 's dad 's brother 's doctor the ring .	your cousin lost my teacher 's daughter 's boss 's dad 's dad 's brother 's doctor the ring .
the driver gave my husband 's son 's daughter 's husband 's husband 's sister 's husband the ring .	the driver shook my husband 's son 's daughter 's husband 's husband 's sister 's husband the ring .
the customer bought my husband 's husband 's husband 's sister 's grandmother 's cousin 's son the bag .	the customer held my husband 's husband 's husband 's sister 's grandmother 's cousin 's son the bag .
the dancer showed your doctor 's brother 's cousin 's dad 's son 's husband 's dad the doll .	the dancer kept your doctor 's brother 's cousin 's dad 's son 's husband 's dad the doll .
my doctor showed your son 's daughter 's boss 's son 's son 's son 's doctor the car .	my doctor lost your son 's daughter 's boss 's son 's son 's son 's doctor the car .
Amy gave my sister 's sister 's daughter 's mother 's mother 's friend 's daughter the window .	Amy cleaned my sister 's sister 's daughter 's mother 's mother 's friend 's daughter the window .
Ann sent my mother 's brother 's cousin 's friend 's mother 's mom 's son the fork .	Ann kept my mother 's brother 's cousin 's friend 's mother 's mom 's son the fork .
Sally gave your daughter 's brother 's dad 's daughter 's friend 's teacher 's boss the plate .	Sally dropped your daughter 's brother 's dad 's daughter 's friend 's teacher 's boss the plate .
my boss showed my son 's boss 's doctor 's doctor 's dad 's sister 's doctor the fork .	my boss held my son 's boss 's doctor 's doctor 's dad 's sister 's doctor the fork .
your cousin bought your father 's husband 's daughter 's mother 's boss 's friend 's doctor the plate .	your cousin kept your father 's husband 's daughter 's mother 's boss 's friend 's doctor the plate .
the dancer gave your wife 's son 's teacher 's son 's doctor 's daughter 's dad the ship .	the dancer kept your wife 's son 's teacher 's son 's doctor 's daughter 's dad the ship .
my boss showed my wife 's dentist 's cousin 's mom 's boss 's grandmother 's grandmother the ring .	my boss cleaned my wife 's dentist 's cousin 's mom 's boss 's grandmother 's grandmother the ring .
Alice showed your brother 's sister 's teacher 's grandmother 's friend 's boss 's dentist the boat .	Alice cleaned your brother 's sister 's teacher 's grandmother 's friend 's boss 's dentist the boat .
James sent your cousin 's wife 's husband 's mom 's dad 's father 's husband the fork .	James cleaned your cousin 's wife 's husband 's mom 's dad 's father 's husband the fork .
my boss showed my mother 's dad 's mom 's grandmother 's mom 's brother 's grandmother the door .	my boss dropped my mother 's dad 's mom 's grandmother 's mom 's brother 's grandmother the door .
Brett bought your friend 's boss 's grandmother 's mom 's doctor 's grandmother 's father the bed .	Brett kept your friend 's boss 's grandmother 's mom 's doctor 's grandmother 's father the bed .
the doctor showed your brother 's friend 's doctor 's mom 's mother 's teacher 's brother the picture .	the doctor lost your brother 's friend 's doctor 's mom 's mother 's teacher 's brother the picture .
the customer sent my father 's friend 's grandmother 's daughter 's father 's wife 's boss the shoe .	the customer lost my father 's friend 's grandmother 's daughter 's father 's wife 's boss the shoe .
Brett gave your mom 's husband 's son 's doctor 's sister 's boss 's teacher the book .	Brett dropped your mom 's husband 's son 's doctor 's sister 's boss 's teacher the book .
the driver showed your boss 's wife 's mother 's father 's friend 's dad 's friend the car .	the driver kept your boss 's wife 's mother 's father 's friend 's dad 's friend the car .
the dancer showed my mother 's grandmother 's cousin 's father 's boss 's boss 's dad the shirt .	the dancer dropped my mother 's grandmother 's cousin 's father 's boss 's boss 's dad the shirt .
my cousin sent your doctor 's husband 's brother 's wife 's grandmother 's sister 's cousin the car .	my cousin moved your doctor 's husband 's brother 's wife 's grandmother 's sister 's cousin the car .
my doctor bought my mother 's mother 's husband 's dentist 's son 's father 's son the plate .	my doctor kept my mother 's mother 's husband 's dentist 's son 's father 's son the plate .
my friend bought your sister 's cousin 's dad 's father 's friend 's boss 's dentist the doll .	my friend dropped your sister 's cousin 's dad 's father 's friend 's boss 's dentist the doll .
Paul sent your friend 's husband 's husband 's wife 's boss 's mother 's mom the glass .	Paul kept your friend 's husband 's husband 's wife 's boss 's mother 's mom the glass .
the driver gave my boss 's husband 's wife 's doctor 's friend 's dentist 's wife the shirt .	the driver kept my boss 's husband 's wife 's doctor 's friend 's dentist 's wife the shirt .
your boss sent your teacher 's boss 's brother 's dentist 's mother 's grandmother 's husband the ring .	your boss dropped your teacher 's boss 's brother 's dentist 's mother 's grandmother 's husband the ring .
the patient bought my son 's mom 's mom 's mother 's cousin 's boss 's cousin the toy .	the patient held my son 's mom 's mom 's mother 's cousin 's boss 's cousin the toy .
my boss sent my friend 's brother 's grandmother 's son 's teacher 's wife 's boss the chair .	my boss held my friend 's brother 's grandmother 's son 's teacher 's wife 's boss the chair .
the driver gave your husband 's mom 's cousin 's doctor 's wife 's son 's teacher the chair .	the driver held your husband 's mom 's cousin 's doctor 's wife 's son 's teacher the chair .
the person sent your mom 's husband 's teacher 's husband 's teacher 's dentist 's mom the boat .	the person cleaned your mom 's husband 's teacher 's husband 's teacher 's dentist 's mom the boat .
my teacher sent my dentist 's teacher 's dad 's daughter 's husband 's dentist 's boss the shoe .	my teacher cleaned my dentist 's teacher 's dad 's daughter 's husband 's dentist 's boss the shoe .
the dentist sent my son 's wife 's husband 's dentist 's boss 's daughter 's sister the cup .	the dentist held my son 's wife 's husband 's dentist 's boss 's daughter 's sister the cup .
my doctor sent your mom 's cousin 's dentist 's boss 's dentist 's dad 's friend the fork .	my doctor lost your mom 's cousin 's dentist 's boss 's dentist 's dad 's friend the fork .
my teacher gave your doctor 's sister 's mom 's brother 's brother 's mom 's son the boat .	my teacher dropped your doctor 's sister 's mom 's brother 's brother 's mom 's son the boat .
your friend sent my wife 's brother 's mother 's dad 's brother 's grandmother 's son the cup .	your friend moved my wife 's brother 's mother 's dad 's brother 's grandmother 's son the cup .
Steve gave your dad 's brother 's father 's daughter 's teacher 's dad 's brother the truck .	Steve held your dad 's brother 's father 's daughter 's teacher 's dad 's brother the truck .
my teacher gave my friend 's son 's doctor 's brother 's friend 's son 's cousin the rug .	my teacher dropped my friend 's son 's doctor 's brother 's friend 's son 's cousin the rug .
the child bought my teacher 's brother 's son 's cousin 's sister 's boss 's daughter the plane .	the child lost my teacher 's brother 's son 's cousin 's sister 's boss 's daughter the plane .
the child bought my dad 's dad 's brother 's mother 's dentist 's boss 's doctor the bottle .	the child lost my dad 's dad 's brother 's mother 's dentist 's boss 's doctor the bottle .
my dentist gave your sister 's mother 's grandmother 's friend 's dad 's teacher 's teacher the car .	my dentist lost your sister 's mother 's grandmother 's friend 's dad 's teacher 's teacher the car .
the child sent my cousin 's friend 's dentist 's brother 's sister 's doctor 's husband the book .	the child lost my cousin 's friend 's dentist 's brother 's sister 's doctor 's husband the book .
Bill gave my teacher 's teacher 's son 's daughter 's mom 's mother 's mother the hat .	Bill shook my teacher 's teacher 's son 's daughter 's mom 's mother 's mother the hat .
your boss sent my doctor 's cousin 's grandmother 's son 's mother 's grandmother 's teacher the book .	your boss lost my doctor 's cousin 's grandmother 's son 's mother 's grandmother 's teacher the book .
your doctor gave your friend 's brother 's sister 's teacher 's husband 's teacher 's husband the box .	your doctor dropped your friend 's brother 's sister 's teacher 's husband 's teacher 's husband the box .
my dentist bought your friend 's son 's grandmother 's grandmother 's friend 's wife 's doctor the crayon .	my dentist kept your friend 's son 's grandmother 's grandmother 's friend 's wife 's doctor the crayon .
your doctor gave my grandmother 's sister 's wife 's daughter 's sister 's husband 's father the bicycle .	your doctor lost my grandmother 's sister 's wife 's daughter 's sister 's husband 's father the bicycle .
the patient gave my son 's friend 's wife 's dentist 's son 's cousin 's boss the truck .	the patient held my son 's friend 's wife 's dentist 's son 's cousin 's boss the truck .
my dentist showed my sister 's doctor 's dentist 's grandmother 's brother 's dentist 's son the bed .	my dentist shook my sister 's doctor 's dentist 's grandmother 's brother 's dentist 's son the bed .
your doctor sent your brother 's daughter 's mother 's boss 's brother 's friend 's mother the box .	your doctor cleaned your brother 's daughter 's mother 's boss 's brother 's friend 's mother the box .
David gave your dad 's cousin 's dentist 's father 's mother 's husband 's husband the doll .	David moved your dad 's cousin 's dentist 's father 's mother 's husband 's husband the doll .
Vanessa sent my friend 's doctor 's grandmother 's sister 's mother 's mom 's husband the truck .	Vanessa held my friend 's doctor 's grandmother 's sister 's mother 's mom 's husband the truck .
your dentist sent your friend 's doctor 's son 's friend 's wife 's sister 's daughter the truck .	your dentist lost your friend 's doctor 's son 's friend 's wife 's sister 's daughter the truck .
my cousin sent your mother 's grandmother 's dentist 's cousin 's son 's wife 's friend the crayon .	my cousin lost your mother 's grandmother 's dentist 's cousin 's son 's wife 's friend the crayon .
my friend sent your dad 's teacher 's father 's dad 's mom 's dad 's dad the bag .	my friend cleaned your dad 's teacher 's father 's dad 's mom 's dad 's dad the bag .
the dentist sent my friend 's son 's cousin 's son 's cousin 's sister 's sister the fork .	the dentist lost my friend 's son 's cousin 's son 's cousin 's sister 's sister the fork .
Emily gave my boss 's teacher 's mom 's wife 's grandmother 's boss 's cousin the cup .	Emily lost my boss 's teacher 's mom 's wife 's grandmother 's boss 's cousin the cup .
Steven sent my wife 's son 's doctor 's father 's mom 's husband 's dad the fork .	Steven moved my wife 's son 's doctor 's father 's mom 's husband 's dad the fork .
the driver bought your daughter 's dentist 's friend 's doctor 's boss 's dad 's friend the plane .	the driver dropped your daughter 's dentist 's friend 's doctor 's boss 's dad 's friend the plane .
the patient bought your mother 's boss 's father 's mother 's dentist 's dad 's wife the glass .	the patient lost your mother 's boss 's father 's mother 's dentist 's dad 's wife the glass .
your dentist gave your son 's doctor 's grandmother 's cousin 's mom 's friend 's father the hat .	your dentist lost your son 's doctor 's grandmother 's cousin 's mom 's friend 's father the hat .
my teacher sent my brother 's father 's dentist 's boss 's doctor 's daughter 's sister the doll .	my teacher moved my brother 's father 's dentist 's boss 's doctor 's daughter 's sister the doll .
Bill gave my boss 's daughter 's daughter 's dad 's mother 's mother 's mom the bag .	Bill lost my boss 's daughter 's daughter 's dad 's mother 's mother 's mom the bag .
your dentist gave my grandmother 's grandmother 's dad 's daughter 's dentist 's mother 's dad the fork .	your dentist moved my grandmother 's grandmother 's dad 's daughter 's dentist 's mother 's dad the fork .
my friend bought your grandmother 's son 's brother 's father 's sister 's daughter 's teacher the book .	my friend dropped your grandmother 's son 's brother 's father 's sister 's daughter 's teacher the book .
Dan sent my daughter 's husband 's brother 's doctor 's boss 's teacher 's cousin the fork .	Dan kept my daughter 's husband 's brother 's doctor 's boss 's teacher 's cousin the fork .
my friend showed my mother 's friend 's daughter 's cousin 's grandmother 's brother 's brother the picture .	my friend moved my mother 's friend 's daughter 's cousin 's grandmother 's brother 's brother the picture .
Gregory showed your brother 's dentist 's friend 's wife 's father 's husband 's daughter the fork .	Gregory moved your brother 's dentist 's friend 's wife 's father 's husband 's daughter the fork .
Brett bought your cousin 's mother 's teacher 's friend 's brother 's brother 's brother the hat .	Brett held your cousin 's mother 's teacher 's friend 's brother 's brother 's brother the hat .
the person sent your cousin 's grandmother 's doctor 's husband 's friend 's teacher 's wife the bicycle .	the person moved your cousin 's grandmother 's doctor 's husband 's friend 's teacher 's wife the bicycle .
the child sent my brother 's daughter 's mother 's doctor 's dad 's wife 's father the bag .	the child shook my brother 's daughter 's mother 's doctor 's dad 's wife 's father the bag .
my teacher gave my son 's dentist 's cousin 's wife 's mother 's cousin 's dentist the bowl .	my teacher lost my son 's dentist 's cousin 's wife 's mother 's cousin 's dentist the bowl .
Rachel bought your mom 's brother 's friend 's father 's dad 's wife 's son the mirror .	Rachel held your mom 's brother 's friend 's father 's dad 's wife 's son the mirror .
Linda gave my dad 's brother 's sister 's father 's dentist 's doctor 's doctor the truck .	Linda held my dad 's brother 's sister 's father 's dentist 's doctor 's doctor the truck .
your cousin gave your dentist 's son 's dad 's teacher 's mother 's brother 's dentist the chair .	your cousin moved your dentist 's son 's dad 's teacher 's mother 's brother 's dentist the chair .
the teacher sent your dentist 's teacher 's wife 's husband 's brother 's father 's dentist the bed .	the teacher moved your dentist 's teacher 's wife 's husband 's brother 's father 's dentist the bed .
the patient showed your doctor 's doctor 's wife 's cousin 's brother 's brother 's teacher the ring .	the patient held your doctor 's doctor 's wife 's cousin 's brother 's brother 's teacher the ring .
the dentist showed my son 's wife 's wife 's doctor 's husband 's husband 's father the doll .	the dentist moved my son 's wife 's wife 's doctor 's husband 's husband 's father the doll .
my boss gave my daughter 's mother 's daughter 's dentist 's daughter 's wife 's cousin the bowl .	my boss moved my daughter 's mother 's daughter 's dentist 's daughter 's wife 's cousin the bowl .
my boss showed your son 's brother 's teacher 's son 's doctor 's son 's friend the box .	my boss held your son 's brother 's teacher 's son 's doctor 's son 's friend the box .
Alexander gave your husband 's mom 's doctor 's son 's dentist 's cousin 's brother the rug .	Alexander shook your husband 's mom 's doctor 's son 's dentist 's cousin 's brother the rug .
my boss sent my teacher 's boss 's daughter 's brother 's wife 's teacher 's brother the rocket .	my boss kept my teacher 's boss 's daughter 's brother 's wife 's teacher 's brother the rocket .
my friend bought your doctor 's sister 's son 's dentist 's friend 's mom 's mom the shirt .	my friend lost your doctor 's sister 's son 's dentist 's friend 's mom 's mom the shirt .
your cousin sent your son 's son 's wife 's dentist 's friend 's teacher 's grandmother the mirror .	your cousin lost your son 's son 's wife 's dentist 's friend 's teacher 's grandmother the mirror .
Stephanie sent your doctor 's friend 's dad 's dad 's dad 's wife 's mother the fork .	Stephanie shook your doctor 's friend 's dad 's dad 's dad 's wife 's mother the fork .
Amelia sent my daughter 's son 's sister 's boss 's cousin 's dentist 's mother the couch .	Amelia cleaned my daughter 's son 's sister 's boss 's cousin 's dentist 's mother the couch .
the adult bought my mom 's mom 's father 's boss 's husband 's dad 's brother the ship .	the adult shook my mom 's mom 's father 's boss 's husband 's dad 's brother the ship .
Vanessa bought your grandmother 's dentist 's friend 's dad 's dentist 's friend 's husband the truck .	Vanessa cleaned your grandmother 's dentist 's friend 's dad 's dentist 's friend 's husband the truck .
Sarah showed your teacher 's dad 's husband 's mother 's cousin 's teacher 's dad the bed .	Sarah shook your teacher 's dad 's husband 's mother 's cousin 's teacher 's dad the bed .
my cousin bought my father 's dentist 's sister 's cousin 's brother 's husband 's friend the toy .	my cousin cleaned my father 's dentist 's sister 's cousin 's brother 's husband 's friend the toy .
my teacher gave your friend 's doctor 's grandmother 's friend 's wife 's sister 's dentist the shirt .	my teacher shook your friend 's doctor 's grandmother 's friend 's wife 's sister 's dentist the shirt .
the person sent your cousin 's son 's teacher 's dad 's grandmother 's doctor 's friend the toy .	the person cleaned your cousin 's son 's teacher 's dad 's grandmother 's doctor 's friend the toy .
your friend gave my teacher 's sister 's dentist 's husband 's daughter 's sister 's daughter the rug .	your friend shook my teacher 's sister 's dentist 's husband 's daughter 's sister 's daughter the rug .
Jerry gave your mom 's friend 's daughter 's doctor 's teacher 's husband 's dentist the bag .	Jerry cleaned your mom 's friend 's daughter 's doctor 's teacher 's husband 's dentist the bag .
my teacher sent my daughter 's father 's mother 's teacher 's daughter 's wife 's mom the spoon .	my teacher kept my daughter 's father 's mother 's teacher 's daughter 's wife 's mom the spoon .
your teacher bought your sister 's father 's wife 's dentist 's boss 's son 's cousin the bowl .	your teacher moved your sister 's father 's wife 's dentist 's boss 's son 's cousin the bowl .
your cousin gave your mother 's dad 's mom 's teacher 's brother 's son 's boss the crayon .	your cousin moved your mother 's dad 's mom 's teacher 's brother 's son 's boss the crayon .
the child sent my dentist 's father 's boss 's grandmother 's daughter 's son 's cousin the shirt .	the child dropped my dentist 's father 's boss 's grandmother 's daughter 's son 's cousin the shirt .
Becky sent your wife 's brother 's daughter 's grandmother 's mother 's mother 's teacher the bicycle .	Becky lost your wife 's brother 's daughter 's grandmother 's mother 's mother 's teacher the bicycle .
the driver gave my father 's boss 's wife 's boss 's doctor 's husband 's cousin the plane .	the driver shook my father 's boss 's wife 's boss 's doctor 's husband 's cousin the plane .
the child bought your cousin 's mom 's doctor 's friend 's mother 's daughter 's cousin the book .	the child shook your cousin 's mom 's doctor 's friend 's mother 's daughter 's cousin the book .
your friend bought your cousin 's dentist 's grandmother 's mother 's boss 's dad 's wife the door .	your friend cleaned your cousin 's dentist 's grandmother 's mother 's boss 's dad 's wife the door .
Aaron bought my teacher 's husband 's daughter 's boss 's brother 's father 's dentist the plate .	Aaron shook my teacher 's husband 's daughter 's boss 's brother 's father 's dentist the plate .
your boss bought your sister 's cousin 's doctor 's dentist 's teacher 's wife 's grandmother the dish .	your boss lost your sister 's cousin 's doctor 's dentist 's teacher 's wife 's grandmother the dish .
the adult sent my teacher 's sister 's friend 's mom 's doctor 's son 's wife the box .	the adult held my teacher 's sister 's friend 's mom 's doctor 's son 's wife the box .
my doctor sent your husband 's boss 's doctor 's dad 's dentist 's daughter 's daughter the dish .	my doctor kept your husband 's boss 's doctor 's dad 's dentist 's daughter 's daughter the dish .
your dentist gave my daughter 's wife 's mother 's mother 's husband 's dad 's daughter the rug .	your dentist held my daughter 's wife 's mother 's mother 's husband 's dad 's daughter the rug .
the dancer bought my wife 's boss 's father 's mother 's mother 's father 's brother the crayon .	the dancer held my wife 's boss 's father 's mother 's mother 's father 's brother the crayon .
my friend showed my sister 's father 's friend 's wife 's wife 's cousin 's sister the bottle .	my friend cleaned my sister 's father 's friend 's wife 's wife 's cousin 's sister the bottle .
Bill bought my dad 's brother 's dad 's cousin 's boss 's friend 's daughter the bed .	Bill shook my dad 's brother 's dad 's cousin 's boss 's friend 's daughter the bed .
my teacher showed my wife 's cousin 's friend 's grandmother 's dad 's father 's boss the chair .	my teacher cleaned my wife 's cousin 's friend 's grandmother 's dad 's father 's boss the chair .
Marie bought my wife 's grandmother 's dad 's grandmother 's dentist 's doctor 's husband the spoon .	Marie moved my wife 's grandmother 's dad 's grandmother 's dentist 's doctor 's husband the spoon .
Sally showed my dad 's son 's wife 's cousin 's dentist 's mom 's grandmother the book .	Sally shook my dad 's son 's wife 's cousin 's dentist 's mom 's grandmother the book .
Jennifer bought your friend 's wife 's grandmother 's wife 's wife 's mom 's mom the couch .	Jennifer cleaned your friend 's wife 's grandmother 's wife 's wife 's mom 's mom the couch .
my friend gave your cousin 's friend 's dentist 's father 's mom 's dentist 's sister the book .	my friend held your cousin 's friend 's dentist 's father 's mom 's dentist 's sister the book .
the doctor showed your mom 's teacher 's mother 's boss 's friend 's husband 's doctor the ship .	the doctor cleaned your mom 's teacher 's mother 's boss 's friend 's husband 's doctor the ship .
Timothy sent my dentist 's husband 's boss 's daughter 's boss 's friend 's wife the bag .	Timothy cleaned my dentist 's husband 's boss 's daughter 's boss 's friend 's wife the bag .
Emily showed your dentist 's dentist 's father 's father 's dad 's sister 's mom the boat .	Emily dropped your dentist 's dentist 's father 's father 's dad 's sister 's mom the boat .
my cousin showed your doctor 's dentist 's son 's friend 's sister 's dad 's brother the bottle .	my cousin moved your doctor 's dentist 's son 's friend 's sister 's dad 's brother the bottle .
the driver bought my husband 's son 's friend 's son 's dentist 's boss 's brother the fork .	the driver kept my husband 's son 's friend 's son 's dentist 's boss 's brother the fork .
my cousin gave your grandmother 's boss 's daughter 's dentist 's cousin 's boss 's friend the doll .	my cousin shook your grandmother 's boss 's daughter 's dentist 's cousin 's boss 's friend the doll .
my doctor showed my sister 's teacher 's boss 's doctor 's friend 's cousin 's doctor the ring .	my doctor cleaned my sister 's teacher 's boss 's doctor 's friend 's cousin 's doctor the ring .
the patient sent my mother 's doctor 's sister 's sister 's doctor 's father 's mother the door .	the patient cleaned my mother 's doctor 's sister 's sister 's doctor 's father 's mother the door .
your teacher gave your sister 's husband 's dentist 's sister 's wife 's friend 's cousin the fork .	your teacher cleaned your sister 's husband 's dentist 's sister 's wife 's friend 's cousin the fork .
your dentist showed your wife 's mother 's dentist 's grandmother 's boss 's boss 's dentist the window .	your dentist kept your wife 's mother 's dentist 's grandmother 's boss 's boss 's dentist the window .
the person showed your teacher 's wife 's grandmother 's boss 's teacher 's grandmother 's teacher the mirror .	the person dropped your teacher 's wife 's grandmother 's boss 's teacher 's grandmother 's teacher the mirror .
the adult showed my brother 's sister 's brother 's son 's father 's friend 's doctor the button .	the adult lost my brother 's sister 's brother 's son 's father 's friend 's doctor the button .
Joseph showed your friend 's brother 's wife 's son 's friend 's brother 's dentist the rocket .	Joseph shook your friend 's brother 's wife 's son 's friend 's brother 's dentist the rocket .
your boss bought your son 's mom 's daughter 's doctor 's wife 's wife 's dad the car .	your boss lost your son 's mom 's daughter 's doctor 's wife 's wife 's dad the car .
the child gave your doctor 's daughter 's mother 's daughter 's son 's wife 's doctor the ship .	the child moved your doctor 's daughter 's mother 's daughter 's son 's wife 's doctor the ship .
Mary sent my dentist 's friend 's husband 's son 's boss 's dentist 's wife the toy .	Mary dropped my dentist 's friend 's husband 's son 's boss 's dentist 's wife the toy .
the patient showed your cousin 's mother 's husband 's teacher 's son 's mom 's cousin the book .	the patient dropped your cousin 's mother 's husband 's teacher 's son 's mom 's cousin the book .
the adult gave your boss 's son 's cousin 's father 's brother 's wife 's teacher the box .	the adult dropped your boss 's son 's cousin 's father 's brother 's wife 's teacher the box .
my friend bought my dad 's grandmother 's mom 's doctor 's brother 's mother 's friend the doll .	my friend moved my dad 's grandmother 's mom 's doctor 's brother 's mother 's friend the doll .
Brian sent my teacher 's dad 's grandmother 's sister 's doctor 's cousin 's daughter the chair .	Brian held my teacher 's dad 's grandmother 's sister 's doctor 's cousin 's daughter the chair .
Jason bought your sister 's dentist 's son 's wife 's father 's cousin 's mom the bag .	Jason dropped your sister 's dentist 's son 's wife 's father 's cousin 's mom the bag .
the child bought my boss 's dentist 's cousin 's mom 's cousin 's dad 's brother the plate .	the child held my boss 's dentist 's cousin 's mom 's cousin 's dad 's brother the plate .
the dancer bought your mother 's doctor 's boss 's husband 's mother 's friend 's grandmother the truck .	the dancer cleaned your mother 's doctor 's boss 's husband 's mother 's friend 's grandmother the truck .
Nancy bought your father 's friend 's wife 's dad 's dad 's son 's daughter the window .	Nancy dropped your father 's friend 's wife 's dad 's dad 's son 's daughter the window .
the child bought my sister 's son 's mom 's dad 's wife 's dentist 's wife the glass .	the child shook my sister 's son 's mom 's dad 's wife 's dentist 's wife the glass .
Kristen sent your son 's cousin 's boss 's daughter 's son 's doctor 's mom the dish .	Kristen dropped your son 's cousin 's boss 's daughter 's son 's doctor 's mom the dish .
the customer gave my friend 's dentist 's mother 's doctor 's sister 's boss 's cousin the ship .	the customer held my friend 's dentist 's mother 's doctor 's sister 's boss 's cousin the ship .
your boss sent your doctor 's boss 's dentist 's dad 's doctor 's dentist 's cousin the window .	your boss dropped your doctor 's boss 's dentist 's dad 's doctor 's dentist 's cousin the window .
the adult gave your cousin 's teacher 's mom 's dentist 's doctor 's boss 's doctor the window .	the adult kept your cousin 's teacher 's mom 's dentist 's doctor 's boss 's doctor the window .
the dancer sent my dentist 's boss 's dentist 's mother 's dentist 's friend 's boss the fork .	the dancer lost my dentist 's boss 's dentist 's mother 's dentist 's friend 's boss the fork .
the dentist bought your doctor 's grandmother 's wife 's husband 's grandmother 's daughter 's brother the ship .	the dentist kept your doctor 's grandmother 's wife 's husband 's grandmother 's daughter 's brother the ship .
Alexander showed your wife 's doctor 's daughter 's sister 's mother 's teacher 's mother the shirt .	Alexander lost your wife 's doctor 's daughter 's sister 's mother 's teacher 's mother the shirt .
my dentist gave my doctor 's brother 's brother 's husband 's mother 's sister 's son the chair .	my dentist dropped my doctor 's brother 's brother 's husband 's mother 's sister 's son the chair .
the driver showed my dad 's cousin 's sister 's daughter 's wife 's dad 's friend the glass .	the driver dropped my dad 's cousin 's sister 's daughter 's wife 's dad 's friend the glass .
Sandra showed my daughter 's son 's boss 's boss 's son 's husband 's mom the ring .	Sandra cleaned my daughter 's son 's boss 's boss 's son 's husband 's mom the ring .
the customer showed my son 's grandmother 's father 's wife 's mom 's mother 's husband the bag .	the customer cleaned my son 's grandmother 's father 's wife 's mom 's mother 's husband the bag .
Naomi showed my boss 's dad 's teacher 's boss 's boss 's sister 's daughter the book .	Naomi held my boss 's dad 's teacher 's boss 's boss 's sister 's daughter the book .
my cousin showed your grandmother 's brother 's brother 's boss 's teacher 's boss 's daughter the bag .	my cousin kept your grandmother 's brother 's brother 's boss 's teacher 's boss 's daughter the bag .
your doctor gave your daughter 's mom 's wife 's cousin 's husband 's doctor 's doctor the bottle .	your doctor dropped your daughter 's mom 's wife 's cousin 's husband 's doctor 's doctor the bottle .
your dentist sent your husband 's boss 's teacher 's dentist 's daughter 's father 's mother the bottle .	your dentist moved your husband 's boss 's teacher 's dentist 's daughter 's father 's mother the bottle .
your doctor sent your husband 's daughter 's mom 's mother 's grandmother 's husband 's brother the cup .	your doctor cleaned your husband 's daughter 's mom 's mother 's grandmother 's husband 's brother the cup .
Barbara gave my friend 's mother 's cousin 's grandmother 's wife 's father 's boss the car .	Barbara lost my friend 's mother 's cousin 's grandmother 's wife 's father 's boss the car .
the adult showed your daughter 's daughter 's brother 's son 's boss 's teacher 's brother the truck .	the adult lost your daughter 's daughter 's brother 's son 's boss 's teacher 's brother the truck .
Aaron bought your mom 's grandmother 's dentist 's doctor 's dentist 's brother 's daughter the picture .	Aaron dropped your mom 's grandmother 's dentist 's doctor 's dentist 's brother 's daughter the picture .
your dentist bought your wife 's son 's teacher 's brother 's teacher 's grandmother 's teacher the bicycle .	your dentist cleaned your wife 's son 's teacher 's brother 's teacher 's grandmother 's teacher the bicycle .
Kevin bought my dad 's friend 's husband 's brother 's friend 's brother 's husband the plate .	Kevin shook my dad 's friend 's husband 's brother 's friend 's brother 's husband the plate .
the customer bought your wife 's son 's son 's boss 's wife 's wife 's teacher the boat .	the customer cleaned your wife 's son 's son 's boss 's wife 's wife 's teacher the boat .
Todd bought your husband 's father 's dad 's son 's father 's teacher 's wife the bicycle .	Todd cleaned your husband 's father 's dad 's son 's father 's teacher 's wife the bicycle .
my friend showed your boss 's friend 's doctor 's husband 's dentist 's teacher 's sister the mirror .	my friend moved your boss 's friend 's doctor 's husband 's dentist 's teacher 's sister the mirror .
my friend showed my brother 's son 's grandmother 's husband 's cousin 's cousin 's dad the hat .	my friend dropped my brother 's son 's grandmother 's husband 's cousin 's cousin 's dad the hat .
your cousin bought my husband 's doctor 's brother 's cousin 's sister 's mother 's doctor the glass .	your cousin dropped my husband 's doctor 's brother 's cousin 's sister 's mother 's doctor the glass .
my teacher bought my daughter 's doctor 's dentist 's friend 's mom 's grandmother 's sister the spoon .	my teacher cleaned my daughter 's doctor 's dentist 's friend 's mom 's grandmother 's sister the spoon .
Wendy gave my brother 's sister 's wife 's husband 's grandmother 's brother 's father the car .	Wendy lost my brother 's sister 's wife 's husband 's grandmother 's brother 's father the car .
your friend gave my cousin 's dad 's father 's dentist 's friend 's mother 's grandmother the plate .	your friend dropped my cousin 's dad 's father 's dentist 's friend 's mother 's grandmother the plate .
my boss gave my mom 's son 's dentist 's brother 's boss 's friend 's dad the glass .	my boss held my mom 's son 's dentist 's brother 's boss 's friend 's dad the glass .
my doctor gave your daughter 's teacher 's grandmother 's teacher 's husband 's mom 's doctor the ship .	my doctor cleaned your daughter 's teacher 's grandmother 's teacher 's husband 's mom 's doctor the ship .
Laurie gave your grandmother 's father 's father 's husband 's wife 's sister 's doctor the chair .	Laurie lost your grandmother 's father 's father 's husband 's wife 's sister 's doctor the chair .
your friend showed your dad 's cousin 's daughter 's wife 's doctor 's boss 's dad the book .	your friend moved your dad 's cousin 's daughter 's wife 's doctor 's boss 's dad the book .
my friend bought my grandmother 's dad 's cousin 's grandmother 's grandmother 's wife 's cousin the window .	my friend held my grandmother 's dad 's cousin 's grandmother 's grandmother 's wife 's cousin the window .
my dentist sent your dad 's grandmother 's sister 's teacher 's boss 's mom 's mother the plane .	my dentist held your dad 's grandmother 's sister 's teacher 's boss 's mom 's mother the plane .
my teacher sent your dad 's dentist 's mom 's father 's mother 's brother 's son the picture .	my teacher held your dad 's dentist 's mom 's father 's mother 's brother 's son the picture .
my friend sent my son 's doctor 's dad 's dad 's dentist 's grandmother 's friend the plate .	my friend held my son 's doctor 's dad 's dad 's dentist 's grandmother 's friend the plate .
Michelle bought my brother 's boss 's sister 's cousin 's sister 's mother 's friend the button .	Michelle held my brother 's boss 's sister 's cousin 's sister 's mother 's friend the button .
my friend bought my sister 's boss 's mom 's dentist 's grandmother 's teacher 's dad the doll .	my friend held my sister 's boss 's mom 's dentist 's grandmother 's teacher 's dad the doll .
Timothy bought your mother 's brother 's wife 's grandmother 's dentist 's dentist 's father the box .	Timothy moved your mother 's brother 's wife 's grandmother 's dentist 's dentist 's father the box .
the dentist showed your teacher 's husband 's boss 's mother 's boss 's son 's son the button .	the dentist dropped your teacher 's husband 's boss 's mother 's boss 's son 's son the button .
my teacher bought my sister 's son 's father 's husband 's cousin 's mother 's teacher the hat .	my teacher held my sister 's son 's father 's husband 's cousin 's mother 's teacher the hat .
the dancer bought your dentist 's dentist 's sister 's mom 's husband 's daughter 's boss the bicycle .	the dancer cleaned your dentist 's dentist 's sister 's mom 's husband 's daughter 's boss the bicycle .
your dentist showed my cousin 's boss 's cousin 's husband 's teacher 's boss 's daughter the rocket .	your dentist dropped my cousin 's boss 's cousin 's husband 's teacher 's boss 's daughter the rocket .
my doctor showed my husband 's daughter 's father 's cousin 's father 's mother 's dentist the car .	my doctor held my husband 's daughter 's father 's cousin 's father 's mother 's dentist the car .
the dentist sent your brother 's dentist 's father 's daughter 's dentist 's sister 's dad the chair .	the dentist moved your brother 's dentist 's father 's daughter 's dentist 's sister 's dad the chair .
your friend showed your grandmother 's friend 's grandmother 's daughter 's father 's mother 's wife the ship .	your friend cleaned your grandmother 's friend 's grandmother 's daughter 's father 's mother 's wife the ship .
your teacher showed my son 's dentist 's boss 's husband 's boss 's dentist 's wife the cup .	your teacher dropped my son 's dentist 's boss 's husband 's boss 's dentist 's wife the cup .
Samantha showed my teacher 's son 's dentist 's son 's brother 's mother 's mother the couch .	Samantha held my teacher 's son 's dentist 's son 's brother 's mother 's mother the couch .
Julia bought my sister 's daughter 's sister 's dad 's sister 's son 's grandmother the bowl .	Julia moved my sister 's daughter 's sister 's dad 's sister 's son 's grandmother the bowl .
Mary gave your daughter 's sister 's teacher 's husband 's friend 's doctor 's boss the dish .	Mary cleaned your daughter 's sister 's teacher 's husband 's friend 's doctor 's boss the dish .
the driver gave your cousin 's mom 's dad 's dentist 's teacher 's dentist 's teacher the shoe .	the driver kept your cousin 's mom 's dad 's dentist 's teacher 's dentist 's teacher the shoe .
Frank sent your son 's grandmother 's cousin 's mom 's grandmother 's teacher 's friend the picture .	Frank held your son 's grandmother 's cousin 's mom 's grandmother 's teacher 's friend the picture .
the patient showed my doctor 's mother 's cousin 's daughter 's mom 's husband 's son the car .	the patient lost my doctor 's mother 's cousin 's daughter 's mom 's husband 's son the car .
Alexander gave my father 's mom 's mother 's brother 's sister 's mom 's sister the doll .	Alexander dropped my father 's mom 's mother 's brother 's sister 's mom 's sister the doll .
the dentist sent my wife 's boss 's cousin 's boss 's friend 's friend 's daughter the book .	the dentist lost my wife 's boss 's cousin 's boss 's friend 's friend 's daughter the book .
the doctor showed your grandmother 's friend 's brother 's mom 's teacher 's cousin 's dad the rug .	the doctor held your grandmother 's friend 's brother 's mom 's teacher 's cousin 's dad the rug .
your doctor sent your brother 's mother 's boss 's grandmother 's grandmother 's friend 's cousin the couch .	your doctor moved your brother 's mother 's boss 's grandmother 's grandmother 's friend 's cousin the couch .
the teacher gave your sister 's doctor 's friend 's father 's brother 's sister 's friend the couch .	the teacher kept your sister 's doctor 's friend 's father 's brother 's sister 's friend the couch .
Melissa bought my mother 's mom 's daughter 's grandmother 's cousin 's son 's mom the shirt .	Melissa cleaned my mother 's mom 's daughter 's grandmother 's cousin 's son 's mom the shirt .
your friend gave your friend 's dad 's brother 's son 's daughter 's sister 's brother the plane .	your friend kept your friend 's dad 's brother 's son 's daughter 's sister 's brother the plane .
the child bought my son 's husband 's boss 's father 's dentist 's mother 's son the plate .	the child lost my son 's husband 's boss 's father 's dentist 's mother 's son the plate .
the doctor showed your wife 's dad 's son 's boss 's mother 's boss 's daughter the spoon .	the doctor shook your wife 's dad 's son 's boss 's mother 's boss 's daughter the spoon .
Sara gave my brother 's friend 's dentist 's teacher 's wife 's cousin 's husband the button .	Sara shook my brother 's friend 's dentist 's teacher 's wife 's cousin 's husband the button .
Mark gave my son 's doctor 's son 's mom 's mom 's cousin 's teacher the candle .	Mark lost my son 's doctor 's son 's mom 's mom 's cousin 's teacher the candle .
Ronald sent my teacher 's husband 's dentist 's teacher 's sister 's son 's brother the glass .	Ronald shook my teacher 's husband 's dentist 's teacher 's sister 's son 's brother the glass .
the adult sent your dad 's mother 's mother 's daughter 's brother 's husband 's mother the mirror .	the adult shook your dad 's mother 's mother 's daughter 's brother 's husband 's mother the mirror .
Denise sent your mom 's sister 's husband 's dentist 's cousin 's dentist 's doctor the window .	Denise cleaned your mom 's sister 's husband 's dentist 's cousin 's dentist 's doctor the window .
the patient sent your sister 's teacher 's mom 's dad 's doctor 's mom 's dentist the button .	the patient shook your sister 's teacher 's mom 's dad 's doctor 's mom 's dentist the button .
Jane sent my grandmother 's grandmother 's friend 's son 's husband 's son 's teacher the door .	Jane moved my grandmother 's grandmother 's friend 's son 's husband 's son 's teacher the door .
my doctor bought my teacher 's wife 's teacher 's husband 's husband 's sister 's daughter the door .	my doctor dropped my teacher 's wife 's teacher 's husband 's husband 's sister 's daughter the door .
the dancer gave my mother 's daughter 's wife 's son 's teacher 's mom 's mother the bag .	the dancer dropped my mother 's daughter 's wife 's son 's teacher 's mom 's mother the bag .
my doctor bought my father 's wife 's son 's husband 's wife 's doctor 's boss the chair .	my doctor dropped my father 's wife 's son 's husband 's wife 's doctor 's boss the chair .
the person bought my grandmother 's dentist 's husband 's father 's dad 's friend 's cousin the mirror .	the person cleaned my grandmother 's dentist 's husband 's father 's dad 's friend 's cousin the mirror .
the customer bought your sister 's dentist 's son 's dad 's brother 's friend 's sister the ship .	the customer shook your sister 's dentist 's son 's dad 's brother 's friend 's sister the ship .
Donna gave your friend 's teacher 's doctor 's father 's dentist 's wife 's mother the bed .	Donna kept your friend 's teacher 's doctor 's father 's dentist 's wife 's mother the bed .
my cousin showed your father 's wife 's wife 's friend 's sister 's son 's dentist the ship .	my cousin held your father 's wife 's wife 's friend 's sister 's son 's dentist the ship .
my teacher bought your doctor 's boss 's grandmother 's dentist 's doctor 's wife 's son the box .	my teacher cleaned your doctor 's boss 's grandmother 's dentist 's doctor 's wife 's son the box .
your doctor sent my friend 's cousin 's teacher 's cousin 's dad 's doctor 's brother the shoe .	your doctor cleaned my friend 's cousin 's teacher 's cousin 's dad 's doctor 's brother the shoe .
the adult sent my daughter 's sister 's mom 's son 's wife 's boss 's mom the ship .	the adult held my daughter 's sister 's mom 's son 's wife 's boss 's mom the ship .
Tracy sent my daughter 's grandmother 's sister 's doctor 's teacher 's daughter 's cousin the truck .	Tracy kept my daughter 's grandmother 's sister 's doctor 's teacher 's daughter 's cousin the truck .
your dentist gave my grandmother 's doctor 's mother 's boss 's cousin 's cousin 's son the crayon .	your dentist moved my grandmother 's doctor 's mother 's boss 's cousin 's cousin 's son the crayon .
your teacher sent your daughter 's son 's teacher 's dentist 's wife 's grandmother 's husband the glass .	your teacher moved your daughter 's son 's teacher 's dentist 's wife 's grandmother 's husband the glass .
Anna sent my doctor 's doctor 's grandmother 's cousin 's sister 's friend 's mom the door .	Anna moved my doctor 's doctor 's grandmother 's cousin 's sister 's friend 's mom the door .
Carl bought your wife 's teacher 's brother 's sister 's son 's dad 's husband the crayon .	Carl dropped your wife 's teacher 's brother 's sister 's son 's dad 's husband the crayon .
Emily sent your mother 's dentist 's dad 's boss 's dentist 's dad 's brother the candle .	Emily dropped your mother 's dentist 's dad 's boss 's dentist 's dad 's brother the candle .
your doctor bought my sister 's dad 's son 's daughter 's husband 's dad 's mom the spoon .	your doctor dropped my sister 's dad 's son 's daughter 's husband 's dad 's mom the spoon .
the child showed my mother 's husband 's husband 's mother 's doctor 's wife 's husband the hat .	the child kept my mother 's husband 's husband 's mother 's doctor 's wife 's husband the hat .
Jane bought my son 's friend 's grandmother 's dentist 's grandmother 's wife 's brother the crayon .	Jane cleaned my son 's friend 's grandmother 's dentist 's grandmother 's wife 's brother the crayon .
my teacher gave my sister 's doctor 's husband 's wife 's sister 's father 's mother the window .	my teacher kept my sister 's doctor 's husband 's wife 's sister 's father 's mother the window .
my boss showed my husband 's mom 's brother 's doctor 's grandmother 's boss 's mother the car .	my boss lost my husband 's mom 's brother 's doctor 's grandmother 's boss 's mother the car .
the customer gave your wife 's wife 's dentist 's grandmother 's daughter 's husband 's cousin the cup .	the customer shook your wife 's wife 's dentist 's grandmother 's daughter 's husband 's cousin the cup .
the customer showed your dentist 's friend 's doctor 's brother 's wife 's mother 's father the car .	the customer dropped your dentist 's friend 's doctor 's brother 's wife 's mother 's father the car .
the child showed your doctor 's son 's doctor 's son 's boss 's cousin 's teacher the rocket .	the child held your doctor 's son 's doctor 's son 's boss 's cousin 's teacher the rocket .
your doctor sent your dentist 's friend 's daughter 's sister 's teacher 's friend 's cousin the rug .	your doctor shook your dentist 's friend 's daughter 's sister 's teacher 's friend 's cousin the rug .
my cousin showed my cousin 's dentist 's boss 's mom 's teacher 's dad 's brother the shirt .	my cousin kept my cousin 's dentist 's boss 's mom 's teacher 's dad 's brother the shirt .
Jessica sent my sister 's doctor 's father 's father 's doctor 's cousin 's dad the door .	Jessica dropped my sister 's doctor 's father 's father 's doctor 's cousin 's dad the door .
the person bought your sister 's dad 's doctor 's boss 's dentist 's cousin 's brother the bicycle .	the person cleaned your sister 's dad 's doctor 's boss 's dentist 's cousin 's brother the bicycle .
Erin bought my sister 's boss 's wife 's daughter 's mom 's brother 's wife the dish .	Erin shook my sister 's boss 's wife 's daughter 's mom 's brother 's wife the dish .
Richard sent my brother 's boss 's mom 's dad 's brother 's dad 's boss the hat .	Richard shook my brother 's boss 's mom 's dad 's brother 's dad 's boss the hat .
the driver sent your father 's daughter 's father 's wife 's friend 's brother 's dad the box .	the driver dropped your father 's daughter 's father 's wife 's friend 's brother 's dad the box .
Nina bought your dentist 's boss 's friend 's mom 's husband 's father 's daughter the shoe .	Nina held your dentist 's boss 's friend 's mom 's husband 's father 's daughter the shoe .
the driver bought my cousin 's father 's mother 's dad 's father 's cousin 's daughter the glass .	the driver kept my cousin 's father 's mother 's dad 's father 's cousin 's daughter the glass .
your dentist sent your son 's father 's mom 's brother 's husband 's father 's son the plane .	your dentist cleaned your son 's father 's mom 's brother 's husband 's father 's son the plane .
my boss sent my cousin 's doctor 's dentist 's doctor 's dad 's doctor 's mother the crayon .	my boss cleaned my cousin 's doctor 's dentist 's doctor 's dad 's doctor 's mother the crayon .
my teacher sent my dentist 's friend 's mom 's sister 's grandmother 's doctor 's grandmother the book .	my teacher kept my dentist 's friend 's mom 's sister 's grandmother 's doctor 's grandmother the book .
the patient showed your son 's doctor 's wife 's father 's dad 's cousin 's father the book .	the patient cleaned your son 's doctor 's wife 's father 's dad 's cousin 's father the book .
my cousin gave your dad 's dentist 's daughter 's mom 's father 's brother 's dentist the truck .	my cousin cleaned your dad 's dentist 's daughter 's mom 's father 's brother 's dentist the truck .
my dentist gave your son 's mother 's husband 's wife 's cousin 's teacher 's wife the candle .	my dentist moved your son 's mother 's husband 's wife 's cousin 's teacher 's wife the candle .
Kristen sent my boss 's husband 's friend 's daughter 's mother 's teacher 's wife the crayon .	Kristen moved my boss 's husband 's friend 's daughter 's mother 's teacher 's wife the crayon .
the dentist sent your father 's mother 's mom 's husband 's wife 's father 's son the mirror .	the dentist lost your father 's mother 's mom 's husband 's wife 's father 's son the mirror .
my dentist gave your father 's daughter 's cousin 's daughter 's dentist 's cousin 's son the bed .	my dentist kept your father 's daughter 's cousin 's daughter 's dentist 's cousin 's son the bed .
the person gave my teacher 's sister 's doctor 's doctor 's friend 's father 's friend the chair .	the person kept my teacher 's sister 's doctor 's doctor 's friend 's father 's friend the chair .
Timothy showed my cousin 's father 's father 's mother 's mother 's wife 's cousin the ring .	Timothy lost my cousin 's father 's father 's mother 's mother 's wife 's cousin the ring .
James bought your teacher 's cousin 's father 's sister 's sister 's mom 's friend the crayon .	James held your teacher 's cousin 's father 's sister 's sister 's mom 's friend the crayon .
your doctor bought your teacher 's wife 's dad 's mom 's grandmother 's dad 's husband the ship .	your doctor cleaned your teacher 's wife 's dad 's mom 's grandmother 's dad 's husband the ship .
Emily bought your mother 's daughter 's dad 's father 's son 's teacher 's husband the glass .	Emily dropped your mother 's daughter 's dad 's father 's son 's teacher 's husband the glass .
the dentist showed your dad 's brother 's friend 's wife 's dad 's daughter 's mom the crayon .	the dentist shook your dad 's brother 's friend 's wife 's dad 's daughter 's mom the crayon .
your dentist sent your father 's friend 's wife 's wife 's husband 's dentist 's grandmother the chair .	your dentist held your father 's friend 's wife 's wife 's husband 's dentist 's grandmother the chair .
the adult gave your doctor 's dad 's mother 's friend 's dentist 's brother 's sister the bottle .	the adult lost your doctor 's dad 's mother 's friend 's dentist 's brother 's sister the bottle .
your friend showed your sister 's husband 's dad 's mom 's grandmother 's mother 's teacher the bowl .	your friend kept your sister 's husband 's dad 's mom 's grandmother 's mother 's teacher the bowl .
the child sent my mom 's sister 's teacher 's mom 's son 's mother 's mom the toy .	the child lost my mom 's sister 's teacher 's mom 's son 's mother 's mom the toy .
my doctor gave your grandmother 's mom 's dad 's mom 's friend 's cousin 's son the book .	my doctor lost your grandmother 's mom 's dad 's mom 's friend 's cousin 's son the book .
your teacher showed your mom 's boss 's dad 's dad 's father 's wife 's father the door .	your teacher lost your mom 's boss 's dad 's dad 's father 's wife 's father the door .
Julia sent your daughter 's grandmother 's mom 's dentist 's husband 's grandmother 's doctor the bottle .	Julia kept your daughter 's grandmother 's mom 's dentist 's husband 's grandmother 's doctor the bottle .
James sent your mom 's dad 's dentist 's mother 's brother 's doctor 's teacher the rocket .	James held your mom 's dad 's dentist 's mother 's brother 's doctor 's teacher the rocket .
the doctor sent your dad 's son 's husband 's dentist 's father 's cousin 's boss the picture .	the doctor moved your dad 's son 's husband 's dentist 's father 's cousin 's boss the picture .
Anne sent my husband 's doctor 's daughter 's dad 's husband 's teacher 's teacher the dish .	Anne moved my husband 's doctor 's daughter 's dad 's husband 's teacher 's teacher the dish .
the adult showed your mom 's brother 's wife 's dentist 's boss 's father 's dentist the hat .	the adult cleaned your mom 's brother 's wife 's dentist 's boss 's father 's dentist the hat .
your boss gave my mom 's sister 's wife 's mom 's father 's son 's son the bicycle .	your boss cleaned my mom 's sister 's wife 's mom 's father 's son 's son the bicycle .
your cousin gave your friend 's dentist 's dentist 's mom 's boss 's cousin 's wife the plane .	your cousin shook your friend 's dentist 's dentist 's mom 's boss 's cousin 's wife the plane .
Liam showed my grandmother 's brother 's son 's mom 's husband 's cousin 's brother the boat .	Liam lost my grandmother 's brother 's son 's mom 's husband 's cousin 's brother the boat .
your boss gave your son 's mother 's son 's sister 's cousin 's son 's daughter the couch .	your boss kept your son 's mother 's son 's sister 's cousin 's son 's daughter the couch .
the dentist showed my mother 's mother 's mom 's mother 's dentist 's grandmother 's father the button .	the dentist lost my mother 's mother 's mom 's mother 's dentist 's grandmother 's father the button .
the driver bought your teacher 's daughter 's brother 's wife 's grandmother 's brother 's friend the bag .	the driver shook your teacher 's daughter 's brother 's wife 's grandmother 's brother 's friend the bag .
the patient showed my dentist 's teacher 's brother 's daughter 's dentist 's father 's sister the shirt .	the patient moved my dentist 's teacher 's brother 's daughter 's dentist 's father 's sister the shirt .
Scott sent my son 's daughter 's dentist 's son 's boss 's boss 's mother the shirt .	Scott cleaned my son 's daughter 's dentist 's son 's boss 's boss 's mother the shirt .
my dentist gave my husband 's brother 's doctor 's sister 's mother 's dad 's dad the picture .	my dentist lost my husband 's brother 's doctor 's sister 's mother 's dad 's dad the picture .
your dentist showed my wife 's daughter 's cousin 's mother 's mother 's son 's teacher the couch .	your dentist kept my wife 's daughter 's cousin 's mother 's mother 's son 's teacher the couch .
my friend sent my doctor 's mother 's boss 's daughter 's friend 's brother 's wife the window .	my friend held my doctor 's mother 's boss 's daughter 's friend 's brother 's wife the window .
Allison showed my mom 's mom 's mother 's boss 's teacher 's dentist 's son the candle .	Allison kept my mom 's mom 's mother 's boss 's teacher 's dentist 's son the candle .
the person sent your husband 's husband 's dad 's daughter 's doctor 's grandmother 's daughter the glass .	the person kept your husband 's husband 's dad 's daughter 's doctor 's grandmother 's daughter the glass .
Kristen gave my mom 's teacher 's sister 's teacher 's grandmother 's son 's wife the bed .	Kristen cleaned my mom 's teacher 's sister 's teacher 's grandmother 's son 's wife the bed .
the doctor gave my teacher 's teacher 's teacher 's mom 's wife 's grandmother 's boss the plate .	the doctor kept my teacher 's teacher 's teacher 's mom 's wife 's grandmother 's boss the plate .
your friend bought your son 's husband 's grandmother 's brother 's sister 's doctor 's dad the shoe .	your friend cleaned your son 's husband 's grandmother 's brother 's sister 's doctor 's dad the shoe .
Anna sent my dentist 's grandmother 's wife 's dad 's brother 's sister 's grandmother the rocket .	Anna held my dentist 's grandmother 's wife 's dad 's brother 's sister 's grandmother the rocket .
my teacher bought your brother 's wife 's dentist 's mother 's cousin 's mom 's doctor the rug .	my teacher shook your brother 's wife 's dentist 's mother 's cousin 's mom 's doctor the rug .
the person bought my wife 's boss 's daughter 's husband 's sister 's mother 's doctor the ship .	the person lost my wife 's boss 's daughter 's husband 's sister 's mother 's doctor the ship .
the teacher showed my daughter 's doctor 's husband 's wife 's mom 's mom 's friend the car .	the teacher cleaned my daughter 's doctor 's husband 's wife 's mom 's mom 's friend the car .
the child bought my wife 's father 's wife 's brother 's boss 's brother 's father the bicycle .	the child lost my wife 's father 's wife 's brother 's boss 's brother 's father the bicycle .
my doctor gave my daughter 's father 's grandmother 's husband 's dad 's teacher 's father the car .	my doctor shook my daughter 's father 's grandmother 's husband 's dad 's teacher 's father the car .
the driver gave my daughter 's grandmother 's son 's wife 's mother 's grandmother 's brother the candle .	the driver moved my daughter 's grandmother 's son 's wife 's mother 's grandmother 's brother the candle .
the teacher gave my teacher 's brother 's father 's dad 's grandmother 's dad 's cousin the bicycle .	the teacher kept my teacher 's brother 's father 's dad 's grandmother 's dad 's cousin the bicycle .
your teacher bought my wife 's father 's daughter 's husband 's friend 's dad 's sister the button .	your teacher lost my wife 's father 's daughter 's husband 's friend 's dad 's sister the button .
the adult bought your dentist 's father 's daughter 's dad 's daughter 's grandmother 's doctor the bed .	the adult moved your dentist 's father 's daughter 's dad 's daughter 's grandmother 's doctor the bed .
Julie showed your cousin 's mother 's mom 's doctor 's mom 's father 's teacher the toy .	Julie held your cousin 's mother 's mom 's doctor 's mom 's father 's teacher the toy .
my boss showed your brother 's husband 's husband 's daughter 's daughter 's doctor 's cousin the couch .	my boss dropped your brother 's husband 's husband 's daughter 's daughter 's doctor 's cousin the couch .
your boss gave my father 's doctor 's grandmother 's mother 's son 's teacher 's doctor the car .	your boss lost my father 's doctor 's grandmother 's mother 's son 's teacher 's doctor the car .
Adam sent my dentist 's boss 's mother 's daughter 's brother 's teacher 's dad the ship .	Adam moved my dentist 's boss 's mother 's daughter 's brother 's teacher 's dad the ship .
the person gave my husband 's daughter 's dad 's mom 's sister 's grandmother 's cousin the box .	the person lost my husband 's daughter 's dad 's mom 's sister 's grandmother 's cousin the box .
Adam showed your dad 's teacher 's sister 's mother 's cousin 's doctor 's cousin the shoe .	Adam held your dad 's teacher 's sister 's mother 's cousin 's doctor 's cousin the shoe .
Noah bought your father 's son 's teacher 's cousin 's mother 's cousin 's mom the chair .	Noah moved your father 's son 's teacher 's cousin 's mother 's cousin 's mom the chair .
your friend sent your sister 's boss 's sister 's dad 's sister 's father 's dentist the bicycle .	your friend moved your sister 's boss 's sister 's dad 's sister 's father 's dentist the bicycle .
my friend bought your brother 's cousin 's cousin 's brother 's brother 's brother 's cousin the bed .	my friend lost your brother 's cousin 's cousin 's brother 's brother 's brother 's cousin the bed .
Jerry sent your brother 's friend 's husband 's cousin 's teacher 's boss 's dentist the door .	Jerry moved your brother 's friend 's husband 's cousin 's teacher 's boss 's dentist the door .
your doctor bought your cousin 's mother 's brother 's mother 's sister 's mother 's cousin the couch .	your doctor kept your cousin 's mother 's brother 's mother 's sister 's mother 's cousin the couch .
the patient gave my doctor 's father 's mother 's sister 's mother 's daughter 's friend the glass .	the patient held my doctor 's father 's mother 's sister 's mother 's daughter 's friend the glass .
my boss showed my dentist 's friend 's daughter 's teacher 's husband 's sister 's daughter the ship .	my boss cleaned my dentist 's friend 's daughter 's teacher 's husband 's sister 's daughter the ship .
the patient bought your daughter 's boss 's husband 's mother 's grandmother 's husband 's son the door .	the patient held your daughter 's boss 's husband 's mother 's grandmother 's husband 's son the door .
Peter bought your boss 's friend 's friend 's mom 's father 's teacher 's cousin the shirt .	Peter shook your boss 's friend 's friend 's mom 's father 's teacher 's cousin the shirt .
the dentist sent my mom 's husband 's daughter 's boss 's brother 's doctor 's dad the bag .	the dentist kept my mom 's husband 's daughter 's boss 's brother 's doctor 's dad the bag .
my friend sent your grandmother 's husband 's teacher 's boss 's wife 's husband 's daughter the car .	my friend moved your grandmother 's husband 's teacher 's boss 's wife 's husband 's daughter the car .
Becca showed your doctor 's wife 's doctor 's grandmother 's friend 's friend 's dad the chair .	Becca lost your doctor 's wife 's doctor 's grandmother 's friend 's friend 's dad the chair .
the dancer gave your father 's husband 's brother 's doctor 's mom 's boss 's brother the book .	the dancer lost your father 's husband 's brother 's doctor 's mom 's boss 's brother the book .
my boss bought my father 's sister 's wife 's mother 's son 's mom 's boss the toy .	my boss moved my father 's sister 's wife 's mother 's son 's mom 's boss the toy .
the patient gave my mom 's mom 's doctor 's doctor 's daughter 's grandmother 's grandmother the cup .	the patient kept my mom 's mom 's doctor 's doctor 's daughter 's grandmother 's grandmother the cup .
Renee showed my cousin 's dentist 's father 's son 's boss 's sister 's grandmother the truck .	Renee shook my cousin 's dentist 's father 's son 's boss 's sister 's grandmother the truck .
the child sent my brother 's mom 's dentist 's teacher 's dentist 's husband 's grandmother the bottle .	the child cleaned my brother 's mom 's dentist 's teacher 's dentist 's husband 's grandmother the bottle .
Julie showed my dentist 's wife 's father 's daughter 's son 's dentist 's teacher the door .	Julie moved my dentist 's wife 's father 's daughter 's son 's dentist 's teacher the door .
Gregory sent your mother 's cousin 's sister 's boss 's mom 's dad 's friend the rug .	Gregory kept your mother 's cousin 's sister 's boss 's mom 's dad 's friend the rug .
Michael bought my friend 's cousin 's boss 's dad 's dentist 's husband 's boss the rug .	Michael shook my friend 's cousin 's boss 's dad 's dentist 's husband 's boss the rug .
the customer sent my sister 's boss 's teacher 's brother 's teacher 's daughter 's boss the rocket .	the customer kept my sister 's boss 's teacher 's brother 's teacher 's daughter 's boss the rocket .
your boss gave my cousin 's son 's father 's grandmother 's father 's cousin 's sister the candle .	your boss lost my cousin 's son 's father 's grandmother 's father 's cousin 's sister the candle .
the teacher sent my cousin 's daughter 's mom 's grandmother 's brother 's brother 's wife the glass .	the teacher kept my cousin 's daughter 's mom 's grandmother 's brother 's brother 's wife the glass .
the dentist bought your father 's mother 's daughter 's mother 's cousin 's wife 's wife the truck .	the dentist lost your father 's mother 's daughter 's mother 's cousin 's wife 's wife the truck .
the doctor bought my wife 's father 's son 's daughter 's friend 's mom 's daughter the car .	the doctor lost my wife 's father 's son 's daughter 's friend 's mom 's daughter the car .
the adult showed my wife 's mom 's mom 's daughter 's dentist 's mother 's husband the car .	the adult moved my wife 's mom 's mom 's daughter 's dentist 's mother 's husband the car .
your friend showed your dad 's friend 's son 's grandmother 's grandmother 's husband 's son the rocket .	your friend shook your dad 's friend 's son 's grandmother 's grandmother 's husband 's son the rocket .
Nina showed your boss 's daughter 's mom 's mom 's son 's mom 's dentist the couch .	Nina lost your boss 's daughter 's mom 's mom 's son 's mom 's dentist the couch .
my boss gave my son 's mom 's brother 's mom 's mother 's grandmother 's son the chair .	my boss dropped my son 's mom 's brother 's mom 's mother 's grandmother 's son the chair .
your doctor gave my father 's boss 's dentist 's dentist 's brother 's father 's dad the rocket .	your doctor moved my father 's boss 's dentist 's dentist 's brother 's father 's dad the rocket .
your dentist bought your brother 's wife 's son 's mom 's friend 's son 's cousin the truck .	your dentist cleaned your brother 's wife 's son 's mom 's friend 's son 's cousin the truck .
Liam showed my son 's son 's mom 's husband 's husband 's dentist 's son the boat .	Liam moved my son 's son 's mom 's husband 's husband 's dentist 's son the boat .
the teacher showed my daughter 's boss 's mom 's cousin 's cousin 's daughter 's dentist the rug .	the teacher shook my daughter 's boss 's mom 's cousin 's cousin 's daughter 's dentist the rug .
Sara sent your son 's daughter 's teacher 's friend 's grandmother 's wife 's grandmother the picture .	Sara moved your son 's daughter 's teacher 's friend 's grandmother 's wife 's grandmother the picture .
your cousin bought your doctor 's boss 's husband 's doctor 's dentist 's father 's father the glass .	your cousin moved your doctor 's boss 's husband 's doctor 's dentist 's father 's father the glass .
the dancer gave your brother 's boss 's son 's dentist 's teacher 's daughter 's cousin the dish .	the dancer cleaned your brother 's boss 's son 's dentist 's teacher 's daughter 's cousin the dish .
my teacher bought your boss 's brother 's wife 's cousin 's teacher 's brother 's wife the window .	my teacher shook your boss 's brother 's wife 's cousin 's teacher 's brother 's wife the window .
Nicole bought my dentist 's grandmother 's brother 's cousin 's friend 's brother 's doctor the plate .	Nicole kept my dentist 's grandmother 's brother 's cousin 's friend 's brother 's doctor the plate .
the person bought your husband 's doctor 's daughter 's brother 's wife 's teacher 's cousin the hat .	the person kept your husband 's doctor 's daughter 's brother 's wife 's teacher 's cousin the hat .
John bought my cousin 's daughter 's husband 's sister 's daughter 's brother 's wife the bicycle .	John kept my cousin 's daughter 's husband 's sister 's daughter 's brother 's wife the bicycle .
Elizabeth showed your boss 's friend 's boss 's son 's husband 's boss 's cousin the door .	Elizabeth held your boss 's friend 's boss 's son 's husband 's boss 's cousin the door .
your teacher bought my boss 's teacher 's boss 's daughter 's grandmother 's doctor 's mom the plane .	your teacher lost my boss 's teacher 's boss 's daughter 's grandmother 's doctor 's mom the plane .
Deborah bought your boss 's husband 's cousin 's brother 's son 's friend 's brother the bicycle .	Deborah cleaned your boss 's husband 's cousin 's brother 's son 's friend 's brother the bicycle .
Jill bought my dentist 's friend 's doctor 's brother 's cousin 's son 's dentist the dish .	Jill dropped my dentist 's friend 's doctor 's brother 's cousin 's son 's dentist the dish .
the customer gave your boss 's father 's doctor 's husband 's teacher 's mother 's teacher the spoon .	the customer shook your boss 's father 's doctor 's husband 's teacher 's mother 's teacher the spoon .
the customer showed my grandmother 's cousin 's friend 's sister 's dad 's husband 's sister the crayon .	the customer dropped my grandmother 's cousin 's friend 's sister 's dad 's husband 's sister the crayon .
the driver sent your cousin 's brother 's boss 's friend 's father 's grandmother 's boss the chair .	the driver dropped your cousin 's brother 's boss 's friend 's father 's grandmother 's boss the chair .
the adult gave my friend 's friend 's mom 's boss 's mom 's mom 's husband the picture .	the adult lost my friend 's friend 's mom 's boss 's mom 's mom 's husband the picture .
my doctor gave my grandmother 's mom 's father 's father 's mom 's boss 's sister the boat .	my doctor lost my grandmother 's mom 's father 's father 's mom 's boss 's sister the boat .
my friend sent my son 's dad 's wife 's brother 's wife 's mother 's mother the door .	my friend moved my son 's dad 's wife 's brother 's wife 's mother 's mother the door .
Tracy bought your dentist 's dad 's mom 's friend 's cousin 's grandmother 's mom the bicycle .	Tracy cleaned your dentist 's dad 's mom 's friend 's cousin 's grandmother 's mom the bicycle .
your dentist showed your cousin 's brother 's mom 's mother 's dad 's dad 's wife the rug .	your dentist shook your cousin 's brother 's mom 's mother 's dad 's dad 's wife the rug .
your teacher bought my son 's teacher 's dad 's father 's dad 's husband 's daughter the button .	your teacher lost my son 's teacher 's dad 's father 's dad 's husband 's daughter the button .
the teacher showed your friend 's cousin 's wife 's father 's doctor 's brother 's mother the car .	the teacher shook your friend 's cousin 's wife 's father 's doctor 's brother 's mother the car .
Carol showed my mom 's friend 's friend 's doctor 's mother 's boss 's son the plane .	Carol cleaned my mom 's friend 's friend 's doctor 's mother 's boss 's son the plane .
Paul bought my husband 's mother 's dentist 's cousin 's dad 's daughter 's friend the chair .	Paul held my husband 's mother 's dentist 's cousin 's dad 's daughter 's friend the chair .
the child gave your sister 's cousin 's son 's cousin 's doctor 's mother 's mother the cup .	the child lost your sister 's cousin 's son 's cousin 's doctor 's mother 's mother the cup .
your doctor bought your husband 's cousin 's grandmother 's son 's father 's teacher 's dentist the plane .	your doctor shook your husband 's cousin 's grandmother 's son 's father 's teacher 's dentist the plane .
Anne gave your brother 's dentist 's sister 's mom 's teacher 's sister 's grandmother the bottle .	Anne moved your brother 's dentist 's sister 's mom 's teacher 's sister 's grandmother the bottle .
my friend bought your dad 's son 's grandmother 's mom 's wife 's cousin 's husband the doll .	my friend kept your dad 's son 's grandmother 's mom 's wife 's cousin 's husband the doll .
my dentist sent your dentist 's cousin 's grandmother 's wife 's friend 's wife 's dentist the bottle .	my dentist dropped your dentist 's cousin 's grandmother 's wife 's friend 's wife 's dentist the bottle .
your friend showed your cousin 's grandmother 's teacher 's teacher 's friend 's teacher 's dad the car .	your friend lost your cousin 's grandmother 's teacher 's teacher 's friend 's teacher 's dad the car .
the customer sent your brother 's father 's boss 's teacher 's boss 's grandmother 's daughter the car .	the customer kept your brother 's father 's boss 's teacher 's boss 's grandmother 's daughter the car .
the driver bought your brother 's mom 's cousin 's grandmother 's husband 's doctor 's mom the bottle .	the driver held your brother 's mom 's cousin 's grandmother 's husband 's doctor 's mom the bottle .
the driver showed your dad 's dentist 's brother 's dentist 's husband 's daughter 's brother the chair .	the driver dropped your dad 's dentist 's brother 's dentist 's husband 's daughter 's brother the chair .
the dentist sent your dad 's husband 's dad 's friend 's dentist 's grandmother 's son the door .	the dentist kept your dad 's husband 's dad 's friend 's dentist 's grandmother 's son the door .
Emily sent your husband 's boss 's dentist 's cousin 's wife 's friend 's boss the bottle .	Emily kept your husband 's boss 's dentist 's cousin 's wife 's friend 's boss the bottle .
the teacher gave your brother 's dentist 's cousin 's grandmother 's doctor 's grandmother 's father the box .	the teacher kept your brother 's dentist 's cousin 's grandmother 's doctor 's grandmother 's father the box .
the customer showed my sister 's mom 's teacher 's grandmother 's teacher 's mother 's friend the couch .	the customer shook my sister 's mom 's teacher 's grandmother 's teacher 's mother 's friend the couch .
your dentist showed your son 's brother 's father 's daughter 's brother 's son 's boss the car .	your dentist kept your son 's brother 's father 's daughter 's brother 's son 's boss the car .
my teacher showed my friend 's husband 's friend 's dad 's mother 's husband 's husband the rug .	my teacher cleaned my friend 's husband 's friend 's dad 's mother 's husband 's husband the rug .
my teacher bought my daughter 's grandmother 's brother 's dad 's son 's mother 's friend the book .	my teacher cleaned my daughter 's grandmother 's brother 's dad 's son 's mother 's friend the book .
the child showed your teacher 's sister 's mom 's doctor 's grandmother 's doctor 's mother the toy .	the child dropped your teacher 's sister 's mom 's doctor 's grandmother 's doctor 's mother the toy .
the child sent my brother 's wife 's grandmother 's wife 's dad 's dentist 's dentist the candle .	the child dropped my brother 's wife 's grandmother 's wife 's dad 's dentist 's dentist the candle .
Gregory gave your husband 's grandmother 's dad 's husband 's wife 's husband 's doctor the bottle .	Gregory kept your husband 's grandmother 's dad 's husband 's wife 's husband 's doctor the bottle .
your cousin showed my mom 's grandmother 's wife 's dentist 's friend 's grandmother 's dad the bowl .	your cousin shook my mom 's grandmother 's wife 's dentist 's friend 's grandmother 's dad the bowl .
your dentist gave my grandmother 's daughter 's wife 's dad 's cousin 's son 's daughter the spoon .	your dentist held my grandmother 's daughter 's wife 's dad 's cousin 's son 's daughter the spoon .
Catherine sent your friend 's cousin 's wife 's son 's friend 's grandmother 's father the spoon .	Catherine cleaned your friend 's cousin 's wife 's son 's friend 's grandmother 's father the spoon .
Scott gave my mom 's mother 's sister 's mother 's doctor 's teacher 's father the plane .	Scott held my mom 's mother 's sister 's mother 's doctor 's teacher 's father the plane .
Noah bought your boss 's grandmother 's cousin 's cousin 's husband 's son 's boss the fork .	Noah lost your boss 's grandmother 's cousin 's cousin 's husband 's son 's boss the fork .
the doctor sent your wife 's mother 's grandmother 's grandmother 's friend 's grandmother 's friend the ship .	the doctor shook your wife 's mother 's grandmother 's grandmother 's friend 's grandmother 's friend the ship .
Donna showed your boss 's boss 's brother 's sister 's cousin 's daughter 's dentist the fork .	Donna held your boss 's boss 's brother 's sister 's cousin 's daughter 's dentist the fork .
Barbara gave your friend 's son 's mom 's doctor 's son 's mother 's dentist the bottle .	Barbara lost your friend 's son 's mom 's doctor 's son 's mother 's dentist the bottle .
my friend sent my dentist 's mother 's husband 's father 's grandmother 's friend 's wife the hat .	my friend moved my dentist 's mother 's husband 's father 's grandmother 's friend 's wife the hat .
the dentist gave my daughter 's doctor 's mother 's brother 's doctor 's friend 's grandmother the doll .	the dentist moved my daughter 's doctor 's mother 's brother 's doctor 's friend 's grandmother the doll .
my teacher showed your mom 's husband 's cousin 's mom 's doctor 's grandmother 's cousin the book .	my teacher held your mom 's husband 's cousin 's mom 's doctor 's grandmother 's cousin the book .
Julia showed my son 's mother 's mom 's mother 's son 's doctor 's daughter the book .	Julia dropped my son 's mother 's mom 's mother 's son 's doctor 's daughter the book .
the customer sent your mom 's wife 's husband 's husband 's wife 's dentist 's daughter the crayon .	the customer shook your mom 's wife 's husband 's husband 's wife 's dentist 's daughter the crayon .
my cousin gave my doctor 's brother 's sister 's dentist 's boss 's son 's father the bicycle .	my cousin held my doctor 's brother 's sister 's dentist 's boss 's son 's father the bicycle .
your dentist sent your father 's mother 's sister 's daughter 's brother 's husband 's boss the shoe .	your dentist kept your father 's mother 's sister 's daughter 's brother 's husband 's boss the shoe .
my doctor gave your doctor 's dad 's boss 's wife 's brother 's father 's mother the shirt .	my doctor kept your doctor 's dad 's boss 's wife 's brother 's father 's mother the shirt .
your boss bought your son 's mom 's grandmother 's husband 's teacher 's dentist 's friend the rug .	your boss held your son 's mom 's grandmother 's husband 's teacher 's dentist 's friend the rug .
the teacher showed my father 's grandmother 's father 's boss 's daughter 's boss 's doctor the book .	the teacher cleaned my father 's grandmother 's father 's boss 's daughter 's boss 's doctor the book .
your teacher gave my son 's daughter 's teacher 's son 's teacher 's sister 's mom the spoon .	your teacher moved my son 's daughter 's teacher 's son 's teacher 's sister 's mom the spoon .
the adult bought your father 's dad 's dentist 's wife 's dad 's sister 's doctor the crayon .	the adult cleaned your father 's dad 's dentist 's wife 's dad 's sister 's doctor the crayon .
your cousin showed my son 's boss 's wife 's son 's friend 's doctor 's husband the door .	your cousin dropped my son 's boss 's wife 's son 's friend 's doctor 's husband the door .
your dentist showed your boss 's wife 's grandmother 's father 's son 's daughter 's wife the car .	your dentist shook your boss 's wife 's grandmother 's father 's son 's daughter 's wife the car .
my friend sent my mom 's brother 's mom 's dentist 's brother 's sister 's wife the cup .	my friend dropped my mom 's brother 's mom 's dentist 's brother 's sister 's wife the cup .
my cousin gave my dad 's mom 's boss 's doctor 's sister 's sister 's mother the truck .	my cousin kept my dad 's mom 's boss 's doctor 's sister 's sister 's mother the truck .
Carol showed my mom 's father 's brother 's teacher 's doctor 's dad 's mother the window .	Carol lost my mom 's father 's brother 's teacher 's doctor 's dad 's mother the window .
the child bought your teacher 's cousin 's wife 's mom 's dad 's father 's mother the picture .	the child shook your teacher 's cousin 's wife 's mom 's dad 's father 's mother the picture .
the dancer gave your sister 's husband 's friend 's mother 's husband 's brother 's cousin the hat .	the dancer kept your sister 's husband 's friend 's mother 's husband 's brother 's cousin the hat .
Cindy showed your boss 's boss 's husband 's cousin 's wife 's father 's boss the plate .	Cindy shook your boss 's boss 's husband 's cousin 's wife 's father 's boss the plate .
your boss gave my doctor 's dad 's wife 's son 's sister 's grandmother 's father the box .	your boss held my doctor 's dad 's wife 's son 's sister 's grandmother 's father the box .
my doctor sent my grandmother 's brother 's doctor 's doctor 's wife 's mother 's brother the book .	my doctor held my grandmother 's brother 's doctor 's doctor 's wife 's mother 's brother the book .
my boss gave my mother 's husband 's dentist 's teacher 's sister 's brother 's cousin the bicycle .	my boss lost my mother 's husband 's dentist 's teacher 's sister 's brother 's cousin the bicycle .
your teacher showed my dad 's dentist 's brother 's cousin 's husband 's daughter 's grandmother the crayon .	your teacher lost my dad 's dentist 's brother 's cousin 's husband 's daughter 's grandmother the crayon .
Ronald sent your mom 's son 's boss 's teacher 's friend 's teacher 's son the truck .	Ronald kept your mom 's son 's boss 's teacher 's friend 's teacher 's son the truck .
the customer gave your dentist 's brother 's doctor 's teacher 's dad 's brother 's wife the bag .	the customer dropped your dentist 's brother 's doctor 's teacher 's dad 's brother 's wife the bag .
the adult sent your dentist 's husband 's mom 's dad 's son 's son 's mother the spoon .	the adult shook your dentist 's husband 's mom 's dad 's son 's son 's mother the spoon .
Kristen showed your boss 's friend 's doctor 's dad 's doctor 's brother 's teacher the truck .	Kristen kept your boss 's friend 's doctor 's dad 's doctor 's brother 's teacher the truck .
my teacher sent my friend 's friend 's teacher 's sister 's boss 's brother 's sister the door .	my teacher cleaned my friend 's friend 's teacher 's sister 's boss 's brother 's sister the door .
Brian sent my grandmother 's mother 's dentist 's cousin 's husband 's son 's mom the book .	Brian kept my grandmother 's mother 's dentist 's cousin 's husband 's son 's mom the book .
my cousin bought my father 's mother 's friend 's doctor 's friend 's grandmother 's daughter the crayon .	my cousin lost my father 's mother 's friend 's doctor 's friend 's grandmother 's daughter the crayon .
the dentist sent my grandmother 's father 's wife 's sister 's dentist 's boss 's wife the cup .	the dentist lost my grandmother 's father 's wife 's sister 's dentist 's boss 's wife the cup .
your dentist showed your son 's mom 's daughter 's sister 's boss 's teacher 's boss the crayon .	your dentist held your son 's mom 's daughter 's sister 's boss 's teacher 's boss the crayon .
my cousin bought my mom 's daughter 's friend 's father 's son 's dad 's mother the plate .	my cousin held my mom 's daughter 's friend 's father 's son 's dad 's mother the plate .
Julie sent your doctor 's mother 's husband 's doctor 's boss 's father 's daughter the button .	Julie cleaned your doctor 's mother 's husband 's doctor 's boss 's father 's daughter the button .
Donald sent my boss 's son 's teacher 's mom 's father 's mom 's mother the fork .	Donald held my boss 's son 's teacher 's mom 's father 's mom 's mother the fork .
the doctor sent my friend 's dentist 's daughter 's father 's dentist 's friend 's doctor the couch .	the doctor cleaned my friend 's dentist 's daughter 's father 's dentist 's friend 's doctor the couch .
Anne bought your sister 's mother 's teacher 's daughter 's mom 's friend 's boss the shirt .	Anne lost your sister 's mother 's teacher 's daughter 's mom 's friend 's boss the shirt .
Julie showed your husband 's boss 's sister 's sister 's dad 's husband 's cousin the chair .	Julie shook your husband 's boss 's sister 's sister 's dad 's husband 's cousin the chair .
my friend showed my father 's grandmother 's brother 's husband 's cousin 's boss 's husband the plane .	my friend cleaned my father 's grandmother 's brother 's husband 's cousin 's boss 's husband the plane .
your cousin gave your boss 's mother 's dad 's dentist 's mother 's brother 's dad the ship .	your cousin shook your boss 's mother 's dad 's dentist 's mother 's brother 's dad the ship .
the adult bought your son 's boss 's boss 's son 's grandmother 's husband 's son the picture .	the adult cleaned your son 's boss 's boss 's son 's grandmother 's husband 's son the picture .
the adult bought your dentist 's sister 's husband 's doctor 's brother 's sister 's boss the book .	the adult cleaned your dentist 's sister 's husband 's doctor 's brother 's sister 's boss the book .
the doctor gave my mother 's mom 's brother 's father 's mother 's son 's husband the dish .	the doctor moved my mother 's mom 's brother 's father 's mother 's son 's husband the dish .
the patient sent your teacher 's wife 's mother 's son 's dad 's doctor 's friend the candle .	the patient lost your teacher 's wife 's mother 's son 's dad 's doctor 's friend the candle .
Cindy bought my sister 's daughter 's dentist 's teacher 's teacher 's dad 's teacher the car .	Cindy lost my sister 's daughter 's dentist 's teacher 's teacher 's dad 's teacher the car .
Joseph sent your dentist 's wife 's boss 's sister 's mom 's teacher 's husband the box .	Joseph shook your dentist 's wife 's boss 's sister 's mom 's teacher 's husband the box .
Kristen sent your dentist 's friend 's father 's dentist 's teacher 's dentist 's wife the toy .	Kristen held your dentist 's friend 's father 's dentist 's teacher 's dentist 's wife the toy .
George showed my doctor 's mom 's friend 's dentist 's dad 's daughter 's boss the bicycle .	George lost my doctor 's mom 's friend 's dentist 's dad 's daughter 's boss the bicycle .
your teacher gave your friend 's cousin 's dad 's doctor 's dentist 's teacher 's husband the shirt .	your teacher cleaned your friend 's cousin 's dad 's doctor 's dentist 's teacher 's husband the shirt .
the teacher bought your husband 's grandmother 's mother 's wife 's cousin 's wife 's sister the book .	the teacher kept your husband 's grandmother 's mother 's wife 's cousin 's wife 's sister the book .
the doctor gave your sister 's grandmother 's mother 's cousin 's cousin 's mom 's brother the glass .	the doctor kept your sister 's grandmother 's mother 's cousin 's cousin 's mom 's brother the glass .
the child gave my mom 's father 's son 's cousin 's cousin 's wife 's cousin the cup .	the child lost my mom 's father 's son 's cousin 's cousin 's wife 's cousin the cup .
Paul bought your wife 's mom 's cousin 's friend 's sister 's teacher 's boss the crayon .	Paul moved your wife 's mom 's cousin 's friend 's sister 's teacher 's boss the crayon .
Jerry showed your boss 's cousin 's friend 's dad 's husband 's mother 's husband the shirt .	Jerry kept your boss 's cousin 's friend 's dad 's husband 's mother 's husband the shirt .
the teacher gave my doctor 's cousin 's teacher 's cousin 's sister 's sister 's friend the plane .	the teacher held my doctor 's cousin 's teacher 's cousin 's sister 's sister 's friend the plane .
the customer bought your teacher 's grandmother 's mom 's cousin 's dentist 's sister 's mom the window .	the customer held your teacher 's grandmother 's mom 's cousin 's dentist 's sister 's mom the window .
Donald sent your dad 's teacher 's cousin 's doctor 's daughter 's husband 's friend the plane .	Donald lost your dad 's teacher 's cousin 's doctor 's daughter 's husband 's friend the plane .
my friend bought my sister 's brother 's daughter 's mother 's brother 's teacher 's son the ring .	my friend kept my sister 's brother 's daughter 's mother 's brother 's teacher 's son the ring .
Wendy bought your doctor 's dentist 's dentist 's teacher 's brother 's father 's boss the spoon .	Wendy shook your doctor 's dentist 's dentist 's teacher 's brother 's father 's boss the spoon .
the dancer gave my grandmother 's friend 's brother 's teacher 's brother 's dentist 's mom the spoon .	the dancer kept my grandmother 's friend 's brother 's teacher 's brother 's dentist 's mom the spoon .
Jennifer gave your wife 's boss 's mother 's mother 's mom 's mom 's mom the rug .	Jennifer held your wife 's boss 's mother 's mother 's mom 's mom 's mom the rug .
my teacher gave my wife 's sister 's wife 's brother 's friend 's sister 's husband the doll .	my teacher kept my wife 's sister 's wife 's brother 's friend 's sister 's husband the doll .
your dentist gave your son 's father 's wife 's mother 's sister 's mom 's wife the car .	your dentist lost your son 's father 's wife 's mother 's sister 's mom 's wife the car .
the patient showed your daughter 's son 's wife 's cousin 's sister 's sister 's friend the spoon .	the patient cleaned your daughter 's son 's wife 's cousin 's sister 's sister 's friend the spoon .
your teacher showed your son 's brother 's sister 's husband 's wife 's dentist 's son the bowl .	your teacher moved your son 's brother 's sister 's husband 's wife 's dentist 's son the bowl .
my cousin gave my father 's mother 's father 's brother 's wife 's doctor 's friend the dish .	my cousin kept my father 's mother 's father 's brother 's wife 's doctor 's friend the dish .
the person bought my dad 's mom 's boss 's dad 's boss 's daughter 's father the crayon .	the person cleaned my dad 's mom 's boss 's dad 's boss 's daughter 's father the crayon .
my doctor gave my husband 's doctor 's cousin 's boss 's brother 's doctor 's mother the bed .	my doctor shook my husband 's doctor 's cousin 's boss 's brother 's doctor 's mother the bed .
the teacher bought your doctor 's brother 's doctor 's son 's wife 's brother 's grandmother the window .	the teacher lost your doctor 's brother 's doctor 's son 's wife 's brother 's grandmother the window .
the patient bought my teacher 's doctor 's father 's brother 's son 's mom 's son the mirror .	the patient held my teacher 's doctor 's father 's brother 's son 's mom 's son the mirror .
the doctor gave your friend 's grandmother 's grandmother 's dad 's husband 's son 's grandmother the button .	the doctor shook your friend 's grandmother 's grandmother 's dad 's husband 's son 's grandmother the button .
your doctor sent my teacher 's brother 's doctor 's brother 's daughter 's wife 's cousin the boat .	your doctor shook my teacher 's brother 's doctor 's brother 's daughter 's wife 's cousin the boat .
Liam bought my cousin 's teacher 's mother 's brother 's daughter 's boss 's mother the truck .	Liam shook my cousin 's teacher 's mother 's brother 's daughter 's boss 's mother the truck .
the customer bought your mother 's teacher 's father 's friend 's father 's sister 's mom the plate .	the customer cleaned your mother 's teacher 's father 's friend 's father 's sister 's mom the plate .
my boss showed your grandmother 's dad 's daughter 's boss 's dad 's cousin 's father the spoon .	my boss kept your grandmother 's dad 's daughter 's boss 's dad 's cousin 's father the spoon .
my teacher bought my mom 's husband 's brother 's mom 's father 's boss 's teacher the plane .	my teacher kept my mom 's husband 's brother 's mom 's father 's boss 's teacher the plane .
your boss showed your daughter 's cousin 's friend 's dentist 's wife 's cousin 's doctor the bowl .	your boss kept your daughter 's cousin 's friend 's dentist 's wife 's cousin 's doctor the bowl .
your doctor sent your doctor 's daughter 's grandmother 's dentist 's mom 's sister 's son the plate .	your doctor dropped your doctor 's daughter 's grandmother 's dentist 's mom 's sister 's son the plate .
Emily bought your daughter 's doctor 's dad 's dentist 's father 's mom 's doctor the bag .	Emily held your daughter 's doctor 's dad 's dentist 's father 's mom 's doctor the bag .
my doctor bought my dentist 's husband 's mom 's dad 's husband 's husband 's grandmother the dish .	my doctor moved my dentist 's husband 's mom 's dad 's husband 's husband 's grandmother the dish .
Lisa gave my teacher 's dad 's wife 's dad 's mom 's mother 's son the couch .	Lisa moved my teacher 's dad 's wife 's dad 's mom 's mother 's son the couch .
Renee gave my father 's father 's dentist 's friend 's dad 's friend 's doctor the plate .	Renee lost my father 's father 's dentist 's friend 's dad 's friend 's doctor the plate .
Patrick showed your sister 's sister 's brother 's father 's teacher 's grandmother 's teacher the shirt .	Patrick lost your sister 's sister 's brother 's father 's teacher 's grandmother 's teacher the shirt .
Paul sent your sister 's sister 's boss 's grandmother 's cousin 's teacher 's dad the chair .	Paul moved your sister 's sister 's boss 's grandmother 's cousin 's teacher 's dad the chair .
the driver sent my dentist 's friend 's sister 's dentist 's wife 's mom 's friend the fork .	the driver lost my dentist 's friend 's sister 's dentist 's wife 's mom 's friend the fork .
Steven gave your doctor 's grandmother 's doctor 's dentist 's dentist 's cousin 's daughter the boat .	Steven held your doctor 's grandmother 's doctor 's dentist 's dentist 's cousin 's daughter the boat .
Peter showed your mother 's mother 's sister 's dad 's sister 's daughter 's mom the rocket .	Peter shook your mother 's mother 's sister 's dad 's sister 's daughter 's mom the rocket .
my boss bought my father 's dentist 's boss 's wife 's dad 's doctor 's teacher the candle .	my boss kept my father 's dentist 's boss 's wife 's dad 's doctor 's teacher the candle .
Amelia gave my dentist 's grandmother 's friend 's boss 's boss 's mother 's brother the truck .	Amelia dropped my dentist 's grandmother 's friend 's boss 's boss 's mother 's brother the truck .
the adult showed my wife 's father 's brother 's dad 's brother 's teacher 's brother the truck .	the adult shook my wife 's father 's brother 's dad 's brother 's teacher 's brother the truck .
Rebecca showed your brother 's boss 's husband 's doctor 's daughter 's father 's teacher the dish .	Rebecca held your brother 's boss 's husband 's doctor 's daughter 's father 's teacher the dish .
the adult sent your boss 's father 's wife 's dad 's boss 's grandmother 's mom the bag .	the adult held your boss 's father 's wife 's dad 's boss 's grandmother 's mom the bag .
Daniel showed my sister 's daughter 's mom 's friend 's dentist 's boss 's wife the rug .	Daniel lost my sister 's daughter 's mom 's friend 's dentist 's boss 's wife the rug .
your dentist sent your cousin 's doctor 's husband 's mother 's friend 's dentist 's brother the box .	your dentist held your cousin 's doctor 's husband 's mother 's friend 's dentist 's brother the box .
Denise showed my grandmother 's son 's sister 's mother 's mom 's dentist 's grandmother the fork .	Denise cleaned my grandmother 's son 's sister 's mother 's mom 's dentist 's grandmother the fork .
Julia bought your brother 's teacher 's mother 's cousin 's father 's mother 's daughter the cup .	Julia kept your brother 's teacher 's mother 's cousin 's father 's mother 's daughter the cup .
your teacher gave your doctor 's dentist 's dad 's cousin 's father 's sister 's daughter the button .	your teacher kept your doctor 's dentist 's dad 's cousin 's father 's sister 's daughter the button .
Ronald bought my wife 's teacher 's husband 's sister 's mom 's daughter 's father the dish .	Ronald shook my wife 's teacher 's husband 's sister 's mom 's daughter 's father the dish .
the dancer showed your boss 's teacher 's father 's friend 's dad 's mother 's grandmother the mirror .	the dancer lost your boss 's teacher 's father 's friend 's dad 's mother 's grandmother the mirror .
your boss gave my boss 's daughter 's friend 's doctor 's mother 's dentist 's wife the book .	your boss held my boss 's daughter 's friend 's doctor 's mother 's dentist 's wife the book .
Becky bought my husband 's doctor 's teacher 's sister 's mom 's father 's sister the cup .	Becky shook my husband 's doctor 's teacher 's sister 's mom 's father 's sister the cup .
my dentist gave my father 's son 's boss 's grandmother 's boss 's teacher 's brother the plane .	my dentist kept my father 's son 's boss 's grandmother 's boss 's teacher 's brother the plane .
your friend showed your boss 's wife 's boss 's brother 's doctor 's mom 's dad the chair .	your friend cleaned your boss 's wife 's boss 's brother 's doctor 's mom 's dad the chair .
my cousin bought your friend 's friend 's husband 's wife 's teacher 's father 's cousin the mirror .	my cousin dropped your friend 's friend 's husband 's wife 's teacher 's father 's cousin the mirror .
the customer showed your dad 's husband 's sister 's father 's sister 's mother 's son the fork .	the customer held your dad 's husband 's sister 's father 's sister 's mother 's son the fork .
Michelle gave your teacher 's grandmother 's father 's son 's sister 's teacher 's dad the ship .	Michelle dropped your teacher 's grandmother 's father 's son 's sister 's teacher 's dad the ship .
the dancer gave your mother 's dad 's doctor 's husband 's daughter 's boss 's wife the shirt .	the dancer cleaned your mother 's dad 's doctor 's husband 's daughter 's boss 's wife the shirt .
the dancer showed your daughter 's son 's husband 's teacher 's daughter 's teacher 's daughter the rocket .	the dancer held your daughter 's son 's husband 's teacher 's daughter 's teacher 's daughter the rocket .
Kristen sent your brother 's wife 's sister 's daughter 's teacher 's wife 's father the button .	Kristen moved your brother 's wife 's sister 's daughter 's teacher 's wife 's father the button .
Anna gave your cousin 's brother 's friend 's teacher 's boss 's husband 's son the ring .	Anna kept your cousin 's brother 's friend 's teacher 's boss 's husband 's son the ring .
the teacher gave your dentist 's brother 's father 's mother 's friend 's wife 's doctor the bed .	the teacher kept your dentist 's brother 's father 's mother 's friend 's wife 's doctor the bed .
the dentist sent my son 's mom 's dad 's brother 's teacher 's brother 's mother the bicycle .	the dentist kept my son 's mom 's dad 's brother 's teacher 's brother 's mother the bicycle .
the adult sent your grandmother 's cousin 's doctor 's doctor 's mom 's father 's daughter the plate .	the adult shook your grandmother 's cousin 's doctor 's doctor 's mom 's father 's daughter the plate .
the doctor gave your teacher 's grandmother 's mom 's mom 's doctor 's doctor 's son the window .	the doctor held your teacher 's grandmother 's mom 's mom 's doctor 's doctor 's son the window .
the adult sent your grandmother 's friend 's doctor 's mother 's grandmother 's teacher 's husband the candle .	the adult cleaned your grandmother 's friend 's doctor 's mother 's grandmother 's teacher 's husband the candle .
Emily gave your boss 's wife 's wife 's teacher 's mom 's cousin 's grandmother the chair .	Emily shook your boss 's wife 's wife 's teacher 's mom 's cousin 's grandmother the chair .
the child gave your friend 's doctor 's son 's son 's grandmother 's teacher 's dentist the bag .	the child dropped your friend 's doctor 's son 's son 's grandmother 's teacher 's dentist the bag .
the adult bought your brother 's daughter 's teacher 's brother 's daughter 's mother 's father the dish .	the adult shook your brother 's daughter 's teacher 's brother 's daughter 's mother 's father the dish .
the doctor gave your daughter 's grandmother 's grandmother 's husband 's mom 's wife 's husband the car .	the doctor shook your daughter 's grandmother 's grandmother 's husband 's mom 's wife 's husband the car .
the dancer sent your grandmother 's friend 's cousin 's wife 's grandmother 's mom 's father the plate .	the dancer lost your grandmother 's friend 's cousin 's wife 's grandmother 's mom 's father the plate .
the child showed my father 's teacher 's grandmother 's mom 's mom 's wife 's doctor the ship .	the child dropped my father 's teacher 's grandmother 's mom 's mom 's wife 's doctor the ship .
your doctor showed my dentist 's dentist 's boss 's grandmother 's mom 's brother 's mother the hat .	your doctor held my dentist 's dentist 's boss 's grandmother 's mom 's brother 's mother the hat .
my boss sent my boss 's sister 's father 's grandmother 's husband 's grandmother 's teacher the spoon .	my boss lost my boss 's sister 's father 's grandmother 's husband 's grandmother 's teacher the spoon .
your friend showed my mother 's dentist 's son 's mom 's mom 's sister 's cousin the ring .	your friend dropped my mother 's dentist 's son 's mom 's mom 's sister 's cousin the ring .
Jane showed my son 's cousin 's husband 's brother 's dad 's dad 's sister the bottle .	Jane shook my son 's cousin 's husband 's brother 's dad 's dad 's sister the bottle .
the teacher showed my mother 's teacher 's sister 's mom 's son 's cousin 's dad the cup .	the teacher shook my mother 's teacher 's sister 's mom 's son 's cousin 's dad the cup .
Barbara sent my cousin 's grandmother 's mom 's mother 's daughter 's boss 's boss the couch .	Barbara held my cousin 's grandmother 's mom 's mother 's daughter 's boss 's boss the couch .
the driver bought your brother 's sister 's mom 's cousin 's doctor 's mom 's dentist the fork .	the driver kept your brother 's sister 's mom 's cousin 's doctor 's mom 's dentist the fork .
Andrew sent my boss 's dentist 's sister 's boss 's dentist 's teacher 's dad the window .	Andrew dropped my boss 's dentist 's sister 's boss 's dentist 's teacher 's dad the window .
my boss gave my dad 's friend 's wife 's friend 's daughter 's daughter 's teacher the car .	my boss cleaned my dad 's friend 's wife 's friend 's daughter 's daughter 's teacher the car .
your doctor bought your daughter 's mom 's mom 's husband 's friend 's dentist 's brother the bed .	your doctor moved your daughter 's mom 's mom 's husband 's friend 's dentist 's brother the bed .
your cousin sent your wife 's brother 's dad 's doctor 's cousin 's teacher 's friend the dish .	your cousin kept your wife 's brother 's dad 's doctor 's cousin 's teacher 's friend the dish .
Joseph sent my friend 's dad 's boss 's mom 's cousin 's father 's husband the car .	Joseph moved my friend 's dad 's boss 's mom 's cousin 's father 's husband the car .
the adult showed my husband 's sister 's husband 's brother 's teacher 's grandmother 's father the ship .	the adult shook my husband 's sister 's husband 's brother 's teacher 's grandmother 's father the ship .
Vanessa bought my doctor 's grandmother 's brother 's wife 's mom 's son 's son the ship .	Vanessa dropped my doctor 's grandmother 's brother 's wife 's mom 's son 's son the ship .
your boss bought my mother 's friend 's boss 's teacher 's mom 's brother 's friend the fork .	your boss cleaned my mother 's friend 's boss 's teacher 's mom 's brother 's friend the fork .
your doctor sent your daughter 's daughter 's doctor 's friend 's grandmother 's grandmother 's doctor the plane .	your doctor shook your daughter 's daughter 's doctor 's friend 's grandmother 's grandmother 's doctor the plane .
your teacher gave my friend 's boss 's husband 's teacher 's son 's dentist 's cousin the bed .	your teacher lost my friend 's boss 's husband 's teacher 's son 's dentist 's cousin the bed .
my friend gave my grandmother 's father 's doctor 's grandmother 's teacher 's boss 's doctor the truck .	my friend held my grandmother 's father 's doctor 's grandmother 's teacher 's boss 's doctor the truck .
the doctor sent my sister 's cousin 's wife 's dad 's doctor 's mom 's grandmother the box .	the doctor held my sister 's cousin 's wife 's dad 's doctor 's mom 's grandmother the box .
the customer gave your wife 's brother 's dad 's daughter 's son 's dentist 's teacher the bag .	the customer dropped your wife 's brother 's dad 's daughter 's son 's dentist 's teacher the bag .
Judy bought my mother 's brother 's dentist 's grandmother 's father 's husband 's doctor the rug .	Judy held my mother 's brother 's dentist 's grandmother 's father 's husband 's doctor the rug .
my cousin showed my dad 's husband 's daughter 's mom 's wife 's mother 's dad the picture .	my cousin held my dad 's husband 's daughter 's mom 's wife 's mother 's dad the picture .
my friend bought your doctor 's husband 's brother 's sister 's dad 's son 's daughter the mirror .	my friend held your doctor 's husband 's brother 's sister 's dad 's son 's daughter the mirror .
the child gave my son 's friend 's boss 's son 's teacher 's brother 's mother the truck .	the child kept my son 's friend 's boss 's son 's teacher 's brother 's mother the truck .
your doctor sent my mother 's wife 's father 's wife 's wife 's grandmother 's grandmother the glass .	your doctor cleaned my mother 's wife 's father 's wife 's wife 's grandmother 's grandmother the glass .
Patrick sent your son 's boss 's teacher 's cousin 's sister 's friend 's grandmother the chair .	Patrick shook your son 's boss 's teacher 's cousin 's sister 's friend 's grandmother the chair .
Daniel gave your mother 's mom 's boss 's wife 's grandmother 's sister 's teacher the door .	Daniel moved your mother 's mom 's boss 's wife 's grandmother 's sister 's teacher the door .
your boss showed my mother 's boss 's mother 's sister 's dentist 's mom 's brother the window .	your boss moved my mother 's boss 's mother 's sister 's dentist 's mom 's brother the window .
Adam sent your doctor 's mom 's mom 's mother 's boss 's mother 's wife the box .	Adam kept your doctor 's mom 's mom 's mother 's boss 's mother 's wife the box .
the person bought your friend 's daughter 's dentist 's dentist 's brother 's mother 's mom the couch .	the person held your friend 's daughter 's dentist 's dentist 's brother 's mother 's mom the couch .
the dancer sent your daughter 's cousin 's grandmother 's brother 's doctor 's wife 's wife the box .	the dancer shook your daughter 's cousin 's grandmother 's brother 's doctor 's wife 's wife the box .
your dentist gave my wife 's son 's daughter 's grandmother 's husband 's dad 's doctor the book .	your dentist shook my wife 's son 's daughter 's grandmother 's husband 's dad 's doctor the book .
Brett sent your boss 's sister 's friend 's grandmother 's mother 's boss 's mother the shoe .	Brett cleaned your boss 's sister 's friend 's grandmother 's mother 's boss 's mother the shoe .
Marie gave my dad 's boss 's wife 's daughter 's teacher 's father 's teacher the book .	Marie shook my dad 's boss 's wife 's daughter 's teacher 's father 's teacher the book .
my friend showed your sister 's father 's daughter 's husband 's mother 's friend 's grandmother the car .	my friend kept your sister 's father 's daughter 's husband 's mother 's friend 's grandmother the car .
Erin showed your grandmother 's wife 's boss 's dentist 's doctor 's mother 's father the mirror .	Erin moved your grandmother 's wife 's boss 's dentist 's doctor 's mother 's father the mirror .
your dentist bought my daughter 's grandmother 's father 's brother 's dad 's brother 's husband the car .	your dentist shook my daughter 's grandmother 's father 's brother 's dad 's brother 's husband the car .
Jill gave your dentist 's sister 's mother 's husband 's teacher 's boss 's dad the button .	Jill cleaned your dentist 's sister 's mother 's husband 's teacher 's boss 's dad the button .
my dentist sent my doctor 's mother 's sister 's sister 's teacher 's daughter 's sister the door .	my dentist cleaned my doctor 's mother 's sister 's sister 's teacher 's daughter 's sister the door .
my boss sent your sister 's sister 's wife 's wife 's dad 's brother 's teacher the bowl .	my boss held your sister 's sister 's wife 's wife 's dad 's brother 's teacher the bowl .
my boss showed my teacher 's friend 's friend 's wife 's boss 's friend 's dad the candle .	my boss moved my teacher 's friend 's friend 's wife 's boss 's friend 's dad the candle .
the adult sent my cousin 's son 's daughter 's brother 's mom 's daughter 's doctor the shoe .	the adult shook my cousin 's son 's daughter 's brother 's mom 's daughter 's doctor the shoe .
Laurie showed my mom 's cousin 's teacher 's brother 's grandmother 's boss 's dad the picture .	Laurie moved my mom 's cousin 's teacher 's brother 's grandmother 's boss 's dad the picture .
the dancer showed your daughter 's grandmother 's sister 's doctor 's wife 's cousin 's mom the bed .	the dancer cleaned your daughter 's grandmother 's sister 's doctor 's wife 's cousin 's mom the bed .
Vanessa showed my son 's teacher 's sister 's cousin 's doctor 's grandmother 's father the mirror .	Vanessa lost my son 's teacher 's sister 's cousin 's doctor 's grandmother 's father the mirror .
the customer bought your son 's son 's doctor 's sister 's son 's dentist 's dentist the mirror .	the customer lost your son 's son 's doctor 's sister 's son 's dentist 's dentist the mirror .
your boss sent your friend 's brother 's mom 's sister 's doctor 's friend 's father the ship .	your boss lost your friend 's brother 's mom 's sister 's doctor 's friend 's father the ship .
your doctor showed your dentist 's grandmother 's mother 's brother 's sister 's son 's mother the rug .	your doctor held your dentist 's grandmother 's mother 's brother 's sister 's son 's mother the rug .
the patient bought my doctor 's brother 's mom 's cousin 's brother 's doctor 's husband the bed .	the patient lost my doctor 's brother 's mom 's cousin 's brother 's doctor 's husband the bed .
the dentist showed my mom 's dentist 's friend 's cousin 's son 's wife 's teacher the spoon .	the dentist lost my mom 's dentist 's friend 's cousin 's son 's wife 's teacher the spoon .
my teacher gave your dentist 's friend 's teacher 's doctor 's friend 's brother 's doctor the bed .	my teacher lost your dentist 's friend 's teacher 's doctor 's friend 's brother 's doctor the bed .
Susan showed your dentist 's sister 's cousin 's dentist 's husband 's mother 's doctor the plane .	Susan moved your dentist 's sister 's cousin 's dentist 's husband 's mother 's doctor the plane .
the patient showed your brother 's boss 's grandmother 's wife 's friend 's doctor 's father the ship .	the patient lost your brother 's boss 's grandmother 's wife 's friend 's doctor 's father the ship .
the dancer sent your grandmother 's doctor 's sister 's doctor 's teacher 's friend 's dad the toy .	the dancer dropped your grandmother 's doctor 's sister 's doctor 's teacher 's friend 's dad the toy .
Patrick gave your sister 's grandmother 's brother 's dad 's teacher 's husband 's mom the box .	Patrick kept your sister 's grandmother 's brother 's dad 's teacher 's husband 's mom the box .
your boss sent your dad 's wife 's husband 's dentist 's daughter 's son 's cousin the truck .	your boss shook your dad 's wife 's husband 's dentist 's daughter 's son 's cousin the truck .
your doctor showed your mom 's daughter 's friend 's wife 's husband 's friend 's mom the candle .	your doctor cleaned your mom 's daughter 's friend 's wife 's husband 's friend 's mom the candle .
Donna sent my dad 's mom 's wife 's father 's sister 's dad 's grandmother the door .	Donna shook my dad 's mom 's wife 's father 's sister 's dad 's grandmother the door .
my friend bought your husband 's mother 's sister 's daughter 's grandmother 's grandmother 's wife the bicycle .	my friend kept your husband 's mother 's sister 's daughter 's grandmother 's grandmother 's wife the bicycle .
Samantha gave your cousin 's mother 's grandmother 's cousin 's mom 's grandmother 's grandmother the window .	Samantha held your cousin 's mother 's grandmother 's cousin 's mom 's grandmother 's grandmother the window .
my friend sent your sister 's dentist 's dentist 's husband 's brother 's cousin 's husband the glass .	my friend lost your sister 's dentist 's dentist 's husband 's brother 's cousin 's husband the glass .
Tracy bought my son 's dentist 's doctor 's teacher 's husband 's dad 's doctor the book .	Tracy shook my son 's dentist 's doctor 's teacher 's husband 's dad 's doctor the book .
my doctor gave your doctor 's boss 's wife 's husband 's teacher 's teacher 's father the mirror .	my doctor cleaned your doctor 's boss 's wife 's husband 's teacher 's teacher 's father the mirror .
Sarah bought my father 's husband 's teacher 's husband 's friend 's boss 's mom the window .	Sarah kept my father 's husband 's teacher 's husband 's friend 's boss 's mom the window .
Guy showed my friend 's teacher 's grandmother 's dentist 's doctor 's brother 's mom the bowl .	Guy shook my friend 's teacher 's grandmother 's dentist 's doctor 's brother 's mom the bowl .
Guy gave my mother 's daughter 's dad 's father 's wife 's dad 's doctor the dish .	Guy dropped my mother 's daughter 's dad 's father 's wife 's dad 's doctor the dish .
the person showed my dad 's grandmother 's dad 's boss 's son 's doctor 's dad the shirt .	the person cleaned my dad 's grandmother 's dad 's boss 's son 's doctor 's dad the shirt .
Becca bought my daughter 's dentist 's father 's son 's son 's friend 's sister the candle .	Becca dropped my daughter 's dentist 's father 's son 's son 's friend 's sister the candle .
the person sent your doctor 's grandmother 's son 's teacher 's husband 's father 's grandmother the mirror .	the person cleaned your doctor 's grandmother 's son 's teacher 's husband 's father 's grandmother the mirror .
the teacher gave my daughter 's teacher 's dentist 's dad 's dad 's cousin 's sister the car .	the teacher cleaned my daughter 's teacher 's dentist 's dad 's dad 's cousin 's sister the car .
Julie sent my friend 's brother 's dad 's mother 's sister 's brother 's daughter the window .	Julie lost my friend 's brother 's dad 's mother 's sister 's brother 's daughter the window .
the teacher showed your friend 's husband 's mom 's husband 's sister 's daughter 's mother the rug .	the teacher kept your friend 's husband 's mom 's husband 's sister 's daughter 's mother the rug .
George showed my mother 's wife 's friend 's friend 's grandmother 's mom 's teacher the picture .	George moved my mother 's wife 's friend 's friend 's grandmother 's mom 's teacher the picture .
the driver gave your friend 's wife 's wife 's dad 's boss 's daughter 's grandmother the toy .	the driver lost your friend 's wife 's wife 's dad 's boss 's daughter 's grandmother the toy .
Allison sent your mom 's mother 's mom 's dentist 's sister 's mom 's mom the shoe .	Allison held your mom 's mother 's mom 's dentist 's sister 's mom 's mom the shoe .
the driver bought my sister 's son 's husband 's wife 's friend 's teacher 's wife the crayon .	the driver held my sister 's son 's husband 's wife 's friend 's teacher 's wife the crayon .
Mark sent my dentist 's doctor 's husband 's sister 's mom 's mother 's cousin the bed .	Mark dropped my dentist 's doctor 's husband 's sister 's mom 's mother 's cousin the bed .
your boss showed my teacher 's doctor 's son 's grandmother 's wife 's mother 's son the rug .	your boss moved my teacher 's doctor 's son 's grandmother 's wife 's mother 's son the rug .
Nancy showed your son 's husband 's father 's friend 's boss 's sister 's daughter the bag .	Nancy cleaned your son 's husband 's father 's friend 's boss 's sister 's daughter the bag .
the customer gave my boss 's wife 's mother 's dad 's son 's father 's sister the rug .	the customer cleaned my boss 's wife 's mother 's dad 's son 's father 's sister the rug .
John bought your brother 's husband 's mom 's doctor 's daughter 's mother 's dad the bowl .	John shook your brother 's husband 's mom 's doctor 's daughter 's mother 's dad the bowl .
Jason showed my dad 's father 's boss 's cousin 's doctor 's wife 's dad the mirror .	Jason shook my dad 's father 's boss 's cousin 's doctor 's wife 's dad the mirror .
the adult bought my sister 's grandmother 's friend 's son 's boss 's boss 's grandmother the ship .	the adult shook my sister 's grandmother 's friend 's son 's boss 's boss 's grandmother the ship .
Stephanie bought your dad 's dad 's mother 's daughter 's teacher 's son 's boss the ring .	Stephanie shook your dad 's dad 's mother 's daughter 's teacher 's son 's boss the ring .
your boss bought your doctor 's mother 's dentist 's mom 's dad 's doctor 's husband the book .	your boss shook your doctor 's mother 's dentist 's mom 's dad 's doctor 's husband the book .
the patient bought my son 's husband 's brother 's friend 's sister 's cousin 's husband the doll .	the patient held my son 's husband 's brother 's friend 's sister 's cousin 's husband the doll .
Ronald bought my wife 's mom 's mom 's teacher 's doctor 's boss 's grandmother the toy .	Ronald kept my wife 's mom 's mom 's teacher 's doctor 's boss 's grandmother the toy .
Aaron gave your cousin 's dad 's grandmother 's mom 's wife 's friend 's mother the spoon .	Aaron shook your cousin 's dad 's grandmother 's mom 's wife 's friend 's mother the spoon .
John sent your mother 's boss 's wife 's wife 's dentist 's brother 's brother the door .	John moved your mother 's boss 's wife 's wife 's dentist 's brother 's brother the door .
the adult bought your wife 's boss 's dentist 's friend 's mother 's grandmother 's teacher the chair .	the adult kept your wife 's boss 's dentist 's friend 's mother 's grandmother 's teacher the chair .
Vanessa showed my grandmother 's teacher 's dentist 's sister 's son 's daughter 's teacher the mirror .	Vanessa held my grandmother 's teacher 's dentist 's sister 's son 's daughter 's teacher the mirror .
the driver bought your mother 's teacher 's father 's friend 's doctor 's daughter 's mom the fork .	the driver held your mother 's teacher 's father 's friend 's doctor 's daughter 's mom the fork .
your dentist gave my mom 's son 's son 's brother 's cousin 's friend 's boss the bottle .	your dentist held my mom 's son 's son 's brother 's cousin 's friend 's boss the bottle .
Jessica showed your dad 's daughter 's cousin 's sister 's brother 's boss 's father the book .	Jessica kept your dad 's daughter 's cousin 's sister 's brother 's boss 's father the book .
your friend gave your teacher 's teacher 's mom 's son 's father 's friend 's wife the rocket .	your friend lost your teacher 's teacher 's mom 's son 's father 's friend 's wife the rocket .
Mary bought your teacher 's friend 's dentist 's dad 's grandmother 's brother 's mom the shoe .	Mary cleaned your teacher 's friend 's dentist 's dad 's grandmother 's brother 's mom the shoe .
the dancer sent your mom 's teacher 's husband 's father 's husband 's boss 's dentist the button .	the dancer shook your mom 's teacher 's husband 's father 's husband 's boss 's dentist the button .
your doctor bought your grandmother 's wife 's sister 's grandmother 's daughter 's cousin 's father the book .	your doctor dropped your grandmother 's wife 's sister 's grandmother 's daughter 's cousin 's father the book .
the doctor showed my brother 's cousin 's friend 's mom 's wife 's brother 's mother the book .	the doctor shook my brother 's cousin 's friend 's mom 's wife 's brother 's mother the book .
the doctor showed your mother 's husband 's brother 's brother 's daughter 's husband 's cousin the button .	the doctor cleaned your mother 's husband 's brother 's brother 's daughter 's husband 's cousin the button .
your teacher sent my cousin 's grandmother 's mother 's son 's daughter 's teacher 's friend the doll .	your teacher kept my cousin 's grandmother 's mother 's son 's daughter 's teacher 's friend the doll .
your doctor gave my husband 's sister 's sister 's grandmother 's daughter 's brother 's mom the bed .	your doctor cleaned my husband 's sister 's sister 's grandmother 's daughter 's brother 's mom the bed .
Paul gave my wife 's dad 's grandmother 's wife 's son 's grandmother 's son the bicycle .	Paul kept my wife 's dad 's grandmother 's wife 's son 's grandmother 's son the bicycle .
your dentist gave my son 's daughter 's dad 's dad 's dad 's father 's father the bag .	your dentist cleaned my son 's daughter 's dad 's dad 's dad 's father 's father the bag .
your dentist sent my wife 's mother 's mother 's teacher 's boss 's son 's boss the doll .	your dentist dropped my wife 's mother 's mother 's teacher 's boss 's son 's boss the doll .
my teacher showed my friend 's son 's cousin 's daughter 's father 's sister 's friend the dish .	my teacher shook my friend 's son 's cousin 's daughter 's father 's sister 's friend the dish .
Michelle bought my mother 's grandmother 's sister 's husband 's doctor 's dentist 's friend the truck .	Michelle dropped my mother 's grandmother 's sister 's husband 's doctor 's dentist 's friend the truck .
the adult bought my friend 's brother 's mom 's doctor 's father 's grandmother 's brother the ship .	the adult shook my friend 's brother 's mom 's doctor 's father 's grandmother 's brother the ship .
Thomas sent my cousin 's mom 's wife 's wife 's boss 's son 's mom the fork .	Thomas shook my cousin 's mom 's wife 's wife 's boss 's son 's mom the fork .
my dentist showed your dad 's teacher 's boss 's dentist 's wife 's dentist 's dentist the fork .	my dentist lost your dad 's teacher 's boss 's dentist 's wife 's dentist 's dentist the fork .
my teacher gave your doctor 's cousin 's mom 's father 's friend 's mother 's brother the rocket .	my teacher dropped your doctor 's cousin 's mom 's father 's friend 's mother 's brother the rocket .
my boss sent my husband 's cousin 's friend 's dad 's husband 's wife 's doctor the rug .	my boss cleaned my husband 's cousin 's friend 's dad 's husband 's wife 's doctor the rug .
my friend showed my daughter 's sister 's wife 's teacher 's dentist 's dentist 's cousin the truck .	my friend shook my daughter 's sister 's wife 's teacher 's dentist 's dentist 's cousin the truck .
Guy gave my wife 's sister 's mom 's grandmother 's father 's daughter 's sister the door .	Guy moved my wife 's sister 's mom 's grandmother 's father 's daughter 's sister the door .
the child bought my boss 's son 's daughter 's cousin 's teacher 's friend 's boss the crayon .	the child dropped my boss 's son 's daughter 's cousin 's teacher 's friend 's boss the crayon .
the dancer gave your brother 's dad 's mother 's brother 's dad 's grandmother 's cousin the truck .	the dancer kept your brother 's dad 's mother 's brother 's dad 's grandmother 's cousin the truck .
the dentist bought your teacher 's teacher 's sister 's mom 's father 's dentist 's wife the fork .	the dentist lost your teacher 's teacher 's sister 's mom 's father 's dentist 's wife the fork .
my dentist sent your husband 's mom 's dad 's son 's cousin 's dad 's boss the bag .	my dentist cleaned your husband 's mom 's dad 's son 's cousin 's dad 's boss the bag .
your doctor showed my grandmother 's wife 's husband 's husband 's boss 's daughter 's son the crayon .	your doctor dropped my grandmother 's wife 's husband 's husband 's boss 's daughter 's son the crayon .
Robert sent your brother 's brother 's mother 's father 's teacher 's son 's daughter the bed .	Robert shook your brother 's brother 's mother 's father 's teacher 's son 's daughter the bed .
Vanessa sent your teacher 's husband 's dad 's doctor 's mom 's doctor 's grandmother the crayon .	Vanessa kept your teacher 's husband 's dad 's doctor 's mom 's doctor 's grandmother the crayon .
Wendy sent my brother 's father 's grandmother 's wife 's grandmother 's wife 's friend the book .	Wendy kept my brother 's father 's grandmother 's wife 's grandmother 's wife 's friend the book .
Susan gave your cousin 's father 's son 's friend 's dentist 's teacher 's teacher the crayon .	Susan held your cousin 's father 's son 's friend 's dentist 's teacher 's teacher the crayon .
the adult showed your dad 's dad 's cousin 's mom 's dentist 's sister 's boss the chair .	the adult moved your dad 's dad 's cousin 's mom 's dentist 's sister 's boss the chair .
Nicole bought your doctor 's father 's brother 's sister 's father 's dentist 's teacher the window .	Nicole shook your doctor 's father 's brother 's sister 's father 's dentist 's teacher the window .
the patient showed my husband 's husband 's daughter 's sister 's wife 's son 's doctor the truck .	the patient cleaned my husband 's husband 's daughter 's sister 's wife 's son 's doctor the truck .
the dancer sent my father 's mother 's son 's dentist 's mom 's brother 's mom the couch .	the dancer held my father 's mother 's son 's dentist 's mom 's brother 's mom the couch .
the child showed your mom 's mom 's dad 's son 's brother 's cousin 's cousin the spoon .	the child kept your mom 's mom 's dad 's son 's brother 's cousin 's cousin the spoon .
the customer showed my cousin 's husband 's mother 's brother 's son 's teacher 's dad the bicycle .	the customer held my cousin 's husband 's mother 's brother 's son 's teacher 's dad the bicycle .
the driver bought my friend 's mom 's mom 's dad 's dentist 's dentist 's boss the bicycle .	the driver cleaned my friend 's mom 's mom 's dad 's dentist 's dentist 's boss the bicycle .
my boss bought your grandmother 's son 's mom 's father 's brother 's cousin 's doctor the mirror .	my boss cleaned your grandmother 's son 's mom 's father 's brother 's cousin 's doctor the mirror .
my friend gave your boss 's teacher 's husband 's teacher 's cousin 's cousin 's teacher the shirt .	my friend moved your boss 's teacher 's husband 's teacher 's cousin 's cousin 's teacher the shirt .
Leslie bought your son 's doctor 's mother 's brother 's grandmother 's friend 's husband the shirt .	Leslie lost your son 's doctor 's mother 's brother 's grandmother 's friend 's husband the shirt .
David showed my brother 's husband 's mother 's doctor 's dentist 's teacher 's dad the dish .	David kept my brother 's husband 's mother 's doctor 's dentist 's teacher 's dad the dish .
the person gave your doctor 's wife 's father 's doctor 's grandmother 's dad 's mother the car .	the person held your doctor 's wife 's father 's doctor 's grandmother 's dad 's mother the car .
Guy gave your dad 's boss 's dentist 's boss 's daughter 's wife 's husband the box .	Guy dropped your dad 's boss 's dentist 's boss 's daughter 's wife 's husband the box .
Jennifer showed my sister 's doctor 's son 's son 's sister 's son 's sister the box .	Jennifer lost my sister 's doctor 's son 's son 's sister 's son 's sister the box .
my teacher sent your dad 's husband 's mother 's dad 's friend 's mom 's teacher the couch .	my teacher kept your dad 's husband 's mother 's dad 's friend 's mom 's teacher the couch .
Emily sent your grandmother 's father 's dad 's dentist 's friend 's husband 's boss the picture .	Emily shook your grandmother 's father 's dad 's dentist 's friend 's husband 's boss the picture .
my dentist bought your dad 's dad 's sister 's mother 's dad 's father 's son the ship .	my dentist moved your dad 's dad 's sister 's mother 's dad 's father 's son the ship .
the teacher showed my friend 's teacher 's father 's husband 's dad 's teacher 's sister the boat .	the teacher shook my friend 's teacher 's father 's husband 's dad 's teacher 's sister the boat .
Mary bought my brother 's husband 's cousin 's brother 's mother 's teacher 's cousin the glass .	Mary cleaned my brother 's husband 's cousin 's brother 's mother 's teacher 's cousin the glass .
Tracy sent my boss 's mom 's mother 's mother 's teacher 's daughter 's cousin the bowl .	Tracy lost my boss 's mom 's mother 's mother 's teacher 's daughter 's cousin the bowl .
the dancer sent your friend 's friend 's boss 's mom 's boss 's sister 's sister the bowl .	the dancer held your friend 's friend 's boss 's mom 's boss 's sister 's sister the bowl .
your friend sent your wife 's cousin 's friend 's son 's cousin 's mom 's grandmother the glass .	your friend shook your wife 's cousin 's friend 's son 's cousin 's mom 's grandmother the glass .
Cindy showed my mom 's mom 's teacher 's daughter 's brother 's cousin 's mother the button .	Cindy shook my mom 's mom 's teacher 's daughter 's brother 's cousin 's mother the button .
your boss sent my friend 's teacher 's father 's boss 's boss 's dad 's teacher the boat .	your boss kept my friend 's teacher 's father 's boss 's boss 's dad 's teacher the boat .
Joseph bought your grandmother 's doctor 's father 's husband 's daughter 's dentist 's teacher the book .	Joseph shook your grandmother 's doctor 's father 's husband 's daughter 's dentist 's teacher the book .
Kristen gave your doctor 's dentist 's friend 's son 's boss 's brother 's father the bicycle .	Kristen cleaned your doctor 's dentist 's friend 's son 's boss 's brother 's father the bicycle .
Amelia bought your son 's husband 's husband 's mother 's dentist 's boss 's boss the book .	Amelia held your son 's husband 's husband 's mother 's dentist 's boss 's boss the book .
your boss gave my mother 's daughter 's brother 's wife 's boss 's friend 's doctor the spoon .	your boss cleaned my mother 's daughter 's brother 's wife 's boss 's friend 's doctor the spoon .
my dentist bought my teacher 's husband 's mother 's grandmother 's daughter 's grandmother 's father the car .	my dentist dropped my teacher 's husband 's mother 's grandmother 's daughter 's grandmother 's father the car .
the dancer gave your sister 's dentist 's boss 's grandmother 's grandmother 's teacher 's dad the car .	the dancer cleaned your sister 's dentist 's boss 's grandmother 's grandmother 's teacher 's dad the car .
the teacher showed your husband 's dentist 's dentist 's mom 's doctor 's dentist 's dad the window .	the teacher lost your husband 's dentist 's dentist 's mom 's doctor 's dentist 's dad the window .
my boss sent my grandmother 's mom 's son 's husband 's father 's doctor 's mother the chair .	my boss dropped my grandmother 's mom 's son 's husband 's father 's doctor 's mother the chair .
my cousin bought my teacher 's daughter 's dad 's father 's daughter 's dad 's doctor the crayon .	my cousin moved my teacher 's daughter 's dad 's father 's daughter 's dad 's doctor the crayon .
the customer showed my cousin 's mother 's sister 's doctor 's wife 's son 's daughter the bowl .	the customer moved my cousin 's mother 's sister 's doctor 's wife 's son 's daughter the bowl .
Noah showed your boss 's mother 's son 's wife 's daughter 's friend 's doctor the chair .	Noah held your boss 's mother 's son 's wife 's daughter 's friend 's doctor the chair .
your cousin sent your daughter 's mom 's grandmother 's wife 's friend 's sister 's mom the plate .	your cousin shook your daughter 's mom 's grandmother 's wife 's friend 's sister 's mom the plate .
Steve sent your friend 's daughter 's mom 's cousin 's doctor 's mom 's doctor the chair .	Steve moved your friend 's daughter 's mom 's cousin 's doctor 's mom 's doctor the chair .
your teacher gave my father 's daughter 's dentist 's cousin 's mom 's mom 's wife the door .	your teacher cleaned my father 's daughter 's dentist 's cousin 's mom 's mom 's wife the door .
Rebecca sent my daughter 's grandmother 's friend 's father 's dad 's son 's friend the toy .	Rebecca cleaned my daughter 's grandmother 's friend 's father 's dad 's son 's friend the toy .
Frank gave my doctor 's grandmother 's doctor 's teacher 's dad 's boss 's mom the plane .	Frank cleaned my doctor 's grandmother 's doctor 's teacher 's dad 's boss 's mom the plane .
my doctor bought your dentist 's doctor 's mother 's dad 's father 's friend 's mom the plane .	my doctor cleaned your dentist 's doctor 's mother 's dad 's father 's friend 's mom the plane .
your teacher sent your friend 's doctor 's doctor 's brother 's grandmother 's grandmother 's boss the boat .	your teacher shook your friend 's doctor 's doctor 's brother 's grandmother 's grandmother 's boss the boat .
Leslie gave your boss 's son 's dentist 's mom 's grandmother 's doctor 's sister the cup .	Leslie dropped your boss 's son 's dentist 's mom 's grandmother 's doctor 's sister the cup .
your boss showed my friend 's friend 's dentist 's mother 's mom 's cousin 's friend the couch .	your boss shook my friend 's friend 's dentist 's mother 's mom 's cousin 's friend the couch .
the customer sent your daughter 's brother 's mom 's doctor 's brother 's mother 's daughter the bag .	the customer moved your daughter 's brother 's mom 's doctor 's brother 's mother 's daughter the bag .
your friend bought your grandmother 's mother 's teacher 's brother 's daughter 's dentist 's mom the bed .	your friend lost your grandmother 's mother 's teacher 's brother 's daughter 's dentist 's mom the bed .
the teacher gave your doctor 's son 's sister 's husband 's dad 's sister 's son the plate .	the teacher held your doctor 's son 's sister 's husband 's dad 's sister 's son the plate .
Carol sent my grandmother 's grandmother 's brother 's mom 's husband 's friend 's brother the crayon .	Carol moved my grandmother 's grandmother 's brother 's mom 's husband 's friend 's brother the crayon .
the person showed my daughter 's husband 's wife 's boss 's father 's dentist 's boss the bed .	the person lost my daughter 's husband 's wife 's boss 's father 's dentist 's boss the bed .
Nina bought my daughter 's dad 's grandmother 's teacher 's cousin 's father 's cousin the mirror .	Nina kept my daughter 's dad 's grandmother 's teacher 's cousin 's father 's cousin the mirror .
the adult showed your dentist 's father 's sister 's mom 's dentist 's friend 's daughter the box .	the adult shook your dentist 's father 's sister 's mom 's dentist 's friend 's daughter the box .
David gave your doctor 's grandmother 's friend 's sister 's brother 's friend 's son the candle .	David shook your doctor 's grandmother 's friend 's sister 's brother 's friend 's son the candle .
my cousin gave my husband 's mother 's son 's brother 's grandmother 's husband 's sister the dish .	my cousin lost my husband 's mother 's son 's brother 's grandmother 's husband 's sister the dish .
the dentist showed my sister 's friend 's dad 's grandmother 's mother 's mother 's husband the crayon .	the dentist lost my sister 's friend 's dad 's grandmother 's mother 's mother 's husband the crayon .
the dentist sent my wife 's father 's son 's mom 's mother 's dad 's cousin the couch .	the dentist held my wife 's father 's son 's mom 's mother 's dad 's cousin the couch .
the dancer sent your grandmother 's grandmother 's dentist 's husband 's dentist 's mother 's husband the bed .	the dancer held your grandmother 's grandmother 's dentist 's husband 's dentist 's mother 's husband the bed .
Steven sent my wife 's grandmother 's mom 's doctor 's daughter 's mother 's grandmother the couch .	Steven held my wife 's grandmother 's mom 's doctor 's daughter 's mother 's grandmother the couch .
my boss gave my cousin 's cousin 's mother 's father 's mother 's grandmother 's dentist the rug .	my boss shook my cousin 's cousin 's mother 's father 's mother 's grandmother 's dentist the rug .
your cousin sent your cousin 's son 's mother 's doctor 's dentist 's grandmother 's friend the bed .	your cousin lost your cousin 's son 's mother 's doctor 's dentist 's grandmother 's friend the bed .
your friend showed my daughter 's cousin 's cousin 's cousin 's dad 's dentist 's father the toy .	your friend cleaned my daughter 's cousin 's cousin 's cousin 's dad 's dentist 's father the toy .
Sara bought your boss 's daughter 's son 's brother 's doctor 's mother 's teacher the hat .	Sara cleaned your boss 's daughter 's son 's brother 's doctor 's mother 's teacher the hat .
Amy gave my doctor 's wife 's husband 's mother 's father 's friend 's son the cup .	Amy cleaned my doctor 's wife 's husband 's mother 's father 's friend 's son the cup .
Naomi bought my dentist 's wife 's mom 's son 's boss 's father 's father the door .	Naomi held my dentist 's wife 's mom 's son 's boss 's father 's father the door .
your boss showed your wife 's dentist 's mother 's cousin 's father 's mom 's dad the chair .	your boss cleaned your wife 's dentist 's mother 's cousin 's father 's mom 's dad the chair .
the dentist bought my teacher 's daughter 's son 's husband 's mom 's father 's daughter the boat .	the dentist kept my teacher 's daughter 's son 's husband 's mom 's father 's daughter the boat .
Andrew showed my cousin 's daughter 's daughter 's dad 's mother 's dad 's doctor the rug .	Andrew cleaned my cousin 's daughter 's daughter 's dad 's mother 's dad 's doctor the rug .
my friend sent your sister 's sister 's cousin 's teacher 's husband 's teacher 's cousin the boat .	my friend moved your sister 's sister 's cousin 's teacher 's husband 's teacher 's cousin the boat .
Wendy bought your boss 's cousin 's mom 's brother 's doctor 's mother 's wife the book .	Wendy kept your boss 's cousin 's mom 's brother 's doctor 's mother 's wife the book .
Nicole bought your husband 's cousin 's mom 's boss 's mother 's dentist 's father the hat .	Nicole dropped your husband 's cousin 's mom 's boss 's mother 's dentist 's father the hat .
the teacher showed your mother 's wife 's grandmother 's mom 's friend 's daughter 's teacher the doll .	the teacher shook your mother 's wife 's grandmother 's mom 's friend 's daughter 's teacher the doll .
the customer sent your dentist 's teacher 's cousin 's mother 's grandmother 's grandmother 's grandmother the car .	the customer kept your dentist 's teacher 's cousin 's mother 's grandmother 's grandmother 's grandmother the car .
your teacher sent my brother 's wife 's friend 's wife 's brother 's cousin 's boss the bowl .	your teacher moved my brother 's wife 's friend 's wife 's brother 's cousin 's boss the bowl .
the child gave your brother 's daughter 's wife 's mom 's mom 's mom 's cousin the glass .	the child lost your brother 's daughter 's wife 's mom 's mom 's mom 's cousin the glass .
Steven gave my daughter 's boss 's father 's doctor 's teacher 's brother 's friend the hat .	Steven moved my daughter 's boss 's father 's doctor 's teacher 's brother 's friend the hat .
the person sent my teacher 's grandmother 's friend 's dentist 's cousin 's sister 's boss the box .	the person cleaned my teacher 's grandmother 's friend 's dentist 's cousin 's sister 's boss the box .
the person gave your husband 's friend 's cousin 's mother 's mother 's sister 's grandmother the mirror .	the person shook your husband 's friend 's cousin 's mother 's mother 's sister 's grandmother the mirror .
my dentist sent my doctor 's boss 's mother 's sister 's son 's father 's mother the spoon .	my dentist shook my doctor 's boss 's mother 's sister 's son 's father 's mother the spoon .
the dancer showed my son 's doctor 's doctor 's sister 's brother 's sister 's daughter the hat .	the dancer dropped my son 's doctor 's doctor 's sister 's brother 's sister 's daughter the hat .
Amelia sent your boss 's brother 's brother 's husband 's mother 's friend 's dentist the box .	Amelia shook your boss 's brother 's brother 's husband 's mother 's friend 's dentist the box .
Renee showed my mom 's sister 's grandmother 's friend 's doctor 's sister 's dad the dish .	Renee kept my mom 's sister 's grandmother 's friend 's doctor 's sister 's dad the dish .
April gave your friend 's wife 's brother 's teacher 's doctor 's son 's husband the crayon .	April shook your friend 's wife 's brother 's teacher 's doctor 's son 's husband the crayon .
Nancy bought your father 's husband 's daughter 's boss 's grandmother 's mother 's dad the picture .	Nancy lost your father 's husband 's daughter 's boss 's grandmother 's mother 's dad the picture .
Alice bought your dad 's teacher 's daughter 's cousin 's husband 's grandmother 's sister the toy .	Alice held your dad 's teacher 's daughter 's cousin 's husband 's grandmother 's sister the toy .
the teacher bought your teacher 's daughter 's sister 's dentist 's dad 's brother 's husband the bed .	the teacher held your teacher 's daughter 's sister 's dentist 's dad 's brother 's husband the bed .
the driver bought my mother 's daughter 's father 's son 's mom 's son 's mom the bottle .	the driver dropped my mother 's daughter 's father 's son 's mom 's son 's mom the bottle .
your dentist showed my wife 's dentist 's wife 's brother 's husband 's husband 's friend the couch .	your dentist dropped my wife 's dentist 's wife 's brother 's husband 's husband 's friend the couch .
Deborah sent my dad 's grandmother 's boss 's wife 's friend 's brother 's son the crayon .	Deborah kept my dad 's grandmother 's boss 's wife 's friend 's brother 's son the crayon .
your friend showed my son 's boss 's dad 's boss 's wife 's doctor 's mom the door .	your friend lost my son 's boss 's dad 's boss 's wife 's doctor 's mom the door .
my boss sent your boss 's daughter 's grandmother 's husband 's grandmother 's grandmother 's wife the shirt .	my boss moved your boss 's daughter 's grandmother 's husband 's grandmother 's grandmother 's wife the shirt .
the teacher bought my daughter 's dad 's wife 's doctor 's dad 's wife 's wife the truck .	the teacher kept my daughter 's dad 's wife 's doctor 's dad 's wife 's wife the truck .
my cousin sent my mom 's dentist 's dentist 's mother 's boss 's husband 's father the couch .	my cousin shook my mom 's dentist 's dentist 's mother 's boss 's husband 's father the couch .
your friend showed my husband 's teacher 's daughter 's father 's grandmother 's wife 's grandmother the crayon .	your friend cleaned my husband 's teacher 's daughter 's father 's grandmother 's wife 's grandmother the crayon .
your dentist gave my dad 's brother 's father 's daughter 's teacher 's cousin 's grandmother the shoe .	your dentist held my dad 's brother 's father 's daughter 's teacher 's cousin 's grandmother the shoe .
Carl sent your cousin 's sister 's mother 's teacher 's sister 's sister 's cousin the candle .	Carl lost your cousin 's sister 's mother 's teacher 's sister 's sister 's cousin the candle .
your teacher sent my doctor 's cousin 's son 's daughter 's daughter 's friend 's cousin the couch .	your teacher held my doctor 's cousin 's son 's daughter 's daughter 's friend 's cousin the couch .
Amy sent my doctor 's mom 's mom 's husband 's grandmother 's sister 's cousin the car .	Amy lost my doctor 's mom 's mom 's husband 's grandmother 's sister 's cousin the car .
the teacher showed your cousin 's doctor 's mom 's dad 's father 's dentist 's daughter the bag .	the teacher kept your cousin 's doctor 's mom 's dad 's father 's dentist 's daughter the bag .
Liam gave my husband 's wife 's friend 's doctor 's mother 's daughter 's teacher the bed .	Liam moved my husband 's wife 's friend 's doctor 's mother 's daughter 's teacher the bed .
the patient showed my mom 's boss 's mom 's sister 's grandmother 's dentist 's husband the bicycle .	the patient moved my mom 's boss 's mom 's sister 's grandmother 's dentist 's husband the bicycle .
your cousin sent my brother 's dad 's husband 's dentist 's husband 's doctor 's boss the toy .	your cousin held my brother 's dad 's husband 's dentist 's husband 's doctor 's boss the toy .
the person bought your grandmother 's grandmother 's teacher 's boss 's brother 's wife 's husband the glass .	the person dropped your grandmother 's grandmother 's teacher 's boss 's brother 's wife 's husband the glass .
the person showed your doctor 's son 's doctor 's son 's son 's wife 's grandmother the hat .	the person kept your doctor 's son 's doctor 's son 's son 's wife 's grandmother the hat .
Marie bought my friend 's dentist 's friend 's doctor 's cousin 's dentist 's brother the car .	Marie lost my friend 's dentist 's friend 's doctor 's cousin 's dentist 's brother the car .
the dancer sent your cousin 's brother 's doctor 's friend 's wife 's cousin 's grandmother the spoon .	the dancer dropped your cousin 's brother 's doctor 's friend 's wife 's cousin 's grandmother the spoon .
Sally bought my brother 's cousin 's sister 's doctor 's dad 's brother 's father the bottle .	Sally shook my brother 's cousin 's sister 's doctor 's dad 's brother 's father the bottle .
your boss gave my teacher 's brother 's cousin 's sister 's dentist 's daughter 's teacher the boat .	your boss kept my teacher 's brother 's cousin 's sister 's dentist 's daughter 's teacher the boat .
the person showed my cousin 's mom 's dentist 's dentist 's grandmother 's dentist 's sister the truck .	the person held my cousin 's mom 's dentist 's dentist 's grandmother 's dentist 's sister the truck .
the person gave my boss 's teacher 's daughter 's husband 's dentist 's wife 's husband the picture .	the person kept my boss 's teacher 's daughter 's husband 's dentist 's wife 's husband the picture .
the child gave my teacher 's boss 's cousin 's wife 's son 's son 's dentist the crayon .	the child kept my teacher 's boss 's cousin 's wife 's son 's son 's dentist the crayon .
Mary showed my husband 's grandmother 's dentist 's mother 's teacher 's dad 's teacher the cup .	Mary cleaned my husband 's grandmother 's dentist 's mother 's teacher 's dad 's teacher the cup .
the adult gave your dentist 's father 's wife 's mother 's cousin 's wife 's friend the car .	the adult lost your dentist 's father 's wife 's mother 's cousin 's wife 's friend the car .
the dentist gave my husband 's dad 's dentist 's father 's doctor 's dad 's friend the box .	the dentist moved my husband 's dad 's dentist 's father 's doctor 's dad 's friend the box .
the person bought your wife 's brother 's daughter 's dad 's mother 's boss 's dentist the cup .	the person lost your wife 's brother 's daughter 's dad 's mother 's boss 's dentist the cup .
the adult gave your dad 's daughter 's friend 's brother 's brother 's cousin 's grandmother the dish .	the adult dropped your dad 's daughter 's friend 's brother 's brother 's cousin 's grandmother the dish .
Sandra bought my son 's husband 's doctor 's grandmother 's father 's mom 's brother the picture .	Sandra lost my son 's husband 's doctor 's grandmother 's father 's mom 's brother the picture .
Janet bought your friend 's boss 's boss 's doctor 's grandmother 's doctor 's sister the shirt .	Janet kept your friend 's boss 's boss 's doctor 's grandmother 's doctor 's sister the shirt .
my boss gave my boss 's mom 's friend 's cousin 's husband 's wife 's mother the plane .	my boss shook my boss 's mom 's friend 's cousin 's husband 's wife 's mother the plane .
the dancer showed your father 's wife 's boss 's dentist 's doctor 's sister 's father the fork .	the dancer cleaned your father 's wife 's boss 's dentist 's doctor 's sister 's father the fork .
Kayla sent your doctor 's husband 's husband 's teacher 's dentist 's boss 's sister the plate .	Kayla lost your doctor 's husband 's husband 's teacher 's dentist 's boss 's sister the plate .
Patrick bought my cousin 's sister 's grandmother 's teacher 's teacher 's cousin 's wife the hat .	Patrick moved my cousin 's sister 's grandmother 's teacher 's teacher 's cousin 's wife the hat .
Dan gave my son 's mother 's boss 's brother 's doctor 's dentist 's cousin the bottle .	Dan moved my son 's mother 's boss 's brother 's doctor 's dentist 's cousin the bottle .
the patient sent your friend 's daughter 's boss 's husband 's brother 's daughter 's dentist the rocket .	the patient lost your friend 's daughter 's boss 's husband 's brother 's daughter 's dentist the rocket .
your teacher sent my daughter 's mom 's dentist 's cousin 's friend 's father 's dad the rug .	your teacher cleaned my daughter 's mom 's dentist 's cousin 's friend 's father 's dad the rug .
your dentist bought my friend 's doctor 's boss 's brother 's brother 's friend 's wife the car .	your dentist kept my friend 's doctor 's boss 's brother 's brother 's friend 's wife the car .
the teacher gave your dentist 's daughter 's sister 's son 's mother 's teacher 's boss the hat .	the teacher moved your dentist 's daughter 's sister 's son 's mother 's teacher 's boss the hat .
my doctor gave my doctor 's grandmother 's friend 's daughter 's dentist 's teacher 's doctor the crayon .	my doctor kept my doctor 's grandmother 's friend 's daughter 's dentist 's teacher 's doctor the crayon .
your friend gave your cousin 's boss 's dad 's friend 's mother 's sister 's brother the plate .	your friend held your cousin 's boss 's dad 's friend 's mother 's sister 's brother the plate .
the dancer showed my brother 's mom 's son 's sister 's son 's teacher 's grandmother the shirt .	the dancer kept my brother 's mom 's son 's sister 's son 's teacher 's grandmother the shirt .
your friend showed my grandmother 's daughter 's doctor 's friend 's son 's boss 's mother the doll .	your friend dropped my grandmother 's daughter 's doctor 's friend 's son 's boss 's mother the doll .
the customer gave your dentist 's doctor 's son 's doctor 's sister 's mom 's son the shoe .	the customer lost your dentist 's doctor 's son 's doctor 's sister 's mom 's son the shoe .
Carl bought my wife 's sister 's cousin 's mom 's cousin 's dentist 's brother the shirt .	Carl kept my wife 's sister 's cousin 's mom 's cousin 's dentist 's brother the shirt .
Liam sent your cousin 's boss 's daughter 's sister 's friend 's brother 's mother the window .	Liam dropped your cousin 's boss 's daughter 's sister 's friend 's brother 's mother the window .
the driver bought my boss 's grandmother 's dentist 's dad 's dad 's cousin 's grandmother the rug .	the driver held my boss 's grandmother 's dentist 's dad 's dad 's cousin 's grandmother the rug .
Vanessa bought your son 's teacher 's son 's grandmother 's mother 's dentist 's mom the glass .	Vanessa moved your son 's teacher 's son 's grandmother 's mother 's dentist 's mom the glass .
my dentist showed your dentist 's brother 's mom 's boss 's brother 's sister 's daughter the plane .	my dentist kept your dentist 's brother 's mom 's boss 's brother 's sister 's daughter the plane .
the dentist bought your dad 's daughter 's father 's dad 's husband 's daughter 's father the doll .	the dentist cleaned your dad 's daughter 's father 's dad 's husband 's daughter 's father the doll .
the driver gave my mom 's sister 's husband 's father 's dentist 's mother 's grandmother the bicycle .	the driver kept my mom 's sister 's husband 's father 's dentist 's mother 's grandmother the bicycle .
my boss showed my brother 's boss 's wife 's brother 's son 's wife 's grandmother the rocket .	my boss lost my brother 's boss 's wife 's brother 's son 's wife 's grandmother the rocket .
Donald sent my son 's doctor 's cousin 's teacher 's cousin 's mother 's boss the boat .	Donald dropped my son 's doctor 's cousin 's teacher 's cousin 's mother 's boss the boat .
the adult gave my cousin 's teacher 's dad 's mom 's friend 's mom 's teacher the doll .	the adult dropped my cousin 's teacher 's dad 's mom 's friend 's mom 's teacher the doll .
the driver bought my mom 's son 's dad 's son 's teacher 's sister 's mother the bottle .	the driver moved my mom 's son 's dad 's son 's teacher 's sister 's mother the bottle .
the dentist bought my father 's wife 's mother 's father 's brother 's dentist 's mom the rocket .	the dentist held my father 's wife 's mother 's father 's brother 's dentist 's mom the rocket .
the doctor showed my friend 's cousin 's father 's grandmother 's mom 's mom 's boss the bicycle .	the doctor shook my friend 's cousin 's father 's grandmother 's mom 's mom 's boss the bicycle .
the customer bought your daughter 's son 's daughter 's brother 's boss 's husband 's friend the bed .	the customer moved your daughter 's son 's daughter 's brother 's boss 's husband 's friend the bed .
my doctor sent my husband 's father 's doctor 's doctor 's son 's mom 's father the cup .	my doctor moved my husband 's father 's doctor 's doctor 's son 's mom 's father the cup .
my doctor showed my boss 's father 's father 's grandmother 's wife 's teacher 's brother the toy .	my doctor dropped my boss 's father 's father 's grandmother 's wife 's teacher 's brother the toy .
Eric gave my daughter 's grandmother 's cousin 's mother 's dentist 's dentist 's boss the book .	Eric cleaned my daughter 's grandmother 's cousin 's mother 's dentist 's dentist 's boss the book .
your teacher gave your brother 's mom 's mom 's dad 's brother 's mom 's daughter the mirror .	your teacher kept your brother 's mom 's mom 's dad 's brother 's mom 's daughter the mirror .
the driver sent your doctor 's boss 's sister 's cousin 's cousin 's brother 's cousin the shoe .	the driver held your doctor 's boss 's sister 's cousin 's cousin 's brother 's cousin the shoe .
Rebecca showed your brother 's grandmother 's son 's friend 's wife 's daughter 's cousin the shirt .	Rebecca shook your brother 's grandmother 's son 's friend 's wife 's daughter 's cousin the shirt .
your boss showed your dad 's doctor 's teacher 's teacher 's father 's dad 's son the chair .	your boss cleaned your dad 's doctor 's teacher 's teacher 's father 's dad 's son the chair .
Melissa bought my father 's wife 's brother 's cousin 's sister 's dentist 's teacher the button .	Melissa held my father 's wife 's brother 's cousin 's sister 's dentist 's teacher the button .
the adult bought your cousin 's husband 's brother 's wife 's friend 's grandmother 's husband the ring .	the adult lost your cousin 's husband 's brother 's wife 's friend 's grandmother 's husband the ring .
the patient bought my cousin 's boss 's doctor 's husband 's father 's father 's mom the hat .	the patient moved my cousin 's boss 's doctor 's husband 's father 's father 's mom the hat .
your teacher gave your mother 's dentist 's dad 's grandmother 's mom 's sister 's dad the ring .	your teacher shook your mother 's dentist 's dad 's grandmother 's mom 's sister 's dad the ring .
your boss showed my grandmother 's dentist 's father 's friend 's brother 's father 's friend the doll .	your boss lost my grandmother 's dentist 's father 's friend 's brother 's father 's friend the doll .
the dancer sent your cousin 's son 's teacher 's daughter 's grandmother 's brother 's father the rug .	the dancer kept your cousin 's son 's teacher 's daughter 's grandmother 's brother 's father the rug .
the adult bought your sister 's cousin 's dentist 's grandmother 's dad 's grandmother 's friend the crayon .	the adult cleaned your sister 's cousin 's dentist 's grandmother 's dad 's grandmother 's friend the crayon .
April gave your mom 's husband 's mother 's husband 's doctor 's mom 's grandmother the cup .	April kept your mom 's husband 's mother 's husband 's doctor 's mom 's grandmother the cup .
Adam showed your dentist 's husband 's doctor 's son 's friend 's wife 's doctor the bowl .	Adam moved your dentist 's husband 's doctor 's son 's friend 's wife 's doctor the bowl .
my cousin showed my brother 's dad 's mother 's mom 's father 's friend 's doctor the bottle .	my cousin shook my brother 's dad 's mother 's mom 's father 's friend 's doctor the bottle .
the customer sent my brother 's dentist 's father 's mom 's father 's mother 's dad the glass .	the customer moved my brother 's dentist 's father 's mom 's father 's mother 's dad the glass .
Amelia showed your brother 's cousin 's dad 's boss 's husband 's boss 's boss the ring .	Amelia lost your brother 's cousin 's dad 's boss 's husband 's boss 's boss the ring .
the driver showed my mother 's cousin 's cousin 's dad 's grandmother 's friend 's sister the bed .	the driver dropped my mother 's cousin 's cousin 's dad 's grandmother 's friend 's sister the bed .
Becky bought your teacher 's husband 's dentist 's boss 's grandmother 's father 's grandmother the shirt .	Becky kept your teacher 's husband 's dentist 's boss 's grandmother 's father 's grandmother the shirt .
Steven gave my father 's mother 's daughter 's doctor 's doctor 's sister 's son the plate .	Steven cleaned my father 's mother 's daughter 's doctor 's doctor 's sister 's son the plate .
the driver showed my husband 's dad 's dad 's mom 's dad 's teacher 's mother the hat .	the driver cleaned my husband 's dad 's dad 's mom 's dad 's teacher 's mother the hat .
the doctor sent your doctor 's mother 's dad 's doctor 's dad 's dad 's son the boat .	the doctor cleaned your doctor 's mother 's dad 's doctor 's dad 's dad 's son the boat .
my friend bought your wife 's dentist 's boss 's mom 's friend 's dentist 's daughter the couch .	my friend dropped your wife 's dentist 's boss 's mom 's friend 's dentist 's daughter the couch .
my cousin sent your cousin 's sister 's father 's boss 's cousin 's dentist 's boss the boat .	my cousin held your cousin 's sister 's father 's boss 's cousin 's dentist 's boss the boat .
Amelia gave your brother 's sister 's dentist 's teacher 's boss 's cousin 's grandmother the mirror .	Amelia moved your brother 's sister 's dentist 's teacher 's boss 's cousin 's grandmother the mirror .
my doctor sent my sister 's friend 's doctor 's doctor 's dentist 's doctor 's doctor the fork .	my doctor held my sister 's friend 's doctor 's doctor 's dentist 's doctor 's doctor the fork .
my boss showed your dentist 's father 's dentist 's sister 's grandmother 's cousin 's son the hat .	my boss dropped your dentist 's father 's dentist 's sister 's grandmother 's cousin 's son the hat .
Elizabeth gave my son 's dad 's mom 's doctor 's brother 's dentist 's boss the mirror .	Elizabeth kept my son 's dad 's mom 's doctor 's brother 's dentist 's boss the mirror .
your teacher sent my daughter 's boss 's father 's cousin 's daughter 's friend 's mother the plane .	your teacher held my daughter 's boss 's father 's cousin 's daughter 's friend 's mother the plane .
Martin sent your teacher 's brother 's father 's dentist 's grandmother 's dentist 's grandmother the book .	Martin shook your teacher 's brother 's father 's dentist 's grandmother 's dentist 's grandmother the book .
Susan sent my daughter 's dentist 's father 's doctor 's dentist 's doctor 's doctor the boat .	Susan shook my daughter 's dentist 's father 's doctor 's dentist 's doctor 's doctor the boat .
the adult showed my wife 's mom 's father 's father 's father 's wife 's sister the box .	the adult kept my wife 's mom 's father 's father 's father 's wife 's sister the box .
the doctor sent my sister 's boss 's mom 's teacher 's husband 's brother 's teacher the bag .	the doctor lost my sister 's boss 's mom 's teacher 's husband 's brother 's teacher the bag .
the child sent your teacher 's dentist 's mother 's wife 's mom 's wife 's mom the toy .	the child moved your teacher 's dentist 's mother 's wife 's mom 's wife 's mom the toy .
Michael showed your husband 's doctor 's daughter 's daughter 's wife 's boss 's mother the car .	Michael lost your husband 's doctor 's daughter 's daughter 's wife 's boss 's mother the car .
the adult sent your dentist 's cousin 's cousin 's grandmother 's husband 's boss 's dentist the candle .	the adult moved your dentist 's cousin 's cousin 's grandmother 's husband 's boss 's dentist the candle .
the person showed your doctor 's boss 's friend 's teacher 's doctor 's son 's son the bag .	the person dropped your doctor 's boss 's friend 's teacher 's doctor 's son 's son the bag .
my cousin sent your brother 's mother 's cousin 's father 's grandmother 's cousin 's cousin the ship .	my cousin kept your brother 's mother 's cousin 's father 's grandmother 's cousin 's cousin the ship .
Judy sent my brother 's teacher 's brother 's mother 's mother 's teacher 's mother the window .	Judy held my brother 's teacher 's brother 's mother 's mother 's teacher 's mother the window .
Amy gave your cousin 's boss 's mother 's teacher 's friend 's mom 's mother the shoe .	Amy shook your cousin 's boss 's mother 's teacher 's friend 's mom 's mother the shoe .
Alexander sent my teacher 's mom 's teacher 's brother 's mother 's teacher 's brother the book .	Alexander lost my teacher 's mom 's teacher 's brother 's mother 's teacher 's brother the book .
the dancer bought my husband 's mom 's son 's grandmother 's mom 's son 's teacher the boat .	the dancer shook my husband 's mom 's son 's grandmother 's mom 's son 's teacher the boat .
my friend bought your wife 's cousin 's sister 's doctor 's friend 's mom 's brother the door .	my friend kept your wife 's cousin 's sister 's doctor 's friend 's mom 's brother the door .
Anna showed my sister 's dentist 's grandmother 's daughter 's wife 's grandmother 's brother the ring .	Anna moved my sister 's dentist 's grandmother 's daughter 's wife 's grandmother 's brother the ring .
the customer gave my brother 's cousin 's son 's dentist 's teacher 's wife 's sister the candle .	the customer kept my brother 's cousin 's son 's dentist 's teacher 's wife 's sister the candle .
the patient gave your teacher 's dad 's wife 's grandmother 's brother 's teacher 's mom the car .	the patient moved your teacher 's dad 's wife 's grandmother 's brother 's teacher 's mom the car .
the teacher showed my mom 's son 's friend 's husband 's cousin 's doctor 's father the rug .	the teacher kept my mom 's son 's friend 's husband 's cousin 's doctor 's father the rug .
the dancer showed your mother 's husband 's friend 's son 's mother 's doctor 's husband the rug .	the dancer moved your mother 's husband 's friend 's son 's mother 's doctor 's husband the rug .
Sally gave your mother 's dentist 's daughter 's mom 's wife 's dentist 's sister the plate .	Sally dropped your mother 's dentist 's daughter 's mom 's wife 's dentist 's sister the plate .
the dancer sent your father 's mother 's mom 's dentist 's boss 's mother 's brother the hat .	the dancer kept your father 's mother 's mom 's dentist 's boss 's mother 's brother the hat .
the dentist sent your boss 's dentist 's son 's sister 's daughter 's daughter 's teacher the ring .	the dentist cleaned your boss 's dentist 's son 's sister 's daughter 's daughter 's teacher the ring .
the dentist gave my teacher 's mother 's brother 's grandmother 's cousin 's dentist 's cousin the bottle .	the dentist moved my teacher 's mother 's brother 's grandmother 's cousin 's dentist 's cousin the bottle .
the patient showed your sister 's doctor 's cousin 's dad 's husband 's cousin 's dad the plane .	the patient moved your sister 's doctor 's cousin 's dad 's husband 's cousin 's dad the plane .
the child sent my dentist 's cousin 's mother 's son 's mother 's dentist 's friend the bowl .	the child shook my dentist 's cousin 's mother 's son 's mother 's dentist 's friend the bowl .
Linda showed my son 's friend 's sister 's son 's mother 's grandmother 's daughter the box .	Linda kept my son 's friend 's sister 's son 's mother 's grandmother 's daughter the box .
Erin gave my sister 's grandmother 's sister 's sister 's boss 's father 's teacher the dish .	Erin cleaned my sister 's grandmother 's sister 's sister 's boss 's father 's teacher the dish .
my dentist bought my dad 's son 's mother 's friend 's father 's father 's son the boat .	my dentist held my dad 's son 's mother 's friend 's father 's father 's son the boat .
your cousin bought your friend 's cousin 's daughter 's dentist 's doctor 's father 's teacher the car .	your cousin held your friend 's cousin 's daughter 's dentist 's doctor 's father 's teacher the car .
the dancer showed my father 's sister 's dentist 's sister 's wife 's husband 's dad the candle .	the dancer dropped my father 's sister 's dentist 's sister 's wife 's husband 's dad the candle .
Ronald bought my cousin 's grandmother 's dentist 's wife 's mother 's sister 's son the door .	Ronald held my cousin 's grandmother 's dentist 's wife 's mother 's sister 's son the door .
your doctor gave my cousin 's brother 's brother 's cousin 's husband 's husband 's son the shoe .	your doctor shook my cousin 's brother 's brother 's cousin 's husband 's husband 's son the shoe .
the person gave my doctor 's mom 's daughter 's dad 's cousin 's grandmother 's sister the bed .	the person kept my doctor 's mom 's daughter 's dad 's cousin 's grandmother 's sister the bed .
Donald showed my dad 's teacher 's boss 's friend 's friend 's grandmother 's boss the shirt .	Donald lost my dad 's teacher 's boss 's friend 's friend 's grandmother 's boss the shirt .
Adam sent your friend 's friend 's mother 's mom 's grandmother 's daughter 's brother the chair .	Adam lost your friend 's friend 's mother 's mom 's grandmother 's daughter 's brother the chair .
your dentist showed my cousin 's daughter 's father 's brother 's friend 's brother 's dad the rug .	your dentist cleaned my cousin 's daughter 's father 's brother 's friend 's brother 's dad the rug .
the dancer gave my dad 's friend 's dad 's teacher 's dentist 's husband 's wife the book .	the dancer shook my dad 's friend 's dad 's teacher 's dentist 's husband 's wife the book .
the person showed my dad 's dad 's daughter 's brother 's dentist 's dentist 's wife the book .	the person held my dad 's dad 's daughter 's brother 's dentist 's dentist 's wife the book .
Mark bought my husband 's sister 's brother 's grandmother 's cousin 's doctor 's friend the shoe .	Mark cleaned my husband 's sister 's brother 's grandmother 's cousin 's doctor 's friend the shoe .
your teacher gave your sister 's father 's sister 's friend 's boss 's mom 's mom the dish .	your teacher held your sister 's father 's sister 's friend 's boss 's mom 's mom the dish .
your teacher bought your daughter 's husband 's dad 's wife 's daughter 's friend 's mom the couch .	your teacher moved your daughter 's husband 's dad 's wife 's daughter 's friend 's mom the couch .
Catherine showed my father 's grandmother 's brother 's cousin 's teacher 's dentist 's boss the book .	Catherine shook my father 's grandmother 's brother 's cousin 's teacher 's dentist 's boss the book .
the dancer gave your wife 's mother 's daughter 's husband 's sister 's husband 's dentist the toy .	the dancer lost your wife 's mother 's daughter 's husband 's sister 's husband 's dentist the toy .
my boss showed my dad 's brother 's brother 's wife 's daughter 's cousin 's cousin the window .	my boss cleaned my dad 's brother 's brother 's wife 's daughter 's cousin 's cousin the window .
my dentist showed your son 's grandmother 's grandmother 's cousin 's dad 's mom 's husband the car .	my dentist held your son 's grandmother 's grandmother 's cousin 's dad 's mom 's husband the car .
your friend bought my brother 's dentist 's brother 's daughter 's mother 's mother 's brother the cup .	your friend cleaned my brother 's dentist 's brother 's daughter 's mother 's mother 's brother the cup .
Michelle showed my daughter 's brother 's brother 's friend 's friend 's boss 's mother the doll .	Michelle moved my daughter 's brother 's brother 's friend 's friend 's boss 's mother the doll .
your cousin sent your daughter 's grandmother 's doctor 's father 's sister 's wife 's daughter the bottle .	your cousin lost your daughter 's grandmother 's doctor 's father 's sister 's wife 's daughter the bottle .
my teacher gave your grandmother 's grandmother 's dentist 's son 's sister 's mom 's husband the ring .	my teacher moved your grandmother 's grandmother 's dentist 's son 's sister 's mom 's husband the ring .
Sara bought your doctor 's husband 's teacher 's grandmother 's wife 's father 's husband the box .	Sara moved your doctor 's husband 's teacher 's grandmother 's wife 's father 's husband the box .
the driver showed your husband 's doctor 's cousin 's brother 's boss 's brother 's mom the bottle .	the driver held your husband 's doctor 's cousin 's brother 's boss 's brother 's mom the bottle .
Rachel bought my son 's teacher 's wife 's husband 's cousin 's husband 's brother the rug .	Rachel cleaned my son 's teacher 's wife 's husband 's cousin 's husband 's brother the rug .
your doctor showed my father 's mom 's dentist 's boss 's boss 's husband 's mom the fork .	your doctor dropped my father 's mom 's dentist 's boss 's boss 's husband 's mom the fork .
Jerry gave my mom 's doctor 's friend 's doctor 's dentist 's cousin 's wife the fork .	Jerry kept my mom 's doctor 's friend 's doctor 's dentist 's cousin 's wife the fork .
your cousin gave my doctor 's cousin 's grandmother 's daughter 's grandmother 's doctor 's boss the bowl .	your cousin lost my doctor 's cousin 's grandmother 's daughter 's grandmother 's doctor 's boss the bowl .
my boss gave your brother 's husband 's mom 's wife 's father 's husband 's doctor the couch .	my boss lost your brother 's husband 's mom 's wife 's father 's husband 's doctor the couch .
my teacher gave your mom 's teacher 's grandmother 's mom 's daughter 's boss 's teacher the candle .	my teacher dropped your mom 's teacher 's grandmother 's mom 's daughter 's boss 's teacher the candle .
Amelia gave my daughter 's doctor 's wife 's boss 's daughter 's dentist 's daughter the crayon .	Amelia lost my daughter 's doctor 's wife 's boss 's daughter 's dentist 's daughter the crayon .
my friend sent my son 's daughter 's mother 's husband 's father 's boss 's dad the rocket .	my friend shook my son 's daughter 's mother 's husband 's father 's boss 's dad the rocket .
the dancer sent your mother 's dad 's daughter 's mother 's cousin 's brother 's dad the picture .	the dancer cleaned your mother 's dad 's daughter 's mother 's cousin 's brother 's dad the picture .
Sandra gave your sister 's sister 's wife 's father 's mother 's daughter 's brother the hat .	Sandra shook your sister 's sister 's wife 's father 's mother 's daughter 's brother the hat .
my doctor bought your father 's husband 's wife 's mom 's sister 's wife 's grandmother the dish .	my doctor held your father 's husband 's wife 's mom 's sister 's wife 's grandmother the dish .
Samantha gave my father 's mom 's sister 's wife 's doctor 's cousin 's dad the book .	Samantha kept my father 's mom 's sister 's wife 's doctor 's cousin 's dad the book .
my boss showed my cousin 's daughter 's son 's cousin 's son 's cousin 's friend the rug .	my boss kept my cousin 's daughter 's son 's cousin 's son 's cousin 's friend the rug .
John gave my mom 's grandmother 's daughter 's mother 's doctor 's mother 's father the ring .	John shook my mom 's grandmother 's daughter 's mother 's doctor 's mother 's father the ring .
Julie gave my dentist 's friend 's sister 's husband 's son 's teacher 's mom the dish .	Julie kept my dentist 's friend 's sister 's husband 's son 's teacher 's mom the dish .
the driver sent your mother 's grandmother 's sister 's son 's teacher 's dentist 's husband the rug .	the driver cleaned your mother 's grandmother 's sister 's son 's teacher 's dentist 's husband the rug .
the child sent my grandmother 's grandmother 's wife 's father 's grandmother 's boss 's boss the truck .	the child dropped my grandmother 's grandmother 's wife 's father 's grandmother 's boss 's boss the truck .
my cousin sent your daughter 's dentist 's wife 's brother 's husband 's cousin 's cousin the shoe .	my cousin moved your daughter 's dentist 's wife 's brother 's husband 's cousin 's cousin the shoe .
my friend bought your cousin 's husband 's grandmother 's sister 's dentist 's father 's wife the car .	my friend lost your cousin 's husband 's grandmother 's sister 's dentist 's father 's wife the car .
Aaron bought your dad 's mother 's daughter 's mom 's doctor 's wife 's grandmother the shoe .	Aaron shook your dad 's mother 's daughter 's mom 's doctor 's wife 's grandmother the shoe .
the child gave my boss 's boss 's daughter 's wife 's father 's brother 's daughter the picture .	the child cleaned my boss 's boss 's daughter 's wife 's father 's brother 's daughter the picture .
the teacher bought your grandmother 's brother 's dad 's sister 's brother 's teacher 's mother the hat .	the teacher lost your grandmother 's brother 's dad 's sister 's brother 's teacher 's mother the hat .
Mark bought your teacher 's boss 's daughter 's mom 's doctor 's daughter 's dentist the bag .	Mark kept your teacher 's boss 's daughter 's mom 's doctor 's daughter 's dentist the bag .
Vanessa gave your boss 's cousin 's sister 's dentist 's teacher 's friend 's teacher the bag .	Vanessa shook your boss 's cousin 's sister 's dentist 's teacher 's friend 's teacher the bag .
Paul showed your brother 's daughter 's mom 's husband 's grandmother 's husband 's doctor the dish .	Paul dropped your brother 's daughter 's mom 's husband 's grandmother 's husband 's doctor the dish .
my friend sent my mom 's cousin 's friend 's mom 's mom 's dentist 's brother the ship .	my friend cleaned my mom 's cousin 's friend 's mom 's mom 's dentist 's brother the ship .
Patrick gave my boss 's teacher 's mother 's brother 's dentist 's dad 's boss the truck .	Patrick shook my boss 's teacher 's mother 's brother 's dentist 's dad 's boss the truck .
your teacher showed your teacher 's brother 's mother 's boss 's brother 's mom 's brother the button .	your teacher cleaned your teacher 's brother 's mother 's boss 's brother 's mom 's brother the button .
Steve showed your sister 's grandmother 's sister 's husband 's dad 's father 's brother the doll .	Steve shook your sister 's grandmother 's sister 's husband 's dad 's father 's brother the doll .
your cousin sent your dad 's father 's dentist 's cousin 's daughter 's mother 's dad the shirt .	your cousin shook your dad 's father 's dentist 's cousin 's daughter 's mother 's dad the shirt .
Rachel bought your cousin 's husband 's husband 's brother 's dentist 's friend 's boss the plate .	Rachel moved your cousin 's husband 's husband 's brother 's dentist 's friend 's boss the plate .
Nancy gave your son 's mother 's mom 's son 's sister 's boss 's daughter the shoe .	Nancy cleaned your son 's mother 's mom 's son 's sister 's boss 's daughter the shoe .
my friend showed my mom 's dad 's friend 's son 's wife 's brother 's teacher the car .	my friend lost my mom 's dad 's friend 's son 's wife 's brother 's teacher the car .
my doctor sent your daughter 's doctor 's friend 's husband 's doctor 's daughter 's doctor the book .	my doctor kept your daughter 's doctor 's friend 's husband 's doctor 's daughter 's doctor the book .
John gave my husband 's dad 's daughter 's doctor 's son 's mother 's mom the bottle .	John dropped my husband 's dad 's daughter 's doctor 's son 's mother 's mom the bottle .
the adult gave my doctor 's husband 's sister 's daughter 's mom 's daughter 's son the bowl .	the adult shook my doctor 's husband 's sister 's daughter 's mom 's daughter 's son the bowl .
the person bought my son 's daughter 's mom 's cousin 's grandmother 's dentist 's doctor the bag .	the person held my son 's daughter 's mom 's cousin 's grandmother 's dentist 's doctor the bag .
your friend gave your teacher 's wife 's boss 's boss 's brother 's boss 's teacher the ship .	your friend moved your teacher 's wife 's boss 's boss 's brother 's boss 's teacher the ship .
my friend bought my husband 's friend 's father 's cousin 's friend 's mother 's friend the car .	my friend held my husband 's friend 's father 's cousin 's friend 's mother 's friend the car .
Laura gave your wife 's wife 's mom 's wife 's husband 's friend 's mother the fork .	Laura lost your wife 's wife 's mom 's wife 's husband 's friend 's mother the fork .
the teacher sent my dentist 's dentist 's mom 's brother 's cousin 's son 's wife the rug .	the teacher shook my dentist 's dentist 's mom 's brother 's cousin 's son 's wife the rug .
my friend gave your father 's dad 's daughter 's dentist 's husband 's brother 's wife the door .	my friend held your father 's dad 's daughter 's dentist 's husband 's brother 's wife the door .
Samantha showed your son 's brother 's husband 's mother 's husband 's mom 's sister the rocket .	Samantha lost your son 's brother 's husband 's mother 's husband 's mom 's sister the rocket .
my doctor gave your wife 's father 's mom 's father 's husband 's dentist 's sister the boat .	my doctor moved your wife 's father 's mom 's father 's husband 's dentist 's sister the boat .
Melissa gave your mom 's dentist 's cousin 's teacher 's cousin 's daughter 's cousin the bottle .	Melissa kept your mom 's dentist 's cousin 's teacher 's cousin 's daughter 's cousin the bottle .
your teacher bought your wife 's mom 's doctor 's brother 's teacher 's cousin 's wife the toy .	your teacher lost your wife 's mom 's doctor 's brother 's teacher 's cousin 's wife the toy .
Andrew bought my mother 's friend 's father 's sister 's son 's son 's mom the crayon .	Andrew moved my mother 's friend 's father 's sister 's son 's son 's mom the crayon .
the child sent my friend 's husband 's friend 's dad 's wife 's brother 's dad the glass .	the child dropped my friend 's husband 's friend 's dad 's wife 's brother 's dad the glass .
James showed your mother 's brother 's wife 's son 's father 's doctor 's doctor the spoon .	James kept your mother 's brother 's wife 's son 's father 's doctor 's doctor the spoon .
the teacher gave your friend 's doctor 's cousin 's mother 's brother 's friend 's husband the car .	the teacher kept your friend 's doctor 's cousin 's mother 's brother 's friend 's husband the car .
my teacher bought your sister 's teacher 's teacher 's grandmother 's cousin 's doctor 's dentist the window .	my teacher kept your sister 's teacher 's teacher 's grandmother 's cousin 's doctor 's dentist the window .
Becca sent my son 's mom 's teacher 's doctor 's father 's wife 's dentist the shoe .	Becca dropped my son 's mom 's teacher 's doctor 's father 's wife 's dentist the shoe .
the dentist bought my doctor 's doctor 's daughter 's dad 's sister 's dentist 's husband the fork .	the dentist lost my doctor 's doctor 's daughter 's dad 's sister 's dentist 's husband the fork .
the customer showed your daughter 's daughter 's grandmother 's doctor 's son 's teacher 's son the toy .	the customer lost your daughter 's daughter 's grandmother 's doctor 's son 's teacher 's son the toy .
my boss sent my teacher 's doctor 's daughter 's boss 's son 's mom 's mom the shoe .	my boss moved my teacher 's doctor 's daughter 's boss 's son 's mom 's mom the shoe .
your cousin showed my father 's mom 's brother 's wife 's grandmother 's wife 's mom the glass .	your cousin moved my father 's mom 's brother 's wife 's grandmother 's wife 's mom the glass .
Denise sent your father 's wife 's son 's sister 's sister 's father 's sister the candle .	Denise cleaned your father 's wife 's son 's sister 's sister 's father 's sister the candle .
Liam gave your brother 's dad 's doctor 's grandmother 's dad 's mother 's mother the car .	Liam cleaned your brother 's dad 's doctor 's grandmother 's dad 's mother 's mother the car .
Eric showed your dentist 's dad 's boss 's husband 's husband 's dentist 's dad the picture .	Eric dropped your dentist 's dad 's boss 's husband 's husband 's dentist 's dad the picture .
your doctor bought my mother 's brother 's dad 's grandmother 's friend 's husband 's dentist the ship .	your doctor cleaned my mother 's brother 's dad 's grandmother 's friend 's husband 's dentist the ship .
the person sent my dad 's sister 's daughter 's teacher 's brother 's brother 's boss the glass .	the person kept my dad 's sister 's daughter 's teacher 's brother 's brother 's boss the glass .
Tracy bought my dentist 's boss 's grandmother 's wife 's son 's grandmother 's mother the dish .	Tracy cleaned my dentist 's boss 's grandmother 's wife 's son 's grandmother 's mother the dish .
the child bought your cousin 's dentist 's cousin 's cousin 's grandmother 's son 's boss the book .	the child cleaned your cousin 's dentist 's cousin 's cousin 's grandmother 's son 's boss the book .
Jill bought my teacher 's son 's mother 's daughter 's cousin 's teacher 's teacher the truck .	Jill shook my teacher 's son 's mother 's daughter 's cousin 's teacher 's teacher the truck .
the teacher gave your dentist 's mom 's mom 's sister 's teacher 's father 's boss the chair .	the teacher held your dentist 's mom 's mom 's sister 's teacher 's father 's boss the chair .
Julia showed my wife 's friend 's mom 's grandmother 's father 's friend 's dad the window .	Julia kept my wife 's friend 's mom 's grandmother 's father 's friend 's dad the window .
the teacher sent your brother 's dad 's son 's dentist 's dentist 's boss 's friend the door .	the teacher lost your brother 's dad 's son 's dentist 's dentist 's boss 's friend the door .
the adult bought my daughter 's cousin 's sister 's husband 's brother 's friend 's sister the crayon .	the adult kept my daughter 's cousin 's sister 's husband 's brother 's friend 's sister the crayon .
your friend bought your dad 's mother 's dad 's doctor 's husband 's mother 's dad the couch .	your friend kept your dad 's mother 's dad 's doctor 's husband 's mother 's dad the couch .
the dentist bought my husband 's husband 's sister 's teacher 's boss 's brother 's doctor the book .	the dentist cleaned my husband 's husband 's sister 's teacher 's boss 's brother 's doctor the book .
George gave my sister 's cousin 's husband 's boss 's sister 's teacher 's teacher the plate .	George lost my sister 's cousin 's husband 's boss 's sister 's teacher 's teacher the plate .
Janet sent your dentist 's mother 's son 's husband 's cousin 's dad 's daughter the cup .	Janet kept your dentist 's mother 's son 's husband 's cousin 's dad 's daughter the cup .
the child bought your doctor 's dad 's boss 's daughter 's doctor 's daughter 's father the box .	the child held your doctor 's dad 's boss 's daughter 's doctor 's daughter 's father the box .
Christopher showed my doctor 's boss 's son 's dentist 's daughter 's father 's son the fork .	Christopher kept my doctor 's boss 's son 's dentist 's daughter 's father 's son the fork .
the child sent my friend 's dad 's wife 's mom 's friend 's brother 's wife the glass .	the child dropped my friend 's dad 's wife 's mom 's friend 's brother 's wife the glass .
the driver bought your sister 's cousin 's wife 's husband 's mother 's teacher 's daughter the window .	the driver shook your sister 's cousin 's wife 's husband 's mother 's teacher 's daughter the window .
Lisa sent my boss 's sister 's sister 's brother 's wife 's wife 's teacher the crayon .	Lisa moved my boss 's sister 's sister 's brother 's wife 's wife 's teacher the crayon .
Nina bought my friend 's mom 's cousin 's dentist 's teacher 's dentist 's brother the bed .	Nina held my friend 's mom 's cousin 's dentist 's teacher 's dentist 's brother the bed .
the dancer sent my dentist 's sister 's teacher 's teacher 's boss 's son 's teacher the rug .	the dancer lost my dentist 's sister 's teacher 's teacher 's boss 's son 's teacher the rug .
the teacher sent your boss 's friend 's cousin 's father 's cousin 's teacher 's friend the bicycle .	the teacher dropped your boss 's friend 's cousin 's father 's cousin 's teacher 's friend the bicycle .
Rachel gave my brother 's teacher 's son 's son 's friend 's father 's mom the rug .	Rachel dropped my brother 's teacher 's son 's son 's friend 's father 's mom the rug .
my dentist bought my sister 's cousin 's brother 's mother 's wife 's dentist 's grandmother the spoon .	my dentist held my sister 's cousin 's brother 's mother 's wife 's dentist 's grandmother the spoon .
my teacher bought your mother 's teacher 's doctor 's dad 's cousin 's doctor 's boss the bed .	my teacher dropped your mother 's teacher 's doctor 's dad 's cousin 's doctor 's boss the bed .
Paul bought your friend 's dentist 's daughter 's grandmother 's dentist 's cousin 's son the boat .	Paul moved your friend 's dentist 's daughter 's grandmother 's dentist 's cousin 's son the boat .
my dentist bought my daughter 's son 's father 's dentist 's grandmother 's brother 's dentist the bowl .	my dentist shook my daughter 's son 's father 's dentist 's grandmother 's brother 's dentist the bowl .
the person bought my father 's mom 's grandmother 's son 's mom 's mom 's wife the shoe .	the person held my father 's mom 's grandmother 's son 's mom 's mom 's wife the shoe .
the child gave my brother 's sister 's dentist 's mom 's sister 's grandmother 's sister the ship .	the child lost my brother 's sister 's dentist 's mom 's sister 's grandmother 's sister the ship .
Christopher gave your daughter 's mother 's husband 's grandmother 's teacher 's mother 's grandmother the picture .	Christopher lost your daughter 's mother 's husband 's grandmother 's teacher 's mother 's grandmother the picture .
your teacher gave your dentist 's grandmother 's mom 's son 's teacher 's dad 's son the rug .	your teacher cleaned your dentist 's grandmother 's mom 's son 's teacher 's dad 's son the rug .
Janet bought your sister 's boss 's sister 's dentist 's doctor 's wife 's friend the book .	Janet held your sister 's boss 's sister 's dentist 's doctor 's wife 's friend the book .
the dentist sent your sister 's grandmother 's sister 's mom 's husband 's doctor 's friend the button .	the dentist held your sister 's grandmother 's sister 's mom 's husband 's doctor 's friend the button .
my cousin bought your father 's daughter 's grandmother 's cousin 's cousin 's son 's doctor the glass .	my cousin held your father 's daughter 's grandmother 's cousin 's cousin 's son 's doctor the glass .
my teacher gave my mom 's boss 's mother 's dad 's friend 's friend 's grandmother the dish .	my teacher shook my mom 's boss 's mother 's dad 's friend 's friend 's grandmother the dish .
Paul bought your friend 's dentist 's dad 's son 's wife 's dentist 's boss the book .	Paul dropped your friend 's dentist 's dad 's son 's wife 's dentist 's boss the book .
Jessica gave your dentist 's daughter 's daughter 's doctor 's dad 's teacher 's son the crayon .	Jessica cleaned your dentist 's daughter 's daughter 's doctor 's dad 's teacher 's son the crayon .
my dentist bought your wife 's doctor 's son 's dad 's mother 's doctor 's doctor the rug .	my dentist dropped your wife 's doctor 's son 's dad 's mother 's doctor 's doctor the rug .
the doctor bought your cousin 's grandmother 's grandmother 's friend 's sister 's mother 's husband the glass .	the doctor kept your cousin 's grandmother 's grandmother 's friend 's sister 's mother 's husband the glass .
the dentist showed my mom 's sister 's sister 's teacher 's doctor 's dentist 's mother the boat .	the dentist held my mom 's sister 's sister 's teacher 's doctor 's dentist 's mother the boat .
the customer showed my grandmother 's doctor 's dad 's cousin 's friend 's dad 's sister the book .	the customer cleaned my grandmother 's doctor 's dad 's cousin 's friend 's dad 's sister the book .
Cindy sent your mother 's husband 's cousin 's husband 's wife 's grandmother 's son the bicycle .	Cindy shook your mother 's husband 's cousin 's husband 's wife 's grandmother 's son the bicycle .
your doctor gave your doctor 's teacher 's boss 's cousin 's dad 's grandmother 's brother the plane .	your doctor kept your doctor 's teacher 's boss 's cousin 's dad 's grandmother 's brother the plane .
your cousin sent my mother 's sister 's mom 's dad 's grandmother 's mother 's teacher the boat .	your cousin held my mother 's sister 's mom 's dad 's grandmother 's mother 's teacher the boat .
Becca sent my dad 's doctor 's grandmother 's teacher 's friend 's sister 's husband the crayon .	Becca moved my dad 's doctor 's grandmother 's teacher 's friend 's sister 's husband the crayon .
Guy bought my dentist 's grandmother 's husband 's boss 's dad 's daughter 's doctor the candle .	Guy cleaned my dentist 's grandmother 's husband 's boss 's dad 's daughter 's doctor the candle .
Leslie gave your boss 's friend 's mom 's sister 's boss 's doctor 's doctor the hat .	Leslie shook your boss 's friend 's mom 's sister 's boss 's doctor 's doctor the hat .
my friend bought my mother 's dentist 's teacher 's father 's dad 's sister 's daughter the plate .	my friend shook my mother 's dentist 's teacher 's father 's dad 's sister 's daughter the plate .
the adult bought my grandmother 's friend 's father 's dad 's husband 's dad 's father the dish .	the adult moved my grandmother 's friend 's father 's dad 's husband 's dad 's father the dish .
Jennifer bought your father 's dentist 's son 's boss 's mother 's wife 's dad the couch .	Jennifer lost your father 's dentist 's son 's boss 's mother 's wife 's dad the couch .
the dancer bought my doctor 's grandmother 's grandmother 's dentist 's doctor 's dad 's boss the plane .	the dancer kept my doctor 's grandmother 's grandmother 's dentist 's doctor 's dad 's boss the plane .
my boss gave my dentist 's sister 's teacher 's mom 's friend 's dad 's boss the door .	my boss lost my dentist 's sister 's teacher 's mom 's friend 's dad 's boss the door .
Amelia gave your father 's son 's mom 's boss 's boss 's cousin 's teacher the shoe .	Amelia kept your father 's son 's mom 's boss 's boss 's cousin 's teacher the shoe .
Judy gave your friend 's friend 's father 's daughter 's mother 's son 's dentist the door .	Judy shook your friend 's friend 's father 's daughter 's mother 's son 's dentist the door .
my teacher bought your teacher 's daughter 's grandmother 's brother 's wife 's grandmother 's doctor the boat .	my teacher cleaned your teacher 's daughter 's grandmother 's brother 's wife 's grandmother 's doctor the boat .
